Post Date,Description,Debit,Status,Balance,date,amount,vendor_group,amount_grouped
6/6/2025,"Recurring Withdrawal Debit Card - MC Debit Gator/SUPERPOWER CHATGPT MIDDLETOWN DE
Date 06/05/25 0 5156229550 1 5734
Card 1247",15.0,Posted,847.61,2025-06-06,15.0,"Recurring Withdrawal Debit Card - MC Debit Gator/SUPERPOWER CHATGPT MIDDLETOWN DE
Date 06/05/25 0 5156229550 1 5734
Card 1247",15.0
6/6/2025,"Recurring Withdrawal Debit Card - MC Debit Gator/SUPERPOWER CHATGPT MIDDLETOWN DE
Date 06/05/25 0 5156229549 1 5734
Card 1247",15.0,Posted,862.61,2025-06-06,15.0,"Recurring Withdrawal Debit Card - MC Debit Gator/SUPERPOWER CHATGPT MIDDLETOWN DE
Date 06/05/25 0 5156229550 1 5734
Card 1247",15.0
6/6/2025,"Withdrawal Debit Card MC Debit Gator/IONOS INC. CHESTERBROOK PA
Date 06/05/25 0 5156041339 1 4816
Card 1247",60.0,Posted,877.61,2025-06-06,60.0,"Withdrawal Debit Card MC Debit Gator/IONOS INC. CHESTERBROOK PA
Date 06/05/25 0 5156041339 1 4816
Card 1247",60.0
6/5/2025,"Recurring Withdrawal Debit Card - MC Debit Gator/OPENAI *CHATGPT SUBSCR SAN FRANCISC CA
Date 06/04/25 0 5155335474 0 5734
Card 1247",20.0,Posted,937.61,2025-06-05,20.0,"Recurring Withdrawal Debit Card - MC Debit Gator/OPENAI *CHATGPT SUBSCR SAN FRANCISC CA
Date 06/04/25 0 5155335474 0 5734
Card 1247",20.0
6/4/2025,"Recurring Withdrawal Debit Card - MC Debit Gator/APPLE.COM/BILL 866-712-7753 CA
Date 06/03/25 0 5154093226 1 5818
Card 1247",6.98,Posted,957.61,2025-06-04,6.98,"Recurring Withdrawal Debit Card - MC Debit Gator/APPLE.COM/BILL 866-712-7753 CA
Date 06/03/25 0 5154093226 1 5818
Card 1247",6.98
6/4/2025,"Withdrawal Bill Payment #000000229775/ADOBE INC ADOBE ADOBE.COM SAN JOSE CA
Card 1247",19.99,Posted,964.59,2025-06-04,19.99,"Withdrawal Bill Payment #000000229775/ADOBE INC ADOBE ADOBE.COM SAN JOSE CA
Card 1247",19.99
6/4/2025,"Withdrawal POS #000000580851/SUNOCO 8002212501 4234 SW 20TH AVE
GAINESVILLE FL
Card 1247",26.86,Posted,984.58,2025-06-04,26.86,"Withdrawal POS #000000580851/SUNOCO 8002212501 4234 SW 20TH AVE
GAINESVILLE FL
Card 1247",26.86
6/3/2025,"Recurring Withdrawal Debit Card - MC Debit Gator/OPENAI SAN FRANCISC CA
Date 06/02/25 0 5153238318 1 5734
Card 1247",6.06,Posted,1011.44,2025-06-03,6.06,Recurring Withdrawal Debit Card - MC Debit Gator/OPENAI SAN FRANCISC CADate 03/08/25 0 5067339145 0 5734Card 1247,6.29875
6/3/2025,"Recurring Withdrawal Debit Card - MC Debit Gator/NOTION LABS, INC. SAN FRANCISC CA
Date 06/02/25 0 5153210973 1 7372
Card 1247",22.0,Posted,1017.5,2025-06-03,22.0,"Recurring Withdrawal Debit Card - MC Debit Gator/NOTION LABS, INC. SAN FRANCISC CA
Date 06/02/25 0 5153210973 1 7372
Card 1247",22.0
6/3/2025,"Recurring Withdrawal Debit Card - MC Debit Gator/OPENAI SAN FRANCISC CA
Date 06/02/25 0 5153210920 1 5734
Card 1247",6.06,Posted,1039.5,2025-06-03,6.06,"Recurring Withdrawal Debit Card - MC Debit Gator/OPENAI SAN FRANCISC CA
Date 05/31/25 0 5151282040 2 5734
Card 1247",6.346666666666667
6/3/2025,"Recurring Withdrawal Debit Card - MC Debit Gator/APPLE.COM/BILL 866-712-7753 CA
Date 06/03/25 0 5154230337 1 5818
Card 1247",2.99,Posted,1045.56,2025-06-03,2.99,"Recurring Withdrawal Debit Card - MC Debit Gator/APPLE.COM/BILL 866-712-7753 CA
Date 06/03/25 0 5154093226 1 5818
Card 1247",2.99
6/3/2025,"Withdrawal Bill Payment #000000197457/ADOBE INC ADOBE ADOBE.COM SAN JOSE CA
Card 1247",19.99,Posted,1048.55,2025-06-03,19.99,"Withdrawal Bill Payment #000000229775/ADOBE INC ADOBE ADOBE.COM SAN JOSE CA
Card 1247",19.99
6/3/2025,"Recurring Withdrawal Bill Payment - #000000000059/ADOBE INC CS ADDTL STORAG ADOBE.COM SAN
JOSE CA
Card 1247",9.99,Posted,1068.54,2025-06-03,9.99,"Recurring Withdrawal Bill Payment - #000000000059/ADOBE INC CS ADDTL STORAG ADOBE.COM SAN
JOSE CA
Card 1247",9.99
6/3/2025,"Recurring Withdrawal Bill Payment - #000000362823/ADOBE INC ADOBE ADOBE.COM SAN JOSE CA
Card 1247",19.99,Posted,1078.53,2025-06-03,19.99,"Recurring Withdrawal Bill Payment - #000000000059/ADOBE INC CS ADDTL STORAG ADOBE.COM SAN
JOSE CA
Card 1247",19.99
6/2/2025,"Withdrawal POS #000000572320/SUNOCO 8002212501 4234 SW 20TH AVE
GAINESVILLE FL
Card 1247",22.17,Posted,1098.52,2025-06-02,22.17,"Withdrawal POS #000000666979/SUNOCO 8002212501 4234 SW 20TH AVE
GAINESVILLE FL
Card 1247",22.005000000000003
6/2/2025,"Recurring Withdrawal Debit Card - MC Debit Gator/MYDESIGNS - PRO - MON LAS VEGAS NV
Date 06/01/25 0 5152146505 1 5734
Card 1247",49.99,Posted,1120.69,2025-06-02,49.99,"Recurring Withdrawal Debit Card - MC Debit Gator/MYDESIGNS - PRO - MON LAS VEGAS NV
Date 06/01/25 0 5152146505 1 5734
Card 1247",49.99
6/2/2025,"Recurring Withdrawal Debit Card - MC Debit Gator/OPENAI SAN FRANCISC CA
Date 06/02/25 0 5153117531 1 5734
Card 1247",6.04,Posted,1170.68,2025-06-02,6.04,Recurring Withdrawal Debit Card - MC Debit Gator/OPENAI SAN FRANCISC CADate 03/08/25 0 5067339145 0 5734Card 1247,6.29875
6/2/2025,"Recurring Withdrawal Debit Card - MC Debit Gator/OPENAI SAN FRANCISC CA
Date 05/31/25 0 5151282040 2 5734
Card 1247",6.27,Posted,1176.72,2025-06-02,6.27,"Recurring Withdrawal Debit Card - MC Debit Gator/OPENAI SAN FRANCISC CA
Date 05/31/25 0 5151282040 2 5734
Card 1247",6.346666666666667
6/2/2025,"Recurring Withdrawal Debit Card - MC Debit Gator/OPENAI SAN FRANCISC CA
Date 06/01/25 0 5152295185 0 5734
Card 1247",6.24,Posted,1182.99,2025-06-02,6.24,Recurring Withdrawal Debit Card - MC Debit Gator/OPENAI SAN FRANCISC CADate 03/08/25 0 5067339145 0 5734Card 1247,6.29875
6/2/2025,"Recurring Withdrawal Debit Card - MC Debit Gator/OPENAI SAN FRANCISC CA
Date 05/31/25 0 5151556312 2 5734
Card 1247",6.22,Posted,1189.23,2025-06-02,6.22,"Withdrawal Debit Card MC Debit Gator/VIDIQ SAN FRANCISC CA
Date 05/31/25 0 5151573162 0 5734
Card 1247",6.22
6/2/2025,"Recurring Withdrawal Debit Card - MC Debit Gator/PARAMOUNT+ WEST HOLLYWO CA
Date 06/01/25 0 5152328615 1 4899
Card 1247",14.96,Posted,1195.45,2025-06-02,14.96,"Recurring Withdrawal Debit Card - MC Debit Gator/PARAMOUNT+ WEST HOLLYWO CA
Date 06/01/25 0 5152328615 1 4899
Card 1247",14.96
6/2/2025,"Recurring Withdrawal Debit Card - MC Debit Gator/PADDLE.NET* SETAPP NEW YORK NY
Date 05/31/25 0 5151555568 2 5817
Card 1247",9.99,Posted,1210.41,2025-06-02,9.99,"Recurring Withdrawal Debit Card - MC Debit Gator/PADDLE.NET* SETAPP NEW YORK NY
Date 05/31/25 0 5151555568 2 5817
Card 1247",9.99
6/2/2025,"Withdrawal Debit Card MC Debit Gator/INVIDEO INC COUNTRY OF S DE
Date 06/01/25 0 5152143829 1 5734
Card 1247",33.04,Posted,1220.4,2025-06-02,33.04,"Withdrawal Debit Card MC Debit Gator/INVIDEO INC COUNTRY OF S DE
Date 06/01/25 0 5152143829 1 5734
Card 1247",33.04
6/2/2025,"Withdrawal Debit Card MC Debit Gator/VIDIQ SAN FRANCISC CA
Date 05/31/25 0 5151573162 0 5734
Card 1247",19.0,Posted,1253.44,2025-06-02,19.0,"Withdrawal Debit Card MC Debit Gator/VIDIQ SAN FRANCISC CA
Date 05/31/25 0 5151573162 0 5734
Card 1247",19.0
6/2/2025,"Withdrawal Debit Card MC Debit Gator/INVIDEO INC COUNTRY OF S DE
Date 05/31/25 0 5151554623 2 5734
Card 1247",25.0,Posted,1272.44,2025-06-02,25.0,"Withdrawal Debit Card MC Debit Gator/INVIDEO INC COUNTRY OF S DE
Date 06/01/25 0 5152143829 1 5734
Card 1247",25.0
6/2/2025,"Withdrawal Debit Card MC Debit Gator/INSTACART*159 SAN FRANCISC CA
Date 05/31/25 0 5151554560 2 5411
Card 1247",3.0,Posted,1297.44,2025-06-02,3.0,"Withdrawal Debit Card MC Debit Gator/INSTACART*159 SAN FRANCISC CA
Date 05/31/25 0 5151554560 2 5411
Card 1247",3.0
6/2/2025,"Withdrawal Debit Card MC Debit Gator/INSTACART*159 SAN FRANCISC CA
Date 05/31/25 0 5151554551 2 5411
Card 1247",39.76,Posted,1300.44,2025-06-02,39.76,"Withdrawal Debit Card MC Debit Gator/INSTACART*159 SAN FRANCISC CA
Date 05/31/25 0 5151554560 2 5411
Card 1247",39.76
6/2/2025,"Recurring Withdrawal Debit Card Fee/MASTERCARD ISSUER CROSS-BORDER FEE
Date 06/01/25 0 5152326251 1 5734
Card 1247",0.1,Posted,1340.2,2025-06-02,0.1,"Recurring Withdrawal Debit Card Fee/MASTERCARD ISSUER CROSS-BORDER FEE
Date 06/01/25 0 5152326251 1 5734
Card 1247",0.065
6/2/2025,"Recurring Withdrawal Debit Card - MC Debit Gator/LEONARDO.AI NORTH SYDNEY NS
Date 06/01/25 0 5152326251 1 5734
Card 1247",12.0,Posted,1340.3,2025-06-02,12.0,"Recurring Withdrawal Debit Card - MC Debit Gator/LEONARDO.AI NORTH SYDNEY NS
Date 06/01/25 0 5152326251 1 5734
Card 1247",12.0
6/2/2025,"Recurring Withdrawal Debit Card Fee/MASTERCARD ISSUER CROSS-BORDER FEE
Date 05/31/25 0 5151375863 2 5817
Card 1247",0.08,Posted,1352.3,2025-06-02,0.08,"Withdrawal Debit Card Fee/MASTERCARD ISSUER CROSS-BORDER FEE
Date 03/31/25 0 5090929332 0 5817
Card 1247",0.11399999999999999
6/2/2025,"Recurring Withdrawal Debit Card - MC Debit Gator/OBSIDIAN.MD OAKVILLE ON
Date 05/31/25 0 5151375863 2 5817
Card 1247",10.0,Posted,1352.38,2025-06-02,10.0,"Recurring Withdrawal Debit Card - MC Debit Gator/OBSIDIAN.MD OAKVILLE ON
Date 05/31/25 0 5151375863 2 5817
Card 1247",10.0
6/2/2025,"Withdrawal Debit Card Fee/MASTERCARD ISSUER CROSS-BORDER FEE
Date 05/31/25 0 5151554310 2 5734
Card 1247",0.16,Posted,1362.38,2025-06-02,0.16,"Withdrawal Debit Card Fee/MASTERCARD ISSUER CROSS-BORDER FEE
Date 03/31/25 0 5090929332 0 5817
Card 1247",0.11399999999999999
6/2/2025,"Withdrawal Debit Card MC Debit Gator/IDEOGRAM AI TORONTO ON
Date 05/31/25 0 5151554310 2 5734
Card 1247",20.0,Posted,1362.54,2025-06-02,20.0,"Withdrawal Debit Card MC Debit Gator/IDEOGRAM AI TORONTO ON
Date 05/31/25 0 5151554310 2 5734
Card 1247",20.0
6/2/2025,"Recurring Withdrawal Debit Card Fee/MASTERCARD ISSUER CROSS-BORDER FEE
Date 05/31/25 0 5151554309 2 5734
Card 1247",0.03,Posted,1382.54,2025-06-02,0.03,"Recurring Withdrawal Debit Card Fee/MASTERCARD ISSUER CROSS-BORDER FEE
Date 06/01/25 0 5152326251 1 5734
Card 1247",0.065
6/2/2025,"Recurring Withdrawal Debit Card - MC Debit Gator/IDEOGRAM AI TORONTO ON
Date 05/31/25 0 5151554309 2 5734
Card 1247",3.2,Posted,1382.57,2025-06-02,3.2,"Recurring Withdrawal Debit Card - MC Debit Gator/IDEOGRAM AI TORONTO ON
Date 04/08/25 0 5098321266 0 5734
Card 1247",3.2
6/2/2025,"Withdrawal ACH Watson Realty Co/TYPE: WEB PMTS ID: 9000321157
CO: Watson Realty Co
NAME: Steven chaplinskiEntry Class Code: WEB",1179.0,Posted,1385.77,2025-06-02,1179.0,"Withdrawal ACH Watson Realty Co/TYPE: WEB PMTS ID: 9000321157
CO: Watson Realty Co
NAME: Steven chaplinskiEntry Class Code: WEB",1179.0
6/2/2025,"Withdrawal ACH AppFolio, Inc. F/TYPE: WEB PMTS ID: 9001406550
CO: AppFolio, Inc. F
NAME: Steven chaplinskiEntry Class Code: WEB",2.49,Posted,2564.77,2025-06-02,2.49,"Withdrawal ACH AppFolio, Inc. F/TYPE: WEB PMTS ID: 9001406550
CO: AppFolio, Inc. F
NAME: Steven chaplinskiEntry Class Code: WEB",2.49
6/1/2025,"Withdrawal POS #000000000002/ETSY.COM*US ETSY.COM*AIAV WWW.ETSY.COM/
BROOKLYN NY
Card 1247",0.6,Posted,2567.26,2025-06-01,0.6,"Withdrawal POS #000000000002/ETSY.COM*US ETSY.COM*AIAV WWW.ETSY.COM/
BROOKLYN NY
Card 1247",0.6
6/1/2025,"Withdrawal POS #000020312090/GOOGLE *YouTubePremium 1600 Amphitheatre
Parkw Mountain View CA
Card 1247",15.92,Posted,2567.86,2025-06-01,15.92,"Withdrawal POS #000020312090/GOOGLE *YouTubePremium 1600 Amphitheatre
Parkw Mountain View CA
Card 1247",15.92
5/31/2025,"Recurring Withdrawal Debit Card - MC Debit Gator/OPENAI SAN FRANCISC CA
Date 05/31/25 0 5151240922 1 5734
Card 1247",6.71,Posted,2583.78,2025-05-31,6.71,"Recurring Withdrawal Debit Card - MC Debit Gator/OPENAI SAN FRANCISC CA
Date 05/31/25 0 5151282040 2 5734
Card 1247",6.346666666666667
5/31/2025,"Recurring Withdrawal Debit Card - MC Debit Gator/OPENAI SAN FRANCISC CA
Date 05/30/25 0 5150240921 1 5734
Card 1247",6.63,Posted,2590.49,2025-05-31,6.63,Recurring Withdrawal Debit Card - MC Debit Gator/OPENAI SAN FRANCISC CADate 03/08/25 0 5067339145 0 5734Card 1247,6.29875
5/31/2025,"Recurring Withdrawal Debit Card - MC Debit Gator/OPENAI SAN FRANCISC CA
Date 05/30/25 0 5150059225 1 5734
Card 1247",6.24,Posted,2597.12,2025-05-31,6.24,Recurring Withdrawal Debit Card - MC Debit Gator/OPENAI SAN FRANCISC CADate 03/08/25 0 5067339145 0 5734Card 1247,6.29875
5/31/2025,"Withdrawal Debit Card MC Debit Gator/WALGREENS #9304 GAINESVILLE FL
Date 05/30/25 0 5150232309 1 5912
Card 1247",23.78,Posted,2603.36,2025-05-31,23.78,"Withdrawal Debit Card MC Debit Gator/WALGREENS #9304 GAINESVILLE FL
Date 05/30/25 0 5150232309 1 5912
Card 1247",23.78
5/31/2025,"Withdrawal Debit Card MC Debit Gator/WALGREENS #5024 GAINESVILLE FL
Date 05/30/25 0 5150232278 1 5912
Card 1247",15.0,Posted,2627.14,2025-05-31,15.0,"Withdrawal Debit Card MC Debit Gator/WALGREENS #9304 GAINESVILLE FL
Date 05/30/25 0 5150232309 1 5912
Card 1247",15.0
5/31/2025,"Withdrawal POS #000000256943/AMAZON.COM*NN6201DU0 SEATTLE WA
Card 1247",30.34,Posted,2642.14,2025-05-31,30.34,"Withdrawal POS #000000256943/AMAZON.COM*NN6201DU0 SEATTLE WA
Card 1247",30.34
5/30/2025,"Withdrawal POS #000000347331/SUNOCO 8002212501 4234 SW 20TH AVE
GAINESVILLE FL
Card 1247",39.5,Posted,2672.48,2025-05-30,39.5,"Withdrawal POS #000000666979/SUNOCO 8002212501 4234 SW 20TH AVE
GAINESVILLE FL
Card 1247",39.5
5/30/2025,"Withdrawal ATM Fee/EFT 6419 W Newberry Rd Gainesville FL
Card 1247",2.0,Posted,2711.98,2025-05-30,2.0,"Withdrawal ATM Fee/EFT 6419 W Newberry Rd Gainesville FL
Card 1247",2.0
5/30/2025,"Withdrawal at ATM #000000785755/EFT 6419 W Newberry Rd Gainesville FL
Card 1247",128.0,Posted,2713.98,2025-05-30,128.0,"Withdrawal at ATM #000000785755/EFT 6419 W Newberry Rd Gainesville FL
Card 1247",128.0
5/30/2025,Withdrawal CourtesyFeeDebit,35.0,Posted,-158.02,2025-05-30,35.0,Withdrawal CourtesyFeeDebit,35.0
5/30/2025,"Recurring Withdrawal Debit Card - MC Debit Gator/SUPERPOWER CHATGPT MIDDLETOWN DE
Date 05/29/25 0 5149990977 0 5734
Card 1247",15.0,Posted,-123.02,2025-05-30,15.0,"Recurring Withdrawal Debit Card - MC Debit Gator/SUPERPOWER CHATGPT MIDDLETOWN DE
Date 06/05/25 0 5156229550 1 5734
Card 1247",15.0
5/28/2025,Withdrawal CourtesyFeeDebit,35.0,Posted,-108.02,2025-05-28,35.0,Withdrawal CourtesyFeeDebit,35.0
5/28/2025,"Recurring Withdrawal Debit Card - MC Debit Gator/IC* INSTACART*SUBSCRIP SAN FRANCISC CA
Date 05/27/25 0 5147989663 0 5411
Card 1247",9.99,Posted,-73.02,2025-05-28,9.99,"Recurring Withdrawal Debit Card - MC Debit Gator/IC* INSTACART*SUBSCRIP SAN FRANCISC CA
Date 05/27/25 0 5147989663 0 5411
Card 1247",9.99
5/26/2025,Withdrawal CourtesyFeeDebit,35.0,Posted,-63.03,2025-05-26,35.0,Withdrawal CourtesyFeeDebit,35.0
5/26/2025,"Withdrawal POS #000000216148/SUNOCO 8002212501 4234 SW 20TH AVE
GAINESVILLE FL
Card 1247",20.76,Posted,-28.03,2025-05-26,20.76,"Withdrawal POS #000000666979/SUNOCO 8002212501 4234 SW 20TH AVE
GAINESVILLE FL
Card 1247",20.76
5/26/2025,"Withdrawal Debit Card MC Debit Gator/CIRCLE K # 26146 GAINESVILLE FL
Date 05/24/25 0 5144137268 1 5499
Card 1247",7.72,Posted,-7.27,2025-05-26,7.72,"Withdrawal Debit Card MC Debit Gator/CIRCLE K # 26146 GAINESVILLE FL
Date 05/24/25 0 5144137268 1 5499
Card 1247",7.72
5/26/2025,"Withdrawal Debit Card MC Debit Gator/CIRCLE K # 06782 GAINESVILLE FL
Date 05/24/25 0 5144137005 1 5499
Card 1247",19.54,Posted,0.45,2025-05-26,19.54,Withdrawal Debit Card MC Debit Gator/CIRCLE K # 06782 GAINESVILLE FLDate 01/31/25 0 5031331003 1 5499Card 1247,19.54
5/25/2025,"Recurring Withdrawal Debit Card - MC Debit Gator/NETFLIX.COM LOS GATOS CA
Date 05/23/25 0 5143471019 2 4899
Card 1247",20.71,Posted,19.99,2025-05-25,20.71,"Recurring Withdrawal Debit Card - MC Debit Gator/NETFLIX.COM LOS GATOS CA
Date 05/23/25 0 5143471019 2 4899
Card 1247",20.71
5/25/2025,"Withdrawal POS #000000133422/SUNOCO 8002212501 4234 SW 20TH AVE
GAINESVILLE FL
Card 1247",20.76,Posted,40.7,2025-05-25,20.76,"Withdrawal POS #000000216148/SUNOCO 8002212501 4234 SW 20TH AVE
GAINESVILLE FL
Card 1247",20.33
5/24/2025,"Withdrawal ATM Fee/EFT 6419 W Newberry Rd Gainesville FL
Card 1247",2.0,Posted,61.46,2025-05-24,2.0,"Withdrawal ATM Fee/EFT 6419 W Newberry Rd Gainesville FL
Card 1247",2.0
5/24/2025,"Withdrawal at ATM #000000478783/EFT 6419 W Newberry Rd Gainesville FL
Card 1247",63.0,Posted,63.46,2025-05-24,63.0,"Withdrawal at ATM #000000785755/EFT 6419 W Newberry Rd Gainesville FL
Card 1247",63.0
5/21/2025,"Withdrawal POS #000000059286/SUNOCO 8002212501 4234 SW 20TH AVE
GAINESVILLE FL
Card 1247",16.79,Posted,1.46,2025-05-21,16.79,"Withdrawal POS #000000666979/SUNOCO 8002212501 4234 SW 20TH AVE
GAINESVILLE FL
Card 1247",16.79
5/21/2025,"Withdrawal Debit Card MC Debit Gator/INSTACART*159 SAN FRANCISC CA
Date 05/20/25 0 5140325944 0 5411
Card 1247",62.0,Posted,-81.75,2025-05-21,62.0,"Withdrawal Debit Card MC Debit Gator/INSTACART*159 SAN FRANCISC CA
Date 03/22/25 0 5081791779 0 5411
Card 1247",62.0
5/21/2025,"Recurring Withdrawal Debit Card - MC Debit Gator/CANVA* I04522-50593645 CAMDEN DE
Date 05/20/25 0 5140963894 0 7333
Card 1247",12.99,Posted,-19.75,2025-05-21,12.99,"Recurring Withdrawal Debit Card - MC Debit Gator/CANVA* I04522-50593645 CAMDEN DE
Date 05/20/25 0 5140963894 0 7333
Card 1247",12.99
5/21/2025,"Withdrawal Debit Card MC Debit Gator/CIRCLE K # 06782 GAINESVILLE FL
Date 05/19/25 0 5139975993 0 5499
Card 1247",19.54,Posted,-6.76,2025-05-21,19.54,Withdrawal Debit Card MC Debit Gator/CIRCLE K # 06782 GAINESVILLE FLDate 01/31/25 0 5031331003 1 5499Card 1247,19.54
5/20/2025,Withdrawal ATM Transaction,20.0,Posted,12.78,2025-05-20,20.0,Withdrawal ATM Transaction,20.0
5/20/2025,"Withdrawal Debit Card MC Debit Gator/SUNOCO 8002212501 QPS GAINESVILLE FL
Date 05/19/25 0 5139082313 1 5541
Card 1247",22.17,Posted,32.78,2025-05-20,22.17,"Withdrawal Debit Card MC Debit Gator/SUNOCO 8002212501 QPS GAINESVILLE FL
Date 05/19/25 0 5139082313 1 5541
Card 1247",22.005000000000003
5/19/2025,"Withdrawal Debit Card MC Debit Gator/INSTACART*159 SAN FRANCISC CA
Date 05/18/25 0 5138957555 0 5411
Card 1247",45.67,Posted,54.95,2025-05-19,45.67,"Withdrawal Debit Card MC Debit Gator/INSTACART*159 SAN FRANCISC CA
Date 03/22/25 0 5081791779 0 5411
Card 1247",45.67
5/19/2025,"Withdrawal Debit Card MC Debit Gator/SUNOCO 8002212501 QPS GAINESVILLE FL
Date 05/18/25 0 5138961883 0 5541
Card 1247",20.76,Posted,100.62,2025-05-19,20.76,"Withdrawal Debit Card MC Debit Gator/SUNOCO 8002212501 QPS GAINESVILLE FL
Date 05/19/25 0 5139082313 1 5541
Card 1247",20.545
5/19/2025,"Withdrawal ACH FLUENT-Gainesvil/TYPE: PAYMENT ID: 1371804719
CO: FLUENT-Gainesvil
NAME: steven chaplinskiEntry Class Code: WEB",55.0,Posted,121.38,2025-05-19,55.0,"Withdrawal ACH FLUENT-Gainesvil/TYPE: PAYMENT ID: 1371804719
CO: FLUENT-Gainesvil
NAME: steven chaplinskiEntry Class Code: WEB",55.0
5/18/2025,"Withdrawal Debit Card MC Debit Gator/UBER *TRIP 8005928996 CA
Date 05/17/25 0 5137425800 0 4121
Card 1247",12.93,Posted,176.38,2025-05-18,12.93,"Withdrawal Debit Card MC Debit Gator/UBER *TRIP 8005928996 CA
Date 05/17/25 0 5137425800 0 4121
Card 1247",12.93
5/18/2025,"Withdrawal Debit Card MC Debit Gator/UBER TRIP* TRIP SAN FRANCISC CA
Date 05/17/25 0 5137032195 1 4121
Card 1247",7.84,Posted,189.31,2025-05-18,7.84,"Withdrawal Debit Card MC Debit Gator/UBER TRIP* TRIP SAN FRANCISC CA
Date 05/17/25 0 5137032195 1 4121
Card 1247",7.84
5/18/2025,"Withdrawal Debit Card MC Debit Gator/SUNOCO 8002212501 QPS GAINESVILLE FL
Date 05/17/25 0 5137923930 0 5541
Card 1247",20.33,Posted,197.15,2025-05-18,20.33,"Withdrawal Debit Card MC Debit Gator/SUNOCO 8002212501 QPS GAINESVILLE FL
Date 05/19/25 0 5139082313 1 5541
Card 1247",20.545
5/18/2025,"Withdrawal Debit Card MC Debit Gator/SUNOCO 8002212501 QPS GAINESVILLE FL
Date 05/17/25 0 5137923929 0 5541
Card 1247",17.28,Posted,217.48,2025-05-18,17.28,"Withdrawal Debit Card MC Debit Gator/SUNOCO 8002212501 QPS GAINESVILLE FL
Date 05/19/25 0 5139082313 1 5541
Card 1247",17.28
5/18/2025,"Recurring Withdrawal Debit Card - MC Debit Gator/CHIPOTLE ONLINE CHIPOTLE.COM CA
Date 05/17/25 0 5137923085 0 5814
Card 1247",20.0,Posted,234.76,2025-05-18,20.0,"Recurring Withdrawal Debit Card - MC Debit Gator/CHIPOTLE ONLINE CHIPOTLE.COM CA
Date 05/17/25 0 5137923085 0 5814
Card 1247",20.0
5/18/2025,"Recurring Withdrawal Debit Card - MC Debit Gator/AMAZON PRIME*NZ72M6V92 AMZN.COM/BIL WA
Date 05/17/25 0 5137026065 1 5968
Card 1247",15.13,Posted,254.76,2025-05-18,15.13,"Recurring Withdrawal Debit Card - MC Debit Gator/AMAZON PRIME*NZ72M6V92 AMZN.COM/BIL WA
Date 05/17/25 0 5137026065 1 5968
Card 1247",15.13
5/16/2025,"Withdrawal Debit Card MC Debit Gator/UBER *TRIP 8005928996 CA
Date 05/15/25 0 5135067572 1 4121
Card 1247",18.97,Posted,269.89,2025-05-16,18.97,"Withdrawal Debit Card MC Debit Gator/UBER *TRIP 8005928996 CA
Date 05/17/25 0 5137425800 0 4121
Card 1247",18.97
5/16/2025,"Withdrawal Debit Card MC Debit Gator/SUNOCO 8002212501 QPS GAINESVILLE FL
Date 05/15/25 0 5135215071 1 5541
Card 1247",34.99,Posted,288.86,2025-05-16,34.99,"Withdrawal Debit Card MC Debit Gator/SUNOCO 8002212501 QPS GAINESVILLE FL
Date 05/19/25 0 5139082313 1 5541
Card 1247",34.99
5/16/2025,"Withdrawal ACH FLUENT-Gainesvil/TYPE: PAYMENT ID: 1371804719
CO: FLUENT-Gainesvil
NAME: steven chaplinskiEntry Class Code: WEB",25.0,Posted,323.85,2025-05-16,25.0,"Withdrawal ACH FLUENT-Gainesvil/TYPE: PAYMENT ID: 1371804719
CO: FLUENT-Gainesvil
NAME: steven chaplinskiEntry Class Code: WEB",25.0
5/15/2025,"Withdrawal Debit Card MC Debit Gator/INSTACART*159 SAN FRANCISC CA
Date 05/14/25 0 5134998729 0 5411
Card 1247",3.41,Posted,348.85,2025-05-15,3.41,Withdrawal Debit Card MC Debit Gator/INSTACART*159 SAN FRANCISC CADate 03/13/25 0 5072883709 0 5411Card 1247,3.75
5/15/2025,"Withdrawal Debit Card MC Debit Gator/INSTACART*159 SAN FRANCISC CA
Date 05/14/25 0 5134998723 0 5411
Card 1247",55.08,Posted,352.26,2025-05-15,55.08,"Withdrawal Debit Card MC Debit Gator/INSTACART*159 SAN FRANCISC CA
Date 03/22/25 0 5081791779 0 5411
Card 1247",55.04
5/15/2025,"Withdrawal Debit Card MC Debit Gator/SUNOCO 8002212501 QPS GAINESVILLE FL
Date 05/14/25 0 5134204005 1 5541
Card 1247",24.19,Posted,407.34,2025-05-15,24.19,"Withdrawal Debit Card MC Debit Gator/SUNOCO 8002212501 QPS GAINESVILLE FL
Date 05/19/25 0 5139082313 1 5541
Card 1247",24.19
5/14/2025,"Withdrawal Debit Card MC Debit Gator/SUNOCO 8002212501 QPS GAINESVILLE FL
Date 05/13/25 0 5133133164 1 5541
Card 1247",24.19,Posted,431.53,2025-05-14,24.19,"Withdrawal Debit Card MC Debit Gator/SUNOCO 8002212501 QPS GAINESVILLE FL
Date 05/19/25 0 5139082313 1 5541
Card 1247",24.19
5/14/2025,"Recurring Withdrawal Debit Card Fee/MASTERCARD ISSUER CROSS-BORDER FEE
Date 05/13/25 0 5133953606 0 5734
Card 1247",0.08,Posted,455.72,2025-05-14,0.08,"Withdrawal Debit Card Fee/MASTERCARD ISSUER CROSS-BORDER FEE
Date 03/31/25 0 5090929332 0 5817
Card 1247",0.11399999999999999
5/14/2025,"Recurring Withdrawal Debit Card - MC Debit Gator/RAYCAST.COM CHESHIRE LN
Date 05/13/25 0 5133953606 0 5734
Card 1247",10.0,Posted,455.8,2025-05-14,10.0,"Recurring Withdrawal Debit Card - MC Debit Gator/RAYCAST.COM CHESHIRE LN
Date 05/13/25 0 5133953606 0 5734
Card 1247",10.0
5/14/2025,"Recurring Withdrawal Debit Card Fee/MASTERCARD ISSUER CROSS-BORDER FEE
Date 05/13/25 0 5133953605 0 5734
Card 1247",0.08,Posted,465.8,2025-05-14,0.08,"Withdrawal Debit Card Fee/MASTERCARD ISSUER CROSS-BORDER FEE
Date 03/31/25 0 5090929332 0 5817
Card 1247",0.11399999999999999
5/14/2025,"Recurring Withdrawal Debit Card - MC Debit Gator/RAYCAST.COM CHESHIRE LN
Date 05/13/25 0 5133953605 0 5734
Card 1247",10.0,Posted,465.88,2025-05-14,10.0,"Recurring Withdrawal Debit Card - MC Debit Gator/RAYCAST.COM CHESHIRE LN
Date 05/13/25 0 5133953606 0 5734
Card 1247",10.0
5/14/2025,"Withdrawal Debit Card MC Debit Gator/CIRCLE K # 26146 GAINESVILLE FL
Date 05/12/25 0 5132947482 0 5499
Card 1247",19.75,Posted,475.88,2025-05-14,19.75,"Withdrawal Debit Card MC Debit Gator/CIRCLE K # 06782 GAINESVILLE FL
Date 04/09/25 0 5099980889 0 5499
Card 1247",19.54
5/11/2025,"Withdrawal POS #000000000047/CIRCLE K # 26146 3525 GAINESVILLE FL
Card 1247",19.75,Posted,495.63,2025-05-11,19.75,"Withdrawal POS #000000000047/CIRCLE K # 26146 3525 GAINESVILLE FL
Card 1247",19.75
5/11/2025,"Withdrawal Debit Card MC Debit Gator/INSTACART*159 SAN FRANCISC CA
Date 05/09/25 0 5129018006 2 5411
Card 1247",38.0,Posted,515.38,2025-05-11,38.0,"Withdrawal Debit Card MC Debit Gator/INSTACART*159 SAN FRANCISC CA
Date 03/22/25 0 5081791779 0 5411
Card 1247",38.010000000000005
5/11/2025,"Withdrawal Debit Card MC Debit Gator/SUNOCO 8002212501 QPS GAINESVILLE FL
Date 05/09/25 0 5129469564 2 5541
Card 1247",23.01,Posted,553.38,2025-05-11,23.01,"Withdrawal Debit Card MC Debit Gator/SUNOCO 8002212501 QPS GAINESVILLE FL
Date 05/19/25 0 5139082313 1 5541
Card 1247",23.01
5/11/2025,"Withdrawal Debit Card MC Debit Gator/AMAZON PRIME*NI9490PZ1 AMZN.COM/BIL WA
Date 05/11/25 0 5131126852 1 5818
Card 1247",3.4,Posted,576.39,2025-05-11,3.4,"Withdrawal Debit Card MC Debit Gator/AMAZON PRIME*NI9490PZ1 AMZN.COM/BIL WA
Date 05/11/25 0 5131126852 1 5818
Card 1247",3.4
5/10/2025,"Withdrawal POS #000000000052/CIRCLE K # 26146 3525 GAINESVILLE FL
Card 1247",19.75,Posted,579.79,2025-05-10,19.75,"Withdrawal POS #000000000047/CIRCLE K # 26146 3525 GAINESVILLE FL
Card 1247",19.75
5/9/2025,"Recurring Withdrawal Debit Card Fee/MASTERCARD ISSUER CROSS-BORDER FEE
Date 05/08/25 0 5128330209 0 5734
Card 1247",0.06,Posted,599.54,2025-05-09,0.06,"Withdrawal Debit Card Fee/MASTERCARD ISSUER CROSS-BORDER FEE
Date 03/31/25 0 5090929332 0 5817
Card 1247",0.11399999999999999
5/9/2025,"Recurring Withdrawal Debit Card - MC Debit Gator/IDEOGRAM AI TORONTO ON
Date 05/08/25 0 5128330209 0 5734
Card 1247",8.0,Posted,599.6,2025-05-09,8.0,"Recurring Withdrawal Debit Card - MC Debit Gator/IDEOGRAM AI TORONTO ON
Date 04/08/25 0 5098321266 0 5734
Card 1247",8.0
5/9/2025,"Withdrawal Debit Card MC Debit Gator/IONOS INC. CHESTERBROOK PA
Date 05/08/25 0 5128032400 1 4816
Card 1247",23.0,Posted,607.6,2025-05-09,23.0,"Withdrawal Debit Card MC Debit Gator/IONOS INC. CHESTERBROOK PA
Date 06/05/25 0 5156041339 1 4816
Card 1247",23.0
5/9/2025,"Withdrawal ACH FLUENT-Gainesvil/TYPE: PAYMENT ID: 1371804719
CO: FLUENT-Gainesvil
NAME: steven chaplinskiEntry Class Code: WEB",20.0,Posted,630.6,2025-05-09,20.0,"Withdrawal ACH FLUENT-Gainesvil/TYPE: PAYMENT ID: 1371804719
CO: FLUENT-Gainesvil
NAME: steven chaplinskiEntry Class Code: WEB",20.5
5/8/2025,"Withdrawal ACH SUNO INC./TYPE: SUNO INC. ID: 1800948598
CO: SUNO INC. NAME: STEVEN J CHAPLINSKI
Entry Class Code: WEB",10.0,Posted,650.6,2025-05-08,10.0,"Withdrawal ACH SUNO INC./TYPE: SUNO INC. ID: 1800948598
CO: SUNO INC. NAME: STEVEN J CHAPLINSKI
Entry Class Code: WEB",10.0
5/8/2025,"Recurring Withdrawal Debit Card - MC Debit Gator/TUBEBUDDYCOM* 8668823239 CA
Date 05/07/25 0 5127999675 0 5734
Card 1247",7.5,Posted,660.6,2025-05-08,7.5,"Recurring Withdrawal Debit Card - MC Debit Gator/TUBEBUDDYCOM* 8668823239 CA
Date 05/07/25 0 5127999675 0 5734
Card 1247",7.5
5/8/2025,"Recurring Withdrawal Debit Card Fee/MASTERCARD ISSUER CROSS-BORDER FEE
Date 05/08/25 0 5128978432 0 5734
Card 1247",0.23,Posted,668.1,2025-05-08,0.23,"Withdrawal Debit Card Fee/MASTERCARD ISSUER CROSS-BORDER FEE
Date 03/31/25 0 5090929332 0 5817
Card 1247",0.11399999999999999
5/8/2025,"Recurring Withdrawal Debit Card - MC Debit Gator/NOTEGPT.IO ADMIRALTY KO
Date 05/08/25 0 5128978432 0 5734
Card 1247",29.0,Posted,668.33,2025-05-08,29.0,"Recurring Withdrawal Debit Card - MC Debit Gator/NOTEGPT.IO ADMIRALTY KO
Date 05/08/25 0 5128978432 0 5734
Card 1247",29.0
5/8/2025,"Withdrawal Debit Card MC Debit Gator/GRU/EZ-PAY WEB PYMT 352-334-3434 FL
Date 05/07/25 0 5127319905 0 4900
Card 1247",143.13,Posted,697.33,2025-05-08,143.13,"Withdrawal Debit Card MC Debit Gator/GRU/EZ-PAY WEB PYMT 352-334-3434 FL
Date 05/07/25 0 5127319905 0 4900
Card 1247",143.13
5/8/2025,"Withdrawal Debit Card MC Debit Gator/COX GAINESVILLE COMM 800-234-3993 FL
Date 05/07/25 0 5127973169 0 4899
Card 1247",156.13,Posted,840.46,2025-05-08,156.13,"Withdrawal Debit Card MC Debit Gator/COX GAINESVILLE COMM 800-234-3993 FL
Date 05/07/25 0 5127973169 0 4899
Card 1247",156.13
5/8/2025,"Withdrawal Bill Payment #000000176250/APPLE COM ONE APPLE PARK WAY ONE APPLE
CA
Card 1247",13.98,Posted,996.59,2025-05-08,13.98,"Withdrawal Bill Payment #000000176250/APPLE COM ONE APPLE PARK WAY ONE APPLE
CA
Card 1247",13.98
5/8/2025,"Withdrawal POS #000000752480/PUBLIX 3100 SW 35TH BLVD GAINESVILLE FL
Card 1247",37.56,Posted,1010.57,2025-05-08,37.56,"Withdrawal POS #000000752480/PUBLIX 3100 SW 35TH BLVD GAINESVILLE FL
Card 1247",37.32
5/7/2025,"Withdrawal POS #000000000025/CIRCLE K # 26146 3525 GAINESVILLE FL
Card 1247",19.75,Posted,1048.13,2025-05-07,19.75,"Withdrawal POS #000000000047/CIRCLE K # 26146 3525 GAINESVILLE FL
Card 1247",19.75
5/7/2025,"Withdrawal Debit Card MC Debit Gator/SUNOCO 8002212501 QPS GAINESVILLE FL
Date 05/06/25 0 5126182193 1 5541
Card 1247",20.33,Posted,1067.88,2025-05-07,20.33,"Withdrawal Debit Card MC Debit Gator/SUNOCO 8002212501 QPS GAINESVILLE FL
Date 05/19/25 0 5139082313 1 5541
Card 1247",20.545
5/7/2025,"Withdrawal Debit Card MC Debit Gator/IONOS INC. CHESTERBROOK PA
Date 05/06/25 0 5126989315 0 4816
Card 1247",25.0,Posted,1088.21,2025-05-07,25.0,"Withdrawal Debit Card MC Debit Gator/IONOS INC. CHESTERBROOK PA
Date 06/05/25 0 5156041339 1 4816
Card 1247",25.0
5/6/2025,"Withdrawal POS #000000248532/AMAZON.COM*NI55D0DC2 SEATTLE WA
Card 1247",20.23,Posted,1113.21,2025-05-06,20.23,"Withdrawal POS #000000134088/AMAZON.COM*N888H1072 SEATTLE WA
Card 1247",20.295
5/6/2025,"Recurring Withdrawal Debit Card - MC Debit Gator/SUPERPOWER CHATGPT MIDDLETOWN DE
Date 05/05/25 0 5125205338 1 5734
Card 1247",15.0,Posted,1133.44,2025-05-06,15.0,"Recurring Withdrawal Debit Card - MC Debit Gator/SUPERPOWER CHATGPT MIDDLETOWN DE
Date 06/05/25 0 5156229550 1 5734
Card 1247",15.0
5/6/2025,"Recurring Withdrawal Debit Card - MC Debit Gator/SUPERPOWER CHATGPT MIDDLETOWN DE
Date 05/05/25 0 5125957245 0 5734
Card 1247",15.0,Posted,1148.44,2025-05-06,15.0,"Recurring Withdrawal Debit Card - MC Debit Gator/SUPERPOWER CHATGPT MIDDLETOWN DE
Date 06/05/25 0 5156229550 1 5734
Card 1247",15.0
5/6/2025,"Withdrawal Debit Card MC Debit Gator/SUNOCO 8002212501 QPS GAINESVILLE FL
Date 05/05/25 0 5125202951 1 5541
Card 1247",22.17,Posted,1163.44,2025-05-06,22.17,"Withdrawal Debit Card MC Debit Gator/SUNOCO 8002212501 QPS GAINESVILLE FL
Date 05/19/25 0 5139082313 1 5541
Card 1247",22.005000000000003
5/6/2025,"Withdrawal Debit Card MC Debit Gator/IONOS INC. CHESTERBROOK PA
Date 05/05/25 0 5125954539 0 4816
Card 1247",60.0,Posted,1185.61,2025-05-06,60.0,"Withdrawal Debit Card MC Debit Gator/IONOS INC. CHESTERBROOK PA
Date 06/05/25 0 5156041339 1 4816
Card 1247",60.0
5/5/2025,"Recurring Withdrawal Debit Card - MC Debit Gator/OPENAI *CHATGPT SUBSCR SAN FRANCISC CA
Date 05/04/25 0 5124280497 0 5734
Card 1247",20.0,Posted,1245.61,2025-05-05,20.0,"Recurring Withdrawal Debit Card - MC Debit Gator/OPENAI SAN FRANCISC CA
Date 05/31/25 0 5151282040 2 5734
Card 1247",20.0
5/5/2025,"Recurring Withdrawal Debit Card - MC Debit Gator/HOSTINGER* HOSTINGER.C WILMINGTON DE
Date 05/05/25 0 5125011239 1 7372
Card 1247",4.68,Posted,1265.61,2025-05-05,4.68,"Recurring Withdrawal Debit Card - MC Debit Gator/HOSTINGER* HOSTINGER.C WILMINGTON DE
Date 05/05/25 0 5125011239 1 7372
Card 1247",4.68
5/5/2025,"Recurring Withdrawal Debit Card - MC Debit Gator/HOSTINGER* HOSTINGER.C WILMINGTON DE
Date 05/04/25 0 5124144321 1 7372
Card 1247",9.99,Posted,1270.29,2025-05-05,9.99,"Recurring Withdrawal Debit Card - MC Debit Gator/HOSTINGER* HOSTINGER.C WILMINGTON DE
Date 05/05/25 0 5125011239 1 7372
Card 1247",9.99
5/5/2025,"Withdrawal ACH FLUENT-Gainesvil/TYPE: PAYMENT ID: 1371804719
CO: FLUENT-Gainesvil
NAME: steven chaplinskiEntry Class Code: WEB",65.0,Posted,1280.28,2025-05-05,65.0,"Withdrawal ACH FLUENT-Gainesvil/TYPE: PAYMENT ID: 1371804719
CO: FLUENT-Gainesvil
NAME: steven chaplinskiEntry Class Code: WEB",65.0
5/4/2025,"Withdrawal POS #000000330773/SUNOCO 8002212501 4234 SW 20TH AVE
GAINESVILLE FL
Card 1247",18.74,Posted,1345.28,2025-05-04,18.74,"Withdrawal POS #000000666979/SUNOCO 8002212501 4234 SW 20TH AVE
GAINESVILLE FL
Card 1247",18.575
5/4/2025,"Recurring Withdrawal Debit Card - MC Debit Gator/NOTION LABS, INC. SAN FRANCISC CA
Date 05/02/25 0 5122358621 2 7372
Card 1247",22.0,Posted,1364.02,2025-05-04,22.0,"Recurring Withdrawal Debit Card - MC Debit Gator/OPENAI SAN FRANCISC CA
Date 05/31/25 0 5151282040 2 5734
Card 1247",22.0
5/4/2025,"Withdrawal Debit Card MC Debit Gator/INSTACART*159 SAN FRANCISC CA
Date 05/02/25 0 5122356706 2 5411
Card 1247",3.01,Posted,1386.02,2025-05-04,3.01,"Withdrawal Debit Card MC Debit Gator/INSTACART*159 SAN FRANCISC CA
Date 03/22/25 0 5081791779 0 5411
Card 1247",3.01
5/4/2025,"Withdrawal Debit Card MC Debit Gator/INSTACART*159 SAN FRANCISC CA
Date 05/02/25 0 5122356703 2 5411
Card 1247",65.28,Posted,1389.03,2025-05-04,65.28,"Withdrawal Debit Card MC Debit Gator/INSTACART*159 SAN FRANCISC CA
Date 05/31/25 0 5151554560 2 5411
Card 1247",65.28
5/4/2025,"Recurring Withdrawal Debit Card - MC Debit Gator/CS ADDTL STORAGE SAN JOSE CA
Date 05/03/25 0 5123478481 2 5817
Card 1247",9.99,Posted,1454.31,2025-05-04,9.99,"Recurring Withdrawal Debit Card - MC Debit Gator/CS ADDTL STORAGE SAN JOSE CA
Date 05/03/25 0 5123478481 2 5817
Card 1247",9.99
5/4/2025,"Recurring Withdrawal Debit Card - MC Debit Gator/ADOBE SAN JOSE CA
Date 05/03/25 0 5123478479 2 5817
Card 1247",19.99,Posted,1464.3,2025-05-04,19.99,"Recurring Withdrawal Debit Card - MC Debit Gator/CS ADDTL STORAGE SAN JOSE CA
Date 05/03/25 0 5123478481 2 5817
Card 1247",19.99
5/4/2025,"Withdrawal Debit Card MC Debit Gator/WALGREENS #9304 GAINESVILLE FL
Date 05/02/25 0 5122473217 2 5912
Card 1247",10.81,Posted,1484.29,2025-05-04,10.81,"Withdrawal Debit Card MC Debit Gator/WALGREENS #9304 GAINESVILLE FL
Date 05/30/25 0 5150232309 1 5912
Card 1247",10.81
5/4/2025,"Recurring Withdrawal Debit Card - MC Debit Gator/APPLE.COM/BILL 866-712-7753 CA
Date 05/03/25 0 5123472314 2 5818
Card 1247",2.99,Posted,1495.1,2025-05-04,2.99,"Recurring Withdrawal Debit Card - MC Debit Gator/APPLE.COM/BILL 866-712-7753 CA
Date 06/03/25 0 5154093226 1 5818
Card 1247",2.99
5/4/2025,"Withdrawal Debit Card MC Debit Gator/CIRCLE K # 06782 GAINESVILLE FL
Date 05/01/25 0 5121349634 2 5499
Card 1247",27.2,Posted,1498.09,2025-05-04,27.2,Withdrawal Debit Card MC Debit Gator/CIRCLE K # 06782 GAINESVILLE FLDate 01/31/25 0 5031331003 1 5499Card 1247,27.095
5/2/2025,"Recurring Withdrawal Debit Card - MC Debit Gator/MYDESIGNS - PRO - MON LAS VEGAS NV
Date 05/01/25 0 5121260380 1 5734
Card 1247",49.99,Posted,1525.29,2025-05-02,49.99,"Recurring Withdrawal Debit Card - MC Debit Gator/MYDESIGNS - PRO - MON LAS VEGAS NV
Date 06/01/25 0 5152146505 1 5734
Card 1247",49.99
5/2/2025,"Recurring Withdrawal Debit Card - MC Debit Gator/PARAMOUNT+ WEST HOLLYWO CA
Date 05/01/25 0 5121277574 1 4899
Card 1247",14.96,Posted,1575.28,2025-05-02,14.96,"Recurring Withdrawal Debit Card - MC Debit Gator/PARAMOUNT+ WEST HOLLYWO CA
Date 06/01/25 0 5152328615 1 4899
Card 1247",14.96
5/2/2025,"Recurring Withdrawal Debit Card - MC Debit Gator/APPLE.COM/BILL 866-712-7753 CA
Date 05/01/25 0 5121270888 1 5818
Card 1247",27.98,Posted,1590.24,2025-05-02,27.98,Recurring Withdrawal Debit Card - MC Debit Gator/APPLE.COM/BILL 866-712-7753 CADate 01/05/25 0 5005839185 0 5818Card 1247,27.98
5/2/2025,"Withdrawal ACH Watson Realty Co/TYPE: WEB PMTS ID: 9000321157
CO: Watson Realty Co
NAME: Steven chaplinskiEntry Class Code: WEB",1179.0,Posted,1618.22,2025-05-02,1179.0,"Withdrawal ACH Watson Realty Co/TYPE: WEB PMTS ID: 9000321157
CO: Watson Realty Co
NAME: Steven chaplinskiEntry Class Code: WEB",1179.0
5/2/2025,"Withdrawal ACH FLUENT-Gainesvil/TYPE: PAYMENT ID: 1371804719
CO: FLUENT-Gainesvil
NAME: steven chaplinskiEntry Class Code: WEB",18.0,Posted,2797.22,2025-05-02,18.0,"Withdrawal ACH FLUENT-Gainesvil/TYPE: PAYMENT ID: 1371804719
CO: FLUENT-Gainesvil
NAME: steven chaplinskiEntry Class Code: WEB",17.75
5/2/2025,"Withdrawal ACH AppFolio, Inc. F/TYPE: WEB PMTS ID: 9001406550
CO: AppFolio, Inc. F
NAME: Steven chaplinskiEntry Class Code: WEB",2.49,Posted,2815.22,2025-05-02,2.49,"Withdrawal ACH AppFolio, Inc. F/TYPE: WEB PMTS ID: 9001406550
CO: AppFolio, Inc. F
NAME: Steven chaplinskiEntry Class Code: WEB",2.49
5/1/2025,"Recurring Withdrawal Debit Card - MC Debit Gator/OPENAI SAN FRANCISC CA
Date 04/30/25 0 5120971870 0 5734
Card 1247",7.39,Posted,2817.71,2025-05-01,7.39,Recurring Withdrawal Debit Card - MC Debit Gator/OPENAI SAN FRANCISC CADate 03/08/25 0 5067339145 0 5734Card 1247,7.39
5/1/2025,"Recurring Withdrawal Debit Card - MC Debit Gator/PADDLE.NET* SETAPP NEW YORK NY
Date 05/01/25 0 5121349771 0 5817
Card 1247",9.99,Posted,2825.1,2025-05-01,9.99,"Recurring Withdrawal Debit Card - MC Debit Gator/PADDLE.NET* SETAPP NEW YORK NY
Date 05/31/25 0 5151555568 2 5817
Card 1247",9.99
5/1/2025,"Withdrawal Debit Card MC Debit Gator/SUNOCO 8002212501 QPS GAINESVILLE FL
Date 04/30/25 0 5120175998 1 5541
Card 1247",21.84,Posted,2835.09,2025-05-01,21.84,"Withdrawal Debit Card MC Debit Gator/SUNOCO 8002212501 QPS GAINESVILLE FL
Date 05/19/25 0 5139082313 1 5541
Card 1247",22.005000000000003
5/1/2025,"Recurring Withdrawal Debit Card Fee/MASTERCARD ISSUER CROSS-BORDER FEE
Date 05/01/25 0 5121175942 1 5817
Card 1247",0.08,Posted,2856.93,2025-05-01,0.08,"Withdrawal Debit Card Fee/MASTERCARD ISSUER CROSS-BORDER FEE
Date 03/31/25 0 5090929332 0 5817
Card 1247",0.11399999999999999
5/1/2025,"Recurring Withdrawal Debit Card - MC Debit Gator/OBSIDIAN.MD OAKVILLE ON
Date 05/01/25 0 5121175942 1 5817
Card 1247",10.0,Posted,2857.01,2025-05-01,10.0,"Recurring Withdrawal Debit Card - MC Debit Gator/OBSIDIAN.MD OAKVILLE ON
Date 05/31/25 0 5151375863 2 5817
Card 1247",10.0
5/1/2025,"Recurring Withdrawal Debit Card - MC Debit Gator/FS *RAINDROP.IO SANTA BARBAR CA
Date 04/30/25 0 5120038015 1 5734
Card 1247",3.0,Posted,2867.01,2025-05-01,3.0,"Recurring Withdrawal Debit Card - MC Debit Gator/FS *RAINDROP.IO SANTA BARBAR CA
Date 04/30/25 0 5120038015 1 5734
Card 1247",3.0
5/1/2025,"Withdrawal POS #000000876017/AMAZON.COM*N26MU72P0 SEATTLE WA
Card 1247",32.0,Posted,2870.01,2025-05-01,32.0,"Withdrawal POS #000000256943/AMAZON.COM*NN6201DU0 SEATTLE WA
Card 1247",32.0
5/1/2025,"Withdrawal POS #000000684070/AMAZON.COM*NB6J799P2 SEATTLE WA
Card 1247",21.36,Posted,2902.01,2025-05-01,21.36,"Withdrawal POS #000000134088/AMAZON.COM*N888H1072 SEATTLE WA
Card 1247",21.36
5/1/2025,"Withdrawal POS #000000680759/AMAZON.COM*N26B91SP0 SEATTLE WA
Card 1247",13.1,Posted,2923.37,2025-05-01,13.1,"Withdrawal POS #000000256943/AMAZON.COM*NN6201DU0 SEATTLE WA
Card 1247",13.1
5/1/2025,"Withdrawal POS #000000194578/Etsy.com*US Etsy.com*AiAv ADAMS STREET
www.etsy.com/ NY
Card 1247",0.2,Posted,2936.47,2025-05-01,0.2,"Withdrawal POS #000000194578/Etsy.com*US Etsy.com*AiAv ADAMS STREET
www.etsy.com/ NY
Card 1247",0.2
5/1/2025,"Withdrawal POS #000020035046/GOOGLE *YouTubePremium 1600 Amphitheatre
Parkw Mountain View CA
Card 1247",15.92,Posted,2936.67,2025-05-01,15.92,"Withdrawal POS #000020312090/GOOGLE *YouTubePremium 1600 Amphitheatre
Parkw Mountain View CA
Card 1247",15.92
4/30/2025,"Recurring Withdrawal Debit Card - MC Debit Gator/SUPERPOWER CHATGPT MIDDLETOWN DE
Date 04/29/25 0 5119982716 0 5734
Card 1247",15.0,Posted,2952.59,2025-04-30,15.0,"Recurring Withdrawal Debit Card - MC Debit Gator/SUPERPOWER CHATGPT MIDDLETOWN DE
Date 06/05/25 0 5156229550 1 5734
Card 1247",15.0
4/30/2025,"Withdrawal Debit Card MC Debit Gator/IONOS INC. CHESTERBROOK PA
Date 04/29/25 0 5119979985 0 4816
Card 1247",2.5,Posted,2967.59,2025-04-30,2.5,"Withdrawal Debit Card MC Debit Gator/IONOS INC. CHESTERBROOK PA
Date 06/05/25 0 5156041339 1 4816
Card 1247",3.0
4/29/2025,"Withdrawal Debit Card MC Debit Gator/SUNOCO 8002212501 QPS GAINESVILLE FL
Date 04/28/25 0 5118116540 1 5541
Card 1247",28.44,Posted,-29.91,2025-04-29,28.44,"Withdrawal Debit Card MC Debit Gator/SUNOCO 8002212501 QPS GAINESVILLE FL
Date 05/19/25 0 5139082313 1 5541
Card 1247",28.44
4/29/2025,"Withdrawal Debit Card MC Debit Gator/WALGREENS #5024 GAINESVILLE FL
Date 04/28/25 0 5118112027 1 5912
Card 1247",15.0,Posted,-1.47,2025-04-29,15.0,"Withdrawal Debit Card MC Debit Gator/WALGREENS #9304 GAINESVILLE FL
Date 05/30/25 0 5150232309 1 5912
Card 1247",15.0
4/29/2025,"Withdrawal POS #000000085932/SUNOCO 8002212501 4234 SW 20TH AVE
GAINESVILLE FL
Card 1247",19.47,Posted,13.53,2025-04-29,19.47,"Withdrawal POS #000000666979/SUNOCO 8002212501 4234 SW 20TH AVE
GAINESVILLE FL
Card 1247",19.685
4/28/2025,"Withdrawal ATM Fee/EFT 6419 W Newberry Rd Gainesville FL
Card 1247",2.0,Posted,3.0,2025-04-28,2.0,"Withdrawal ATM Fee/EFT 6419 W Newberry Rd Gainesville FL
Card 1247",2.0
4/28/2025,"Withdrawal at ATM #000000105254/EFT 6419 W Newberry Rd Gainesville FL
Card 1247",13.0,Posted,5.0,2025-04-28,13.0,"Withdrawal at ATM #000000785755/EFT 6419 W Newberry Rd Gainesville FL
Card 1247",13.0
4/28/2025,"Withdrawal Debit Card MC Debit Gator/INSTACART*159 SAN FRANCISC CA
Date 04/27/25 0 5117311838 1 5411
Card 1247",58.0,Posted,18.0,2025-04-28,58.0,"Withdrawal Debit Card MC Debit Gator/INSTACART*159 SAN FRANCISC CA
Date 03/22/25 0 5081791779 0 5411
Card 1247",58.0
4/28/2025,Withdrawal Courtesy Pay Fee/Entry Class Code: WEB,35.0,Posted,-59.0,2025-04-28,35.0,Withdrawal Courtesy Pay Fee/Entry Class Code: WEB,35.0
4/28/2025,"Withdrawal ACH FLUENT-Gainesvil/TYPE: PAYMENT ID: 1371804719
CO: FLUENT-Gainesvil
NAME: steven chaplinski",18.0,Posted,-24.0,2025-04-28,18.0,Withdrawal ACH FLUENT-Gainesvil/TYPE: PAYMENT ID: 1371804719CO: FLUENT-GainesvilNAME: steven chaplinski,18.0
4/27/2025,"Withdrawal Debit Card MC Debit Gator/IC* INSTACART*SUBSCRIP SAN FRANCISC CA
Date 04/26/25 0 5116980985 0 5411
Card 1247",9.99,Posted,-6.0,2025-04-27,9.99,"Recurring Withdrawal Debit Card - MC Debit Gator/IC* INSTACART*SUBSCRIP SAN FRANCISC CA
Date 05/27/25 0 5147989663 0 5411
Card 1247",9.99
4/27/2025,"Withdrawal POS #000000045037/SUNOCO 8002212501 4234 SW 20TH AVE
GAINESVILLE FL
Card 1247",21.84,Posted,3.99,2025-04-27,21.84,"Withdrawal POS #000000666979/SUNOCO 8002212501 4234 SW 20TH AVE
GAINESVILLE FL
Card 1247",22.005000000000003
4/26/2025,"Withdrawal POS #000000977612/SUNOCO 8002212501 4234 SW 20TH AVE
GAINESVILLE FL
Card 1247",21.84,Posted,25.83,2025-04-26,21.84,"Withdrawal POS #000000666979/SUNOCO 8002212501 4234 SW 20TH AVE
GAINESVILLE FL
Card 1247",22.005000000000003
4/25/2025,"Withdrawal POS #000080196760/SMOKE CITY 2120 SW 34TH ST GAINESVILLE
Card 1247",6.34,Posted,47.67,2025-04-25,6.34,"Withdrawal POS #000080196760/SMOKE CITY 2120 SW 34TH ST GAINESVILLE
Card 1247",6.34
4/25/2025,"Withdrawal POS #000000940381/SUNOCO 8002212501 4234 SW 20TH AVE
GAINESVILLE FL
Card 1247",21.84,Posted,54.01,2025-04-25,21.84,"Withdrawal POS #000000666979/SUNOCO 8002212501 4234 SW 20TH AVE
GAINESVILLE FL
Card 1247",22.005000000000003
4/25/2025,"Withdrawal ACH FLUENT-Gainesvil/TYPE: PAYMENT ID: 1371804719
CO: FLUENT-Gainesvil
NAME: steven chaplinskiEntry Class Code: WEB",28.5,Posted,75.85,2025-04-25,28.5,"Withdrawal ACH FLUENT-Gainesvil/TYPE: PAYMENT ID: 1371804719
CO: FLUENT-Gainesvil
NAME: steven chaplinskiEntry Class Code: WEB",28.5
4/24/2025,"Withdrawal POS #000000912703/SUNOCO 8002212501 4234 SW 20TH AVE
GAINESVILLE FL
Card 1247",24.52,Posted,104.35,2025-04-24,24.52,"Withdrawal POS #000000666979/SUNOCO 8002212501 4234 SW 20TH AVE
GAINESVILLE FL
Card 1247",24.52
4/24/2025,"Withdrawal ACH FLUENT-Gainesvil/TYPE: PAYMENT ID: 1371804719
CO: FLUENT-Gainesvil
NAME: steven chaplinskiEntry Class Code: WEB",21.0,Posted,128.87,2025-04-24,21.0,"Withdrawal ACH FLUENT-Gainesvil/TYPE: PAYMENT ID: 1371804719
CO: FLUENT-Gainesvil
NAME: steven chaplinskiEntry Class Code: WEB",20.5
4/23/2025,"Withdrawal POS #000000767866/PUBLIX 3100 SW 35TH BLVD GAINESVILLE FL
Card 1247",18.35,Posted,149.87,2025-04-23,18.35,"Withdrawal POS #000000752480/PUBLIX 3100 SW 35TH BLVD GAINESVILLE FL
Card 1247",18.405
4/23/2025,"Withdrawal POS #000000880006/SUNOCO 8002212501 4234 SW 20TH AVE
GAINESVILLE FL
Card 1247",21.84,Posted,168.22,2025-04-23,21.84,"Withdrawal POS #000000580851/SUNOCO 8002212501 4234 SW 20TH AVE
GAINESVILLE FL
Card 1247",21.84
4/23/2025,"Recurring Withdrawal Debit Card - MC Debit Gator/NETFLIX.COM CA
Date 04/23/25 0 5113169724 1 4899
Card 1247",20.71,Posted,190.06,2025-04-23,20.71,"Recurring Withdrawal Debit Card - MC Debit Gator/NETFLIX.COM LOS GATOS CA
Date 05/23/25 0 5143471019 2 4899
Card 1247",20.71
4/23/2025,"Withdrawal ACH FLUENT-Gainesvil/TYPE: PAYMENT ID: 1371804719
CO: FLUENT-Gainesvil
NAME: steven chaplinskiEntry Class Code: WEB",15.0,Posted,210.77,2025-04-23,15.0,"Withdrawal ACH FLUENT-Gainesvil/TYPE: PAYMENT ID: 1371804719
CO: FLUENT-Gainesvil
NAME: steven chaplinskiEntry Class Code: WEB",15.0
4/22/2025,"Withdrawal POS #000000788429/SUNOCO 8002212501 4234 SW 20TH AVE
GAINESVILLE FL
Card 1247",21.84,Posted,225.77,2025-04-22,21.84,"Withdrawal POS #000000666979/SUNOCO 8002212501 4234 SW 20TH AVE
GAINESVILLE FL
Card 1247",22.005000000000003
4/22/2025,"Withdrawal Debit Card MC Debit Gator/INSTACART*159 SAN FRANCISC CA
Date 04/21/25 0 5111802992 0 5411
Card 1247",55.0,Posted,247.61,2025-04-22,55.0,"Withdrawal Debit Card MC Debit Gator/INSTACART*159 SAN FRANCISC CA
Date 03/22/25 0 5081791779 0 5411
Card 1247",55.04
4/22/2025,"Withdrawal ACH FLUENT-Gainesvil/TYPE: PAYMENT ID: 1371804719
CO: FLUENT-Gainesvil
NAME: steven chaplinskiEntry Class Code: WEB",17.5,Posted,302.61,2025-04-22,17.5,"Withdrawal ACH FLUENT-Gainesvil/TYPE: PAYMENT ID: 1371804719
CO: FLUENT-Gainesvil
NAME: steven chaplinskiEntry Class Code: WEB",17.75
4/22/2025,"Withdrawal POS #000000773256/SUNOCO 8002212501 4234 SW 20TH AVE
GAINESVILLE FL
Card 1247",21.84,Posted,320.11,2025-04-22,21.84,"Withdrawal POS #000000216148/SUNOCO 8002212501 4234 SW 20TH AVE
GAINESVILLE FL
Card 1247",21.84
4/21/2025,"Recurring Withdrawal Debit Card - MC Debit Gator/CANVA* I04492-37655487 CAMDEN DE
Date 04/20/25 0 5110064939 1 7333
Card 1247",12.99,Posted,341.95,2025-04-21,12.99,"Recurring Withdrawal Debit Card - MC Debit Gator/CANVA* I04522-50593645 CAMDEN DE
Date 05/20/25 0 5140963894 0 7333
Card 1247",12.99
4/21/2025,"Withdrawal POS #000028288185/WAWA 5325 GAINESVILLE GAINESVILLE FL
Card 1247",15.54,Posted,354.94,2025-04-21,15.54,"Withdrawal POS #000028288185/WAWA 5325 GAINESVILLE GAINESVILLE FL
Card 1247",15.54
4/21/2025,"Withdrawal ACH FLUENT-Gainesvil/TYPE: PAYMENT ID: 1371804719
CO: FLUENT-Gainesvil
NAME: steven chaplinskiEntry Class Code: WEB",42.0,Posted,370.48,2025-04-21,42.0,"Withdrawal ACH FLUENT-Gainesvil/TYPE: PAYMENT ID: 1371804719
CO: FLUENT-Gainesvil
NAME: steven chaplinskiEntry Class Code: WEB",42.0
4/20/2025,"Withdrawal POS #000000732586/SUNOCO 8002212501 4234 SW 20TH AVE
GAINESVILLE FL
Card 1247",18.41,Posted,412.48,2025-04-20,18.41,"Withdrawal POS #000000216148/SUNOCO 8002212501 4234 SW 20TH AVE
GAINESVILLE FL
Card 1247",18.41
4/20/2025,"Withdrawal Debit Card MC Debit Gator/INSTACART*159 SAN FRANCISC CA
Date 04/19/25 0 5109159889 1 5411
Card 1247",48.79,Posted,430.89,2025-04-20,48.79,"Withdrawal Debit Card MC Debit Gator/INSTACART*159 SAN FRANCISC CA
Date 03/22/25 0 5081791779 0 5411
Card 1247",48.965
4/20/2025,"Withdrawal POS #000000752843/SUNOCO 8002212501 4234 SW 20TH AVE
GAINESVILLE FL
Card 1247",18.41,Posted,479.68,2025-04-20,18.41,"Withdrawal POS #000000216148/SUNOCO 8002212501 4234 SW 20TH AVE
GAINESVILLE FL
Card 1247",18.41
4/19/2025,"Withdrawal POS #000000000007/CIRCLE K # 06782 5237 GAINESVILLE FL
Card 1247",16.99,Posted,498.09,2025-04-19,16.99,Withdrawal POS #000000000343/CIRCLE K # 06782 5237 GAINESVILLE FLCard 1247,16.875
4/18/2025,"Recurring Withdrawal Debit Card - MC Debit Gator/AMAZON PRIME*TG93S4M53 AMZN.COM/BIL WA
Date 04/17/25 0 5107336159 0 5968
Card 1247",15.13,Posted,515.08,2025-04-18,15.13,"Recurring Withdrawal Debit Card - MC Debit Gator/AMAZON PRIME*NZ72M6V92 AMZN.COM/BIL WA
Date 05/17/25 0 5137026065 1 5968
Card 1247",15.13
4/18/2025,"Withdrawal POS #000000736804/PUBLIX 3100 SW 35TH BLVD GAINESVILLE FL
Card 1247",25.01,Posted,530.21,2025-04-18,25.01,"Withdrawal POS #000000752480/PUBLIX 3100 SW 35TH BLVD GAINESVILLE FL
Card 1247",25.01
4/17/2025,"Withdrawal POS #000000597264/SUNOCO 8002212501 4234 SW 20TH AVE
GAINESVILLE FL
Card 1247",23.65,Posted,555.22,2025-04-17,23.65,"Withdrawal POS #000000666979/SUNOCO 8002212501 4234 SW 20TH AVE
GAINESVILLE FL
Card 1247",23.653333333333336
4/17/2025,"Recurring Withdrawal Debit Card - MC Debit Gator/APPLE.COM/BILL 866-712-7753 CA
Date 04/16/25 0 5106955527 0 5818
Card 1247",36.98,Posted,578.87,2025-04-17,36.98,Recurring Withdrawal Debit Card - MC Debit Gator/APPLE.COM/BILL 866-712-7753 CADate 01/05/25 0 5005839185 0 5818Card 1247,36.98
4/17/2025,"Withdrawal ACH FLUENT-Gainesvil/TYPE: PAYMENT ID: 1371804719
CO: FLUENT-Gainesvil
NAME: steven chaplinskiEntry Class Code: WEB",42.0,Posted,615.85,2025-04-17,42.0,"Withdrawal ACH FLUENT-Gainesvil/TYPE: PAYMENT ID: 1371804719
CO: FLUENT-Gainesvil
NAME: steven chaplinskiEntry Class Code: WEB",42.0
4/16/2025,"Withdrawal POS #000000560579/SUNOCO 8002212501 4234 SW 20TH AVE
GAINESVILLE FL
Card 1247",18.41,Posted,657.85,2025-04-16,18.41,"Withdrawal POS #000000666979/SUNOCO 8002212501 4234 SW 20TH AVE
GAINESVILLE FL
Card 1247",18.575
4/16/2025,"Withdrawal Debit Card MC Debit Gator/INSTACART*159 SAN FRANCISC CA
Date 04/15/25 0 5105953159 0 5411
Card 1247",70.0,Posted,676.26,2025-04-16,70.0,"Withdrawal Debit Card MC Debit Gator/INSTACART*159 SAN FRANCISC CA
Date 03/22/25 0 5081791779 0 5411
Card 1247",70.0
4/15/2025,"Withdrawal POS #000000515552/SUNOCO 8002212501 4234 SW 20TH AVE
GAINESVILLE FL
Card 1247",21.84,Posted,746.26,2025-04-15,21.84,"Withdrawal POS #000000580851/SUNOCO 8002212501 4234 SW 20TH AVE
GAINESVILLE FL
Card 1247",21.84
4/14/2025,"Withdrawal POS #000000500473/SUNOCO 8002212501 4234 SW 20TH AVE
GAINESVILLE FL
Card 1247",21.84,Posted,768.1,2025-04-14,21.84,"Withdrawal POS #000000347331/SUNOCO 8002212501 4234 SW 20TH AVE
GAINESVILLE FL
Card 1247",21.84
4/14/2025,"Recurring Withdrawal Debit Card Fee/MASTERCARD ISSUER CROSS-BORDER FEE
Date 04/13/25 0 5103998380 0 5734
Card 1247",0.08,Posted,789.94,2025-04-14,0.08,"Withdrawal Debit Card Fee/MASTERCARD ISSUER CROSS-BORDER FEE
Date 03/31/25 0 5090929332 0 5817
Card 1247",0.11399999999999999
4/14/2025,"Recurring Withdrawal Debit Card - MC Debit Gator/RAYCAST.COM CHESHIRE LN
Date 04/13/25 0 5103998380 0 5734
Card 1247",10.0,Posted,790.02,2025-04-14,10.0,"Recurring Withdrawal Debit Card - MC Debit Gator/RAYCAST.COM CHESHIRE LN
Date 05/13/25 0 5133953606 0 5734
Card 1247",10.0
4/14/2025,"Recurring Withdrawal Debit Card Fee/MASTERCARD ISSUER CROSS-BORDER FEE
Date 04/13/25 0 5103998379 0 5734
Card 1247",0.08,Posted,800.02,2025-04-14,0.08,"Withdrawal Debit Card Fee/MASTERCARD ISSUER CROSS-BORDER FEE
Date 03/31/25 0 5090929332 0 5817
Card 1247",0.11399999999999999
4/14/2025,"Recurring Withdrawal Debit Card - MC Debit Gator/RAYCAST.COM CHESHIRE LN
Date 04/13/25 0 5103998379 0 5734
Card 1247",10.0,Posted,800.1,2025-04-14,10.0,"Recurring Withdrawal Debit Card - MC Debit Gator/RAYCAST.COM CHESHIRE LN
Date 05/13/25 0 5133953606 0 5734
Card 1247",10.0
4/13/2025,"Withdrawal POS #000000406174/SUNOCO 8002212501 4234 SW 20TH AVE
GAINESVILLE FL
Card 1247",23.44,Posted,810.1,2025-04-13,23.44,"Withdrawal POS #000000666979/SUNOCO 8002212501 4234 SW 20TH AVE
GAINESVILLE FL
Card 1247",23.653333333333336
4/11/2025,"Withdrawal Debit Card MC Debit Gator/IONOS INC. CHESTERBROOK PA
Date 04/10/25 0 5100985699 0 4816
Card 1247",7.0,Posted,833.54,2025-04-11,7.0,"Withdrawal Debit Card MC Debit Gator/IONOS INC. CHESTERBROOK PA
Date 06/05/25 0 5156041339 1 4816
Card 1247",7.0
4/11/2025,"Withdrawal Debit Card MC Debit Gator/AMAZON PRIME*GN80C1F53 AMZN.COM/BIL WA
Date 04/11/25 0 5101982298 0 5818
Card 1247",3.4,Posted,840.54,2025-04-11,3.4,"Withdrawal Debit Card MC Debit Gator/AMAZON PRIME*NI9490PZ1 AMZN.COM/BIL WA
Date 05/11/25 0 5131126852 1 5818
Card 1247",3.4
4/11/2025,"Withdrawal Debit Card MC Debit Gator/CIRCLE K # 06782 GAINESVILLE FL
Date 04/09/25 0 5099980889 0 5499
Card 1247",19.33,Posted,843.94,2025-04-11,19.33,"Withdrawal Debit Card MC Debit Gator/CIRCLE K # 06782 GAINESVILLE FL
Date 04/09/25 0 5099980889 0 5499
Card 1247",19.54
4/11/2025,"Withdrawal POS #000000375291/SUNOCO 8002212501 4234 SW 20TH AVE
GAINESVILLE FL
Card 1247",23.87,Posted,863.27,2025-04-11,23.87,"Withdrawal POS #000000666979/SUNOCO 8002212501 4234 SW 20TH AVE
GAINESVILLE FL
Card 1247",23.653333333333336
4/10/2025,"Withdrawal Debit Card MC Debit Gator/INSTACART*159 SAN FRANCISC CA
Date 04/09/25 0 5099942565 0 5411
Card 1247",49.14,Posted,887.14,2025-04-10,49.14,"Withdrawal Debit Card MC Debit Gator/INSTACART*159 SAN FRANCISC CA
Date 03/22/25 0 5081791779 0 5411
Card 1247",48.965
4/9/2025,"Recurring Withdrawal Debit Card Fee/MASTERCARD ISSUER CROSS-BORDER FEE
Date 04/08/25 0 5098321266 0 5734
Card 1247",0.06,Posted,485.28,2025-04-09,0.06,"Withdrawal Debit Card Fee/MASTERCARD ISSUER CROSS-BORDER FEE
Date 03/31/25 0 5090929332 0 5817
Card 1247",0.11399999999999999
4/9/2025,"Recurring Withdrawal Debit Card - MC Debit Gator/IDEOGRAM AI TORONTO ON
Date 04/08/25 0 5098321266 0 5734
Card 1247",8.0,Posted,485.34,2025-04-09,8.0,"Recurring Withdrawal Debit Card - MC Debit Gator/IDEOGRAM AI TORONTO ON
Date 04/08/25 0 5098321266 0 5734
Card 1247",8.0
4/9/2025,"Withdrawal Debit Card MC Debit Gator/IONOS INC. CHESTERBROOK PA
Date 04/08/25 0 5098011593 1 4816
Card 1247",23.0,Posted,493.34,2025-04-09,23.0,"Withdrawal Debit Card MC Debit Gator/IONOS INC. CHESTERBROOK PA
Date 06/05/25 0 5156041339 1 4816
Card 1247",23.0
4/9/2025,"Withdrawal Debit Card MC Debit Gator/COX GAINESVILLE COMM 800-234-3993 FL
Date 04/08/25 0 5098319723 0 4899
Card 1247",156.13,Posted,516.34,2025-04-09,156.13,Withdrawal Debit Card MC Debit Gator/COX GAINESVILLE COMM 800-234-3993 FLDate 03/09/25 0 5068137922 1 4899Card 1247,156.13
4/8/2025,"Withdrawal ACH SUNO INC./TYPE: SUNO INC. ID: 1800948598
CO: SUNO INC. NAME: STEVEN J CHAPLINSKI
Entry Class Code: WEB",10.0,Posted,672.47,2025-04-08,10.0,"Withdrawal ACH SUNO INC./TYPE: SUNO INC. ID: 1800948598
CO: SUNO INC. NAME: STEVEN J CHAPLINSKI
Entry Class Code: WEB",10.0
4/8/2025,"Recurring Withdrawal Debit Card - MC Debit Gator/OPENAI SAN FRANCISC CA
Date 04/07/25 0 5097912116 0 5734
Card 1247",6.87,Posted,682.47,2025-04-08,6.87,Recurring Withdrawal Debit Card - MC Debit Gator/OPENAI SAN FRANCISC CADate 03/08/25 0 5067339145 0 5734Card 1247,6.29875
4/8/2025,"Recurring Withdrawal Debit Card - MC Debit Gator/TUBEBUDDYCOM* 8668823239 CA
Date 04/07/25 0 5097928096 0 5734
Card 1247",7.5,Posted,689.34,2025-04-08,7.5,"Recurring Withdrawal Debit Card - MC Debit Gator/TUBEBUDDYCOM* 8668823239 CA
Date 05/07/25 0 5127999675 0 5734
Card 1247",7.5
4/8/2025,"Recurring Withdrawal Debit Card Fee/MASTERCARD ISSUER CROSS-BORDER FEE
Date 04/08/25 0 5098910705 0 5734
Card 1247",0.23,Posted,696.84,2025-04-08,0.23,"Withdrawal Debit Card Fee/MASTERCARD ISSUER CROSS-BORDER FEE
Date 03/31/25 0 5090929332 0 5817
Card 1247",0.11399999999999999
4/8/2025,"Recurring Withdrawal Debit Card - MC Debit Gator/NOTEGPT.IO ADMIRALTY KO
Date 04/08/25 0 5098910705 0 5734
Card 1247",29.0,Posted,697.07,2025-04-08,29.0,Recurring Withdrawal Debit Card - MC Debit Gator/NOTEGPT.IO ADMIRALTY KODate 02/08/25 0 5039144067 2 5734Card 1247,29.0
4/8/2025,"Withdrawal Debit Card MC Debit Gator/GRU/EZ-PAY WEB PYMT 352-334-3434 FL
Date 04/07/25 0 5097325360 0 4900
Card 1247",133.69,Posted,726.07,2025-04-08,133.69,"Withdrawal Debit Card MC Debit Gator/GRU/EZ-PAY WEB PYMT 352-334-3434 FL
Date 05/07/25 0 5127319905 0 4900
Card 1247",133.69
4/8/2025,"Withdrawal POS #000000112784/SUNOCO 8002212501 4234 SW 20TH AVE
GAINESVILLE FL
Card 1247",21.84,Posted,859.76,2025-04-08,21.84,"Withdrawal POS #000000216148/SUNOCO 8002212501 4234 SW 20TH AVE
GAINESVILLE FL
Card 1247",21.84
4/7/2025,"Withdrawal POS #000000134088/AMAZON.COM*N888H1072 SEATTLE WA
Card 1247",10.18,Posted,881.6,2025-04-07,10.18,"Withdrawal POS #000000134088/AMAZON.COM*N888H1072 SEATTLE WA
Card 1247",10.46
4/7/2025,"Withdrawal POS #000000000003/AMAZON.COM*1U8092W83 SEATTLE WA
Card 1247",44.65,Posted,891.78,2025-04-07,44.65,"Withdrawal POS #000000000003/AMAZON.COM*1U8092W83 SEATTLE WA
Card 1247",44.65
4/7/2025,"Withdrawal POS #000000000032/AMAZON.COM*EO01Y18N3 SEATTLE WA
Card 1247",20.36,Posted,936.43,2025-04-07,20.36,"Withdrawal POS #000000000003/AMAZON.COM*1U8092W83 SEATTLE WA
Card 1247",20.36
4/7/2025,"Recurring Withdrawal Debit Card - MC Debit Gator/SUPERPOWER CHATGPT MIDDLETOWN DE
Date 04/05/25 0 5095135373 1 5734
Card 1247",15.0,Posted,956.79,2025-04-07,15.0,"Recurring Withdrawal Debit Card - MC Debit Gator/SUPERPOWER CHATGPT MIDDLETOWN DE
Date 06/05/25 0 5156229550 1 5734
Card 1247",15.0
4/7/2025,"Recurring Withdrawal Debit Card - MC Debit Gator/SUPERPOWER CHATGPT MIDDLETOWN DE
Date 04/05/25 0 5095135372 1 5734
Card 1247",15.0,Posted,971.79,2025-04-07,15.0,"Recurring Withdrawal Debit Card - MC Debit Gator/SUPERPOWER CHATGPT MIDDLETOWN DE
Date 06/05/25 0 5156229550 1 5734
Card 1247",15.0
4/7/2025,"Withdrawal Debit Card MC Debit Gator/IONOS INC. CHESTERBROOK PA
Date 04/06/25 0 5096139388 1 4816
Card 1247",1.0,Posted,986.79,2025-04-07,1.0,"Withdrawal Debit Card MC Debit Gator/IONOS INC. CHESTERBROOK PA
Date 06/05/25 0 5156041339 1 4816
Card 1247",1.0
4/7/2025,"Withdrawal Debit Card MC Debit Gator/CIRCLE K # 06782 GAINESVILLE FL
Date 04/05/25 0 5095133634 1 5499
Card 1247",26.99,Posted,987.79,2025-04-07,26.99,Withdrawal Debit Card MC Debit Gator/CIRCLE K # 06782 GAINESVILLE FLDate 01/31/25 0 5031331003 1 5499Card 1247,27.095
4/7/2025,"Recurring Withdrawal Debit Card - MC Debit Gator/APPLE.COM/BILL 866-712-7753 CA
Date 04/06/25 0 5096127456 1 5818
Card 1247",2.99,Posted,1014.78,2025-04-07,2.99,Recurring Withdrawal Debit Card - MC Debit Gator/APPLE.COM/BILL 866-712-7753 CADate 01/05/25 0 5005839185 0 5818Card 1247,2.99
4/7/2025,"Withdrawal ACH FLUENT-Gainesvil/TYPE: PAYMENT ID: 1371804719
CO: FLUENT-Gainesvil
NAME: steven chaplinskiEntry Class Code: WEB",45.0,Posted,1017.77,2025-04-07,45.0,"Withdrawal ACH FLUENT-Gainesvil/TYPE: PAYMENT ID: 1371804719
CO: FLUENT-Gainesvil
NAME: steven chaplinskiEntry Class Code: WEB",45.0
4/7/2025,"Withdrawal ACH AIRTABLE.com/bil/TYPE: AIRTABLE.c ID: 4270465600
CO: AIRTABLE.com/bil
NAME: STEVEN CHAPLINSKIEntry Class Code: WEB",31.0,Posted,1062.77,2025-04-07,31.0,"Withdrawal ACH AIRTABLE.com/bil/TYPE: AIRTABLE.c ID: 4270465600
CO: AIRTABLE.com/bil
NAME: STEVEN CHAPLINSKIEntry Class Code: WEB",31.0
4/7/2025,"Withdrawal POS #000000204012/SUNOCO 8002212501 4234 SW 20TH AVE
GAINESVILLE FL
Card 1247",21.84,Posted,1093.77,2025-04-07,21.84,"Withdrawal POS #000000216148/SUNOCO 8002212501 4234 SW 20TH AVE
GAINESVILLE FL
Card 1247",21.84
4/6/2025,"Recurring Withdrawal Debit Card - MC Debit Gator/OPENAI *CHATGPT SUBSCR SAN FRANCISC CA
Date 04/04/25 0 5094561526 0 5734
Card 1247",20.0,Posted,1115.61,2025-04-06,20.0,"Recurring Withdrawal Debit Card - MC Debit Gator/OPENAI *CHATGPT SUBSCR SAN FRANCISC CA
Date 06/04/25 0 5155335474 0 5734
Card 1247",20.0
4/6/2025,"Recurring Withdrawal Debit Card - MC Debit Gator/OPENAI SAN FRANCISC CA
Date 04/04/25 0 5094381115 2 5734
Card 1247",6.09,Posted,1135.61,2025-04-06,6.09,Recurring Withdrawal Debit Card - MC Debit Gator/OPENAI SAN FRANCISC CADate 03/08/25 0 5067339145 0 5734Card 1247,6.29875
4/6/2025,"Withdrawal Debit Card MC Debit Gator/HOSTINGER* HOSTINGER.C WILMINGTON DE
Date 04/04/25 0 5094291695 2 7372
Card 1247",14.98,Posted,1141.7,2025-04-06,14.98,"Recurring Withdrawal Debit Card - MC Debit Gator/HOSTINGER* HOSTINGER.C WILMINGTON DE
Date 05/05/25 0 5125011239 1 7372
Card 1247",14.98
4/6/2025,"Withdrawal Debit Card MC Debit Gator/INSTACART*159 SAN FRANCISC CA
Date 04/05/25 0 5095016197 1 5411
Card 1247",38.02,Posted,1156.68,2025-04-06,38.02,"Withdrawal Debit Card MC Debit Gator/INSTACART*159 SAN FRANCISC CA
Date 03/22/25 0 5081791779 0 5411
Card 1247",38.010000000000005
4/6/2025,"Withdrawal Debit Card MC Debit Gator/IONOS INC. CHESTERBROOK PA
Date 04/05/25 0 5095015218 1 4816
Card 1247",18.0,Posted,1194.7,2025-04-06,18.0,"Withdrawal Debit Card MC Debit Gator/IONOS INC. CHESTERBROOK PA
Date 06/05/25 0 5156041339 1 4816
Card 1247",18.0
4/4/2025,"Withdrawal ACH XAI LLC/TYPE: XAI LLC ID: 1800948598 CO: XAI LLC
NAME: STEVEN J CHAPLINSKI
Entry Class Code: WEB",5.0,Posted,1212.7,2025-04-04,5.0,"Withdrawal ACH XAI LLC/TYPE: XAI LLC ID: 1800948598 CO: XAI LLC
NAME: STEVEN J CHAPLINSKI
Entry Class Code: WEB",5.0
4/4/2025,"Withdrawal Debit Card MC Debit Gator/HOSTINGER* HOSTINGER.C WILMINGTON DE
Date 04/04/25 0 5094028682 1 7372
Card 1247",13.17,Posted,1217.7,2025-04-04,13.17,"Recurring Withdrawal Debit Card - MC Debit Gator/HOSTINGER* HOSTINGER.C WILMINGTON DE
Date 05/05/25 0 5125011239 1 7372
Card 1247",13.17
4/4/2025,"Recurring Withdrawal Debit Card - MC Debit Gator/APPLE.COM/BILL 866-712-7753 CA
Date 04/03/25 0 5093962196 0 5818
Card 1247",2.99,Posted,1230.87,2025-04-04,2.99,Recurring Withdrawal Debit Card - MC Debit Gator/APPLE.COM/BILL 866-712-7753 CADate 01/05/25 0 5005839185 0 5818Card 1247,2.99
4/3/2025,"Withdrawal Bill Payment #000000362529/CS Addtl Storage Park Avenue,345
CA
Card 1247",9.99,Posted,1233.86,2025-04-03,9.99,"Withdrawal Bill Payment #000000362529/CS Addtl Storage Park Avenue,345
CA
Card 1247",9.99
4/3/2025,"Withdrawal Bill Payment #000000366741/Adobe Park Avenue,345 adobe.com CA
Card 1247",19.99,Posted,1243.85,2025-04-03,19.99,"Withdrawal Bill Payment #000000366741/Adobe Park Avenue,345 adobe.com CA
Card 1247",19.99
4/3/2025,"Withdrawal POS #000000995800/SUNOCO 8002212501 4234 SW 20TH AVE
GAINESVILLE FL
Card 1247",18.41,Posted,1263.84,2025-04-03,18.41,"Withdrawal POS #000000666979/SUNOCO 8002212501 4234 SW 20TH AVE
GAINESVILLE FL
Card 1247",18.575
4/3/2025,"Recurring Withdrawal Debit Card - MC Debit Gator/NOTION LABS, INC. SAN FRANCISC CA
Date 04/02/25 0 5092100172 1 7372
Card 1247",22.0,Posted,1282.25,2025-04-03,22.0,"Recurring Withdrawal Debit Card - MC Debit Gator/NOTION LABS, INC. SAN FRANCISC CA
Date 06/02/25 0 5153210973 1 7372
Card 1247",22.0
4/2/2025,"Recurring Withdrawal Debit Card - MC Debit Gator/MYDESIGNS - PRO - MON LAS VEGAS NV
Date 04/01/25 0 5091214195 1 5734
Card 1247",49.99,Posted,1304.25,2025-04-02,49.99,"Recurring Withdrawal Debit Card - MC Debit Gator/MYDESIGNS - PRO - MON LAS VEGAS NV
Date 06/01/25 0 5152146505 1 5734
Card 1247",49.99
4/2/2025,"Recurring Withdrawal Debit Card - MC Debit Gator/PARAMOUNT+ WEST HOLLYWO CA
Date 04/01/25 0 5091067744 1 4899
Card 1247",14.96,Posted,1354.24,2025-04-02,14.96,Recurring Withdrawal Debit Card - MC Debit Gator/PARAMOUNT+ WEST HOLLYWO CADate 01/01/25 0 5001909499 0 4899Card 1247,14.96
4/2/2025,"Withdrawal ACH Watson Realty Co/TYPE: WEB PMTS ID: 9000321157
CO: Watson Realty Co
NAME: Steven chaplinskiEntry Class Code: WEB",1179.0,Posted,1369.2,2025-04-02,1179.0,"Withdrawal ACH Watson Realty Co/TYPE: WEB PMTS ID: 9000321157
CO: Watson Realty Co
NAME: Steven chaplinskiEntry Class Code: WEB",1179.0
4/2/2025,"Withdrawal ACH FLUENT-Gainesvil/TYPE: PAYMENT ID: 1371804719
CO: FLUENT-Gainesvil
NAME: steven chaplinskiEntry Class Code: WEB",25.0,Posted,2548.2,2025-04-02,25.0,"Withdrawal ACH FLUENT-Gainesvil/TYPE: PAYMENT ID: 1371804719
CO: FLUENT-Gainesvil
NAME: steven chaplinskiEntry Class Code: WEB",25.0
4/2/2025,"Withdrawal ACH AppFolio, Inc. F/TYPE: WEB PMTS ID: 9001406550
CO: AppFolio, Inc. F
NAME: Steven chaplinskiEntry Class Code: WEB",2.49,Posted,2573.2,2025-04-02,2.49,"Withdrawal ACH AppFolio, Inc. F/TYPE: WEB PMTS ID: 9001406550
CO: AppFolio, Inc. F
NAME: Steven chaplinskiEntry Class Code: WEB",2.49
4/1/2025,"Recurring Withdrawal Debit Card - MC Debit Gator/PADDLE.NET* SETAPP NEW YORK NY
Date 04/01/25 0 5091930268 0 5817
Card 1247",9.99,Posted,2575.69,2025-04-01,9.99,"Recurring Withdrawal Debit Card - MC Debit Gator/PADDLE.NET* SETAPP NEW YORK NY
Date 05/31/25 0 5151555568 2 5817
Card 1247",9.99
4/1/2025,"Withdrawal Debit Card MC Debit Gator/INSTACART*159 SAN FRANCISC CA
Date 03/31/25 0 5090929413 0 5411
Card 1247",52.0,Posted,2585.68,2025-04-01,52.0,Withdrawal Debit Card MC Debit Gator/INSTACART*159 SAN FRANCISC CADate 03/13/25 0 5072883709 0 5411Card 1247,52.0
4/1/2025,"Withdrawal Debit Card Fee/MASTERCARD ISSUER CROSS-BORDER FEE
Date 03/31/25 0 5090929332 0 5817
Card 1247",0.08,Posted,2637.68,2025-04-01,0.08,"Withdrawal Debit Card Fee/MASTERCARD ISSUER CROSS-BORDER FEE
Date 03/31/25 0 5090929332 0 5817
Card 1247",0.11399999999999999
4/1/2025,"Withdrawal Debit Card MC Debit Gator/OBSIDIAN.MD OAKVILLE NOR ON
Date 03/31/25 0 5090929332 0 5817
Card 1247",10.0,Posted,2637.76,2025-04-01,10.0,"Withdrawal Debit Card MC Debit Gator/OBSIDIAN.MD OAKVILLE NOR ON
Date 03/31/25 0 5090929332 0 5817
Card 1247",10.0
4/1/2025,"Recurring Withdrawal Debit Card - MC Debit Gator/FS *RAINDROP.IO SANTA BARBAR CA
Date 03/31/25 0 5090928275 0 5734
Card 1247",3.0,Posted,2647.76,2025-04-01,3.0,"Recurring Withdrawal Debit Card - MC Debit Gator/FS *RAINDROP.IO SANTA BARBAR CA
Date 04/30/25 0 5120038015 1 5734
Card 1247",3.0
4/1/2025,"Withdrawal POS #000020856446/GOOGLE *YouTubePremium 1600 Amphitheatre
Parkw Mountain View CA
Card 1247",15.92,Posted,2646.69,2025-04-01,15.92,"Withdrawal POS #000020312090/GOOGLE *YouTubePremium 1600 Amphitheatre
Parkw Mountain View CA
Card 1247",15.92
4/1/2025,"Withdrawal POS #000000904370/SUNOCO 8002212501 4234 SW 20TH AVE
GAINESVILLE FL
Card 1247",18.41,Posted,2662.61,2025-04-01,18.41,"Withdrawal POS #000000666979/SUNOCO 8002212501 4234 SW 20TH AVE
GAINESVILLE FL
Card 1247",18.575
3/31/2025,"Withdrawal Debit Card MC Debit Gator/ANTHROPIC SAN FRANCISC CA
Date 03/30/25 0 5089101571 1 5734
Card 1247",5.0,Posted,2681.02,2025-03-31,5.0,"Withdrawal Debit Card MC Debit Gator/VIDIQ SAN FRANCISC CA
Date 05/31/25 0 5151573162 0 5734
Card 1247",5.0
3/31/2025,"Withdrawal Debit Card Fee/MASTERCARD ISSUER CROSS-BORDER FEE
Date 03/30/25 0 5089099408 1 5817
Card 1247",0.08,Posted,2686.02,2025-03-31,0.08,"Withdrawal Debit Card Fee/MASTERCARD ISSUER CROSS-BORDER FEE
Date 03/31/25 0 5090929332 0 5817
Card 1247",0.11399999999999999
3/31/2025,"Withdrawal Debit Card MC Debit Gator/HAILUOAI.VIDEO SINGAPORE SG
Date 03/30/25 0 5089099408 1 5817
Card 1247",9.99,Posted,2686.1,2025-03-31,9.99,"Withdrawal Debit Card MC Debit Gator/HAILUOAI.VIDEO SINGAPORE SG
Date 03/30/25 0 5089099408 1 5817
Card 1247",9.99
3/31/2025,"Withdrawal Debit Card Fee/MASTERCARD ISSUER CROSS-BORDER FEE
Date 03/30/25 0 5089270441 0 4816
Card 1247",0.04,Posted,2696.09,2025-03-31,0.04,"Withdrawal Debit Card Fee/MASTERCARD ISSUER CROSS-BORDER FEE
Date 03/31/25 0 5090929332 0 5817
Card 1247",0.11399999999999999
3/31/2025,"Withdrawal Debit Card MC Debit Gator/PAYPAL *SHENDUQRWEA 4029357733 HK
Date 03/30/25 0 5089270441 0 4816
Card 1247",5.3,Posted,2696.13,2025-03-31,5.3,"Withdrawal Debit Card MC Debit Gator/PAYPAL *SHENDUQRWEA 4029357733 HK
Date 03/30/25 0 5089270441 0 4816
Card 1247",5.3
3/31/2025,"Withdrawal ACH FLUENT-Gainesvil/TYPE: PAYMENT ID: 1371804719
CO: FLUENT-Gainesvil
NAME: steven chaplinskiEntry Class Code: WEB",35.0,Posted,2701.43,2025-03-31,35.0,"Withdrawal ACH FLUENT-Gainesvil/TYPE: PAYMENT ID: 1371804719
CO: FLUENT-Gainesvil
NAME: steven chaplinskiEntry Class Code: WEB",35.0
3/31/2025,"Withdrawal ACH FLUENT-Gainesvil/TYPE: PAYMENT ID: 1371804719
CO: FLUENT-Gainesvil
NAME: steven chaplinskiEntry Class Code: WEB",25.0,Posted,2736.43,2025-03-31,25.0,"Withdrawal ACH FLUENT-Gainesvil/TYPE: PAYMENT ID: 1371804719
CO: FLUENT-Gainesvil
NAME: steven chaplinskiEntry Class Code: WEB",25.0
3/30/2025,"Withdrawal POS #000000828055/SUNOCO 8002212501 4234 SW 20TH AVE
GAINESVILLE FL
Card 1247",18.41,Posted,2761.43,2025-03-30,18.41,"Withdrawal POS #000000216148/SUNOCO 8002212501 4234 SW 20TH AVE
GAINESVILLE FL
Card 1247",18.41
3/30/2025,"Withdrawal POS #000000362248/AMAZON.COM*S368X2NI3 SEATTLE WA
Card 1247",10.74,Posted,2779.84,2025-03-30,10.74,"Withdrawal POS #000000134088/AMAZON.COM*N888H1072 SEATTLE WA
Card 1247",10.46
3/30/2025,"Recurring Withdrawal Debit Card - MC Debit Gator/OPENAI SAN FRANCISC CA
Date 03/29/25 0 5088560328 2 5734
Card 1247",6.36,Posted,2790.58,2025-03-30,6.36,Recurring Withdrawal Debit Card - MC Debit Gator/OPENAI SAN FRANCISC CADate 03/08/25 0 5067339145 0 5734Card 1247,6.29875
3/30/2025,"Recurring Withdrawal Debit Card - MC Debit Gator/SUPERPOWER CHATGPT MIDDLETOWN DE
Date 03/29/25 0 5088037830 1 5734
Card 1247",15.0,Posted,2796.94,2025-03-30,15.0,"Recurring Withdrawal Debit Card - MC Debit Gator/SUPERPOWER CHATGPT MIDDLETOWN DE
Date 06/05/25 0 5156229550 1 5734
Card 1247",15.0
3/30/2025,"Withdrawal Debit Card MC Debit Gator/IONOS INC. CHESTERBROOK PA
Date 03/29/25 0 5088910148 0 4816
Card 1247",3.5,Posted,2811.94,2025-03-30,3.5,"Withdrawal Debit Card MC Debit Gator/IONOS INC. CHESTERBROOK PA
Date 06/05/25 0 5156041339 1 4816
Card 1247",3.0
3/30/2025,"Withdrawal Debit Card MC Debit Gator/WALGREENS #5024 GAINESVILLE FL
Date 03/28/25 0 5087551811 2 5912
Card 1247",15.0,Posted,2815.44,2025-03-30,15.0,"Withdrawal Debit Card MC Debit Gator/WALGREENS #9304 GAINESVILLE FL
Date 05/30/25 0 5150232309 1 5912
Card 1247",15.0
3/30/2025,"Withdrawal Debit Card MC Debit Gator/CIRCLE K # 06782 GAINESVILLE FL
Date 03/28/25 0 5087904842 0 5499
Card 1247",19.33,Posted,2830.44,2025-03-30,19.33,"Withdrawal Debit Card MC Debit Gator/CIRCLE K # 06782 GAINESVILLE FL
Date 04/09/25 0 5099980889 0 5499
Card 1247",19.54
3/30/2025,"Withdrawal POS #000000000089/AMAZON.COM*NF6Z16BF3 SEATTLE WA
Card 1247",20.36,Posted,2849.77,2025-03-30,20.36,"Withdrawal POS #000000000003/AMAZON.COM*1U8092W83 SEATTLE WA
Card 1247",20.36
3/28/2025,"Withdrawal POS #000000721608/SUNOCO 8002212501 4234 SW 20TH AVE
GAINESVILLE FL
Card 1247",18.41,Posted,2870.13,2025-03-28,18.41,"Withdrawal POS #000000216148/SUNOCO 8002212501 4234 SW 20TH AVE
GAINESVILLE FL
Card 1247",18.41
3/28/2025,"Withdrawal Debit Card MC Debit Gator/INSTACART*159 SAN FRANCISC CA
Date 03/27/25 0 5086352176 0 5411
Card 1247",63.11,Posted,2888.54,2025-03-28,63.11,Withdrawal Debit Card MC Debit Gator/INSTACART*159 SAN FRANCISC CADate 03/13/25 0 5072883709 0 5411Card 1247,63.11
3/28/2025,"Withdrawal Debit Card MC Debit Gator/CIRCLE K # 06782 GAINESVILLE FL
Date 03/26/25 0 5085313150 1 5499
Card 1247",3.86,Posted,2951.65,2025-03-28,3.86,Withdrawal Debit Card MC Debit Gator/CIRCLE K # 06782 GAINESVILLE FLDate 01/31/25 0 5031331003 1 5499Card 1247,3.86
3/28/2025,"Withdrawal POS #000010144479/WALGREENS 2415 SW 75TH 2415 SW 75TH ST
GAINESVILLE FL
Card 1247",17.03,Posted,2955.51,2025-03-28,17.03,"Withdrawal POS #000010144479/WALGREENS 2415 SW 75TH 2415 SW 75TH ST
GAINESVILLE FL
Card 1247",17.03
3/27/2025,"Withdrawal Debit Card MC Debit Gator/INSTACART*159 SAN FRANCISC CA
Date 03/26/25 0 5085947835 0 5411
Card 1247",35.13,Posted,2972.54,2025-03-27,35.13,Withdrawal Debit Card MC Debit Gator/INSTACART*159 SAN FRANCISC CADate 03/13/25 0 5072883709 0 5411Card 1247,35.565
3/27/2025,"Recurring Withdrawal Debit Card - MC Debit Gator/APPLE.COM/BILL 866-712-7753 CA
Date 03/26/25 0 5085687073 0 5818
Card 1247",15.99,Posted,3007.67,2025-03-27,15.99,Recurring Withdrawal Debit Card - MC Debit Gator/APPLE.COM/BILL 866-712-7753 CADate 01/05/25 0 5005839185 0 5818Card 1247,15.99
3/27/2025,"Withdrawal POS #000000666979/SUNOCO 8002212501 4234 SW 20TH AVE
GAINESVILLE FL
Card 1247",18.41,Posted,3023.66,2025-03-27,18.41,"Withdrawal POS #000000666979/SUNOCO 8002212501 4234 SW 20TH AVE
GAINESVILLE FL
Card 1247",18.575
3/26/2025,"Recurring Withdrawal Debit Card - MC Debit Gator/IC* INSTACART*SUBSCRIP SAN FRANCISC CA
Date 03/25/25 0 5084015896 1 5411
Card 1247",9.99,Posted,-7.93,2025-03-26,9.99,"Recurring Withdrawal Debit Card - MC Debit Gator/IC* INSTACART*SUBSCRIP SAN FRANCISC CA
Date 05/27/25 0 5147989663 0 5411
Card 1247",9.99
3/26/2025,"Withdrawal ACH FLUENT-Gainesvil/TYPE: PAYMENT ID: 1371804719
CO: FLUENT-Gainesvil
NAME: steven chaplinskiEntry Class Code: WEB",20.0,Posted,2.06,2025-03-26,20.0,"Withdrawal ACH FLUENT-Gainesvil/TYPE: PAYMENT ID: 1371804719
CO: FLUENT-Gainesvil
NAME: steven chaplinskiEntry Class Code: WEB",20.5
3/26/2025,"Withdrawal POS #000096294989/FAST TRACK #200 GAINESVILLE GAINESVILLE
Card 1247",11.35,Posted,22.06,2025-03-26,11.35,"Withdrawal POS #000096294989/FAST TRACK #200 GAINESVILLE GAINESVILLE
Card 1247",11.35
3/25/2025,"Withdrawal Debit Card MC Debit Gator/INSTACART*159 SAN FRANCISC CA
Date 03/24/25 0 5083900436 0 5411
Card 1247",29.0,Posted,33.41,2025-03-25,29.0,Withdrawal Debit Card MC Debit Gator/INSTACART*159 SAN FRANCISC CADate 03/13/25 0 5072883709 0 5411Card 1247,29.0
3/24/2025,"Withdrawal POS #000000564898/WAWA 5325 2373 SW ARCHER ROAD
FL
Card 1247",14.71,Posted,12.41,2025-03-24,14.71,"Withdrawal POS #000000564898/WAWA 5325 2373 SW ARCHER ROAD
FL
Card 1247",14.71
3/23/2025,"Withdrawal POS #000000519848/SUNOCO 8002212501 4234 SW 20TH AVE
GAINESVILLE FL
Card 1247",19.9,Posted,27.12,2025-03-23,19.9,"Withdrawal POS #000000216148/SUNOCO 8002212501 4234 SW 20TH AVE
GAINESVILLE FL
Card 1247",20.33
3/23/2025,"Withdrawal Debit Card MC Debit Gator/INSTACART*159 SAN FRANCISC CA
Date 03/22/25 0 5081791779 0 5411
Card 1247",1.25,Posted,47.02,2025-03-23,1.25,Withdrawal Debit Card MC Debit Gator/INSTACART*159 SAN FRANCISC CADate 03/13/25 0 5072883709 0 5411Card 1247,1.125
3/23/2025,"Withdrawal Debit Card MC Debit Gator/INSTACART*159 SAN FRANCISC CA
Date 03/22/25 0 5081281165 0 5411
Card 1247",52.02,Posted,48.27,2025-03-23,52.02,"Withdrawal Debit Card MC Debit Gator/INSTACART*159 SAN FRANCISC CA
Date 03/22/25 0 5081791779 0 5411
Card 1247",52.02
3/23/2025,"Recurring Withdrawal Bill Payment - #000000017652/NETFLIX COM LOS GATOS CA
Card 1247",20.71,Posted,100.29,2025-03-23,20.71,"Recurring Withdrawal Bill Payment - #000000017652/NETFLIX COM LOS GATOS CA
Card 1247",20.71
3/22/2025,"Withdrawal POS #000000936870/AMAZON.COM*V86L723P3 SEATTLE WA
Card 1247",20.36,Posted,121.0,2025-03-22,20.36,"Withdrawal POS #000000134088/AMAZON.COM*N888H1072 SEATTLE WA
Card 1247",20.295
3/22/2025,"Withdrawal ATM Fee/EFT 3401 W University Ave Gainesville FL
Card 1247",2.0,Posted,141.36,2025-03-22,2.0,"Withdrawal ATM Fee/EFT 3401 W University Ave Gainesville FL
Card 1247",2.0
3/22/2025,"Withdrawal at ATM #000000776623/EFT 3401 W University Ave Gainesville FL
Card 1247",23.0,Posted,143.36,2025-03-22,23.0,"Withdrawal at ATM #000000776623/EFT 3401 W University Ave Gainesville FL
Card 1247",23.0
3/22/2025,"Withdrawal POS #000000470173/SUNOCO 8002212501 4234 SW 20TH AVE
GAINESVILLE FL
Card 1247",21.84,Posted,166.36,2025-03-22,21.84,"Withdrawal POS #000000347331/SUNOCO 8002212501 4234 SW 20TH AVE
GAINESVILLE FL
Card 1247",21.84
3/21/2025,"Recurring Withdrawal Debit Card - MC Debit Gator/CANVA* I04461-36076553 CAMDEN DE
Date 03/20/25 0 5079931674 0 7333
Card 1247",12.99,Posted,-11.8,2025-03-21,12.99,"Recurring Withdrawal Debit Card - MC Debit Gator/CANVA* I04522-50593645 CAMDEN DE
Date 05/20/25 0 5140963894 0 7333
Card 1247",12.99
3/21/2025,"Withdrawal Debit Card MC Debit Gator/INSTACART*159 SAN FRANCISC CA
Date 03/20/25 0 5079931393 0 5411
Card 1247",36.0,Posted,1.19,2025-03-21,36.0,Withdrawal Debit Card MC Debit Gator/INSTACART*159 SAN FRANCISC CADate 03/13/25 0 5072883709 0 5411Card 1247,35.565
3/20/2025,"Withdrawal POS #000000402629/SUNOCO 8002212501 4234 SW 20TH AVE
GAINESVILLE FL
Card 1247",19.9,Posted,37.19,2025-03-20,19.9,"Withdrawal POS #000000666979/SUNOCO 8002212501 4234 SW 20TH AVE
GAINESVILLE FL
Card 1247",19.685
3/20/2025,"Withdrawal ACH FLUENT-Gainesvil/TYPE: PAYMENT ID: 1371804719
CO: FLUENT-Gainesvil
NAME: steven chaplinskiEntry Class Code: WEB",15.0,Posted,57.09,2025-03-20,15.0,"Withdrawal ACH FLUENT-Gainesvil/TYPE: PAYMENT ID: 1371804719
CO: FLUENT-Gainesvil
NAME: steven chaplinskiEntry Class Code: WEB",15.0
3/19/2025,"Withdrawal POS #000000336821/SUNOCO 8002212501 4234 SW 20TH AVE
GAINESVILLE FL
Card 1247",23.87,Posted,72.09,2025-03-19,23.87,"Withdrawal POS #000000216148/SUNOCO 8002212501 4234 SW 20TH AVE
GAINESVILLE FL
Card 1247",23.655
3/19/2025,"Withdrawal Debit Card MC Debit Gator/INSTACART*159 SAN FRANCISC CA
Date 03/18/25 0 5077362198 0 5411
Card 1247",43.0,Posted,95.96,2025-03-19,43.0,Withdrawal Debit Card MC Debit Gator/INSTACART*159 SAN FRANCISC CADate 03/13/25 0 5072883709 0 5411Card 1247,43.0
3/19/2025,"Withdrawal Debit Card MC Debit Gator/WAWA 5325 GAINESVILLE FL
Date 03/18/25 0 5077155043 1 5541
Card 1247",16.64,Posted,138.96,2025-03-19,16.64,"Withdrawal Debit Card MC Debit Gator/WAWA 5325 GAINESVILLE FL
Date 03/18/25 0 5077155043 1 5541
Card 1247",16.64
3/18/2025,"Recurring Withdrawal Debit Card - MC Debit Gator/AMAZON PRIME*RT81V9UJ3 AMZN.COM/BIL WA
Date 03/17/25 0 5076013448 1 5968
Card 1247",15.13,Posted,155.6,2025-03-18,15.13,"Recurring Withdrawal Debit Card - MC Debit Gator/AMAZON PRIME*NZ72M6V92 AMZN.COM/BIL WA
Date 05/17/25 0 5137026065 1 5968
Card 1247",15.13
3/18/2025,"Withdrawal POS #000000293182/SUNOCO 8002212501 4234 SW 20TH AVE
GAINESVILLE FL
Card 1247",23.44,Posted,170.73,2025-03-18,23.44,"Withdrawal POS #000000216148/SUNOCO 8002212501 4234 SW 20TH AVE
GAINESVILLE FL
Card 1247",23.655
3/17/2025,"Recurring Withdrawal Debit Card - MC Debit Gator/OPENAI SAN FRANCISC CA
Date 03/17/25 0 5076063070 1 5734
Card 1247",6.06,Posted,194.17,2025-03-17,6.06,Recurring Withdrawal Debit Card - MC Debit Gator/OPENAI SAN FRANCISC CADate 03/08/25 0 5067339145 0 5734Card 1247,6.29875
3/17/2025,"Recurring Withdrawal Debit Card - MC Debit Gator/APPLE.COM/BILL 866-712-7753 CA
Date 03/16/25 0 5075055681 1 5818
Card 1247",21.99,Posted,200.23,2025-03-17,21.99,Recurring Withdrawal Debit Card - MC Debit Gator/APPLE.COM/BILL 866-712-7753 CADate 01/05/25 0 5005839185 0 5818Card 1247,21.99
3/17/2025,"Withdrawal POS #000000237561/SUNOCO 8002212501 4234 SW 20TH AVE
GAINESVILLE FL
Card 1247",21.84,Posted,222.22,2025-03-17,21.84,"Withdrawal POS #000000216148/SUNOCO 8002212501 4234 SW 20TH AVE
GAINESVILLE FL
Card 1247",21.84
3/16/2025,"Withdrawal POS #000000209606/SUNOCO 8002212501 4234 SW 20TH AVE
GAINESVILLE FL
Card 1247",18.41,Posted,244.06,2025-03-16,18.41,"Withdrawal POS #000000666979/SUNOCO 8002212501 4234 SW 20TH AVE
GAINESVILLE FL
Card 1247",18.575
3/16/2025,"Withdrawal Bill Payment #000000406377/APPLE COM ONE APPLE PARK WAY ONE APPLE
CA
Card 1247",0.99,Posted,262.47,2025-03-16,0.99,"Withdrawal Bill Payment #000000176250/APPLE COM ONE APPLE PARK WAY ONE APPLE
CA
Card 1247",0.99
3/14/2025,Withdrawal Debit Card MC Debit Gator/INSTACART*159 SAN FRANCISC CADate 03/13/25 0 5072883709 0 5411Card 1247,72.0,Posted,263.46,2025-03-14,72.0,Withdrawal Debit Card MC Debit Gator/INSTACART*159 SAN FRANCISC CADate 03/13/25 0 5072883709 0 5411Card 1247,72.0
3/14/2025,Withdrawal POS #000000138065/SUNOCO 8002212501 4234 SW 20TH AVEGAINESVILLE FLCard 1247,23.65,Posted,335.46,2025-03-14,23.65,Withdrawal POS #000000231268/SUNOCO 8002212501 4234 SW 20TH AVEGAINESVILLE FLCard 1247,24.119999999999997
3/12/2025,Withdrawal POS #000000029649/SUNOCO 8002212501 4234 SW 20TH AVEGAINESVILLE FLCard 1247,19.9,Posted,359.11,2025-03-12,19.9,Withdrawal POS #000000231268/SUNOCO 8002212501 4234 SW 20TH AVEGAINESVILLE FLCard 1247,19.955
3/11/2025,Withdrawal Debit Card MC Debit Gator/AMAZON PRIME*CU90U9EJ3 AMZN.COM/BIL WADate 03/11/25 0 5070388912 1 5818Card 1247,3.4,Posted,379.01,2025-03-11,3.4,Withdrawal Debit Card MC Debit Gator/AMAZON PRIME*CU90U9EJ3 AMZN.COM/BIL WADate 03/11/25 0 5070388912 1 5818Card 1247,3.4
3/10/2025,Withdrawal Debit Card MC Debit Gator/GRU/EZ-PAY WEB PYMT 352-334-3434 FLDate 03/09/25 0 5068009425 1 4900Card 1247,182.55,Posted,382.41,2025-03-10,182.55,Withdrawal Debit Card MC Debit Gator/GRU/EZ-PAY WEB PYMT 352-334-3434 FLDate 03/09/25 0 5068009425 1 4900Card 1247,182.55
3/10/2025,Withdrawal Debit Card MC Debit Gator/COX GAINESVILLE COMM 800-234-3993 FLDate 03/09/25 0 5068137922 1 4899Card 1247,156.13,Posted,564.96,2025-03-10,156.13,Withdrawal Debit Card MC Debit Gator/COX GAINESVILLE COMM 800-234-3993 FLDate 03/09/25 0 5068137922 1 4899Card 1247,156.13
3/10/2025,Withdrawal ACH FLUENT-Gainesvil/TYPE: PAYMENT ID: 1371804719CO: FLUENT-GainesvilNAME: steven chaplinskiEntry Class Code: WEB,75.0,Posted,721.09,2025-03-10,75.0,Withdrawal ACH FLUENT-Gainesvil/TYPE: PAYMENT ID: 1371804719CO: FLUENT-GainesvilNAME: steven chaplinski,75.0
3/10/2025,Withdrawal ACH SUNO INC./TYPE: SUNO INC. ID: 1800948598CO: SUNO INC. NAME: STEVEN J CHAPLINSKIEntry Class Code: WEB,10.0,Posted,796.09,2025-03-10,10.0,"Withdrawal ACH SUNO INC./TYPE: SUNO INC. ID: 1800948598
CO: SUNO INC. NAME: STEVEN J CHAPLINSKI
Entry Class Code: WEB",10.0
3/10/2025,Withdrawal ACH QUORA.COM/TYPE: QUORA.COM ID: 4270465600CO: QUORA.COM NAME: STEVEN J CHAPLINSKIEntry Class Code: WEB,4.99,Posted,806.09,2025-03-10,4.99,Withdrawal ACH QUORA.COM/TYPE: QUORA.COM ID: 4270465600CO: QUORA.COM NAME: STEVEN J CHAPLINSKIEntry Class Code: WEB,4.99
3/10/2025,Withdrawal POS #000000160477/SUNOCO 8002212501 4234 SW 20TH AVEGAINESVILLE FLCard 1247,34.84,Posted,811.08,2025-03-10,34.84,Withdrawal POS #000000616677/SUNOCO 8002212501 4234 SW 20TH AVEGAINESVILLE FLCard 1231,34.76
3/9/2025,Withdrawal Debit Card MC Debit Gator/I-BLOCKLIST/PEERBLOCK MIAMI FLDate 03/08/25 0 5067675779 3 5734Card 1247,9.99,Posted,843.93,2025-03-09,9.99,Withdrawal Debit Card MC Debit Gator/I-BLOCKLIST/PEERBLOCK MIAMI FLDate 03/08/25 0 5067675779 3 5734Card 1247,9.99
3/9/2025,Recurring Withdrawal Debit Card - MC Debit Gator/OPENAI SAN FRANCISC CADate 03/08/25 0 5067339145 0 5734Card 1247,6.1,Posted,853.92,2025-03-09,6.1,Recurring Withdrawal Debit Card - MC Debit Gator/OPENAI SAN FRANCISC CADate 03/08/25 0 5067339145 0 5734Card 1247,6.29875
3/9/2025,Recurring Withdrawal Debit Card - MC Debit Gator/TUBEBUDDYCOM* 8668823239 CADate 03/07/25 0 5066672774 3 5045Card 1247,7.5,Posted,860.02,2025-03-09,7.5,Recurring Withdrawal Debit Card - MC Debit Gator/TUBEBUDDYCOM* 8668823239 CADate 03/07/25 0 5066672774 3 5045Card 1247,7.5
3/9/2025,Recurring Withdrawal Debit Card - MC Debit Gator/INVIDEO INC COUNTRY OF S DEDate 03/07/25 0 5066671640 3 5734Card 1247,35.0,Posted,867.52,2025-03-09,35.0,Recurring Withdrawal Debit Card - MC Debit Gator/INVIDEO INC COUNTRY OF S DEDate 03/07/25 0 5066671640 3 5734Card 1247,35.0
3/9/2025,Recurring Withdrawal Debit Card Fee/MASTERCARD ISSUER CROSS-BORDER FEEDate 03/08/25 0 5067338695 0 5734Card 1247,0.06,Posted,902.52,2025-03-09,0.06,Recurring Withdrawal Debit Card Fee/MASTERCARD ISSUER CROSS-BORDER FEEDate 01/06/24 0 4006875269 0 5815Card 2801,0.20272727272727267
3/9/2025,Recurring Withdrawal Debit Card - MC Debit Gator/IDEOGRAM AI TORONTO ONDate 03/08/25 0 5067338695 0 5734Card 1247,8.0,Posted,902.58,2025-03-09,8.0,"Recurring Withdrawal Debit Card - MC Debit Gator/IDEOGRAM AI TORONTO ON
Date 04/08/25 0 5098321266 0 5734
Card 1247",8.0
3/9/2025,Recurring Withdrawal Debit Card Fee/MASTERCARD ISSUER CROSS-BORDER FEEDate 03/08/25 0 5067744961 0 5734Card 1247,0.23,Posted,910.58,2025-03-09,0.23,Withdrawal Debit Card Fee/MASTERCARD ISSUER CROSS-BORDER FEEDate 03/01/25 0 5060117430 2 5967Card 1247,0.07250000000000001
3/9/2025,Recurring Withdrawal Debit Card - MC Debit Gator/NOTEGPT.IO ADMIRALTY KODate 03/08/25 0 5067744961 0 5734Card 1247,29.0,Posted,910.81,2025-03-09,29.0,Recurring Withdrawal Debit Card - MC Debit Gator/NOTEGPT.IO ADMIRALTY KODate 02/08/25 0 5039144067 2 5734Card 1247,29.0
3/9/2025,Withdrawal Debit Card MC Debit Gator/IONOS INC. CHESTERBROOK PADate 03/08/25 0 5067522264 1 4816Card 1247,23.0,Posted,939.81,2025-03-09,23.0,Withdrawal Debit Card MC Debit Gator/IONOS INC. CHESTERBROOK PADate 03/08/25 0 5067522264 1 4816Card 1247,23.0
3/9/2025,Recurring Withdrawal Debit Card - MC Debit Gator/APPLE.COM/BILL 866-712-7753 CADate 03/08/25 0 5067516617 1 5818Card 1247,14.97,Posted,962.81,2025-03-09,14.97,Recurring Withdrawal Debit Card - MC Debit Gator/APPLE.COM/BILL 866-712-7753 CADate 01/05/25 0 5005839185 0 5818Card 1247,14.97
3/9/2025,Withdrawal POS #000000571139/AMAZON.COM*BI6JD3LZ3 SEATTLE WACard 1247,18.2,Posted,977.78,2025-03-09,18.2,Withdrawal POS #000000571139/AMAZON.COM*BI6JD3LZ3 SEATTLE WACard 1247,18.2
3/9/2025,Withdrawal POS #000000000099/AMAZON.COM*VA0IZ8DO3 SEATTLE WACard 1247,33.84,Posted,995.98,2025-03-09,33.84,Withdrawal POS #000000000099/AMAZON.COM*VA0IZ8DO3 SEATTLE WACard 1247,33.84
3/8/2025,Withdrawal POS #000000117409/SUNOCO 8002212501 4234 SW 20TH AVEGAINESVILLE FLCard 1247,18.41,Posted,1029.82,2025-03-08,18.41,Withdrawal POS #000000129774/SUNOCO 8002212501 4234 SW 20TH AVEGAINESVILLE FLCard 1247,18.41
3/8/2025,Withdrawal POS #000061190506/SMOKE CITY 2120 SW 34TH ST GAINESVILLECard 1247,6.34,Posted,1048.23,2025-03-08,6.34,"Withdrawal POS #000080196760/SMOKE CITY 2120 SW 34TH ST GAINESVILLE
Card 1247",6.34
3/8/2025,Withdrawal POS #000000788547/PUBLIX 3100 SW 35TH BLVD GAINESVILLE FLCard 1247,26.8,Posted,1054.57,2025-03-08,26.8,"Withdrawal POS #000000752480/PUBLIX 3100 SW 35TH BLVD GAINESVILLE FL
Card 1247",26.8
3/7/2025,Withdrawal POS #000000956289/SUNOCO 8002212501 4234 SW 20TH AVEGAINESVILLE FLCard 1247,21.84,Posted,1081.37,2025-03-07,21.84,Withdrawal POS #000000966158/SUNOCO 8002212501 4234 SW 20TH AVEGAINESVILLE FLCard 2801,22.130000000000003
3/6/2025,Withdrawal Debit Card MC Debit Gator/WWW.PERPLEXITY.AI SAN FRANCISC CADate 03/06/25 0 5065324957 1 5815Card 1247,4.0,Posted,1103.21,2025-03-06,4.0,Withdrawal Debit Card MC Debit Gator/WWW.PERPLEXITY.AI SAN FRANCISC CADate 03/06/25 0 5065324957 1 5815Card 1247,4.0
3/6/2025,Recurring Withdrawal Debit Card - MC Debit Gator/OPENAI SAN FRANCISC CADate 03/06/25 0 5065324949 1 5734Card 1247,10.0,Posted,1107.21,2025-03-06,10.0,Recurring Withdrawal Debit Card - MC Debit Gator/OPENAI SAN FRANCISC CADate 03/08/25 0 5067339145 0 5734Card 1247,10.0
3/6/2025,Recurring Withdrawal Debit Card - MC Debit Gator/SUPERPOWER CHATGPT MIDDLETOWN DEDate 03/06/25 0 5065760660 0 5734Card 1247,15.0,Posted,1117.21,2025-03-06,15.0,"Recurring Withdrawal Debit Card - MC Debit Gator/SUPERPOWER CHATGPT MIDDLETOWN DE
Date 06/05/25 0 5156229550 1 5734
Card 1247",15.0
3/6/2025,Recurring Withdrawal Debit Card - MC Debit Gator/SUPERPOWER CHATGPT MIDDLETOWN DEDate 03/06/25 0 5065760659 0 5734Card 1247,15.0,Posted,1132.21,2025-03-06,15.0,"Recurring Withdrawal Debit Card - MC Debit Gator/SUPERPOWER CHATGPT MIDDLETOWN DE
Date 06/05/25 0 5156229550 1 5734
Card 1247",15.0
3/6/2025,Withdrawal Debit Card MC Debit Gator/INSTACART*159 SAN FRANCISC CADate 03/05/25 0 5064759595 0 5411Card 1247,4.09,Posted,1147.21,2025-03-06,4.09,Withdrawal Debit Card MC Debit Gator/INSTACART*159 SAN FRANCISC CADate 03/13/25 0 5072883709 0 5411Card 1247,3.75
3/6/2025,Withdrawal Debit Card MC Debit Gator/INSTACART*159 SAN FRANCISC CADate 03/05/25 0 5064759594 0 5411Card 1247,49.98,Posted,1151.3,2025-03-06,49.98,Withdrawal Debit Card MC Debit Gator/INSTACART*159 SAN FRANCISC CADate 03/13/25 0 5072883709 0 5411Card 1247,49.66
3/6/2025,Withdrawal Debit Card MC Debit Gator/IONOS INC. CHESTERBROOK PADate 03/05/25 0 5064758543 0 4816Card 1247,17.0,Posted,1201.28,2025-03-06,17.0,Withdrawal Debit Card MC Debit Gator/IONOS INC. CHESTERBROOK PADate 03/08/25 0 5067522264 1 4816Card 1247,16.5
3/5/2025,Recurring Withdrawal Debit Card - MC Debit Gator/OPENAI *CHATGPT SUBSCR SAN FRANCISC CADate 03/04/25 0 5063322854 0 5734Card 1247,20.0,Posted,1218.28,2025-03-05,20.0,Recurring Withdrawal Debit Card - MC Debit Gator/OPENAI SAN FRANCISC CADate 03/08/25 0 5067339145 0 5734Card 1247,20.0
3/5/2025,Withdrawal Debit Card MC Debit Gator/IONOS INC. CHESTERBROOK PADate 03/04/25 0 5063027389 1 4816Card 1247,1.0,Posted,1238.28,2025-03-05,1.0,Withdrawal Debit Card MC Debit Gator/IONOS INC. CHESTERBROOK PADate 03/08/25 0 5067522264 1 4816Card 1247,1.0
3/5/2025,Withdrawal POS #000000403709/SUNOCO 8002212501 4234 SW 20TH AVEGAINESVILLE FLCard 1247,21.84,Posted,1239.28,2025-03-05,21.84,Withdrawal POS #000000764400/SUNOCO 8002212501 4234 SW 20TH AVEGAINESVILLE FLCard 1247,21.84
3/4/2025,"Withdrawal Bill Payment #000000352498/Adobe Park Avenue,345 San Jose CACard 1247",19.99,Posted,1261.12,2025-03-04,19.99,"Withdrawal Bill Payment #000000352498/Adobe Park Avenue,345 San Jose CACard 1247",19.99
3/4/2025,Withdrawal POS #000000897140/SUNOCO 8002212501 4234 SW 20TH AVEGAINESVILLE FLCard 1247,21.84,Posted,1281.11,2025-03-04,21.84,Withdrawal POS #000000129774/SUNOCO 8002212501 4234 SW 20TH AVEGAINESVILLE FLCard 1247,21.97
3/3/2025,"Recurring Withdrawal Debit Card - MC Debit Gator/NOTION LABS, INC. SAN FRANCISC CADate 03/02/25 0 5061145246 1 7372Card 1247",22.0,Posted,1302.95,2025-03-03,22.0,Recurring Withdrawal Debit Card - MC Debit Gator/OPENAI SAN FRANCISC CADate 03/08/25 0 5067339145 0 5734Card 1247,22.0
3/3/2025,Recurring Withdrawal Debit Card - MC Debit Gator/APPLE.COM/BILL 866-712-7753 CADate 03/03/25 0 5062986121 0 5818Card 1247,2.99,Posted,1324.95,2025-03-03,2.99,Recurring Withdrawal Debit Card - MC Debit Gator/APPLE.COM/BILL 866-712-7753 CADate 01/05/25 0 5005839185 0 5818Card 1247,2.99
3/3/2025,Withdrawal ACH Watson Realty Co/TYPE: WEB PMTS ID: 9000321157CO: Watson Realty CoNAME: Steven chaplinskiEntry Class Code: WEB,1179.0,Posted,1327.94,2025-03-03,1179.0,"Withdrawal ACH Watson Realty Co/TYPE: WEB PMTS ID: 9000321157
CO: Watson Realty Co
NAME: Steven chaplinskiEntry Class Code: WEB",1179.0
3/3/2025,Withdrawal ACH FLUENT-Gainesvil/TYPE: PAYMENT ID: 1371804719CO: FLUENT-GainesvilNAME: steven chaplinskiEntry Class Code: WEB,30.0,Posted,2506.94,2025-03-03,30.0,Withdrawal ACH FLUENT-Gainesvil/TYPE: PAYMENT ID: 1371804719CO: FLUENT-GainesvilNAME: steven chaplinski,30.0
3/3/2025,"Withdrawal ACH AppFolio, Inc. F/TYPE: WEB PMTS ID: 9001406550CO: AppFolio, Inc. FNAME: Steven chaplinskiEntry Class Code: WEB",2.49,Posted,2536.94,2025-03-03,2.49,"Withdrawal ACH AppFolio, Inc. F/TYPE: WEB PMTS ID: 9001406550
CO: AppFolio, Inc. F
NAME: Steven chaplinskiEntry Class Code: WEB",2.49
3/2/2025,Withdrawal Debit Card Fee/MASTERCARD ISSUER CROSS-BORDER FEEDate 03/01/25 0 5060117430 2 5967Card 1247,0.03,Posted,2539.43,2025-03-02,0.03,Withdrawal Debit Card Fee/MASTERCARD ISSUER CROSS-BORDER FEEDate 03/01/25 0 5060117430 2 5967Card 1247,0.07250000000000001
3/2/2025,Withdrawal Debit Card MC Debit Gator/SEEMYHELP.COM 15143341887 NLDate 03/01/25 0 5060117430 2 5967Card 1247,3.17,Posted,2539.46,2025-03-02,3.17,Withdrawal Debit Card MC Debit Gator/SEEMYHELP.COM 15143341887 NLDate 03/01/25 0 5060117430 2 5967Card 1247,3.17
3/2/2025,Recurring Withdrawal Debit Card - MC Debit Gator/MYDESIGNS - PRO - MON LAS VEGAS NVDate 03/01/25 0 5060117238 2 5734Card 1247,49.99,Posted,2542.63,2025-03-02,49.99,"Recurring Withdrawal Debit Card - MC Debit Gator/MYDESIGNS - PRO - MON LAS VEGAS NV
Date 06/01/25 0 5152146505 1 5734
Card 1247",49.99
3/2/2025,Recurring Withdrawal Debit Card - MC Debit Gator/SUPERPOWER CHATGPT MIDDLETOWN DEDate 03/01/25 0 5060800147 3 5734Card 1247,15.0,Posted,2592.62,2025-03-02,15.0,"Recurring Withdrawal Debit Card - MC Debit Gator/SUPERPOWER CHATGPT MIDDLETOWN DE
Date 06/05/25 0 5156229550 1 5734
Card 1247",15.0
3/2/2025,Recurring Withdrawal Debit Card - MC Debit Gator/PARAMOUNT+ WEST HOLLYWO CADate 03/01/25 0 5060115089 2 4899Card 1247,14.96,Posted,2607.62,2025-03-02,14.96,Recurring Withdrawal Debit Card - MC Debit Gator/PARAMOUNT+ WEST HOLLYWO CADate 01/01/25 0 5001909499 0 4899Card 1247,14.96
3/2/2025,Recurring Withdrawal Debit Card - MC Debit Gator/PADDLE.NET* SETAPP NEW YORK NYDate 03/01/25 0 5060337134 0 5817Card 1247,9.99,Posted,2622.58,2025-03-02,9.99,"Recurring Withdrawal Debit Card - MC Debit Gator/PADDLE.NET* SETAPP NEW YORK NY
Date 05/31/25 0 5151555568 2 5817
Card 1247",9.99
3/2/2025,Withdrawal Debit Card MC Debit Gator/CIRCLE K # 06782 GAINESVILLE FLDate 02/27/25 0 5058785660 3 5499Card 1247,15.47,Posted,2632.57,2025-03-02,15.47,Withdrawal Debit Card MC Debit Gator/CIRCLE K # 06782 GAINESVILLE FLDate 01/31/25 0 5031331003 1 5499Card 1247,15.425
3/2/2025,Withdrawal POS #000000754970/SUNOCO 8002212501 4234 SW 20TH AVEGAINESVILLE FLCard 1247,18.41,Posted,2648.04,2025-03-02,18.41,Withdrawal POS #000000129774/SUNOCO 8002212501 4234 SW 20TH AVEGAINESVILLE FLCard 1247,18.41
3/1/2025,Withdrawal POS #000000764400/SUNOCO 8002212501 4234 SW 20TH AVEGAINESVILLE FLCard 1247,18.41,Posted,2666.45,2025-03-01,18.41,Withdrawal POS #000000782633/SUNOCO 8002212501 4234 SW 20TH AVEGAINESVILLE FLCard 1247,18.54
3/1/2025,Withdrawal POS #000019039802/GOOGLE *YouTubePremium 1600 AmphitheatreParkw Mountain View CACard 1247,15.92,Posted,2684.86,2025-03-01,15.92,"Withdrawal POS #000020312090/GOOGLE *YouTubePremium 1600 Amphitheatre
Parkw Mountain View CA
Card 1247",15.92
3/1/2025,Withdrawal POS #000000774167/PUBLIX 3100 SW 35TH BLVD GAINESVILLE FLCard 1247,45.09,Posted,2700.78,2025-03-01,45.09,"Withdrawal POS #000000752480/PUBLIX 3100 SW 35TH BLVD GAINESVILLE FL
Card 1247",45.09
2/28/2025,Withdrawal Debit Card MC Debit Gator/WALGREENS #5024 GAINESVILLE FLDate 02/27/25 0 5058715205 1 5912Card 1247,15.0,Posted,2745.87,2025-02-28,15.0,"Withdrawal Debit Card MC Debit Gator/WALGREENS #9304 GAINESVILLE FL
Date 05/30/25 0 5150232309 1 5912
Card 1247",15.0
2/28/2025,Withdrawal Debit Card MC Debit Gator/WALGREENS #5024 GAINESVILLE FLDate 02/27/25 0 5058715204 1 5912Card 1247,36.66,Posted,2760.87,2025-02-28,36.66,"Withdrawal Debit Card MC Debit Gator/WALGREENS #9304 GAINESVILLE FL
Date 05/30/25 0 5150232309 1 5912
Card 1247",36.66
2/28/2025,Withdrawal Debit Card MC Debit Gator/CIRCLE K # 26146 GAINESVILLE FLDate 02/26/25 0 5057712171 1 5499Card 1247,15.38,Posted,2797.53,2025-02-28,15.38,Withdrawal Debit Card MC Debit Gator/CIRCLE K # 06782 GAINESVILLE FLDate 01/31/25 0 5031331003 1 5499Card 1247,15.425
2/27/2025,Withdrawal ATM Fee/EFT 3401 W University Ave Gainesville FLCard 1247,2.0,Posted,1812.91,2025-02-27,2.0,"Withdrawal ATM Fee/EFT 3401 W University Ave Gainesville FL
Card 1247",2.0
2/27/2025,Withdrawal at ATM #000000570838/EFT 3401 W University Ave Gainesville FLCard 1247,23.0,Posted,1814.91,2025-02-27,23.0,"Withdrawal at ATM #000000776623/EFT 3401 W University Ave Gainesville FL
Card 1247",23.0
2/26/2025,Withdrawal POS #000000584528/SUNOCO 8002212501 4234 SW 20TH AVEGAINESVILLE FLCard 1247,21.84,Posted,1837.91,2025-02-26,21.84,Withdrawal POS #000000231268/SUNOCO 8002212501 4234 SW 20TH AVEGAINESVILLE FLCard 1247,21.625
2/26/2025,Withdrawal Debit Card MC Debit Gator/INSTACART*159 SAN FRANCISC CADate 02/25/25 0 5056880216 0 5411Card 1247,45.23,Posted,1859.75,2025-02-26,45.23,Withdrawal Debit Card MC Debit Gator/INSTACART*159 SAN FRANCISC CADate 03/13/25 0 5072883709 0 5411Card 1247,45.41
2/25/2025,Recurring Withdrawal Debit Card - MC Debit Gator/IC* INSTACART*SUBSCRIP SAN FRANCISC CADate 02/24/25 0 5055823500 0 5411Card 1247,9.99,Posted,1904.98,2025-02-25,9.99,"Recurring Withdrawal Debit Card - MC Debit Gator/IC* INSTACART*SUBSCRIP SAN FRANCISC CA
Date 05/27/25 0 5147989663 0 5411
Card 1247",9.99
2/25/2025,Withdrawal POS #000000509694/SUNOCO 8002212501 4234 SW 20TH AVEGAINESVILLE FLCard 1247,21.84,Posted,1914.97,2025-02-25,21.84,Withdrawal POS #000000129774/SUNOCO 8002212501 4234 SW 20TH AVEGAINESVILLE FLCard 1247,21.97
2/24/2025,Withdrawal ATM Fee/EFT 3401 W University Ave Gainesville FLCard 1247,2.0,Posted,1936.81,2025-02-24,2.0,"Withdrawal ATM Fee/EFT 3401 W University Ave Gainesville FL
Card 1247",2.0
2/24/2025,Withdrawal at ATM #000000359753/EFT 3401 W University Ave Gainesville FLCard 1247,33.0,Posted,1938.81,2025-02-24,33.0,"Withdrawal at ATM #000000776623/EFT 3401 W University Ave Gainesville FL
Card 1247",33.0
2/24/2025,Withdrawal POS #000000517746/SUNOCO 8002212501 4234 SW 20TH AVEGAINESVILLE FLCard 1247,21.84,Posted,1971.81,2025-02-24,21.84,Withdrawal POS #000000231268/SUNOCO 8002212501 4234 SW 20TH AVEGAINESVILLE FLCard 1247,21.625
2/23/2025,Withdrawal Debit Card MC Debit Gator/INSTACART*159 SAN FRANCISC CADate 02/22/25 0 5053321628 0 5411Card 1247,50.0,Posted,-6.35,2025-02-23,50.0,Withdrawal Debit Card MC Debit Gator/INSTACART*159 SAN FRANCISC CADate 03/13/25 0 5072883709 0 5411Card 1247,49.66
2/23/2025,Withdrawal Debit Card MC Debit Gator/CIRCLE K # 26146 GAINESVILLE FLDate 02/21/25 0 5052836319 0 5499Card 1247,17.19,Posted,43.65,2025-02-23,17.19,Withdrawal Debit Card MC Debit Gator/CIRCLE K # 06782 GAINESVILLE FLDate 01/31/25 0 5031331003 1 5499Card 1247,17.05333333333333
2/23/2025,Recurring Withdrawal Bill Payment - #000000331607/NETFLIX COM LOS GATOS CACard 1247,20.71,Posted,60.84,2025-02-23,20.71,"Recurring Withdrawal Bill Payment - #000000017652/NETFLIX COM LOS GATOS CA
Card 1247",20.71
2/22/2025,Withdrawal ATM Fee/EFT 3401 W University Ave Gainesville FLCard 1247,2.0,Posted,81.55,2025-02-22,2.0,"Withdrawal ATM Fee/EFT 3401 W University Ave Gainesville FL
Card 1247",2.0
2/22/2025,Withdrawal at ATM #000000068777/EFT 3401 W University Ave Gainesville FLCard 1247,33.0,Posted,83.55,2025-02-22,33.0,"Withdrawal at ATM #000000776623/EFT 3401 W University Ave Gainesville FL
Card 1247",33.0
2/21/2025,Recurring Withdrawal Debit Card - MC Debit Gator/CANVA* I04433-39431369 CAMDEN DEDate 02/20/25 0 5051832939 0 7333Card 1247,12.99,Posted,116.55,2025-02-21,12.99,Recurring Withdrawal Debit Card - MC Debit Gator/CANVA* I04433-39431369 CAMDEN DEDate 02/20/25 0 5051832939 0 7333Card 1247,12.99
2/21/2025,Withdrawal POS #000000938881/SUNOCO 8002212501 4234 SW 20TH AVEGAINESVILLE FLCard 1247,21.84,Posted,129.54,2025-02-21,21.84,Withdrawal POS #000000231268/SUNOCO 8002212501 4234 SW 20TH AVEGAINESVILLE FLCard 1247,21.625
2/20/2025,Withdrawal POS #000000393434/SUNOCO 8002212501 4234 SW 20TH AVEGAINESVILLE FLCard 1247,18.41,Posted,151.38,2025-02-20,18.41,Withdrawal POS #000000782633/SUNOCO 8002212501 4234 SW 20TH AVEGAINESVILLE FLCard 1247,18.54
2/19/2025,Withdrawal ATM Fee/SOUTH STATE BK 3535 SW 34TH STREETGAINESVILLE FLCard 1247,2.0,Posted,169.79,2025-02-19,2.0,Withdrawal ATM Fee/SOUTH STATE BK 3535 SW 34TH STREETGAINESVILLE FLCard 1247,2.0
2/19/2025,Withdrawal at ATM #000000002102/SOUTH STATE BK 3535 SW 34TH STREETGAINESVILLE FLCard 1247,63.5,Posted,171.79,2025-02-19,63.5,Withdrawal at ATM #000000002102/SOUTH STATE BK 3535 SW 34TH STREETGAINESVILLE FLCard 1247,63.5
2/19/2025,Withdrawal POS #000000879769/SUNOCO 8002212501 4234 SW 20TH AVEGAINESVILLE FLCard 1247,21.41,Posted,235.29,2025-02-19,21.41,Withdrawal POS #000000782633/SUNOCO 8002212501 4234 SW 20TH AVEGAINESVILLE FLCard 1247,21.625
2/19/2025,Withdrawal Debit Card MC Debit Gator/INSTACART*159 SAN FRANCISC CADate 02/18/25 0 5049873156 0 5411Card 1247,45.0,Posted,256.7,2025-02-19,45.0,Withdrawal Debit Card MC Debit Gator/INSTACART*159 SAN FRANCISC CADate 03/13/25 0 5072883709 0 5411Card 1247,45.41
2/18/2025,Withdrawal POS #000000324063/SUNOCO 8002212501 4234 SW 20TH AVEGAINESVILLE FLCard 1247,21.84,Posted,301.7,2025-02-18,21.84,Withdrawal POS #000000231268/SUNOCO 8002212501 4234 SW 20TH AVEGAINESVILLE FLCard 1247,21.625
2/18/2025,Recurring Withdrawal Debit Card - MC Debit Gator/AMAZON PRIME*U74BM3BG3 AMZN.COM/BIL WADate 02/17/25 0 5048844767 0 5968Card 1247,15.13,Posted,323.54,2025-02-18,15.13,Recurring Withdrawal Debit Card - MC Debit Gator/AMAZON PRIME*U74BM3BG3 AMZN.COM/BIL WADate 02/17/25 0 5048844767 0 5968Card 1247,15.13
2/17/2025,Withdrawal POS #000000203758/SUNOCO 8002212501 4234 SW 20TH AVEGAINESVILLE FLCard 1247,20.01,Posted,338.67,2025-02-17,20.01,Withdrawal POS #000000231268/SUNOCO 8002212501 4234 SW 20TH AVEGAINESVILLE FLCard 1247,19.955
2/16/2025,Withdrawal Debit Card MC Debit Gator/INSTACART*159 SAN FRANCISC CADate 02/14/25 0 5045264835 0 5411Card 1247,49.0,Posted,358.68,2025-02-16,49.0,Withdrawal Debit Card MC Debit Gator/INSTACART*159 SAN FRANCISC CADate 03/13/25 0 5072883709 0 5411Card 1247,49.66
2/16/2025,Withdrawal POS #000000193415/SUNOCO 8002212501 4234 SW 20TH AVEGAINESVILLE FLCard 1247,23.44,Posted,407.68,2025-02-16,23.44,Withdrawal POS #000000966158/SUNOCO 8002212501 4234 SW 20TH AVEGAINESVILLE FLCard 2801,23.155
2/15/2025,Withdrawal POS #000000267044/SUNOCO 8002212501 4234 SW 20TH AVEGAINESVILLE FLCard 1247,21.41,Posted,431.12,2025-02-15,21.41,Withdrawal POS #000000231268/SUNOCO 8002212501 4234 SW 20TH AVEGAINESVILLE FLCard 1247,21.625
2/13/2025,Withdrawal POS #000000159674/SUNOCO 8002212501 4234 SW 20TH AVEGAINESVILLE FLCard 1247,23.65,Posted,452.53,2025-02-13,23.65,Withdrawal POS #000000231268/SUNOCO 8002212501 4234 SW 20TH AVEGAINESVILLE FLCard 1247,24.119999999999997
2/12/2025,Withdrawal ATM Fee/EFT 6419 W Newberry Rd Gainesville FLCard 1247,2.0,Posted,476.18,2025-02-12,2.0,"Withdrawal ATM Fee/EFT 6419 W Newberry Rd Gainesville FL
Card 1247",2.0
2/12/2025,Withdrawal at ATM #000000160796/EFT 6419 W Newberry Rd Gainesville FLCard 1247,48.0,Posted,478.18,2025-02-12,48.0,"Withdrawal at ATM #000000785755/EFT 6419 W Newberry Rd Gainesville FL
Card 1247",48.0
2/12/2025,Withdrawal POS #000000126612/SUNOCO 8002212501 4234 SW 20TH AVEGAINESVILLE FLCard 1247,21.84,Posted,526.18,2025-02-12,21.84,Withdrawal POS #000000966158/SUNOCO 8002212501 4234 SW 20TH AVEGAINESVILLE FLCard 2801,22.130000000000003
2/11/2025,Withdrawal Debit Card MC Debit Gator/AMAZON PRIME*B45DR82X3 AMZN.COM/BIL WADate 02/11/25 0 5042051984 1 5818Card 1247,3.4,Posted,548.02,2025-02-11,3.4,Withdrawal Debit Card MC Debit Gator/AMAZON PRIME*CU90U9EJ3 AMZN.COM/BIL WADate 03/11/25 0 5070388912 1 5818Card 1247,3.4
2/11/2025,Withdrawal POS #000000072493/SUNOCO 8002212501 4234 SW 20TH AVEGAINESVILLE FLCard 1247,18.41,Posted,551.42,2025-02-11,18.41,Withdrawal POS #000000782633/SUNOCO 8002212501 4234 SW 20TH AVEGAINESVILLE FLCard 1247,18.54
2/11/2025,Withdrawal POS #000000446485/AMAZON.COM*XN90T43R3 SEATTLE WACard 1247,20.38,Posted,569.83,2025-02-11,20.38,Withdrawal POS #000000446485/AMAZON.COM*XN90T43R3 SEATTLE WACard 1247,20.38
2/11/2025,Withdrawal POS #000000000004/AMAZON.COM*Q443411V3 SEATTLE WACard 1247,20.38,Posted,590.21,2025-02-11,20.38,Withdrawal POS #000000000099/AMAZON.COM*VA0IZ8DO3 SEATTLE WACard 1247,20.38
2/10/2025,Withdrawal Debit Card MC Debit Gator/GRU/EZ-PAY WEB PYMT 352-334-3434 FLDate 02/09/25 0 5040010734 1 4900Card 1247,172.98,Posted,610.59,2025-02-10,172.98,Withdrawal Debit Card MC Debit Gator/GRU/EZ-PAY WEB PYMT 352-334-3434 FLDate 03/09/25 0 5068009425 1 4900Card 1247,172.98
2/9/2025,Withdrawal POS #000000943545/SUNOCO 8002212501 4234 SW 20TH AVEGAINESVILLE FLCard 1247,20.88,Posted,783.57,2025-02-09,20.88,Withdrawal POS #000000455581/SUNOCO 8002212501 4234 SW 20TH AVEGAINESVILLE FLCard 1247,20.695
2/9/2025,Withdrawal Debit Card MC Debit Gator/INSTACART*159 SAN FRANCISC CADate 02/08/25 0 5039877461 0 5411Card 1247,1.0,Posted,804.45,2025-02-09,1.0,Withdrawal Debit Card MC Debit Gator/INSTACART*159 SAN FRANCISC CADate 03/13/25 0 5072883709 0 5411Card 1247,1.125
2/9/2025,Withdrawal Debit Card MC Debit Gator/INSTACART*159 SAN FRANCISC CADate 02/08/25 0 5039378930 0 5411Card 1247,46.0,Posted,805.45,2025-02-09,46.0,Withdrawal Debit Card MC Debit Gator/INSTACART*159 SAN FRANCISC CADate 03/13/25 0 5072883709 0 5411Card 1247,45.41
2/9/2025,Recurring Withdrawal Debit Card Fee/MASTERCARD ISSUER CROSS-BORDER FEEDate 02/08/25 0 5039378735 0 5734Card 1247,0.06,Posted,851.45,2025-02-09,0.06,Recurring Withdrawal Debit Card Fee/MASTERCARD ISSUER CROSS-BORDER FEEDate 12/31/23 0 3365740203 0 5734Card 2801,0.10500000000000001
2/9/2025,Recurring Withdrawal Debit Card - MC Debit Gator/IDEOGRAM AI TORONTO ONDate 02/08/25 0 5039378735 0 5734Card 1247,8.0,Posted,851.51,2025-02-09,8.0,"Recurring Withdrawal Debit Card - MC Debit Gator/IDEOGRAM AI TORONTO ON
Date 04/08/25 0 5098321266 0 5734
Card 1247",8.0
2/9/2025,Recurring Withdrawal Debit Card Fee/MASTERCARD ISSUER CROSS-BORDER FEEDate 02/08/25 0 5039144067 2 5734Card 1247,0.23,Posted,859.51,2025-02-09,0.23,Withdrawal Debit Card Fee/MASTERCARD ISSUER CROSS-BORDER FEEDate 03/01/25 0 5060117430 2 5967Card 1247,0.07250000000000001
2/9/2025,Recurring Withdrawal Debit Card - MC Debit Gator/NOTEGPT.IO ADMIRALTY KODate 02/08/25 0 5039144067 2 5734Card 1247,29.0,Posted,859.74,2025-02-09,29.0,Recurring Withdrawal Debit Card - MC Debit Gator/NOTEGPT.IO ADMIRALTY KODate 02/08/25 0 5039144067 2 5734Card 1247,29.0
2/9/2025,Withdrawal Debit Card MC Debit Gator/IONOS INC. CHESTERBROOK PADate 02/08/25 0 5039876633 0 4816Card 1247,23.0,Posted,888.74,2025-02-09,23.0,Withdrawal Debit Card MC Debit Gator/IONOS INC. CHESTERBROOK PADate 03/08/25 0 5067522264 1 4816Card 1247,23.0
2/9/2025,Recurring Withdrawal Debit Card - MC Debit Gator/APPLE.COM/BILL 866-712-7753 CADate 02/08/25 0 5039325895 2 5818Card 1247,12.99,Posted,911.74,2025-02-09,12.99,Recurring Withdrawal Debit Card - MC Debit Gator/APPLE.COM/BILL 866-712-7753 CADate 01/05/25 0 5005839185 0 5818Card 1247,12.99
2/9/2025,Withdrawal Debit Card MC Debit Gator/COX GAINESVILLE COMM 800-234-3993 FLDate 02/08/25 0 5039376753 0 4899Card 1247,156.13,Posted,924.73,2025-02-09,156.13,Withdrawal Debit Card MC Debit Gator/COX GAINESVILLE COMM 800-234-3993 FLDate 03/09/25 0 5068137922 1 4899Card 1247,156.13
2/8/2025,Withdrawal POS #000000957137/SUNOCO 8002212501 4234 SW 20TH AVEGAINESVILLE FLCard 1247,21.84,Posted,1080.86,2025-02-08,21.84,Withdrawal POS #000000782633/SUNOCO 8002212501 4234 SW 20TH AVEGAINESVILLE FLCard 1247,21.625
2/7/2025,Withdrawal Debit Card MC Debit Gator/IONOS INC. CHESTERBROOK PADate 02/06/25 0 5037921337 0 4816Card 1247,16.0,Posted,1102.7,2025-02-07,16.0,Withdrawal Debit Card MC Debit Gator/IONOS INC. CHESTERBROOK PADate 03/08/25 0 5067522264 1 4816Card 1247,16.5
2/7/2025,Withdrawal POS #000000827056/SUNOCO 8002212501 4234 SW 20TH AVEGAINESVILLE FLCard 1247,18.41,Posted,1118.7,2025-02-07,18.41,Withdrawal POS #000000782633/SUNOCO 8002212501 4234 SW 20TH AVEGAINESVILLE FLCard 1247,18.54
2/6/2025,Withdrawal Debit Card MC Debit Gator/IONOS INC. CHESTERBROOK PADate 02/05/25 0 5036019016 1 4816Card 1247,1.0,Posted,1107.12,2025-02-06,1.0,Withdrawal Debit Card MC Debit Gator/IONOS INC. CHESTERBROOK PADate 03/08/25 0 5067522264 1 4816Card 1247,1.0
2/5/2025,Recurring Withdrawal Debit Card - MC Debit Gator/OPENAI SAN FRANCISC CADate 02/04/25 0 5035991425 0 5734Card 1247,0.63,Posted,1108.12,2025-02-05,0.63,Recurring Withdrawal Debit Card - MC Debit Gator/OPENAI SAN FRANCISC CADate 03/08/25 0 5067339145 0 5734Card 1247,0.63
2/5/2025,Recurring Withdrawal Debit Card - MC Debit Gator/OPENAI *CHATGPT SUBSCR SAN FRANCISC CADate 02/04/25 0 5035323752 0 5734Card 1247,20.0,Posted,1108.75,2025-02-05,20.0,Recurring Withdrawal Debit Card - MC Debit Gator/OPENAI SAN FRANCISC CADate 03/08/25 0 5067339145 0 5734Card 1247,20.0
2/5/2025,Withdrawal Debit Card Fee/MASTERCARD ISSUER CROSS-BORDER FEEDate 02/03/25 0 5034323004 0 5967Card 1247,0.03,Posted,1128.75,2025-02-05,0.03,Withdrawal Debit Card Fee/MASTERCARD ISSUER CROSS-BORDER FEEDate 03/01/25 0 5060117430 2 5967Card 1247,0.07250000000000001
2/5/2025,Withdrawal Debit Card MC Debit Gator/ZUBBHELP.COM HAARLEM NLDate 02/03/25 0 5034323004 0 5967Card 1247,3.17,Posted,1128.78,2025-02-05,3.17,Withdrawal Debit Card MC Debit Gator/ZUBBHELP.COM HAARLEM NLDate 02/03/25 0 5034323004 0 5967Card 1247,3.17
2/5/2025,Withdrawal Debit Card MC Debit Gator/YVETTE GODET DMD GAINESVILLE FLDate 02/04/25 0 5035835029 0 8021Card 1247,56.8,Posted,1131.95,2025-02-05,56.8,Withdrawal Debit Card MC Debit Gator/YVETTE GODET DMD GAINESVILLE FLDate 02/04/25 0 5035835029 0 8021Card 1247,56.8
2/5/2025,Withdrawal Debit Card MC Debit Gator/CIRCLE K # 06782 GAINESVILLE FLDate 02/03/25 0 5034984751 0 5499Card 1247,20.84,Posted,1188.75,2025-02-05,20.84,Withdrawal Debit Card MC Debit Gator/CIRCLE K # 06782 GAINESVILLE FLDate 01/31/25 0 5031331003 1 5499Card 1247,20.73
2/5/2025,Withdrawal POS #000000734068/PUBLIX 3100 SW 35TH BLVD GAINESVILLE FLCard 1247,60.92,Posted,1209.59,2025-02-05,60.92,"Withdrawal POS #000000752480/PUBLIX 3100 SW 35TH BLVD GAINESVILLE FL
Card 1247",60.92
2/5/2025,Withdrawal ATM Fee/EFT 3401 W University Ave Gainesville FLCard 1247,2.0,Posted,1270.51,2025-02-05,2.0,"Withdrawal ATM Fee/EFT 3401 W University Ave Gainesville FL
Card 1247",2.0
2/5/2025,Withdrawal at ATM #000000464773/EFT 3401 W University Ave Gainesville FLCard 1247,43.0,Posted,1272.51,2025-02-05,43.0,"Withdrawal at ATM #000000776623/EFT 3401 W University Ave Gainesville FL
Card 1247",43.0
2/4/2025,Withdrawal POS #000000646864/AMAZON.COM*MZ5BC8D43 SEATTLE WACard 1247,10.19,Posted,1315.51,2025-02-04,10.19,Withdrawal POS #000000446485/AMAZON.COM*XN90T43R3 SEATTLE WACard 1247,10.19
2/4/2025,Recurring Withdrawal Debit Card - MC Debit Gator/APPLE.COM/BILL 866-712-7753 CADate 02/04/25 0 5035127693 1 5818Card 1247,29.99,Posted,1325.7,2025-02-04,29.99,Recurring Withdrawal Debit Card - MC Debit Gator/APPLE.COM/BILL 866-712-7753 CADate 01/05/25 0 5005839185 0 5818Card 1247,29.99
2/4/2025,"Withdrawal Bill Payment #000000199905/Adobe Park Avenue,345 San Jose CACard 1247",19.99,Posted,1355.69,2025-02-04,19.99,"Withdrawal Bill Payment #000000352498/Adobe Park Avenue,345 San Jose CACard 1247",19.99
2/3/2025,"Recurring Withdrawal Debit Card - MC Debit Gator/NOTION LABS, INC. SAN FRANCISC CADate 02/02/25 0 5033134219 1 7372Card 1247",22.0,Posted,1375.68,2025-02-03,22.0,"Recurring Withdrawal Debit Card - MC Debit Gator/NOTION LABS, INC. SAN FRANCISC CA
Date 06/02/25 0 5153210973 1 7372
Card 1247",22.0
2/3/2025,Recurring Withdrawal Debit Card - MC Debit Gator/OPENAI SAN FRANCISC CADate 02/02/25 0 5033247681 1 5734Card 1247,5.0,Posted,1397.68,2025-02-03,5.0,Recurring Withdrawal Debit Card - MC Debit Gator/OPENAI SAN FRANCISC CADate 03/08/25 0 5067339145 0 5734Card 1247,5.0
2/3/2025,Recurring Withdrawal Debit Card - MC Debit Gator/OPENAI SAN FRANCISC CADate 02/02/25 0 5033247680 1 5734Card 1247,5.0,Posted,1402.68,2025-02-03,5.0,Recurring Withdrawal Debit Card - MC Debit Gator/OPENAI SAN FRANCISC CADate 03/08/25 0 5067339145 0 5734Card 1247,5.0
2/3/2025,Recurring Withdrawal Debit Card - MC Debit Gator/APPLE.COM/BILL 866-712-7753 CADate 02/03/25 0 5034963465 0 5818Card 1247,2.99,Posted,1407.68,2025-02-03,2.99,Recurring Withdrawal Debit Card - MC Debit Gator/APPLE.COM/BILL 866-712-7753 CADate 01/05/25 0 5005839185 0 5818Card 1247,2.99
2/3/2025,Recurring Withdrawal Debit Card - MC Debit Gator/APPLE.COM/BILL 866-712-7753 CADate 02/02/25 0 5033127007 1 5818Card 1247,29.99,Posted,1410.67,2025-02-03,29.99,Recurring Withdrawal Debit Card - MC Debit Gator/APPLE.COM/BILL 866-712-7753 CADate 01/05/25 0 5005839185 0 5818Card 1247,29.99
2/3/2025,Withdrawal ACH Watson Realty Co/TYPE: WEB PMTS ID: 9000321157CO: Watson Realty CoNAME: Steven chaplinskiEntry Class Code: WEB,1179.0,Posted,1440.66,2025-02-03,1179.0,"Withdrawal ACH Watson Realty Co/TYPE: WEB PMTS ID: 9000321157
CO: Watson Realty Co
NAME: Steven chaplinskiEntry Class Code: WEB",1179.0
2/3/2025,"Withdrawal ACH AppFolio, Inc. F/TYPE: WEB PMTS ID: 9001406550CO: AppFolio, Inc. FNAME: Steven chaplinskiEntry Class Code: WEB",2.49,Posted,2619.66,2025-02-03,2.49,"Withdrawal ACH AppFolio, Inc. F/TYPE: WEB PMTS ID: 9001406550
CO: AppFolio, Inc. F
NAME: Steven chaplinskiEntry Class Code: WEB",2.49
2/2/2025,Withdrawal POS #000000781738/SUNOCO 8002212501 4234 SW 20TH AVEGAINESVILLE FLCard 1247,17.08,Posted,2622.15,2025-02-02,17.08,Withdrawal POS #000000782633/SUNOCO 8002212501 4234 SW 20TH AVEGAINESVILLE FLCard 1247,17.08
2/2/2025,Recurring Withdrawal Debit Card - MC Debit Gator/PARAMOUNT+ WEST HOLLYWO CADate 02/01/25 0 5032847059 0 4899Card 1247,14.96,Posted,2639.23,2025-02-02,14.96,Recurring Withdrawal Debit Card - MC Debit Gator/PARAMOUNT+ WEST HOLLYWO CADate 01/01/25 0 5001909499 0 4899Card 1247,14.96
2/2/2025,Withdrawal Debit Card MC Debit Gator/INSTACART*159 SAN FRANCISC CADate 01/31/25 0 5031931716 1 5411Card 1247,52.0,Posted,2654.19,2025-02-02,52.0,Withdrawal Debit Card MC Debit Gator/INSTACART*159 SAN FRANCISC CADate 03/13/25 0 5072883709 0 5411Card 1247,52.0
2/2/2025,Recurring Withdrawal Debit Card Fee/MASTERCARD ISSUER CROSS-BORDER FEEDate 02/01/25 0 5032990634 0 5967Card 1247,0.01,Posted,2706.19,2025-02-02,0.01,Recurring Withdrawal Debit Card Fee/MASTERCARD ISSUER CROSS-BORDER FEEDate 12/31/23 0 3365740203 0 5734Card 2801,0.10500000000000001
2/2/2025,Recurring Withdrawal Debit Card - MC Debit Gator/PROBILLER.COM 855-232-9555 CYDate 02/01/25 0 5032990634 0 5967Card 1247,1.14,Posted,2706.2,2025-02-02,1.14,Recurring Withdrawal Debit Card - MC Debit Gator/PROBILLER.COM 855-232-9555 CYDate 02/01/25 0 5032990634 0 5967Card 1247,1.14
2/2/2025,Withdrawal Debit Card Fee/MASTERCARD ISSUER CROSS-BORDER FEEDate 02/01/25 0 5032990633 0 5967Card 1247,0.01,Posted,2707.34,2025-02-02,0.01,Withdrawal Debit Card Fee/MASTERCARD ISSUER CROSS-BORDER FEEDate 03/01/25 0 5060117430 2 5967Card 1247,0.07250000000000001
2/2/2025,Withdrawal Debit Card MC Debit Gator/PROBILLER.COM 855-232-9555 CYDate 02/01/25 0 5032990633 0 5967Card 1247,1.14,Posted,2707.35,2025-02-02,1.14,Recurring Withdrawal Debit Card - MC Debit Gator/PROBILLER.COM 855-232-9555 CYDate 02/01/25 0 5032990634 0 5967Card 1247,1.14
2/2/2025,Withdrawal Debit Card MC Debit Gator/IONOS INC. CHESTERBROOK PADate 01/31/25 0 5031845289 0 4816Card 1247,40.0,Posted,2708.49,2025-02-02,40.0,Withdrawal Debit Card MC Debit Gator/IONOS INC. CHESTERBROOK PADate 03/08/25 0 5067522264 1 4816Card 1247,40.0
2/2/2025,Withdrawal Debit Card MC Debit Gator/CIRCLE K # 06782 GAINESVILLE FLDate 01/31/25 0 5031331003 1 5499Card 1247,16.99,Posted,2748.49,2025-02-02,16.99,Withdrawal Debit Card MC Debit Gator/CIRCLE K # 06782 GAINESVILLE FLDate 01/31/25 0 5031331003 1 5499Card 1247,17.05333333333333
2/1/2025,Withdrawal POS #000000675669/SUNOCO 8002212501 4234 SW 20TH AVEGAINESVILLE FLCard 1247,17.08,Posted,2765.48,2025-02-01,17.08,Withdrawal POS #000000782633/SUNOCO 8002212501 4234 SW 20TH AVEGAINESVILLE FLCard 1247,17.08
2/1/2025,Withdrawal POS #000000364287/ETSY.COM*US WWW.ETSY.COM/ BROOKLYN NYCard 1247,0.6,Posted,2782.56,2025-02-01,0.6,Withdrawal POS #000000364287/ETSY.COM*US WWW.ETSY.COM/ BROOKLYN NYCard 1247,0.6
1/31/2025,Recurring Withdrawal Debit Card - MC Debit Gator/APPLE.COM/BILL 866-712-7753 CADate 01/31/25 0 5031045448 1 5818Card 1247,2.99,Posted,1783.16,2025-01-31,2.99,Recurring Withdrawal Debit Card - MC Debit Gator/APPLE.COM/BILL 866-712-7753 CADate 01/05/25 0 5005839185 0 5818Card 1247,2.99
1/31/2025,Recurring Withdrawal Debit Card - MC Debit Gator/APPLE.COM/BILL 866-712-7753 CADate 01/31/25 0 5031045443 1 5818Card 1247,24.99,Posted,1786.15,2025-01-31,24.99,Recurring Withdrawal Debit Card - MC Debit Gator/APPLE.COM/BILL 866-712-7753 CADate 01/05/25 0 5005839185 0 5818Card 1247,24.99
1/31/2025,Recurring Withdrawal Debit Card - MC Debit Gator/NETFLIX.COM CADate 01/30/25 0 5030869462 0 4899Card 1247,17.84,Posted,1811.14,2025-01-31,17.84,Recurring Withdrawal Debit Card - MC Debit Gator/NETFLIX.COM CADate 01/30/25 0 5030869462 0 4899Card 1247,17.84
1/31/2025,Withdrawal POS #000000000043/AMAZON.COM*ZC1UW3U40 SEATTLE WACard 1247,10.19,Posted,1828.98,2025-01-31,10.19,Withdrawal POS #000000000099/AMAZON.COM*VA0IZ8DO3 SEATTLE WACard 1247,10.19
1/31/2025,Withdrawal POS #000000000343/CIRCLE K # 06782 5237 GAINESVILLE FLCard 1247,10.01,Posted,1839.17,2025-01-31,10.01,Withdrawal POS #000000000343/CIRCLE K # 06782 5237 GAINESVILLE FLCard 1247,10.42
1/30/2025,Withdrawal POS #000019353777/GOOGLE *YouTubePremium 1600 AmphitheatreParkw Mountain View CACard 1247,9.1,Posted,1849.18,2025-01-30,9.1,"Withdrawal POS #000020312090/GOOGLE *YouTubePremium 1600 Amphitheatre
Parkw Mountain View CA
Card 1247",9.1
1/30/2025,Recurring Withdrawal Debit Card - MC Debit Gator/MYDESIGNS - PRO - MON LAS VEGAS NVDate 01/29/25 0 5029913031 0 5734Card 1247,49.99,Posted,1858.28,2025-01-30,49.99,"Recurring Withdrawal Debit Card - MC Debit Gator/MYDESIGNS - PRO - MON LAS VEGAS NV
Date 06/01/25 0 5152146505 1 5734
Card 1247",49.99
1/30/2025,Recurring Withdrawal Debit Card - MC Debit Gator/SUPERPOWER CHATGPT MIDDLETOWN DEDate 01/29/25 0 5029912376 0 5734Card 1247,15.0,Posted,1908.27,2025-01-30,15.0,"Recurring Withdrawal Debit Card - MC Debit Gator/SUPERPOWER CHATGPT MIDDLETOWN DE
Date 06/05/25 0 5156229550 1 5734
Card 1247",15.0
1/30/2025,Recurring Withdrawal Debit Card - MC Debit Gator/PADDLE.NET* SETAPP NEW YORK NYDate 01/29/25 0 5029860662 0 5817Card 1247,14.5,Posted,1923.27,2025-01-30,14.5,"Recurring Withdrawal Debit Card - MC Debit Gator/PADDLE.NET* SETAPP NEW YORK NY
Date 05/31/25 0 5151555568 2 5817
Card 1247",14.5
1/30/2025,Withdrawal Debit Card MC Debit Gator/CANVA* I04402-39206221 CAMDEN DEDate 01/29/25 0 5029860414 0 7333Card 1247,12.99,Posted,1937.77,2025-01-30,12.99,Withdrawal Debit Card MC Debit Gator/CANVA* I04402-39206221 CAMDEN DEDate 01/29/25 0 5029860414 0 7333Card 1247,12.99
1/30/2025,Withdrawal Debit Card MC Debit Gator/COPYTONOTI WILMINGTON DEDate 01/29/25 0 5029909612 0 5817Card 1247,47.0,Posted,1950.76,2025-01-30,47.0,Withdrawal Debit Card MC Debit Gator/COPYTONOTI WILMINGTON DEDate 01/29/25 0 5029909612 0 5817Card 1247,47.0
1/30/2025,Withdrawal Debit Card MC Debit Gator/WALGREENS #5024 GAINESVILLE FLDate 01/29/25 0 5029087400 1 5912Card 1247,15.0,Posted,1997.76,2025-01-30,15.0,"Withdrawal Debit Card MC Debit Gator/WALGREENS #9304 GAINESVILLE FL
Date 05/30/25 0 5150232309 1 5912
Card 1247",15.0
1/30/2025,Withdrawal Debit Card MC Debit Gator/CIRCLE K # 06782 GAINESVILLE FLDate 01/28/25 0 5028905568 0 5499Card 1247,15.47,Posted,2012.76,2025-01-30,15.47,Withdrawal Debit Card MC Debit Gator/CIRCLE K # 06782 GAINESVILLE FLDate 01/31/25 0 5031331003 1 5499Card 1247,15.425
1/29/2025,Withdrawal POS #000000525481/SUNOCO 8002212501 4234 SW 20TH AVEGAINESVILLE FLCard 1247,17.08,Posted,28.23,2025-01-29,17.08,Withdrawal POS #000000455581/SUNOCO 8002212501 4234 SW 20TH AVEGAINESVILLE FLCard 1247,17.08
1/29/2025,Withdrawal Debit Card MC Debit Gator/WALGREENS #5024 GAINESVILLE FLDate 01/28/25 0 5028088379 1 5912Card 1247,10.81,Posted,45.31,2025-01-29,10.81,"Withdrawal Debit Card MC Debit Gator/WALGREENS #9304 GAINESVILLE FL
Date 05/30/25 0 5150232309 1 5912
Card 1247",10.81
1/27/2025,Withdrawal Debit Card MC Debit Gator/INSTACART*159 SAN FRANCISC CADate 01/26/25 0 5026250026 0 5411Card 1247,50.23,Posted,56.12,2025-01-27,50.23,Withdrawal Debit Card MC Debit Gator/INSTACART*159 SAN FRANCISC CADate 03/13/25 0 5072883709 0 5411Card 1247,50.23
1/27/2025,Withdrawal ATM Fee/EFT 6419 W Newberry Rd Gainesville FLCard 1247,2.0,Posted,106.35,2025-01-27,2.0,"Withdrawal ATM Fee/EFT 6419 W Newberry Rd Gainesville FL
Card 1247",2.0
1/27/2025,Withdrawal at ATM #000000618599/EFT 6419 W Newberry Rd Gainesville FLCard 1247,53.0,Posted,108.35,2025-01-27,53.0,"Withdrawal at ATM #000000785755/EFT 6419 W Newberry Rd Gainesville FL
Card 1247",53.0
1/27/2025,Withdrawal POS #000000553411/WAWA 5325 2373 SW ARCHER ROADFLCard 1247,14.71,Posted,161.35,2025-01-27,14.71,Withdrawal POS #000000553411/WAWA 5325 2373 SW ARCHER ROADFLCard 1247,14.71
1/26/2025,Withdrawal ATM Fee/EFT 6419 W Newberry Rd Gainesville FLCard 1247,2.0,Posted,176.06,2025-01-26,2.0,"Withdrawal ATM Fee/EFT 6419 W Newberry Rd Gainesville FL
Card 1247",2.0
1/26/2025,Withdrawal at ATM #000000554718/EFT 6419 W Newberry Rd Gainesville FLCard 1247,23.0,Posted,178.06,2025-01-26,23.0,"Withdrawal at ATM #000000785755/EFT 6419 W Newberry Rd Gainesville FL
Card 1247",23.0
1/26/2025,Withdrawal POS #000097243000/WAWA 5325 2373 SW ARCHER ROADFLCard 1247,10.98,Posted,1.06,2025-01-26,10.98,Withdrawal POS #000000553411/WAWA 5325 2373 SW ARCHER ROADFLCard 1247,10.98
1/25/2025,Withdrawal POS #000000455581/SUNOCO 8002212501 4234 SW 20TH AVEGAINESVILLE FLCard 1247,20.51,Posted,10.04,2025-01-25,20.51,Withdrawal POS #000000455581/SUNOCO 8002212501 4234 SW 20TH AVEGAINESVILLE FLCard 1247,20.695
1/24/2025,Withdrawal ATM Fee/EFT 6419 W Newberry Rd Gainesville FLCard 1247,2.0,Posted,30.55,2025-01-24,2.0,"Withdrawal ATM Fee/EFT 6419 W Newberry Rd Gainesville FL
Card 1247",2.0
1/24/2025,Withdrawal at ATM #000000365727/EFT 6419 W Newberry Rd Gainesville FLCard 1247,28.0,Posted,32.55,2025-01-24,28.0,"Withdrawal at ATM #000000785755/EFT 6419 W Newberry Rd Gainesville FL
Card 1247",28.0
1/24/2025,Recurring Withdrawal Debit Card - MC Debit Gator/IC* INSTACART*SUBSCRIP SAN FRANCISC CADate 01/24/25 0 5024009804 1 5411Card 1247,9.99,Posted,60.55,2025-01-24,9.99,"Recurring Withdrawal Debit Card - MC Debit Gator/IC* INSTACART*SUBSCRIP SAN FRANCISC CA
Date 05/27/25 0 5147989663 0 5411
Card 1247",9.99
1/24/2025,Withdrawal POS #000000439538/SUNOCO 8002212501 4234 SW 20TH AVEGAINESVILLE FLCard 1247,22.87,Posted,70.54,2025-01-24,22.87,Withdrawal POS #000000966158/SUNOCO 8002212501 4234 SW 20TH AVEGAINESVILLE FLCard 2801,23.155
1/24/2025,Withdrawal POS #000000507326/AMAZON.COM*ZG65P87B0 SEATTLE WACard 1247,44.65,Posted,93.41,2025-01-24,44.65,Withdrawal POS #000000507326/AMAZON.COM*ZG65P87B0 SEATTLE WACard 1247,44.65
1/23/2025,Withdrawal POS #000000375346/SUNOCO 8002212501 4234 SW 20TH AVEGAINESVILLE FLCard 1247,17.08,Posted,38.06,2025-01-23,17.08,Withdrawal POS #000000782633/SUNOCO 8002212501 4234 SW 20TH AVEGAINESVILLE FLCard 1247,17.08
1/23/2025,Withdrawal POS #000000409491/AMAZON.COM*Z55VK0Y01 SEATTLE WACard 1247,10.19,Posted,55.14,2025-01-23,10.19,Withdrawal POS #000000914130/AMAZON.COM*ZR50X2ML1 SEATTLE WACard 1231,10.46
1/22/2025,Withdrawal POS #000000268342/SUNOCO 8002212501 4234 SW 20TH AVEGAINESVILLE FLCard 1247,20.51,Posted,65.33,2025-01-22,20.51,Withdrawal POS #000000028242/SUNOCO 8002212501 4234 SW 20TH AVEGAINESVILLE FLCard 1231,20.51
1/21/2025,Withdrawal Debit Card MC Debit Gator/INSTACART*159 SAN FRANCISC CADate 01/20/25 0 5020903203 0 5411Card 1247,58.79,Posted,85.84,2025-01-21,58.79,Withdrawal Debit Card MC Debit Gator/INSTACART*159 SAN FRANCISC CADate 03/13/25 0 5072883709 0 5411Card 1247,58.79
1/21/2025,Withdrawal Debit Card MC Debit Gator/CIRCLE K # 26146 GAINESVILLE FLDate 01/19/25 0 5019898493 0 5499Card 1247,16.98,Posted,144.63,2025-01-21,16.98,Withdrawal Debit Card MC Debit Gator/CIRCLE K # 06782 GAINESVILLE FLDate 01/31/25 0 5031331003 1 5499Card 1247,17.05333333333333
1/21/2025,Withdrawal ACH FLUENT-Gainesvil/TYPE: PAYMENT ID: 1371804719CO: FLUENT-GainesvilNAME: steven chaplinskiEntry Class Code: WEB,15.0,Posted,161.61,2025-01-21,15.0,Withdrawal ACH FLUENT-Gainesvil/TYPE: PAYMENT ID: 1371804719CO: FLUENT-GainesvilNAME: steven chaplinski,15.0
1/20/2025,Withdrawal POS #000000308001/SUNOCO 8002212501 4234 SW 20TH AVEGAINESVILLE FLCard 1247,20.51,Posted,176.61,2025-01-20,20.51,Withdrawal POS #000000455581/SUNOCO 8002212501 4234 SW 20TH AVEGAINESVILLE FLCard 1247,20.695
1/20/2025,Withdrawal Debit Card MC Debit Gator/CIRCLE K # 06782 GAINESVILLE FLDate 01/18/25 0 5018029946 1 5499Card 1247,20.62,Posted,-2.88,2025-01-20,20.62,Withdrawal Debit Card MC Debit Gator/CIRCLE K # 06782 GAINESVILLE FLDate 01/31/25 0 5031331003 1 5499Card 1247,20.73
1/19/2025,Withdrawal POS #000000187957/SUNOCO 8002212501 4234 SW 20TH AVEGAINESVILLE FLCard 1247,14.92,Posted,17.74,2025-01-19,14.92,Withdrawal POS #000000129774/SUNOCO 8002212501 4234 SW 20TH AVEGAINESVILLE FLCard 1247,14.92
1/19/2025,Recurring Withdrawal Debit Card - MC Debit Gator/AMAZON PRIME*Z585917C0 AMZN.COM/BIL WADate 01/17/25 0 5017190493 2 5968Card 1247,15.13,Posted,32.66,2025-01-19,15.13,Recurring Withdrawal Debit Card - MC Debit Gator/AMAZON PRIME*U74BM3BG3 AMZN.COM/BIL WADate 02/17/25 0 5048844767 0 5968Card 1247,15.13
1/19/2025,Withdrawal POS #000000759580/PUBLIX 3100 SW 35TH BLVD GAINESVILLE FLCard 1247,14.74,Posted,47.79,2025-01-19,14.74,"Withdrawal POS #000000752480/PUBLIX 3100 SW 35TH BLVD GAINESVILLE FL
Card 1247",14.74
1/17/2025,Withdrawal POS #000000120665/SUNOCO 8002212501 4234 SW 20TH AVEGAINESVILLE FLCard 1247,17.08,Posted,62.53,2025-01-17,17.08,Withdrawal POS #000000966158/SUNOCO 8002212501 4234 SW 20TH AVEGAINESVILLE FLCard 2801,17.08
1/17/2025,Withdrawal ACH FLUENT-Gainesvil/TYPE: PAYMENT ID: 1371804719CO: FLUENT-GainesvilNAME: steven chaplinskiEntry Class Code: WEB,27.5,Posted,79.61,2025-01-17,27.5,Withdrawal ACH FLUENT-Gainesvil/TYPE: PAYMENT ID: 1371804719CO: FLUENT-GainesvilNAME: steven chaplinski,27.5
1/16/2025,Withdrawal POS #000000129774/SUNOCO 8002212501 4234 SW 20TH AVEGAINESVILLE FLCard 1247,22.1,Posted,107.11,2025-01-16,22.1,Withdrawal POS #000000129774/SUNOCO 8002212501 4234 SW 20TH AVEGAINESVILLE FLCard 1247,21.97
1/15/2025,Withdrawal POS #000000300162/SUNOCO 8002212501 4234 SW 20TH AVEGAINESVILLE FLCard 1247,17.08,Posted,129.21,2025-01-15,17.08,Withdrawal POS #000000900121/SUNOCO 8002212501 4234 SW 20TH AVEGAINESVILLE FLCard 1231,17.08
1/14/2025,Withdrawal POS #000000194849/ETSY.COM*US WWW.ETSY.COM/ BROOKLYN NYCard 1247,11.8,Posted,146.29,2025-01-14,11.8,Withdrawal POS #000000364287/ETSY.COM*US WWW.ETSY.COM/ BROOKLYN NYCard 1247,11.8
1/14/2025,Withdrawal POS #000000753028/PUBLIX 3930 SW ARCHER ROAD GAINESVILLECard 1247,22.97,Posted,158.09,2025-01-14,22.97,Withdrawal POS #000000753028/PUBLIX 3930 SW ARCHER ROAD GAINESVILLECard 1247,22.97
1/14/2025,Withdrawal POS #000096297241/FAST TRACK #200 GAINESVILLE GAINESVILLECard 1247,10.0,Posted,181.06,2025-01-14,10.0,"Withdrawal POS #000096294989/FAST TRACK #200 GAINESVILLE GAINESVILLE
Card 1247",10.0
1/14/2025,Withdrawal POS #000000230647/SUNOCO 8002212501 4234 SW 20TH AVEGAINESVILLE FLCard 1247,0.17,Posted,191.06,2025-01-14,0.17,Withdrawal POS #000000231268/SUNOCO 8002212501 4234 SW 20TH AVEGAINESVILLE FLCard 1247,0.17
1/14/2025,Withdrawal POS #000000223141/SUNOCO 8002212501 4234 SW 20TH AVEGAINESVILLE FLCard 1247,17.08,Posted,191.23,2025-01-14,17.08,Withdrawal POS #000000231268/SUNOCO 8002212501 4234 SW 20TH AVEGAINESVILLE FLCard 1247,17.08
1/13/2025,Withdrawal ACH VENMO/TYPE: PAYMENT ID: 3264681992 CO: VENMONAME: AVATAR ARTSEntry Class Code: WEB,14.99,Posted,208.31,2025-01-13,14.99,Withdrawal ACH VENMO/TYPE: PAYMENT ID: 3264681992 CO: VENMONAME: AVATAR ARTSEntry Class Code: WEB,14.99
1/13/2025,Withdrawal POS #000000758317/PUBLIX 3100 SW 35TH BLVD GAINESVILLE FLCard 1247,37.08,Posted,223.3,2025-01-13,37.08,"Withdrawal POS #000000752480/PUBLIX 3100 SW 35TH BLVD GAINESVILLE FL
Card 1247",37.32
1/12/2025,Recurring Withdrawal Debit Card - MC Debit Gator/APPLE.COM/BILL 866-712-7753 CADate 01/11/25 0 5011099289 2 5818Card 1247,9.99,Posted,260.38,2025-01-12,9.99,Recurring Withdrawal Debit Card - MC Debit Gator/APPLE.COM/BILL 866-712-7753 CADate 01/05/25 0 5005839185 0 5818Card 1247,9.995000000000001
1/12/2025,Withdrawal Debit Card MC Debit Gator/AMAZON PRIME*ZD49Q6KK0 AMZN.COM/BIL WADate 01/11/25 0 5011099282 2 5818Card 1247,3.4,Posted,270.37,2025-01-12,3.4,Withdrawal Debit Card MC Debit Gator/AMAZON PRIME*CU90U9EJ3 AMZN.COM/BIL WADate 03/11/25 0 5070388912 1 5818Card 1247,3.4
1/11/2025,Withdrawal POS #000000169586/SUNOCO 8002212501 4234 SW 20TH AVEGAINESVILLE FLCard 1247,17.08,Posted,273.77,2025-01-11,17.08,Withdrawal POS #000000966158/SUNOCO 8002212501 4234 SW 20TH AVEGAINESVILLE FLCard 2801,17.08
1/11/2025,Withdrawal POS #000000757925/PUBLIX 3100 SW 35TH BLVD GAINESVILLE FLCard 1247,57.86,Posted,290.85,2025-01-11,57.86,"Withdrawal POS #000000752480/PUBLIX 3100 SW 35TH BLVD GAINESVILLE FL
Card 1247",57.86
1/10/2025,Withdrawal ACH VENMO/TYPE: PAYMENT ID: 3264681992 CO: VENMONAME: AVATAR ARTSEntry Class Code: WEB,9.99,Posted,348.71,2025-01-10,9.99,Withdrawal ACH VENMO/TYPE: PAYMENT ID: 3264681992 CO: VENMONAME: AVATAR ARTSEntry Class Code: WEB,9.99
1/9/2025,Withdrawal POS #000000944455/SUNOCO 8002212501 4234 SW 20TH AVEGAINESVILLE FLCard 1247,22.42,Posted,358.7,2025-01-09,22.42,Withdrawal POS #000000455581/SUNOCO 8002212501 4234 SW 20TH AVEGAINESVILLE FLCard 1247,22.42
1/7/2025,Withdrawal Bill Payment #000000483994/GRU EZ PAY 301 SE 4TH AVE 301 SE 4TH AVCard 1247,169.56,Posted,381.12,2025-01-07,169.56,Withdrawal Bill Payment #000000483994/GRU EZ PAY 301 SE 4TH AVE 301 SE 4TH AVCard 1247,169.56
1/7/2025,Withdrawal POS #000000000007/AMAZON.COM*ZD7CG3LN0 SEATTLE WACard 1247,18.2,Posted,550.68,2025-01-07,18.2,Withdrawal POS #000000507326/AMAZON.COM*ZG65P87B0 SEATTLE WACard 1247,18.2
1/6/2025,"Recurring Withdrawal Debit Card - MC Debit Gator/NOTION LABS, INC. SAN FRANCISC CADate 01/05/25 0 5005050863 1 7372Card 1247",22.0,Posted,568.88,2025-01-06,22.0,"Recurring Withdrawal Debit Card - MC Debit Gator/NOTION LABS, INC. SAN FRANCISC CA
Date 06/02/25 0 5153210973 1 7372
Card 1247",22.0
1/5/2025,Withdrawal POS #000000348915/SUNOCO 8002212501 4234 SW 20TH AVEGAINESVILLE FLCard 1247,17.08,Posted,590.88,2025-01-05,17.08,Withdrawal POS #000000966158/SUNOCO 8002212501 4234 SW 20TH AVEGAINESVILLE FLCard 2801,17.08
1/5/2025,Recurring Withdrawal Debit Card - MC Debit Gator/OPENAI *CHATGPT SUBSCR SAN FRANCISC CADate 01/04/25 0 5004256434 0 5734Card 1247,20.0,Posted,607.96,2025-01-05,20.0,Recurring Withdrawal Debit Card - MC Debit Gator/OPENAI SAN FRANCISC CADate 03/08/25 0 5067339145 0 5734Card 1247,20.0
1/5/2025,Recurring Withdrawal Debit Card - MC Debit Gator/APPLE.COM/BILL 866-712-7753 CADate 01/05/25 0 5005839186 0 5818Card 1247,10.0,Posted,627.96,2025-01-05,10.0,Recurring Withdrawal Debit Card - MC Debit Gator/APPLE.COM/BILL 866-712-7753 CADate 01/05/25 0 5005839185 0 5818Card 1247,9.995000000000001
1/5/2025,Recurring Withdrawal Debit Card - MC Debit Gator/APPLE.COM/BILL 866-712-7753 CADate 01/05/25 0 5005839185 0 5818Card 1247,2.99,Posted,637.96,2025-01-05,2.99,Recurring Withdrawal Debit Card - MC Debit Gator/APPLE.COM/BILL 866-712-7753 CADate 01/05/25 0 5005839185 0 5818Card 1247,2.99
1/5/2025,Recurring Withdrawal Debit Card - MC Debit Gator/APPLE.COM/BILL 866-712-7753 CADate 01/05/25 0 5005839184 0 5818Card 1247,2.99,Posted,640.95,2025-01-05,2.99,Recurring Withdrawal Debit Card - MC Debit Gator/APPLE.COM/BILL 866-712-7753 CADate 01/05/25 0 5005839185 0 5818Card 1247,2.99
1/5/2025,"Withdrawal Bill Payment #000000192398/Adobe Park Avenue,345 San Jose CACard 1247",19.99,Posted,643.94,2025-01-05,19.99,"Withdrawal Bill Payment #000000352498/Adobe Park Avenue,345 San Jose CACard 1247",19.99
1/3/2025,Withdrawal POS #000000782633/SUNOCO 8002212501 4234 SW 20TH AVEGAINESVILLE FLCard 1247,18.67,Posted,663.93,2025-01-03,18.67,Withdrawal POS #000000782633/SUNOCO 8002212501 4234 SW 20TH AVEGAINESVILLE FLCard 1247,18.54
1/3/2025,Withdrawal Debit Card Fee/MASTERCARD ISSUER CROSS-BORDER FEEDate 01/02/25 0 5002325431 0 8999Card 1247,0.02,Posted,682.6,2025-01-03,0.02,Withdrawal Debit Card Fee/MASTERCARD ISSUER CROSS-BORDER FEEDate 03/01/25 0 5060117430 2 5967Card 1247,0.07250000000000001
1/3/2025,Withdrawal Debit Card MC Debit Gator/SOCIALWICK INNSBRUCK ATDate 01/02/25 0 5002325431 0 8999Card 1247,2.53,Posted,682.62,2025-01-03,2.53,Withdrawal Debit Card MC Debit Gator/SOCIALWICK INNSBRUCK ATDate 01/02/25 0 5002325431 0 8999Card 1247,2.53
1/3/2025,Withdrawal Debit Card MC Debit Gator/COX GAINESVILLE COMM 800-234-3993 FLDate 01/02/25 0 5002952888 0 4899Card 1247,156.13,Posted,685.15,2025-01-03,156.13,Withdrawal Debit Card MC Debit Gator/COX GAINESVILLE COMM 800-234-3993 FLDate 03/09/25 0 5068137922 1 4899Card 1247,156.13
1/3/2025,Withdrawal POS #000000837107/AMAZON.COM*ZD3F87JM2 SEATTLE WACard 1247,28.75,Posted,841.28,2025-01-03,28.75,Withdrawal POS #000000507326/AMAZON.COM*ZG65P87B0 SEATTLE WACard 1247,28.75
1/2/2025,Withdrawal POS #000000231268/SUNOCO 8002212501 4234 SW 20TH AVEGAINESVILLE FLCard 1247,24.59,Posted,870.03,2025-01-02,24.59,Withdrawal POS #000000231268/SUNOCO 8002212501 4234 SW 20TH AVEGAINESVILLE FLCard 1247,24.119999999999997
1/2/2025,Withdrawal Debit Card MC Debit Seminol/CIRCLE K # 26146 GAINESVILLE FLDate 12/31/24 0 4366909335 0 5499Card 1231,18.88,Posted,894.62,2025-01-02,18.88,Withdrawal Debit Card MC Debit Seminol/CIRCLE K # 26146 GAINESVILLE FLDate 12/31/24 0 4366909335 0 5499Card 1231,18.88
1/2/2025,Withdrawal Debit Card MC Debit Gator/OPENAI SAN FRANCISC CADate 01/02/25 0 5002915655 0 5734Card 1247,5.0,Posted,913.5,2025-01-02,5.0,Recurring Withdrawal Debit Card - MC Debit Gator/OPENAI SAN FRANCISC CADate 03/08/25 0 5067339145 0 5734Card 1247,5.0
1/2/2025,Recurring Withdrawal Debit Card - MC Debit Gator/PARAMOUNT+ WEST HOLLYWO CADate 01/01/25 0 5001909499 0 4899Card 1247,14.96,Posted,918.5,2025-01-02,14.96,Recurring Withdrawal Debit Card - MC Debit Gator/PARAMOUNT+ WEST HOLLYWO CADate 01/01/25 0 5001909499 0 4899Card 1247,14.96
1/2/2025,Withdrawal ACH Watson Realty Co/TYPE: WEB PMTS ID: 9000321157CO: Watson Realty CoNAME: Steven chaplinskiEntry Class Code: WEB,1179.0,Posted,933.46,2025-01-02,1179.0,"Withdrawal ACH Watson Realty Co/TYPE: WEB PMTS ID: 9000321157
CO: Watson Realty Co
NAME: Steven chaplinskiEntry Class Code: WEB",1179.0
1/2/2025,Withdrawal ACH FLUENT-Gainesvil/TYPE: PAYMENT ID: 1371804719CO: FLUENT-GainesvilNAME: steven chaplinskiEntry Class Code: WEB,54.0,Posted,2112.46,2025-01-02,54.0,Withdrawal ACH FLUENT-Gainesvil/TYPE: PAYMENT ID: 1371804719CO: FLUENT-GainesvilNAME: steven chaplinski,54.0
1/2/2025,"Withdrawal ACH AppFolio, Inc. F/TYPE: WEB PMTS ID: 9001406550CO: AppFolio, Inc. FNAME: Steven chaplinskiEntry Class Code: WEB",2.49,Posted,2166.46,2025-01-02,2.49,"Withdrawal ACH AppFolio, Inc. F/TYPE: WEB PMTS ID: 9001406550
CO: AppFolio, Inc. F
NAME: Steven chaplinskiEntry Class Code: WEB",2.49
1/2/2025,Withdrawal POS #000000305858/AMAZON.COM*ZP8I63AL0 SEATTLE WACard 1247,23.64,Posted,2168.95,2025-01-02,23.64,Withdrawal POS #000000507326/AMAZON.COM*ZG65P87B0 SEATTLE WACard 1247,23.64
1/1/2025,Withdrawal Debit Card MC Debit Seminol/GAINESVILLE PSYCHIATRY GAINESVILLE FLDate 12/31/24 0 4366974295 0 8011Card 1231,78.0,Posted,2192.59,2025-01-01,78.0,Withdrawal Debit Card MC Debit Seminol/GAINESVILLE PSYCHIATRY GAINESVILLE FLDate 12/31/24 0 4366974295 0 8011Card 1231,78.0
1/1/2025,Withdrawal Debit Card MC Debit Seminol/WALGREENS #5024 GAINESVILLE FLDate 12/31/24 0 4366953359 0 5912Card 1231,15.0,Posted,2270.59,2025-01-01,15.0,Withdrawal Debit Card MC Debit Seminol/WALGREENS #9304 GAINESVILLE FLDate 10/30/24 0 4304125853 1 5912Card 1231,15.0
1/1/2025,Recurring Withdrawal Debit Card - MC Debit Gator/FS *CONTEXTSFORMAC SANTA BARBAR CADate 12/31/24 0 4366973571 0 5734Card 1247,9.99,Posted,2285.59,2025-01-01,9.99,Recurring Withdrawal Debit Card - MC Debit Gator/FS *CONTEXTSFORMAC SANTA BARBAR CADate 12/31/24 0 4366973571 0 5734Card 1247,9.99
12/31/2024,Withdrawal POS #000082182619/SMOKE CITY 2120 SW 34TH ST GAINESVILLECard 1247,11.66,Posted,2295.58,2024-12-31,11.66,"Withdrawal POS #000080196760/SMOKE CITY 2120 SW 34TH ST GAINESVILLE
Card 1247",11.66
12/31/2024,Withdrawal POS #000000733350/PUBLIX 3100 SW 35TH BLVD GAINESVILLE FLCard 1247,29.57,Posted,2307.24,2024-12-31,29.57,"Withdrawal POS #000000752480/PUBLIX 3100 SW 35TH BLVD GAINESVILLE FL
Card 1247",29.57
12/31/2024,Withdrawal ATM Fee/EFT 3401 W University Ave Gainesville FLCard 1247,2.0,Posted,2336.81,2024-12-31,2.0,"Withdrawal ATM Fee/EFT 3401 W University Ave Gainesville FL
Card 1247",2.0
12/31/2024,Withdrawal at ATM #000000158366/EFT 3401 W University Ave Gainesville FLCard 1247,13.0,Posted,2338.81,2024-12-31,13.0,"Withdrawal at ATM #000000776623/EFT 3401 W University Ave Gainesville FL
Card 1247",13.0
12/30/2024,Withdrawal POS #000000188532/AMAZON.COM*ZP06Y6CW0 SEATTLE WACard 1231,18.2,Posted,2351.81,2024-12-30,18.2,Withdrawal POS #000000188532/AMAZON.COM*ZP06Y6CW0 SEATTLE WACard 1231,18.2
12/30/2024,Withdrawal POS #000000570772/SUNOCO 8002212501 4234 SW 20TH AVEGAINESVILLE FLCard 1231,17.08,Posted,2370.01,2024-12-30,17.08,Withdrawal POS #000000778591/SUNOCO 8002212501 4234 SW 20TH AVEGAINESVILLE FLCard 1231,17.08
12/30/2024,Withdrawal Debit Card MC Debit Seminol/IONOS INC. CHESTERBROOK PADate 12/29/24 0 4364954464 0 4816Card 1231,1.0,Posted,2387.09,2024-12-30,1.0,Withdrawal Debit Card MC Debit Seminol/IONOS INC. CHESTERBROOK PADate 12/29/24 0 4364954464 0 4816Card 1231,0.8400000000000001
12/30/2024,Withdrawal ACH FLUENT-Gainesvil/TYPE: PAYMENT ID: 1371804719CO: FLUENT-GainesvilNAME: steven chaplinskiEntry Class Code: WEB,54.0,Posted,2388.09,2024-12-30,54.0,Withdrawal ACH FLUENT-Gainesvil/TYPE: PAYMENT ID: 1371804719CO: FLUENT-GainesvilNAME: steven chaplinski,54.0
12/30/2024,Withdrawal POS #000000522639/SUNOCO 8002212501 4234 SW 20TH AVEGAINESVILLE FLCard 1231,18.67,Posted,2442.09,2024-12-30,18.67,Withdrawal POS #000000778591/SUNOCO 8002212501 4234 SW 20TH AVEGAINESVILLE FLCard 1231,18.67
12/29/2024,Withdrawal Debit Card MC Debit Seminol/SAMSUNG ELECTRONICS RIDGEFIELD P NJDate 12/27/24 0 4362999827 1 5734Card 1231,8.99,Posted,2460.76,2024-12-29,8.99,Withdrawal Debit Card MC Debit Seminol/SAMSUNG ELECTRONICS RIDGEFIELD P NJDate 12/27/24 0 4362999827 1 5734Card 1231,8.99
12/29/2024,Withdrawal Debit Card MC Debit Seminol/WAWA 5325 GAINESVILLE FLDate 12/28/24 0 4363858796 0 5541Card 1231,19.72,Posted,2469.75,2024-12-29,19.72,Withdrawal Debit Card MC Debit Seminol/WAWA 5325 GAINESVILLE FLDate 12/28/24 0 4363858796 0 5541Card 1231,20.21
12/29/2024,Withdrawal Debit Card MC Debit Seminol/WALGREENS #5024 GAINESVILLE FLDate 12/27/24 0 4362000611 2 5912Card 1231,23.78,Posted,2489.47,2024-12-29,23.78,Withdrawal Debit Card MC Debit Seminol/WALGREENS #5024 GAINESVILLE FLDate 12/27/24 0 4362000611 2 5912Card 1231,23.78
12/29/2024,Withdrawal POS #000000504303/SUNOCO 8002212501 4234 SW 20TH AVEGAINESVILLE FLCard 1231,22.42,Posted,2513.25,2024-12-29,22.42,Withdrawal POS #000000488663/SUNOCO 8002212501 4234 SW 20TH AVEGAINESVILLE FLCard 1231,22.42
12/28/2024,Withdrawal POS #000000443910/SUNOCO 8002212501 4234 SW 20TH AVEGAINESVILLE FLCard 1231,20.83,Posted,1735.67,2024-12-28,20.83,Withdrawal POS #000000488663/SUNOCO 8002212501 4234 SW 20TH AVEGAINESVILLE FLCard 1231,20.67
12/27/2024,Withdrawal POS #000000014638/SUNOCO 8002212501 4234 SW 20TH AVEGAINESVILLE FLCard 1231,20.83,Posted,1756.5,2024-12-27,20.83,Withdrawal POS #000000488663/SUNOCO 8002212501 4234 SW 20TH AVEGAINESVILLE FLCard 1231,20.67
12/26/2024,Withdrawal Debit Card MC Debit Seminol/CIRCLE K # 06782 GAINESVILLE FLDate 12/24/24 0 4359511759 0 5499Card 1231,18.67,Posted,1777.33,2024-12-26,18.67,Withdrawal Debit Card MC Debit Seminol/CIRCLE K # 06782 GAINESVILLE FLDate 09/08/24 0 4252889868 0 5499Card 1231,18.505000000000003
12/25/2024,Withdrawal Debit Card MC Debit Seminol/INSTACART*159 SAN FRANCISC CADate 12/24/24 0 4359294650 0 5411Card 1231,70.0,Posted,1796.0,2024-12-25,70.0,Withdrawal Debit Card MC Debit Seminol/INSTACART*159 SAN FRANCISC CADate 12/24/24 0 4359294650 0 5411Card 1231,70.0
12/25/2024,Recurring Withdrawal Debit Card - MC Debit Seminol/FS *ADOBE SANTA BARBAR CADate 12/24/24 0 4359034647 1 5734Card 1231,0.95,Posted,1866.0,2024-12-25,0.95,Recurring Withdrawal Debit Card - MC Debit Seminol/FS *ADOBE SANTA BARBAR CADate 12/24/24 0 4359034647 1 5734Card 1231,0.95
12/24/2024,Withdrawal POS #000013340229/WALGREENS 2415 SW 75TH 2415 SW 75TH STGAINESVILLE FLCard 1231,19.05,Posted,1866.95,2024-12-24,19.05,Withdrawal POS #000013340229/WALGREENS 2415 SW 75TH 2415 SW 75TH STGAINESVILLE FLCard 1231,19.05
12/24/2024,Withdrawal ACH FLUENT-Gainesvil/TYPE: PAYMENT ID: 1371804719CO: FLUENT-GainesvilNAME: steven chaplinskiEntry Class Code: WEB,42.5,Posted,1886.0,2024-12-24,42.5,Withdrawal ACH FLUENT-Gainesvil/TYPE: PAYMENT ID: 1371804719CO: FLUENT-GainesvilNAME: steven chaplinski,42.7
12/24/2024,Withdrawal POS #000000383621/SUNOCO 8002212501 4234 SW 20TH AVEGAINESVILLE FLCard 1231,20.51,Posted,1928.5,2024-12-24,20.51,Withdrawal POS #000000488663/SUNOCO 8002212501 4234 SW 20TH AVEGAINESVILLE FLCard 1231,20.67
12/23/2024,Withdrawal Debit Card MC Debit Seminol/INSTACART*159 SAN FRANCISC CADate 12/22/24 0 4357281797 0 5411Card 1231,59.0,Posted,1949.01,2024-12-23,59.0,Withdrawal Debit Card MC Debit Seminol/INSTACART*159 SAN FRANCISC CADate 12/24/24 0 4359294650 0 5411Card 1231,59.0
12/23/2024,Recurring Withdrawal Bill Payment - #000000122428/NETFLIX COM LOS GATOS CACard 1231,17.84,Posted,2008.01,2024-12-23,17.84,"Recurring Withdrawal Bill Payment - #000000017652/NETFLIX COM LOS GATOS CA
Card 1247",17.84
12/22/2024,Withdrawal POS #000000255092/SUNOCO 8002212501 4234 SW 20TH AVEGAINESVILLE FLCard 1231,10.0,Posted,2025.85,2024-12-22,10.0,Withdrawal POS #000000235720/SUNOCO 8002212501 4234 SW 20TH AVEGAINESVILLE FLCard 1231,10.0
12/22/2024,Withdrawal POS #000000344581/SUNOCO 8002212501 4234 SW 20TH AVEGAINESVILLE FLCard 1231,14.92,Posted,2035.85,2024-12-22,14.92,Withdrawal POS #000000488663/SUNOCO 8002212501 4234 SW 20TH AVEGAINESVILLE FLCard 1231,14.92
12/22/2024,Recurring Withdrawal Debit Card - MC Debit Seminol/CANVA* I04371-41297102 CAMDEN DEDate 12/20/24 0 4355594081 2 7333Card 1231,12.99,Posted,50.77,2024-12-22,12.99,Recurring Withdrawal Debit Card - MC Debit Seminol/CANVA* I04371-41297102 CAMDEN DEDate 12/20/24 0 4355594081 2 7333Card 1231,12.99
12/22/2024,Withdrawal Debit Card MC Debit Seminol/WAWA 5325 GAINESVILLE FLDate 12/21/24 0 4356579974 1 5541Card 1231,17.18,Posted,63.76,2024-12-22,17.18,Withdrawal Debit Card MC Debit Seminol/WAWA 5325 GAINESVILLE FLDate 12/28/24 0 4363858796 0 5541Card 1231,16.92
12/22/2024,Withdrawal Debit Card MC Debit Seminol/APPLE.COM/BILL CUPERTINO CADate 12/21/24 0 4356190590 1 5818Card 1231,9.99,Posted,80.94,2024-12-22,9.99,Withdrawal Debit Card MC Debit Seminol/APPLE.COM/BILL CUPERTINO CADate 12/21/24 0 4356190590 1 5818Card 1231,9.99
12/21/2024,Withdrawal POS #000000223326/SUNOCO 8002212501 4234 SW 20TH AVEGAINESVILLE FLCard 1231,27.26,Posted,90.93,2024-12-21,27.26,Withdrawal POS #000000028242/SUNOCO 8002212501 4234 SW 20TH AVEGAINESVILLE FLCard 1231,27.26
12/20/2024,Withdrawal POS #000000282496/SUNOCO 8002212501 4234 SW 20TH AVEGAINESVILLE FLCard 1231,17.08,Posted,118.19,2024-12-20,17.08,Withdrawal POS #000000028242/SUNOCO 8002212501 4234 SW 20TH AVEGAINESVILLE FLCard 1231,17.08
12/20/2024,Withdrawal Debit Card MC Debit Seminol/CANNAMD 855-4209170 FLDate 12/19/24 0 4354703841 0 8011Card 1231,149.0,Posted,135.27,2024-12-20,149.0,Withdrawal Debit Card MC Debit Seminol/CANNAMD 855-4209170 FLDate 12/19/24 0 4354703841 0 8011Card 1231,149.0
12/20/2024,Withdrawal Debit Card MC Debit Seminol/INSTACART*159 SAN FRANCISC CADate 12/19/24 0 4354168310 1 5411Card 1231,46.0,Posted,284.27,2024-12-20,46.0,Withdrawal Debit Card MC Debit Seminol/INSTACART*159 SAN FRANCISC CADate 12/24/24 0 4359294650 0 5411Card 1231,46.0
12/19/2024,Withdrawal POS #000000205771/SUNOCO 8002212501 4234 SW 20TH AVEGAINESVILLE FLCard 1231,20.83,Posted,230.27,2024-12-19,20.83,Withdrawal POS #000000778591/SUNOCO 8002212501 4234 SW 20TH AVEGAINESVILLE FLCard 1231,20.83
12/19/2024,Recurring Withdrawal Debit Card Fee/MASTERCARD ISSUER CROSS-BORDER FEEDate 12/18/24 0 4353969048 0 5734Card 1231,0.05,Posted,251.1,2024-12-19,0.05,Recurring Withdrawal Debit Card Fee/MASTERCARD ISSUER CROSS-BORDER FEEDate 12/31/23 0 3365740203 0 5734Card 2801,0.10500000000000001
12/19/2024,Recurring Withdrawal Debit Card - MC Debit Seminol/SAVE TO NOTION VAUREAL ILDate 12/18/24 0 4353969048 0 5734Card 1231,5.99,Posted,251.15,2024-12-19,5.99,Recurring Withdrawal Debit Card - MC Debit Seminol/SAVE TO NOTION VAUREAL ILDate 12/18/24 0 4353969048 0 5734Card 1231,5.99
12/18/2024,Withdrawal POS #000000175132/SUNOCO 8002212501 4234 SW 20TH AVEGAINESVILLE FLCard 1231,24.26,Posted,257.14,2024-12-18,24.26,Withdrawal POS #000000778591/SUNOCO 8002212501 4234 SW 20TH AVEGAINESVILLE FLCard 1231,24.26
12/18/2024,Withdrawal Debit Card MC Debit Seminol/INSTACART*159 SAN FRANCISC CADate 12/17/24 0 4352953677 0 5411Card 1231,49.0,Posted,281.4,2024-12-18,49.0,Withdrawal Debit Card MC Debit Seminol/INSTACART*159 SAN FRANCISC CADate 12/24/24 0 4359294650 0 5411Card 1231,49.5
12/18/2024,Recurring Withdrawal Debit Card - MC Debit Seminol/AMAZON PRIME*Z97W01ZG2 AMZN.COM/BIL WADate 12/17/24 0 4352950216 0 5968Card 1231,15.11,Posted,330.4,2024-12-18,15.11,Recurring Withdrawal Debit Card - MC Debit Seminol/AMAZON PRIME*Z97W01ZG2 AMZN.COM/BIL WADate 12/17/24 0 4352950216 0 5968Card 1231,15.120000000000001
12/17/2024,Recurring Withdrawal Debit Card - MC Debit Seminol/SUPERPOWER CHATGPT MIDDLETOWN DEDate 12/17/24 0 4352703539 1 5734Card 1231,15.0,Posted,345.51,2024-12-17,15.0,Recurring Withdrawal Debit Card - MC Debit Seminol/SUPERPOWER CHATGPT MIDDLETOWN DEDate 12/17/24 0 4352703539 1 5734Card 1231,15.0
12/17/2024,Recurring Withdrawal Debit Card - MC Debit Seminol/PADDLE.NET* LEONARDOAI ASTORIA NYDate 12/16/24 0 4351323834 0 5817Card 1231,9.0,Posted,360.51,2024-12-17,9.0,Recurring Withdrawal Debit Card - MC Debit Seminol/PADDLE.NET* LEONARDOAI ASTORIA NYDate 12/16/24 0 4351323834 0 5817Card 1231,9.0
12/17/2024,Recurring Withdrawal Debit Card - MC Debit Seminol/PADDLE.NET* SETAPP ASTORIA NYDate 12/16/24 0 4351886849 0 5817Card 1231,12.49,Posted,369.51,2024-12-17,12.49,Recurring Withdrawal Debit Card - MC Debit Seminol/PADDLE.NET* SETAPP NEW YORK NYDate 10/14/24 0 4288882561 0 5817Card 1231,12.49
12/17/2024,Recurring Withdrawal Debit Card Fee/MASTERCARD ISSUER CROSS-BORDER FEEDate 12/17/24 0 4352700468 1 5734Card 1231,0.16,Posted,382.0,2024-12-17,0.16,Recurring Withdrawal Debit Card Fee/MASTERCARD ISSUER CROSS-BORDER FEEDate 12/31/23 0 3365740203 0 5734Card 2801,0.10500000000000001
12/17/2024,Recurring Withdrawal Debit Card - MC Debit Seminol/IDEOGRAM AI TORONTO ONDate 12/17/24 0 4352700468 1 5734Card 1231,20.0,Posted,382.16,2024-12-17,20.0,Recurring Withdrawal Debit Card - MC Debit Seminol/IDEOGRAM AI TORONTO ONDate 12/17/24 0 4352700468 1 5734Card 1231,20.0
12/16/2024,Withdrawal Debit Card MC Debit Seminol/INSTACART*159 SAN FRANCISC CADate 12/15/24 0 4350919827 0 5411Card 1231,50.0,Posted,402.16,2024-12-16,50.0,Withdrawal Debit Card MC Debit Seminol/INSTACART*159 SAN FRANCISC CADate 12/24/24 0 4359294650 0 5411Card 1231,49.5
12/15/2024,Recurring Withdrawal Debit Card - MC Debit Seminol/RUNWAY STANDARD PLAN NEWARK DEDate 12/15/24 0 4350745942 1 5734Card 1231,15.0,Posted,452.16,2024-12-15,15.0,Recurring Withdrawal Debit Card - MC Debit Seminol/RUNWAY STANDARD PLAN NEWARK DEDate 12/15/24 0 4350745942 1 5734Card 1231,15.0
12/13/2024,Withdrawal POS #000000000027/CIRCLE K # 26146 3525 GAINESVILLE FLCard 1231,18.88,Posted,467.16,2024-12-13,18.88,Withdrawal POS #000000000343/CIRCLE K # 06782 5237 GAINESVILLE FLCard 1247,18.88
12/13/2024,Withdrawal ATM Fee/EFT 3401 W University Ave Gainesville FLCard 1231,2.0,Posted,486.04,2024-12-13,2.0,"Withdrawal ATM Fee/EFT 3401 W University Ave Gainesville FL
Card 1247",2.0
12/13/2024,Withdrawal at ATM #000000472357/EFT 3401 W University Ave Gainesville FLCard 1231,23.0,Posted,488.04,2024-12-13,23.0,"Withdrawal at ATM #000000776623/EFT 3401 W University Ave Gainesville FL
Card 1247",23.0
12/13/2024,Withdrawal Debit Card MC Debit Seminol/INSTACART*159 SAN FRANCISC CADate 12/12/24 0 4347002718 1 5411Card 1231,54.0,Posted,511.04,2024-12-13,54.0,Withdrawal Debit Card MC Debit Seminol/INSTACART*159 SAN FRANCISC CADate 12/24/24 0 4359294650 0 5411Card 1231,53.5
12/12/2024,Withdrawal POS #000000900121/SUNOCO 8002212501 4234 SW 20TH AVEGAINESVILLE FLCard 1231,24.26,Posted,565.04,2024-12-12,24.26,Withdrawal POS #000000909995/SUNOCO 8002212501 4234 SW 20TH AVEGAINESVILLE FLCard 1231,24.26
12/12/2024,Withdrawal ACH VENMO/TYPE: PAYMENT ID: 3264681992 CO: VENMONAME: AVATAR ARTSEntry Class Code: WEB,14.99,Posted,339.3,2024-12-12,14.99,Withdrawal ACH VENMO/TYPE: PAYMENT ID: 3264681992 CO: VENMONAME: AVATAR ARTSEntry Class Code: WEB,14.99
12/11/2024,Withdrawal Debit Card MC Debit Seminol/AMAZON PRIME*ZR78T8681 AMZN.COM/BIL WADate 12/11/24 0 4346447241 1 5818Card 1231,3.4,Posted,354.29,2024-12-11,3.4,Withdrawal Debit Card MC Debit Seminol/AMAZON PRIME*ZR78T8681 AMZN.COM/BIL WADate 12/11/24 0 4346447241 1 5818Card 1231,3.4
12/11/2024,Withdrawal POS #000000000041/CIRCLE K # 26146 3525 GAINESVILLE FLCard 1231,26.18,Posted,357.69,2024-12-11,26.18,Withdrawal POS #000000000343/CIRCLE K # 06782 5237 GAINESVILLE FLCard 1247,26.395
12/10/2024,Recurring Withdrawal Debit Card - MC Debit Seminol/INVIDEO INC COUNTRY OF S DEDate 12/09/24 0 4344808122 0 5734Card 1231,35.0,Posted,383.87,2024-12-10,35.0,Recurring Withdrawal Debit Card - MC Debit Seminol/INVIDEO INC COUNTRY OF S DEDate 12/09/24 0 4344808122 0 5734Card 1231,35.0
12/10/2024,Withdrawal POS #000000914130/AMAZON.COM*ZR50X2ML1 SEATTLE WACard 1231,11.91,Posted,418.87,2024-12-10,11.91,Withdrawal POS #000000914130/AMAZON.COM*ZR50X2ML1 SEATTLE WACard 1231,11.91
12/10/2024,Withdrawal ACH VENMO/TYPE: PAYMENT ID: 3264681992 CO: VENMONAME: AVATAR ARTSEntry Class Code: WEB,9.99,Posted,430.78,2024-12-10,9.99,Withdrawal ACH VENMO/TYPE: PAYMENT ID: 3264681992 CO: VENMONAME: AVATAR ARTSEntry Class Code: WEB,9.99
12/9/2024,Withdrawal POS #000000179448/AMAZON.COM*ZR3RB12D0 SEATTLE WACard 1231,19.12,Posted,436.86,2024-12-09,19.12,Withdrawal POS #000000914130/AMAZON.COM*ZR50X2ML1 SEATTLE WACard 1231,19.12
12/9/2024,Recurring Withdrawal Debit Card - MC Debit Seminol/MYDESIGNS - PRO - MON LAS VEGAS NVDate 12/08/24 0 4343357881 0 5734Card 1231,29.99,Posted,455.98,2024-12-09,29.99,Recurring Withdrawal Debit Card - MC Debit Seminol/MYDESIGNS - PRO - MON LAS VEGAS NVDate 12/08/24 0 4343357881 0 5734Card 1231,29.99
12/9/2024,Withdrawal Debit Card MC Debit Seminol/IONOS INC. CHESTERBROOK PADate 12/08/24 0 4343153168 1 4816Card 1231,23.0,Posted,485.97,2024-12-09,23.0,Withdrawal Debit Card MC Debit Seminol/IONOS INC. CHESTERBROOK PADate 12/29/24 0 4364954464 0 4816Card 1231,23.0
12/9/2024,Withdrawal ACH FLUENT-Gainesvil/TYPE: PAYMENT ID: 1371804719CO: FLUENT-GainesvilNAME: steven chaplinskiEntry Class Code: WEB,32.0,Posted,508.97,2024-12-09,32.0,Withdrawal ACH FLUENT-Gainesvil/TYPE: PAYMENT ID: 1371804719CO: FLUENT-GainesvilNAME: steven chaplinski,32.5
12/9/2024,Withdrawal POS #000020941197/GOOGLE *YouTubePremium 1600 AmphitheatreParkw Mountain View CACard 1231,9.1,Posted,540.97,2024-12-09,9.1,"Withdrawal POS #000020312090/GOOGLE *YouTubePremium 1600 Amphitheatre
Parkw Mountain View CA
Card 1247",9.1
12/8/2024,Recurring Withdrawal Debit Card - MC Debit Seminol/KREA.AI SAN FRANCISC CADate 12/06/24 0 4341842673 0 5734Card 1231,10.0,Posted,550.07,2024-12-08,10.0,Recurring Withdrawal Debit Card - MC Debit Seminol/OPENAI *CHATGPT SUBSCR SAN FRANCISC CADate 12/04/24 0 4339869196 0 5734Card 1231,10.0
12/8/2024,Recurring Withdrawal Debit Card - MC Debit Seminol/PADDLE.NET* COPYTONOTI NEW YORK NYDate 12/07/24 0 4342788023 3 5817Card 1231,9.0,Posted,560.07,2024-12-08,9.0,Recurring Withdrawal Debit Card - MC Debit Seminol/PADDLE.NET* COPYTONOTI NEW YORK NYDate 12/07/24 0 4342788023 3 5817Card 1231,9.0
12/8/2024,Withdrawal Debit Card MC Debit Seminol/SAMSUNG ELECTRONICS RIDGEFIELD P NJDate 12/06/24 0 4341784790 3 5734Card 1231,16.99,Posted,569.07,2024-12-08,16.99,Withdrawal Debit Card MC Debit Seminol/SAMSUNG ELECTRONICS RIDGEFIELD P NJDate 12/27/24 0 4362999827 1 5734Card 1231,16.99
12/8/2024,Recurring Withdrawal Debit Card - MC Debit Seminol/APPLE.COM/BILL 866-712-7753 CADate 12/06/24 0 4341327079 2 5818Card 1231,49.98,Posted,586.06,2024-12-08,49.98,Recurring Withdrawal Debit Card - MC Debit Seminol/APPLE.COM/BILL 866-712-7753 CADate 12/06/24 0 4341327079 2 5818Card 1231,49.98
12/6/2024,Withdrawal POS #000000000070/CIRCLE K # 26146 3525 GAINESVILLE FLCard 1231,37.34,Posted,636.04,2024-12-06,37.34,Withdrawal POS #000000000343/CIRCLE K # 06782 5237 GAINESVILLE FLCard 1247,37.34
12/6/2024,Withdrawal Debit Card MC Debit Seminol/PP*P321458226 2033189708 NYDate 12/05/24 0 4340999603 0 4816Card 1231,1.13,Posted,673.38,2024-12-06,1.13,Withdrawal Debit Card MC Debit Seminol/PP*P321458226 2033189708 NYDate 12/05/24 0 4340999603 0 4816Card 1231,1.13
12/6/2024,Recurring Withdrawal Debit Card - MC Debit Seminol/PADDLE.NET* SETAPP NEW YORK NYDate 12/05/24 0 4340998738 0 5817Card 1231,9.99,Posted,674.51,2024-12-06,9.99,Recurring Withdrawal Debit Card - MC Debit Seminol/PADDLE.NET* SETAPP NEW YORK NYDate 10/14/24 0 4288882561 0 5817Card 1231,9.495000000000001
12/6/2024,Withdrawal Debit Card MC Debit Seminol/IONOS INC. CHESTERBROOK PADate 12/05/24 0 4340534140 1 4816Card 1231,16.0,Posted,684.5,2024-12-06,16.0,Withdrawal Debit Card MC Debit Seminol/IONOS INC. CHESTERBROOK PADate 12/29/24 0 4364954464 0 4816Card 1231,16.0
12/6/2024,Withdrawal Debit Card MC Debit Seminol/CIRCLE K # 06782 GAINESVILLE FLDate 12/04/24 0 4339524954 1 5499Card 1231,31.57,Posted,700.5,2024-12-06,31.57,Withdrawal Debit Card MC Debit Seminol/CIRCLE K # 06782 GAINESVILLE FLDate 09/08/24 0 4252889868 0 5499Card 1231,31.57
12/6/2024,Withdrawal Debit Card MC Debit Seminol/GRU/EZ-PAY WEB PYMT 352-334-3434 FLDate 12/05/24 0 4340279271 0 4900Card 1231,171.03,Posted,732.07,2024-12-06,171.03,Withdrawal Debit Card MC Debit Seminol/GRU/EZ-PAY WEB PYMT 352-334-3434 FLDate 12/05/24 0 4340279271 0 4900Card 1231,171.15
12/5/2024,Recurring Withdrawal Debit Card - MC Debit Seminol/WWW.EVERBEE.IO AUSTIN TXDate 12/04/24 0 4339869891 0 5734Card 1231,29.99,Posted,903.1,2024-12-05,29.99,Recurring Withdrawal Debit Card - MC Debit Seminol/WWW.EVERBEE.IO AUSTIN TXDate 12/04/24 0 4339869891 0 5734Card 1231,29.99
12/5/2024,Recurring Withdrawal Debit Card - MC Debit Seminol/OPENAI *CHATGPT SUBSCR SAN FRANCISC CADate 12/04/24 0 4339869196 0 5734Card 1231,20.0,Posted,933.09,2024-12-05,20.0,Recurring Withdrawal Debit Card - MC Debit Seminol/OPENAI *CHATGPT SUBSCR SAN FRANCISC CADate 12/04/24 0 4339869196 0 5734Card 1231,20.0
12/5/2024,Withdrawal Debit Card MC Debit Seminol/INSTACART*159 SAN FRANCISC CADate 12/04/24 0 4339868026 0 5411Card 1231,51.0,Posted,953.09,2024-12-05,51.0,Withdrawal Debit Card MC Debit Seminol/VIDIQ SAN FRANCISC CADate 12/03/24 0 4338664809 1 5734Card 1231,51.0
12/5/2024,Recurring Withdrawal Debit Card Fee/MASTERCARD ISSUER CROSS-BORDER FEEDate 12/05/24 0 4340418348 1 5734Card 1231,0.1,Posted,1004.09,2024-12-05,0.1,Recurring Withdrawal Debit Card Fee/MASTERCARD ISSUER CROSS-BORDER FEEDate 12/31/23 0 3365740203 0 5734Card 2801,0.10500000000000001
12/5/2024,Recurring Withdrawal Debit Card - MC Debit Seminol/LEONARDO.AI NORTH SYDNEY NSDate 12/05/24 0 4340418348 1 5734Card 1231,12.0,Posted,1004.19,2024-12-05,12.0,Recurring Withdrawal Debit Card - MC Debit Seminol/LEONARDO.AI NORTH SYDNEY NSDate 12/05/24 0 4340418348 1 5734Card 1231,12.0
12/5/2024,Withdrawal Debit Card MC Debit Seminol/COX GAINESVILLE COMM 800-234-3993 FLDate 12/04/24 0 4339376311 0 4899Card 1231,156.13,Posted,1016.19,2024-12-05,156.13,Withdrawal Debit Card MC Debit Seminol/COX GAINESVILLE COMM 800-234-3993 FLDate 12/04/24 0 4339376311 0 4899Card 1231,156.13
12/5/2024,Recurring Withdrawal Debit Card - MC Debit Seminol/APPLE.COM/BILL 866-712-7753 CADate 12/04/24 0 4339984092 0 5818Card 1231,2.99,Posted,1172.32,2024-12-05,2.99,Recurring Withdrawal Debit Card - MC Debit Seminol/APPLE.COM/BILL 866-712-7753 CADate 01/08/24 0 4008756344 0 5818Card 2801,2.99
12/4/2024,Withdrawal POS #000083179688/SMOKE CITY 2120 SW 34TH ST GAINESVILLECard 1231,9.68,Posted,1175.31,2024-12-04,9.68,"Withdrawal POS #000080196760/SMOKE CITY 2120 SW 34TH ST GAINESVILLE
Card 1247",9.68
12/4/2024,Recurring Withdrawal Debit Card - MC Debit Seminol/SUPERPOWER CHATGPT MIDDLETOWN DEDate 12/04/24 0 4339846699 0 5734Card 1231,15.0,Posted,1184.99,2024-12-04,15.0,Recurring Withdrawal Debit Card - MC Debit Seminol/SUPERPOWER CHATGPT MIDDLETOWN DEDate 12/17/24 0 4352703539 1 5734Card 1231,15.0
12/4/2024,Recurring Withdrawal Debit Card - MC Debit Seminol/TUBEBUDDYCOM* 8668823239 CADate 12/03/24 0 4338443995 0 5045Card 1231,19.79,Posted,1199.99,2024-12-04,19.79,Recurring Withdrawal Debit Card - MC Debit Seminol/TUBEBUDDYCOM* 8668823239 CADate 12/03/24 0 4338443995 0 5045Card 1231,19.79
12/4/2024,Recurring Withdrawal Debit Card - MC Debit Seminol/APPLE.COM/BILL CUPERTINO CADate 12/03/24 0 4338442272 0 5818Card 1231,2.99,Posted,1219.78,2024-12-04,2.99,Recurring Withdrawal Debit Card - MC Debit Seminol/APPLE.COM/BILL CUPERTINO CADate 05/03/24 0 4124646881 1 5735Card 1231,2.99
12/4/2024,"Withdrawal Bill Payment #000000196200/Adobe Park Avenue,345 San Jose CACard 1231",19.99,Posted,1222.77,2024-12-04,19.99,"Withdrawal Bill Payment #000000352498/Adobe Park Avenue,345 San Jose CACard 1247",19.99
12/3/2024,Withdrawal POS #000000000049/AMAZON.COM*ZL4MI32Y2 SEATTLE WACard 1231,9.13,Posted,1242.76,2024-12-03,9.13,Withdrawal POS #000000000006/AMAZON.COM*RJ6HJ7RA2 SEATTLE WACard 1231,8.86
12/3/2024,"Recurring Withdrawal Debit Card - MC Debit Seminol/NOTION LABS, INC. SAN FRANCISC CADate 12/02/24 0 4337878572 0 7372Card 1231",17.86,Posted,1251.89,2024-12-03,17.86,"Recurring Withdrawal Debit Card - MC Debit Seminol/NOTION LABS, INC. SAN FRANCISC CADate 12/02/24 0 4337878572 0 7372Card 1231",17.86
12/3/2024,Withdrawal Debit Card MC Debit Seminol/VIDIQ SAN FRANCISC CADate 12/03/24 0 4338664809 1 5734Card 1231,19.0,Posted,1269.75,2024-12-03,19.0,Withdrawal Debit Card MC Debit Seminol/VIDIQ SAN FRANCISC CADate 12/03/24 0 4338664809 1 5734Card 1231,19.0
12/3/2024,Recurring Withdrawal Debit Card - MC Debit Seminol/TASKADE SAN FRANCISC CADate 12/03/24 0 4338877562 0 5734Card 1231,10.0,Posted,1288.75,2024-12-03,10.0,"Recurring Withdrawal Debit Card - MC Debit Seminol/NOTION LABS, INC. SAN FRANCISC CADate 12/02/24 0 4337878572 0 7372Card 1231",10.0
12/3/2024,Recurring Withdrawal Debit Card Fee/MASTERCARD ISSUER CROSS-BORDER FEEDate 12/02/24 0 4337877232 0 5734Card 1231,0.05,Posted,1298.75,2024-12-03,0.05,Recurring Withdrawal Debit Card Fee/MASTERCARD ISSUER CROSS-BORDER FEEDate 12/31/23 0 3365740203 0 5734Card 2801,0.10500000000000001
12/3/2024,Recurring Withdrawal Debit Card - MC Debit Seminol/IDEOGRAM AI TORONTO ONDate 12/02/24 0 4337877232 0 5734Card 1231,5.81,Posted,1298.8,2024-12-03,5.81,Recurring Withdrawal Debit Card - MC Debit Seminol/IDEOGRAM AI TORONTO ONDate 12/17/24 0 4352700468 1 5734Card 1231,5.81
12/3/2024,Withdrawal Debit Card MC Debit Seminol/WALGREENS #5024 GAINESVILLE FLDate 12/02/24 0 4337658312 1 5912Card 1231,31.74,Posted,1304.61,2024-12-03,31.74,Withdrawal Debit Card MC Debit Seminol/WALGREENS #9304 GAINESVILLE FLDate 10/30/24 0 4304125853 1 5912Card 1231,31.74
12/3/2024,Recurring Withdrawal POS #000006174112/PAYPAL *TUBEBUDDY TUBEBUD 2211 NorthStreet 8882211161 CACard 1231,19.79,Posted,1336.35,2024-12-03,19.79,Recurring Withdrawal POS #000006174112/PAYPAL *TUBEBUDDY TUBEBUD 2211 NorthStreet 8882211161 CACard 1231,19.79
12/2/2024,Withdrawal POS #000000513221/SUNOCO 8002212501 4234 SW 20TH AVEGAINESVILLE FLCard 1231,20.83,Posted,1356.14,2024-12-02,20.83,Withdrawal POS #000000221295/SUNOCO 8002212501 4234 SW 20TH AVEGAINESVILLE FLCard 1231,20.83
12/2/2024,Recurring Withdrawal Debit Card - MC Debit Seminol/IC* INSTACART*SUBSCRIP SAN FRANCISC CADate 11/30/24 0 4335692546 1 5411Card 1231,9.99,Posted,1376.97,2024-12-02,9.99,Recurring Withdrawal Debit Card - MC Debit Seminol/IC* INSTACART*SUBSCRIP SAN FRANCISC CADate 11/30/24 0 4335692546 1 5411Card 1231,9.99
12/2/2024,Withdrawal Debit Card MC Debit Seminol/SCRUBS CARWASH - GAINE GAINESVILLE FLDate 11/29/24 0 4334403825 2 7542Card 1231,6.0,Posted,1386.96,2024-12-02,6.0,Withdrawal Debit Card MC Debit Seminol/SCRUBS CARWASH - GAINE GAINESVILLE FLDate 11/29/24 0 4334403825 2 7542Card 1231,6.0
12/2/2024,Withdrawal ACH Watson Realty Co/TYPE: WEB PMTS ID: 9000321157CO: Watson Realty CoNAME: Steven chaplinskiEntry Class Code: WEB,1179.0,Posted,1392.96,2024-12-02,1179.0,"Withdrawal ACH Watson Realty Co/TYPE: WEB PMTS ID: 9000321157
CO: Watson Realty Co
NAME: Steven chaplinskiEntry Class Code: WEB",1179.0
12/2/2024,Withdrawal ACH FLUENT-Gainesvil/TYPE: PAYMENT ID: 1371804719CO: FLUENT-GainesvilNAME: steven chaplinskiEntry Class Code: WEB,40.0,Posted,2571.96,2024-12-02,40.0,Withdrawal ACH FLUENT-Gainesvil/TYPE: PAYMENT ID: 1371804719CO: FLUENT-GainesvilNAME: steven chaplinski,40.0
12/2/2024,Withdrawal ACH FLUENT-Gainesvil/TYPE: PAYMENT ID: 1371804719CO: FLUENT-GainesvilNAME: steven chaplinskiEntry Class Code: WEB,20.0,Posted,2611.96,2024-12-02,20.0,Withdrawal ACH FLUENT-Gainesvil/TYPE: PAYMENT ID: 1371804719CO: FLUENT-GainesvilNAME: steven chaplinski,20.0
12/2/2024,"Withdrawal ACH AppFolio, Inc. F/TYPE: WEB PMTS ID: 9001406550CO: AppFolio, Inc. FNAME: Steven chaplinskiEntry Class Code: WEB",2.49,Posted,2631.96,2024-12-02,2.49,"Withdrawal ACH AppFolio, Inc. F/TYPE: WEB PMTS ID: 9001406550
CO: AppFolio, Inc. F
NAME: Steven chaplinskiEntry Class Code: WEB",2.49
12/2/2024,Withdrawal Bill Payment #000000352178/Disney PLUS Recurring 1375 Buena VistaDrive Lake Buena Vi FLCard 1231,18.41,Posted,2634.45,2024-12-02,18.41,Withdrawal Bill Payment #000000352178/Disney PLUS Recurring 1375 Buena VistaDrive Lake Buena Vi FLCard 1231,18.41
12/1/2024,Withdrawal POS #000000047747/SUNOCO 8002212501 4234 SW 20TH AVEGAINESVILLE FLCard 1231,31.05,Posted,2652.86,2024-12-01,31.05,Withdrawal POS #000000616677/SUNOCO 8002212501 4234 SW 20TH AVEGAINESVILLE FLCard 1231,31.05
11/30/2024,Withdrawal Debit Card MC Debit Seminol/INSTACART*159 SAN FRANCISC CADate 11/29/24 0 4334853720 0 5411Card 1231,53.0,Posted,2683.91,2024-11-30,53.0,Withdrawal Debit Card MC Debit Seminol/INSTACART*159 SAN FRANCISC CADate 12/24/24 0 4359294650 0 5411Card 1231,53.5
11/30/2024,Withdrawal Debit Card MC Debit Seminol/IONOS INC. CHESTERBROOK PADate 11/29/24 0 4334602237 1 4816Card 1231,1.0,Posted,2736.91,2024-11-30,1.0,Withdrawal Debit Card MC Debit Seminol/IONOS INC. CHESTERBROOK PADate 12/29/24 0 4364954464 0 4816Card 1231,0.8400000000000001
11/29/2024,Withdrawal POS #000000292609/SUNOCO 8002212501 4234 SW 20TH AVEGAINESVILLE FLCard 1231,24.8,Posted,2737.91,2024-11-29,24.8,Withdrawal POS #000000235720/SUNOCO 8002212501 4234 SW 20TH AVEGAINESVILLE FLCard 1231,24.8
11/29/2024,Withdrawal Debit Card MC Debit Seminol/WAWA 5325 GAINESVILLE FLDate 11/28/24 0 4333451434 0 5541Card 1231,17.82,Posted,2762.71,2024-11-29,17.82,Withdrawal Debit Card MC Debit Seminol/WAWA 5325 GAINESVILLE FLDate 12/28/24 0 4363858796 0 5541Card 1231,17.82
11/28/2024,Withdrawal POS #000000296305/SUNOCO 8002212501 4234 SW 20TH AVEGAINESVILLE FLCard 1231,20.83,Posted,2780.53,2024-11-28,20.83,Withdrawal POS #000000966158/SUNOCO 8002212501 4234 SW 20TH AVEGAINESVILLE FLCard 2801,20.83
11/28/2024,Withdrawal Debit Card MC Debit Seminol/SAMSUNG ELECTRONICS RIDGEFIELD P NJDate 11/27/24 0 4332105121 1 5734Card 1231,8.99,Posted,1.36,2024-11-28,8.99,Withdrawal Debit Card MC Debit Seminol/SAMSUNG ELECTRONICS RIDGEFIELD P NJDate 12/27/24 0 4362999827 1 5734Card 1231,8.99
11/27/2024,Withdrawal POS #000000000029/AMAZON.COM*Z38LO1T72 SEATTLE WACard 1231,14.63,Posted,10.35,2024-11-27,14.63,Withdrawal POS #000000000006/AMAZON.COM*RJ6HJ7RA2 SEATTLE WACard 1231,14.63
11/26/2024,Withdrawal POS #000000238833/SILVER SPRINGS FOOD MART 5501 NE 35TH STSILVER SPRING FLCard 1231,10.0,Posted,24.98,2024-11-26,10.0,Withdrawal POS #000000238833/SILVER SPRINGS FOOD MART 5501 NE 35TH STSILVER SPRING FLCard 1231,10.0
11/26/2024,Withdrawal POS #000000201980/SUNOCO 8002212501 4234 SW 20TH AVEGAINESVILLE FLCard 1231,17.08,Posted,34.98,2024-11-26,17.08,Withdrawal POS #000000221295/SUNOCO 8002212501 4234 SW 20TH AVEGAINESVILLE FLCard 1231,17.08
11/26/2024,Withdrawal Debit Card MC Debit Seminol/ARCHER ANIMAL HOSPITAL ARCHER FLDate 11/25/24 0 4330350737 0 0742Card 1231,49.24,Posted,52.06,2024-11-26,49.24,Withdrawal Debit Card MC Debit Seminol/ARCHER ANIMAL HOSPITAL ARCHER FLDate 11/25/24 0 4330350737 0 0742Card 1231,49.24
11/26/2024,Withdrawal Debit Card MC Debit Seminol/WALGREENS #5024 GAINESVILLE FLDate 11/25/24 0 4330149353 1 5912Card 1231,10.81,Posted,101.3,2024-11-26,10.81,Withdrawal Debit Card MC Debit Seminol/WALGREENS #9304 GAINESVILLE FLDate 10/30/24 0 4304125853 1 5912Card 1231,10.81
11/25/2024,Withdrawal POS #000000144391/SUNOCO 8002212501 4234 SW 20TH AVEGAINESVILLE FLCard 1231,21.35,Posted,110.76,2024-11-25,21.35,Withdrawal POS #000000144391/SUNOCO 8002212501 4234 SW 20TH AVEGAINESVILLE FLCard 1231,21.35
11/25/2024,Recurring Withdrawal Debit Card - MC Debit Seminol/FS *ADOBE SANTA BARBAR CADate 11/24/24 0 4329138605 1 5734Card 1231,0.95,Posted,132.11,2024-11-25,0.95,Recurring Withdrawal Debit Card - MC Debit Seminol/FS *ADOBE SANTA BARBAR CADate 12/24/24 0 4359034647 1 5734Card 1231,0.95
11/25/2024,Withdrawal Courtesy Pay Fee/Entry Class Code: WEB,35.0,Posted,-41.94,2024-11-25,35.0,Withdrawal Courtesy Pay Fee/Entry Class Code: WEB,35.0
11/25/2024,Withdrawal ACH FLUENT-Gainesvil/TYPE: PAYMENT ID: 1371804719CO: FLUENT-GainesvilNAME: steven chaplinski,18.0,Posted,-6.94,2024-11-25,18.0,Withdrawal ACH FLUENT-Gainesvil/TYPE: PAYMENT ID: 1371804719CO: FLUENT-GainesvilNAME: steven chaplinski,18.0
11/25/2024,Withdrawal POS #000000125261/SUNOCO 8002212501 4234 SW 20TH AVEGAINESVILLE FLCard 1231,14.92,Posted,11.06,2024-11-25,14.92,Withdrawal POS #000000235720/SUNOCO 8002212501 4234 SW 20TH AVEGAINESVILLE FLCard 1231,15.135
11/24/2024,Withdrawal Debit Card MC Debit Seminol/INSTACART*159 SAN FRANCISC CADate 11/23/24 0 4328257179 0 5411Card 1231,41.06,Posted,25.98,2024-11-24,41.06,Withdrawal Debit Card MC Debit Seminol/INSTACART*159 SAN FRANCISC CADate 12/24/24 0 4359294650 0 5411Card 1231,41.06
11/24/2024,Withdrawal Debit Card MC Debit Seminol/WAWA 5325 GAINESVILLE FLDate 11/23/24 0 4328070994 1 5541Card 1231,20.7,Posted,67.04,2024-11-24,20.7,Withdrawal Debit Card MC Debit Seminol/WAWA 5325 GAINESVILLE FLDate 12/28/24 0 4363858796 0 5541Card 1231,20.21
11/24/2024,Withdrawal POS #000000000055/CIRCLE K # 06782 5237 GAINESVILLE FLCard 1231,16.76,Posted,87.74,2024-11-24,16.76,Withdrawal POS #000000000343/CIRCLE K # 06782 5237 GAINESVILLE FLCard 1247,16.875
11/23/2024,Withdrawal POS #000000064289/SUNOCO 8002212501 4234 SW 20TH AVEGAINESVILLE FLCard 1231,22.42,Posted,104.5,2024-11-23,22.42,Withdrawal POS #000000028242/SUNOCO 8002212501 4234 SW 20TH AVEGAINESVILLE FLCard 1231,22.42
11/23/2024,Recurring Withdrawal Bill Payment - #000000145767/NETFLIX COM LOS GATOS CACard 1231,17.84,Posted,126.92,2024-11-23,17.84,"Recurring Withdrawal Bill Payment - #000000017652/NETFLIX COM LOS GATOS CA
Card 1247",17.84
11/22/2024,Withdrawal POS #000000994295/SUNOCO 8002212501 4234 SW 20TH AVEGAINESVILLE FLCard 1231,22.1,Posted,19.76,2024-11-22,22.1,Withdrawal POS #000000221295/SUNOCO 8002212501 4234 SW 20TH AVEGAINESVILLE FLCard 1231,22.1
11/22/2024,Withdrawal Debit Card MC Debit Seminol/WAWA 5325 GAINESVILLE FLDate 11/21/24 0 4326148333 1 5541Card 1231,16.66,Posted,41.86,2024-11-22,16.66,Withdrawal Debit Card MC Debit Seminol/WAWA 5325 GAINESVILLE FLDate 12/28/24 0 4363858796 0 5541Card 1231,16.92
11/21/2024,Withdrawal POS #000000998084/AMAZON.COM*9I40T2VL3 SEATTLE WACard 1231,10.73,Posted,58.52,2024-11-21,10.73,Withdrawal POS #000000914130/AMAZON.COM*ZR50X2ML1 SEATTLE WACard 1231,10.46
11/21/2024,Recurring Withdrawal Debit Card - MC Debit Seminol/CANVA* I04341-45036624 CAMDEN DEDate 11/20/24 0 4325914916 0 7333Card 1231,12.99,Posted,69.25,2024-11-21,12.99,Recurring Withdrawal Debit Card - MC Debit Seminol/CANVA* I04249-43399962 CAMDEN DEDate 08/20/24 0 4233594945 0 7221Card 1231,12.99
11/21/2024,Withdrawal POS #000000951422/SUNOCO 8002212501 4234 SW 20TH AVEGAINESVILLE FLCard 1231,22.42,Posted,82.24,2024-11-21,22.42,Withdrawal POS #000000909995/SUNOCO 8002212501 4234 SW 20TH AVEGAINESVILLE FLCard 1231,22.42
11/20/2024,Withdrawal POS #000000000009/CIRCLE K # 06782 5237 GAINESVILLE FLCard 1231,20.4,Posted,104.66,2024-11-20,20.4,Withdrawal POS #000000000343/CIRCLE K # 06782 5237 GAINESVILLE FLCard 1247,20.4
11/19/2024,Recurring Withdrawal Debit Card Fee/MASTERCARD ISSUER CROSS-BORDER FEEDate 11/18/24 0 4323867046 0 5734Card 1231,0.05,Posted,125.06,2024-11-19,0.05,Recurring Withdrawal Debit Card Fee/MASTERCARD ISSUER CROSS-BORDER FEEDate 12/31/23 0 3365740203 0 5734Card 2801,0.10500000000000001
11/19/2024,Recurring Withdrawal Debit Card - MC Debit Seminol/SAVE TO NOTION VAUREAL ILDate 11/18/24 0 4323867046 0 5734Card 1231,5.99,Posted,125.11,2024-11-19,5.99,Recurring Withdrawal Debit Card - MC Debit Seminol/SAVE TO NOTION VAUREAL ILDate 12/18/24 0 4353969048 0 5734Card 1231,5.99
11/18/2024,Withdrawal POS #000000359086/INSTACART*159 WWW.INSTACART.COM/ SANFRANCISCO CACard 1231,43.0,Posted,131.1,2024-11-18,43.0,Withdrawal POS #000000804821/INSTACART*159 WWW.INSTACART.COM/ SANFRANCISCO CACard 1231,42.96
11/18/2024,Recurring Withdrawal Debit Card - MC Debit Seminol/SUPERPOWER CHATGPT MIDDLETOWN DEDate 11/17/24 0 4322285245 0 5734Card 1231,15.0,Posted,174.1,2024-11-18,15.0,Recurring Withdrawal Debit Card - MC Debit Seminol/SUPERPOWER CHATGPT MIDDLETOWN DEDate 12/17/24 0 4352703539 1 5734Card 1231,15.0
11/18/2024,Recurring Withdrawal Debit Card Fee/MASTERCARD ISSUER CROSS-BORDER FEEDate 11/17/24 0 4322076165 1 5734Card 1231,0.06,Posted,189.1,2024-11-18,0.06,Recurring Withdrawal Debit Card Fee/MASTERCARD ISSUER CROSS-BORDER FEEDate 12/31/23 0 3365740203 0 5734Card 2801,0.10500000000000001
11/18/2024,Recurring Withdrawal Debit Card - MC Debit Seminol/IDEOGRAM AI TORONTO ONDate 11/17/24 0 4322076165 1 5734Card 1231,8.0,Posted,189.16,2024-11-18,8.0,Recurring Withdrawal Debit Card - MC Debit Seminol/IDEOGRAM AI TORONTO ONDate 12/17/24 0 4352700468 1 5734Card 1231,8.0
11/18/2024,Recurring Withdrawal Debit Card - MC Debit Seminol/AMAZON PRIME*LF6U08PC3 AMZN.COM/BIL WADate 11/17/24 0 4322071074 1 5968Card 1231,15.11,Posted,197.16,2024-11-18,15.11,Recurring Withdrawal Debit Card - MC Debit Seminol/AMAZON PRIME*Z97W01ZG2 AMZN.COM/BIL WADate 12/17/24 0 4352950216 0 5968Card 1231,15.120000000000001
11/17/2024,Recurring Withdrawal Debit Card - MC Debit Seminol/PADDLE.NET* LEONARDOAI ASTORIA NYDate 11/16/24 0 4321386811 0 5817Card 1231,9.0,Posted,212.27,2024-11-17,9.0,Recurring Withdrawal Debit Card - MC Debit Seminol/PADDLE.NET* LEONARDOAI ASTORIA NYDate 12/16/24 0 4351323834 0 5817Card 1231,9.0
11/17/2024,Recurring Withdrawal Debit Card - MC Debit Seminol/PADDLE.NET* SETAPP ASTORIA NYDate 11/16/24 0 4321038237 1 5817Card 1231,12.49,Posted,221.27,2024-11-17,12.49,Recurring Withdrawal Debit Card - MC Debit Seminol/PADDLE.NET* SETAPP NEW YORK NYDate 10/14/24 0 4288882561 0 5817Card 1231,12.49
11/15/2024,Withdrawal POS #000000000003/INSTACART*159 WWW.INSTACART.COM/ SANFRANCISCO CACard 1231,69.0,Posted,233.76,2024-11-15,69.0,Withdrawal POS #000000000003/INSTACART*159 WWW.INSTACART.COM/ SANFRANCISCO CACard 1231,69.0
11/15/2024,"Recurring Withdrawal Debit Card - MC Debit Seminol/NOTION LABS, INC. SAN FRANCISC CADate 11/15/24 0 4320097919 1 7372Card 1231",10.0,Posted,302.76,2024-11-15,10.0,"Recurring Withdrawal Debit Card - MC Debit Seminol/NOTION LABS, INC. SAN FRANCISC CADate 12/02/24 0 4337878572 0 7372Card 1231",10.0
11/15/2024,Recurring Withdrawal Debit Card - MC Debit Seminol/RUNWAY STANDARD PLAN NEWARK DEDate 11/15/24 0 4320097866 1 5734Card 1231,15.0,Posted,312.76,2024-11-15,15.0,Recurring Withdrawal Debit Card - MC Debit Seminol/RUNWAY STANDARD PLAN NEWARK DEDate 12/15/24 0 4350745942 1 5734Card 1231,15.0
11/14/2024,"Withdrawal Home Banking Transfer refund/To CHAPLINSKI,LEONA 3496297 Share 0090",414.0,Posted,327.76,2024-11-14,414.0,"Withdrawal Home Banking Transfer refund/To CHAPLINSKI,LEONA 3496297 Share 0090",414.0
11/14/2024,Withdrawal POS #000000639340/SUNOCO 8002212501 4234 SW 20TH AVEGAINESVILLE FLCard 1231,44.56,Posted,327.76,2024-11-14,44.56,Withdrawal POS #000000909995/SUNOCO 8002212501 4234 SW 20TH AVEGAINESVILLE FLCard 1231,44.56
11/14/2024,Withdrawal POS #000000353696/INSTACART*159 WWW.INSTACART.COM/ SANFRANCISCO CACard 1231,64.0,Posted,372.32,2024-11-14,64.0,Withdrawal POS #000000792733/INSTACART*159 WWW.INSTACART.COM/ SANFRANCISCO CACard 1231,64.0
11/12/2024,Recurring Withdrawal Debit Card - MC Debit Seminol/CAPCUT WILMINGTON DEDate 11/11/24 0 4316889558 0 5734Card 1231,9.99,Posted,436.32,2024-11-12,9.99,Recurring Withdrawal Debit Card - MC Debit Seminol/CAPCUT WILMINGTON DEDate 11/11/24 0 4316889558 0 5734Card 1231,9.99
11/12/2024,Withdrawal Debit Card MC Debit Seminol/ARCHER ANIMAL HOSPITAL ARCHER FLDate 11/11/24 0 4316304922 0 0742Card 1231,82.28,Posted,446.31,2024-11-12,82.28,Withdrawal Debit Card MC Debit Seminol/ARCHER ANIMAL HOSPITAL ARCHER FLDate 11/25/24 0 4330350737 0 0742Card 1231,82.28
11/12/2024,Recurring Withdrawal Debit Card - MC Debit Seminol/APPLE.COM/BILL 866-712-7753 CADate 11/11/24 0 4316616813 0 5818Card 1231,5.99,Posted,528.59,2024-11-12,5.99,Recurring Withdrawal Debit Card - MC Debit Seminol/APPLE.COM/BILL 866-712-7753 CADate 11/11/24 0 4316616811 0 5818Card 1231,5.99
11/12/2024,Recurring Withdrawal Debit Card - MC Debit Seminol/APPLE.COM/BILL 866-712-7753 CADate 11/11/24 0 4316616811 0 5818Card 1231,9.99,Posted,534.58,2024-11-12,9.99,Recurring Withdrawal Debit Card - MC Debit Seminol/APPLE.COM/BILL 866-712-7753 CADate 11/11/24 0 4316616811 0 5818Card 1231,9.99
11/12/2024,Withdrawal ACH VENMO/TYPE: PAYMENT ID: 3264681992 CO: VENMONAME: AVATAR ARTSEntry Class Code: WEB,14.99,Posted,544.57,2024-11-12,14.99,Withdrawal ACH VENMO/TYPE: PAYMENT ID: 3264681992 CO: VENMONAME: AVATAR ARTSEntry Class Code: WEB,14.99
11/12/2024,Withdrawal ACH VENMO/TYPE: PAYMENT ID: 3264681992 CO: VENMONAME: AVATAR ARTSEntry Class Code: WEB,9.99,Posted,559.56,2024-11-12,9.99,Withdrawal ACH VENMO/TYPE: PAYMENT ID: 3264681992 CO: VENMONAME: AVATAR ARTSEntry Class Code: WEB,9.99
11/11/2024,Withdrawal Debit Card MC Debit Seminol/AMAZON PRIME*2Z8Q443B3 AMZN.COM/BIL WADate 11/11/24 0 4316267232 1 5818Card 1231,3.4,Posted,289.55,2024-11-11,3.4,Withdrawal Debit Card MC Debit Seminol/AMAZON PRIME*XS2HD1WH3 AMZN.COM/BIL WADate 09/11/24 0 4255908162 0 5818Card 1231,3.4
11/11/2024,Withdrawal POS #000000359959/INSTACART*159 WWW.INSTACART.COM/ SANFRANCISCO CACard 1231,55.0,Posted,292.95,2024-11-11,55.0,Withdrawal POS #000000000003/INSTACART*159 WWW.INSTACART.COM/ SANFRANCISCO CACard 1231,55.0
11/10/2024,Recurring Withdrawal Debit Card - MC Debit Seminol/MYDESIGNS - PRO - MON LAS VEGAS NVDate 11/08/24 0 4313744024 0 5734Card 1231,29.99,Posted,347.95,2024-11-10,29.99,Recurring Withdrawal Debit Card - MC Debit Seminol/MYDESIGNS - PRO - MON LAS VEGAS NVDate 12/08/24 0 4343357881 0 5734Card 1231,29.99
11/10/2024,Recurring Withdrawal Debit Card - MC Debit Seminol/OPENAI SAN FRANCISC CADate 11/10/24 0 4315698126 1 5734Card 1231,15.01,Posted,377.94,2024-11-10,15.01,Recurring Withdrawal Debit Card - MC Debit Seminol/OPENAI *CHATGPT SUBSCR SAN FRANCISC CADate 12/04/24 0 4339869196 0 5734Card 1231,15.01
11/10/2024,Recurring Withdrawal Debit Card - MC Debit Seminol/INVIDEO INC COUNTRY OF S DEDate 11/09/24 0 4314032712 1 5734Card 1231,25.0,Posted,392.95,2024-11-10,25.0,Recurring Withdrawal Debit Card - MC Debit Seminol/INVIDEO INC COUNTRY OF S DEDate 12/09/24 0 4344808122 0 5734Card 1231,25.0
11/10/2024,Withdrawal Debit Card MC Debit Seminol/IONOS INC. CHESTERBROOK PADate 11/08/24 0 4313995164 0 4816Card 1231,23.0,Posted,417.95,2024-11-10,23.0,Withdrawal Debit Card MC Debit Seminol/IONOS INC. CHESTERBROOK PADate 12/29/24 0 4364954464 0 4816Card 1231,23.0
11/10/2024,Withdrawal Debit Card MC Debit Seminol/COX GAINESVILLE COMM 800-234-3993 FLDate 11/08/24 0 4313741580 0 4899Card 1231,156.13,Posted,440.95,2024-11-10,156.13,Withdrawal Debit Card MC Debit Seminol/COX GAINESVILLE COMM 800-234-3993 FLDate 12/04/24 0 4339376311 0 4899Card 1231,156.13
11/10/2024,Withdrawal POS #000000548638/SUNOCO 8002212501 4234 SW 20TH AVEGAINESVILLE FLCard 1231,41.74,Posted,597.08,2024-11-10,41.74,Withdrawal POS #000000488663/SUNOCO 8002212501 4234 SW 20TH AVEGAINESVILLE FLCard 1231,41.74
11/9/2024,Withdrawal POS #000020542095/GOOGLE *YouTubePremium 1600 AmphitheatreParkw Mountain View CACard 1231,9.1,Posted,638.82,2024-11-09,9.1,"Withdrawal POS #000020312090/GOOGLE *YouTubePremium 1600 Amphitheatre
Parkw Mountain View CA
Card 1247",9.1
11/8/2024,Withdrawal Debit Card MC Debit Seminol/GRU/EZ-PAY WEB PYMT 352-334-3434 FLDate 11/07/24 0 4312396219 0 4900Card 1231,171.27,Posted,647.92,2024-11-08,171.27,Withdrawal Debit Card MC Debit Seminol/GRU/EZ-PAY WEB PYMT 352-334-3434 FLDate 12/05/24 0 4340279271 0 4900Card 1231,171.15
11/8/2024,Withdrawal POS #000000000016/INSTACART*159 WWW.INSTACART.COM/ SANFRANCISCO CACard 1231,55.22,Posted,819.19,2024-11-08,55.22,Withdrawal POS #000000804821/INSTACART*159 WWW.INSTACART.COM/ SANFRANCISCO CACard 1231,55.22
11/8/2024,Withdrawal POS #000000470276/SUNOCO 8002212501 4234 SW 20TH AVEGAINESVILLE FLCard 1231,38.31,Posted,874.41,2024-11-08,38.31,Withdrawal POS #000000616677/SUNOCO 8002212501 4234 SW 20TH AVEGAINESVILLE FLCard 1231,38.31
11/8/2024,Withdrawal POS #000000000002/AMAZON.COM*5A0D46X63 SEATTLE WACard 1231,17.94,Posted,912.72,2024-11-08,17.94,Withdrawal POS #000000000001/AMAZON.COM*TK5HF56S1 SEATTLE WACard 2801,17.94
11/7/2024,Recurring Withdrawal Debit Card - MC Debit Seminol/KREA.AI SAN FRANCISC CADate 11/06/24 0 4311608810 0 5734Card 1231,10.0,Posted,930.66,2024-11-07,10.0,Recurring Withdrawal Debit Card - MC Debit Seminol/KREA.AI SAN FRANCISC CADate 12/06/24 0 4341842673 0 5734Card 1231,10.0
11/7/2024,Recurring Withdrawal Debit Card - MC Debit Seminol/PADDLE.NET* COPYTONOTI NEW YORK NYDate 11/07/24 0 4312608046 0 5817Card 1231,9.0,Posted,940.66,2024-11-07,9.0,Recurring Withdrawal Debit Card - MC Debit Seminol/PADDLE.NET* SETAPP NEW YORK NYDate 10/14/24 0 4288882561 0 5817Card 1231,9.495000000000001
11/7/2024,Recurring Withdrawal Debit Card - MC Debit Seminol/TUBEBUDDYCOM* 8668823239 CADate 11/07/24 0 4312454387 1 5734Card 1231,7.5,Posted,949.66,2024-11-07,7.5,Recurring Withdrawal Debit Card - MC Debit Seminol/TUBEBUDDYCOM* 8668823239 CADate 12/03/24 0 4338443995 0 5045Card 1231,7.5
11/7/2024,Withdrawal Debit Card MC Debit Seminol/SAMSUNG ELECTRONICS RIDGEFIELD P NJDate 11/06/24 0 4311606417 0 5734Card 1231,16.99,Posted,957.16,2024-11-07,16.99,Withdrawal Debit Card MC Debit Seminol/SAMSUNG ELECTRONICS RIDGEFIELD P NJDate 12/27/24 0 4362999827 1 5734Card 1231,16.99
11/7/2024,Withdrawal POS #000000685024/AMAZON.COM*AS4EW0V93 SEATTLE WACard 1231,13.85,Posted,974.15,2024-11-07,13.85,Withdrawal POS #000000049785/AMAZON.COM*AV5RE3583 SEATTLE WACard 1231,13.85
11/6/2024,Withdrawal Debit Card MC Debit Seminol/IONOS INC. CHESTERBROOK PADate 11/05/24 0 4310089629 1 4816Card 1231,16.0,Posted,988.0,2024-11-06,16.0,Withdrawal Debit Card MC Debit Seminol/IONOS INC. CHESTERBROOK PADate 12/29/24 0 4364954464 0 4816Card 1231,16.0
11/6/2024,Withdrawal ACH FLUENT-Gainesvil/TYPE: PAYMENT ID: 1371804719CO: FLUENT-GainesvilNAME: steven chaplinskiEntry Class Code: WEB,52.0,Posted,1004.0,2024-11-06,52.0,Withdrawal ACH FLUENT-Gainesvil/TYPE: PAYMENT ID: 1371804719CO: FLUENT-GainesvilNAME: steven chaplinski,51.75
11/5/2024,Recurring Withdrawal Debit Card - MC Debit Seminol/OPENAI *CHATGPT SUBSCR SAN FRANCISC CADate 11/04/24 0 4309006198 1 5734Card 1231,20.0,Posted,1056.0,2024-11-05,20.0,Recurring Withdrawal Debit Card - MC Debit Seminol/OPENAI *CHATGPT SUBSCR SAN FRANCISC CADate 12/04/24 0 4339869196 0 5734Card 1231,20.0
11/5/2024,Recurring Withdrawal Debit Card - MC Debit Seminol/PADDLE.NET* SETAPP NEW YORK NYDate 11/05/24 0 4310972348 0 5817Card 1231,9.99,Posted,1076.0,2024-11-05,9.99,Recurring Withdrawal Debit Card - MC Debit Seminol/PADDLE.NET* SETAPP NEW YORK NYDate 10/14/24 0 4288882561 0 5817Card 1231,9.495000000000001
11/5/2024,Recurring Withdrawal Debit Card - MC Debit Seminol/WWW.EVERBEE.IO AUSTIN TXDate 11/05/24 0 4310004793 1 5734Card 1231,29.99,Posted,1085.99,2024-11-05,29.99,Recurring Withdrawal Debit Card - MC Debit Seminol/WWW.EVERBEE.IO AUSTIN TXDate 12/04/24 0 4339869891 0 5734Card 1231,29.99
11/5/2024,Withdrawal Debit Card MC Debit Seminol/WAWA CARD RELOAD MEDIA PADate 11/03/24 0 4308001823 1 6540Card 1231,15.0,Posted,1115.98,2024-11-05,15.0,Withdrawal Debit Card MC Debit Seminol/WAWA CARD RELOAD MEDIA PADate 11/03/24 0 4308001823 1 6540Card 1231,15.0
11/5/2024,Recurring Withdrawal Debit Card - MC Debit Seminol/APPLE.COM/BILL 866-712-7753 CADate 11/05/24 0 4310965680 0 5818Card 1231,2.99,Posted,1130.98,2024-11-05,2.99,Recurring Withdrawal Debit Card - MC Debit Seminol/APPLE.COM/BILL 866-712-7753 CADate 01/08/24 0 4008756344 0 5818Card 2801,2.99
11/5/2024,Withdrawal POS #000000794627/SUNOCO 8002212501 4234 SW 20TH AVEGAINESVILLE FLCard 1231,34.56,Posted,1069.93,2024-11-05,34.56,Withdrawal POS #000000616677/SUNOCO 8002212501 4234 SW 20TH AVEGAINESVILLE FLCard 1231,34.76
11/4/2024,"Withdrawal Bill Payment #000000195926/Adobe Park Avenue,345 San Jose CACard 1231",19.99,Posted,1104.49,2024-11-04,19.99,"Withdrawal Bill Payment #000000352498/Adobe Park Avenue,345 San Jose CACard 1247",19.99
11/4/2024,Recurring Withdrawal Debit Card - MC Debit Seminol/SUPERPOWER CHATGPT MIDDLETOWN DEDate 11/03/24 0 4308505507 0 5734Card 1231,15.0,Posted,1124.48,2024-11-04,15.0,Recurring Withdrawal Debit Card - MC Debit Seminol/SUPERPOWER CHATGPT MIDDLETOWN DEDate 12/17/24 0 4352703539 1 5734Card 1231,15.0
11/4/2024,Recurring Withdrawal Debit Card - MC Debit Seminol/SALESAMURAI SOFTWARE BOULDER CODate 11/04/24 0 4309610111 1 5734Card 1231,1.0,Posted,1139.48,2024-11-04,1.0,Recurring Withdrawal Debit Card - MC Debit Seminol/SALESAMURAI SOFTWARE BOULDER CODate 11/04/24 0 4309610111 1 5734Card 1231,1.0
11/4/2024,Withdrawal Debit Card MC Debit Seminol/WALGREENS #5024 GAINESVILLE FLDate 11/03/24 0 4308603683 1 5912Card 1231,27.97,Posted,1140.48,2024-11-04,27.97,Withdrawal Debit Card MC Debit Seminol/WALGREENS #9304 GAINESVILLE FLDate 10/30/24 0 4304125853 1 5912Card 1231,28.46
11/4/2024,Recurring Withdrawal Debit Card - MC Debit Seminol/APPLE.COM/BILL 866-712-7753 CADate 11/04/24 0 4309601161 1 5818Card 1231,2.99,Posted,1168.45,2024-11-04,2.99,Recurring Withdrawal Debit Card - MC Debit Seminol/APPLE.COM/BILL 866-712-7753 CADate 01/08/24 0 4008756344 0 5818Card 2801,2.99
11/4/2024,Withdrawal ACH Watson Realty Co/TYPE: WEB PMTS ID: 9000321157CO: Watson Realty CoNAME: Steven chaplinskiEntry Class Code: WEB,1179.0,Posted,1171.44,2024-11-04,1179.0,"Withdrawal ACH Watson Realty Co/TYPE: WEB PMTS ID: 9000321157
CO: Watson Realty Co
NAME: Steven chaplinskiEntry Class Code: WEB",1179.0
11/4/2024,"Withdrawal ACH AppFolio, Inc. F/TYPE: WEB PMTS ID: 9001406550CO: AppFolio, Inc. FNAME: Steven chaplinskiEntry Class Code: WEB",2.49,Posted,2350.44,2024-11-04,2.49,"Withdrawal ACH AppFolio, Inc. F/TYPE: WEB PMTS ID: 9001406550
CO: AppFolio, Inc. F
NAME: Steven chaplinskiEntry Class Code: WEB",2.49
11/3/2024,Withdrawal POS #000000212529/AMAZON.COM*HG16B6833 SEATTLE WACard 1231,45.43,Posted,2352.93,2024-11-03,45.43,Withdrawal POS #000000000021/AMAZON.COM*TQ9TB8YN3 SEATTLE WACard 1231,45.43
11/3/2024,Withdrawal Debit Card MC Debit Seminol/IONOS INC. CHESTERBROOK PADate 11/01/24 0 4306766970 1 4816Card 1231,0.68,Posted,2398.36,2024-11-03,0.68,Withdrawal Debit Card MC Debit Seminol/IONOS INC. CHESTERBROOK PADate 12/29/24 0 4364954464 0 4816Card 1231,0.8400000000000001
11/3/2024,"Withdrawal Bill Payment #000000227815/Adobe Park Avenue,345 San Jose CACard 1231",34.99,Posted,2399.04,2024-11-03,34.99,"Withdrawal Bill Payment #000000352498/Adobe Park Avenue,345 San Jose CACard 1247",34.99
11/3/2024,Withdrawal POS #000000000013/CIRCLE K # 06782 5237 GAINESVILLE FLCard 1231,12.83,Posted,2434.03,2024-11-03,12.83,Withdrawal POS #000000000343/CIRCLE K # 06782 5237 GAINESVILLE FLCard 1247,12.83
11/2/2024,Withdrawal POS #000000000021/AMAZON.COM*TQ9TB8YN3 SEATTLE WACard 1231,30.45,Posted,2446.86,2024-11-02,30.45,Withdrawal POS #000000000021/AMAZON.COM*TQ9TB8YN3 SEATTLE WACard 1231,30.45
11/2/2024,Withdrawal POS #000000680703/SUNOCO 8002212501 4234 SW 20TH AVEGAINESVILLE FLCard 1231,34.88,Posted,2477.31,2024-11-02,34.88,Withdrawal POS #000000616677/SUNOCO 8002212501 4234 SW 20TH AVEGAINESVILLE FLCard 1231,34.76
11/2/2024,Withdrawal Bill Payment #000000353116/Disney PLUS Recurring 1375 Buena VistaDrive Lake Buena Vi FLCard 1231,18.41,Posted,2512.19,2024-11-02,18.41,Withdrawal Bill Payment #000000352178/Disney PLUS Recurring 1375 Buena VistaDrive Lake Buena Vi FLCard 1231,18.41
11/1/2024,Recurring Withdrawal Debit Card - MC Debit Seminol/MYDESIGNS.IO LAS VEGAS NVDate 10/31/24 0 4305943289 0 5734Card 1231,30.57,Posted,2530.6,2024-11-01,30.57,Withdrawal Debit Card MC Debit Seminol/MYDESIGNS.IO LAS VEGAS NVDate 01/07/24 0 4007751481 0 5734Card 2801,30.57
11/1/2024,Withdrawal ACH FLUENT-Gainesvil/TYPE: PAYMENT ID: 1371804719CO: FLUENT-GainesvilNAME: steven chaplinskiEntry Class Code: WEB,36.0,Posted,2561.17,2024-11-01,36.0,Withdrawal ACH FLUENT-Gainesvil/TYPE: PAYMENT ID: 1371804719CO: FLUENT-GainesvilNAME: steven chaplinski,36.0
10/31/2024,Withdrawal POS #000000000000/INSTACART*159 WWW.INSTACART.COM/ SANFRANCISCO CACard 1231,70.69,Posted,2597.17,2024-10-31,70.69,Withdrawal POS #000000000003/INSTACART*159 WWW.INSTACART.COM/ SANFRANCISCO CACard 1231,70.69
10/31/2024,Withdrawal Debit Card MC Debit Seminol/WALGREENS #9304 GAINESVILLE FLDate 10/30/24 0 4304125853 1 5912Card 1231,10.81,Posted,2667.86,2024-10-31,10.81,Withdrawal Debit Card MC Debit Seminol/WALGREENS #9304 GAINESVILLE FLDate 10/30/24 0 4304125853 1 5912Card 1231,10.81
10/30/2024,Withdrawal POS #000000772673/INSTACART*159 WWW.INSTACART.COM/ SANFRANCISCO CACard 1231,59.1,Posted,2678.67,2024-10-30,59.1,Withdrawal POS #000000792733/INSTACART*159 WWW.INSTACART.COM/ SANFRANCISCO CACard 1231,59.085
10/30/2024,Recurring Withdrawal Debit Card - MC Debit Seminol/IC* INSTACART*SUBSCRIP SAN FRANCISC CADate 10/29/24 0 4303918463 0 5411Card 1231,9.99,Posted,2665.77,2024-10-30,9.99,Recurring Withdrawal Debit Card - MC Debit Seminol/IC* INSTACART*SUBSCRIP SAN FRANCISC CADate 11/30/24 0 4335692546 1 5411Card 1231,9.99
10/30/2024,Withdrawal POS #000000563213/SUNOCO 8002212501 4234 SW 20TH AVEGAINESVILLE FLCard 1231,38.64,Posted,2675.76,2024-10-30,38.64,Withdrawal POS #000000555763/SUNOCO 8002212501 4234 SW 20TH AVEGAINESVILLE FLCard 1231,38.21
10/28/2024,Withdrawal Debit Card MC Debit Seminol/SAMSUNG ELECTRONICS RIDGEFIELD P NJDate 10/27/24 0 4301061054 1 5734Card 1231,8.99,Posted,-85.6,2024-10-28,8.99,Withdrawal Debit Card MC Debit Seminol/SAMSUNG ELECTRONICS RIDGEFIELD P NJDate 12/27/24 0 4362999827 1 5734Card 1231,8.99
10/27/2024,Withdrawal CourtesyFeeDebit,35.0,Posted,-76.61,2024-10-27,35.0,Withdrawal CourtesyFeeDebit,35.0
10/27/2024,Withdrawal Debit Card MC Debit Seminol/IONOS INC. CHESTERBROOK PADate 10/26/24 0 4300913613 0 4816Card 1231,165.0,Posted,-41.61,2024-10-27,165.0,Withdrawal Debit Card MC Debit Seminol/IONOS INC. CHESTERBROOK PADate 12/29/24 0 4364954464 0 4816Card 1231,165.0
10/27/2024,Withdrawal POS #000000929659/SUNOCO 8002212501 4234 SW 20TH AVEGAINESVILLE FLCard 1231,18.89,Posted,123.39,2024-10-27,18.89,Withdrawal POS #000000966158/SUNOCO 8002212501 4234 SW 20TH AVEGAINESVILLE FLCard 2801,18.89
10/26/2024,Withdrawal POS #000000901989/SUNOCO 8002212501 4234 SW 20TH AVEGAINESVILLE FLCard 1231,22.42,Posted,142.28,2024-10-26,22.42,Withdrawal POS #000000966158/SUNOCO 8002212501 4234 SW 20TH AVEGAINESVILLE FLCard 2801,22.130000000000003
10/25/2024,Withdrawal POS #000000776690/INSTACART*159 WWW.INSTACART.COM/ SANFRANCISCO CACard 1231,72.0,Posted,164.7,2024-10-25,72.0,Withdrawal POS #000000772291/INSTACART*159 WWW.INSTACART.COM/ SANFRANCISCO CACard 1231,72.0
10/25/2024,Recurring Withdrawal Debit Card - MC Debit Seminol/FS *ADOBE SANTA BARBAR CADate 10/24/24 0 4298968563 0 5734Card 1231,0.95,Posted,36.7,2024-10-25,0.95,Recurring Withdrawal Debit Card - MC Debit Seminol/FS *ADOBE SANTA BARBAR CADate 12/24/24 0 4359034647 1 5734Card 1231,0.95
10/25/2024,Withdrawal POS #000000850898/SUNOCO 8002212501 4234 SW 20TH AVEGAINESVILLE FLCard 1231,25.96,Posted,37.65,2024-10-25,25.96,Withdrawal POS #000000778591/SUNOCO 8002212501 4234 SW 20TH AVEGAINESVILLE FLCard 1231,25.96
10/24/2024,Withdrawal POS #000000805070/SUNOCO 8002212501 4234 SW 20TH AVEGAINESVILLE FLCard 1231,22.42,Posted,63.61,2024-10-24,22.42,Withdrawal POS #000000235720/SUNOCO 8002212501 4234 SW 20TH AVEGAINESVILLE FLCard 1231,22.42
10/23/2024,Recurring Withdrawal Bill Payment - #000000864701/Netflix.com NETFLIX.COM LOS GATOS CACard 1231,17.84,Posted,86.03,2024-10-23,17.84,Recurring Withdrawal Bill Payment - #000000864701/Netflix.com NETFLIX.COM LOS GATOS CACard 1231,17.84
10/23/2024,Withdrawal POS #000000761115/PUBLIX 3100 SW 35TH BLVD GAINESVILLE FLCard 1231,10.08,Posted,103.87,2024-10-23,10.08,"Withdrawal POS #000000752480/PUBLIX 3100 SW 35TH BLVD GAINESVILLE FL
Card 1247",10.08
10/23/2024,Withdrawal POS #000000570907/SUNOCO 8002212501 4234 SW 20TH AVEGAINESVILLE FLCard 1231,22.42,Posted,113.95,2024-10-23,22.42,Withdrawal POS #000000235720/SUNOCO 8002212501 4234 SW 20TH AVEGAINESVILLE FLCard 1231,22.42
10/22/2024,Withdrawal POS #000000793069/INSTACART*159 WWW.INSTACART.COM/ SANFRANCISCO CACard 1231,55.94,Posted,136.37,2024-10-22,55.94,Withdrawal POS #000000792733/INSTACART*159 WWW.INSTACART.COM/ SANFRANCISCO CACard 1231,55.94
10/21/2024,Recurring Withdrawal Debit Card - MC Debit Seminol/CANVA* I04310-27668476 CAMDEN DEDate 10/20/24 0 4294054048 1 7333Card 1231,12.99,Posted,175.59,2024-10-21,12.99,Recurring Withdrawal Debit Card - MC Debit Seminol/CANVA* I04371-41297102 CAMDEN DEDate 12/20/24 0 4355594081 2 7333Card 1231,12.99
10/21/2024,Withdrawal ACH FLUENT-Gainesvil/TYPE: PAYMENT ID: 1371804719CO: FLUENT-GainesvilNAME: steven chaplinskiEntry Class Code: WEB,35.0,Posted,188.58,2024-10-21,35.0,Withdrawal ACH FLUENT-Gainesvil/TYPE: PAYMENT ID: 1371804719CO: FLUENT-GainesvilNAME: steven chaplinski,34.5
10/20/2024,Recurring Withdrawal Debit Card - MC Debit Seminol/OPENAI SAN FRANCISC CADate 10/18/24 0 4292079345 2 5734Card 1231,15.03,Posted,223.58,2024-10-20,15.03,Withdrawal Debit Card MC Debit Seminol/OPENAI SAN FRANCISC CADate 02/16/24 0 4047896474 1 5734Card 1231,15.026
10/20/2024,Recurring Withdrawal Debit Card Fee/MASTERCARD ISSUER CROSS-BORDER FEEDate 10/18/24 0 4292359683 2 5734Card 1231,0.05,Posted,238.61,2024-10-20,0.05,Recurring Withdrawal Debit Card Fee/MASTERCARD ISSUER CROSS-BORDER FEEDate 06/15/24 0 4167922806 1 5734Card 1231,0.08
10/20/2024,Recurring Withdrawal Debit Card - MC Debit Seminol/SAVE TO NOTION VAUREAL ILDate 10/18/24 0 4292359683 2 5734Card 1231,5.99,Posted,238.66,2024-10-20,5.99,Recurring Withdrawal Debit Card - MC Debit Seminol/SAVE TO NOTION VAUREAL ILDate 12/18/24 0 4353969048 0 5734Card 1231,5.99
10/20/2024,Recurring Withdrawal Debit Card - MC Debit Seminol/MYDESIGNS.IO LAS VEGAS NVDate 10/18/24 0 4292077676 2 5734Card 1231,12.68,Posted,244.65,2024-10-20,12.68,Recurring Withdrawal Debit Card - MC Debit Seminol/MYDESIGNS.IO LAS VEGAS NVDate 10/18/24 0 4292077676 2 5734Card 1231,12.68
10/20/2024,Recurring Withdrawal Debit Card Fee/MASTERCARD ISSUER CROSS-BORDER FEEDate 10/19/24 0 4293358426 2 5817Card 1231,0.01,Posted,257.33,2024-10-20,0.01,Recurring Withdrawal Debit Card Fee/MASTERCARD ISSUER CROSS-BORDER FEEDate 02/25/24 0 4056812425 0 4816Card 1231,0.04
10/20/2024,Recurring Withdrawal Debit Card - MC Debit Seminol/CAPCUT SINGAPORE SGDate 10/19/24 0 4293358426 2 5817Card 1231,0.99,Posted,257.34,2024-10-20,0.99,Recurring Withdrawal Debit Card - MC Debit Seminol/CAPCUT SINGAPORE SGDate 10/19/24 0 4293358426 2 5817Card 1231,0.99
10/18/2024,Withdrawal POS #000000500838/SUNOCO 8002212501 4234 SW 20TH AVEGAINESVILLE FLCard 1231,37.78,Posted,258.33,2024-10-18,37.78,Withdrawal POS #000000504303/SUNOCO 8002212501 4234 SW 20TH AVEGAINESVILLE FLCard 1231,37.78
10/18/2024,Recurring Withdrawal Debit Card - MC Debit Seminol/AMAZON PRIME*ZZ8XZ1T22 AMZN.COM/BIL WADate 10/17/24 0 4291354760 0 5968Card 1231,15.11,Posted,296.11,2024-10-18,15.11,Recurring Withdrawal Debit Card - MC Debit Seminol/AMAZON PRIME*Z97W01ZG2 AMZN.COM/BIL WADate 12/17/24 0 4352950216 0 5968Card 1231,15.120000000000001
10/17/2024,Withdrawal POS #000000514838/SUNOCO 8002212501 4234 SW 20TH AVEGAINESVILLE FLCard 1231,22.42,Posted,71.22,2024-10-17,22.42,Withdrawal POS #000000488663/SUNOCO 8002212501 4234 SW 20TH AVEGAINESVILLE FLCard 1231,22.42
10/17/2024,Recurring Withdrawal Debit Card - MC Debit Seminol/SUPERPOWER CHATGPT MIDDLETOWN DEDate 10/17/24 0 4291148991 1 5734Card 1231,15.0,Posted,93.64,2024-10-17,15.0,Recurring Withdrawal Debit Card - MC Debit Seminol/SUPERPOWER CHATGPT MIDDLETOWN DEDate 12/17/24 0 4352703539 1 5734Card 1231,15.0
10/17/2024,Recurring Withdrawal Debit Card - MC Debit Seminol/PADDLE.NET* LEONARDOAI ASTORIA NYDate 10/16/24 0 4290347897 0 5817Card 1231,9.0,Posted,108.64,2024-10-17,9.0,Recurring Withdrawal Debit Card - MC Debit Seminol/PADDLE.NET* LEONARDOAI ASTORIA NYDate 12/16/24 0 4351323834 0 5817Card 1231,9.0
10/17/2024,Recurring Withdrawal Debit Card - MC Debit Seminol/PADDLE.NET* SETAPP ASTORIA NYDate 10/16/24 0 4290896850 0 5817Card 1231,12.49,Posted,117.64,2024-10-17,12.49,Recurring Withdrawal Debit Card - MC Debit Seminol/PADDLE.NET* SETAPP NEW YORK NYDate 10/14/24 0 4288882561 0 5817Card 1231,12.49
10/17/2024,Recurring Withdrawal Debit Card Fee/MASTERCARD ISSUER CROSS-BORDER FEEDate 10/17/24 0 4291146721 1 5734Card 1231,0.06,Posted,130.13,2024-10-17,0.06,Recurring Withdrawal Debit Card Fee/MASTERCARD ISSUER CROSS-BORDER FEEDate 12/31/23 0 3365740203 0 5734Card 2801,0.10500000000000001
10/17/2024,Recurring Withdrawal Debit Card - MC Debit Seminol/IDEOGRAM AI TORONTO ONDate 10/17/24 0 4291146721 1 5734Card 1231,8.0,Posted,130.19,2024-10-17,8.0,Recurring Withdrawal Debit Card - MC Debit Seminol/IDEOGRAM AI TORONTO ONDate 12/17/24 0 4352700468 1 5734Card 1231,8.0
10/16/2024,"Recurring Withdrawal Debit Card - MC Debit Seminol/NOTION LABS, INC. SAN FRANCISC CADate 10/15/24 0 4289885767 0 7372Card 1231",10.0,Posted,138.19,2024-10-16,10.0,"Recurring Withdrawal Debit Card - MC Debit Seminol/NOTION LABS, INC. SAN FRANCISC CADate 12/02/24 0 4337878572 0 7372Card 1231",10.0
10/16/2024,Recurring Withdrawal Debit Card - MC Debit Seminol/RUNWAY STANDARD PLAN NEWARK DEDate 10/15/24 0 4289885711 0 5734Card 1231,15.0,Posted,148.19,2024-10-16,15.0,Recurring Withdrawal Debit Card - MC Debit Seminol/RUNWAY STANDARD PLAN NEWARK DEDate 12/15/24 0 4350745942 1 5734Card 1231,15.0
10/16/2024,Withdrawal POS #000000796464/INSTACART*159 WWW.INSTACART.COM/ SANFRANCISCO CACard 1231,60.0,Posted,163.19,2024-10-16,60.0,Withdrawal POS #000000772291/INSTACART*159 WWW.INSTACART.COM/ SANFRANCISCO CACard 1231,60.0
10/16/2024,Withdrawal POS #000000388399/SUNOCO 8002212501 4234 SW 20TH AVEGAINESVILLE FLCard 1231,32.42,Posted,223.19,2024-10-16,32.42,Withdrawal POS #000000488663/SUNOCO 8002212501 4234 SW 20TH AVEGAINESVILLE FLCard 1231,32.42
10/15/2024,Recurring Withdrawal Debit Card - MC Debit Seminol/PADDLE.NET* SETAPP NEW YORK NYDate 10/14/24 0 4288882561 0 5817Card 1231,9.99,Posted,254.39,2024-10-15,9.99,Recurring Withdrawal Debit Card - MC Debit Seminol/PADDLE.NET* SETAPP NEW YORK NYDate 10/14/24 0 4288882561 0 5817Card 1231,9.495000000000001
10/14/2024,Recurring Withdrawal Debit Card - MC Debit Seminol/D-ID STUDIO WILMINGTON DEDate 10/13/24 0 4287011811 1 7399Card 1231,5.9,Posted,264.38,2024-10-14,5.9,Recurring Withdrawal Debit Card - MC Debit Seminol/D-ID STUDIO WILMINGTON DEDate 10/13/24 0 4287011811 1 7399Card 1231,5.9
10/11/2024,Withdrawal POS #000000219736/SUNOCO 8002212501 4234 SW 20TH AVEGAINESVILLE FLCard 1231,34.24,Posted,270.28,2024-10-11,34.24,Withdrawal POS #000000221295/SUNOCO 8002212501 4234 SW 20TH AVEGAINESVILLE FLCard 1231,34.24
10/11/2024,Recurring Withdrawal Debit Card Fee/MASTERCARD ISSUER CROSS-BORDER FEEDate 10/11/24 0 4285915368 0 5817Card 1231,0.08,Posted,304.52,2024-10-11,0.08,Recurring Withdrawal Debit Card Fee/MASTERCARD ISSUER CROSS-BORDER FEEDate 01/06/24 0 4006875269 0 5815Card 2801,0.20272727272727267
10/11/2024,Recurring Withdrawal Debit Card - MC Debit Seminol/CAPCUT SINGAPORE SGDate 10/11/24 0 4285915368 0 5817Card 1231,9.99,Posted,304.6,2024-10-11,9.99,Recurring Withdrawal Debit Card - MC Debit Seminol/ETSYHUNT TECH SINGAPORE SGDate 06/14/24 0 4166958438 0 5734Card 1231,9.99
10/11/2024,Withdrawal Debit Card MC Debit Seminol/AMAZON PRIME*NL5H74FI3 AMZN.COM/BIL WADate 10/11/24 0 4285071195 1 5818Card 1231,3.4,Posted,314.59,2024-10-11,3.4,Withdrawal Debit Card MC Debit Seminol/AMAZON PRIME*XS2HD1WH3 AMZN.COM/BIL WADate 09/11/24 0 4255908162 0 5818Card 1231,3.4
10/11/2024,Withdrawal ACH VENMO/TYPE: PAYMENT ID: 3264681992 CO: VENMONAME: AVATAR ARTSEntry Class Code: WEB,14.99,Posted,317.99,2024-10-11,14.99,Withdrawal ACH VENMO/TYPE: PAYMENT ID: 3264681992 CO: VENMONAME: AVATAR ARTSEntry Class Code: WEB,14.99
10/10/2024,Withdrawal ACH VENMO/TYPE: PAYMENT ID: 3264681992 CO: VENMONAME: AVATAR ARTSEntry Class Code: WEB,9.99,Posted,332.98,2024-10-10,9.99,Withdrawal ACH VENMO/TYPE: PAYMENT ID: 3264681992 CO: VENMONAME: AVATAR ARTSEntry Class Code: WEB,9.99
10/9/2024,Withdrawal POS #000000110496/SUNOCO 8002212501 4234 SW 20TH AVEGAINESVILLE FLCard 1231,37.78,Posted,342.97,2024-10-09,37.78,Withdrawal POS #000000031004/SUNOCO 8002212501 4234 SW 20TH AVEGAINESVILLE FLCard 1231,37.78
10/9/2024,Recurring Withdrawal Debit Card - MC Debit Seminol/INVIDEO INC COUNTRY OF S DEDate 10/09/24 0 4283111145 1 5734Card 1231,60.0,Posted,380.75,2024-10-09,60.0,Recurring Withdrawal Debit Card - MC Debit Seminol/INVIDEO INC COUNTRY OF S DEDate 12/09/24 0 4344808122 0 5734Card 1231,60.0
10/9/2024,Recurring Withdrawal Debit Card - MC Debit Seminol/MYDESIGNS - PRO - MON LAS VEGAS NVDate 10/09/24 0 4283929863 0 5734Card 1231,29.99,Posted,440.75,2024-10-09,29.99,Recurring Withdrawal Debit Card - MC Debit Seminol/MYDESIGNS.IO LAS VEGAS NVDate 10/18/24 0 4292077676 2 5734Card 1231,29.99
10/9/2024,Withdrawal Debit Card MC Debit Seminol/CIRCLE K # 06782 GAINESVILLE FLDate 10/07/24 0 4281924124 0 5499Card 1231,33.08,Posted,470.74,2024-10-09,33.08,Withdrawal Debit Card MC Debit Seminol/CIRCLE K # 06782 GAINESVILLE FLDate 09/08/24 0 4252889868 0 5499Card 1231,33.08
10/9/2024,Recurring Withdrawal Debit Card - MC Debit Seminol/APPLE.COM/BILL 866-712-7753 CADate 10/08/24 0 4282739947 0 5818Card 1231,2.99,Posted,503.82,2024-10-09,2.99,Recurring Withdrawal Debit Card - MC Debit Seminol/APPLE.COM/BILL 866-712-7753 CADate 01/08/24 0 4008756344 0 5818Card 2801,2.99
10/9/2024,Withdrawal ACH FLUENT-Gainesvil/TYPE: PAYMENT ID: 1371804719CO: FLUENT-GainesvilNAME: steven chaplinskiEntry Class Code: WEB,33.0,Posted,506.81,2024-10-09,33.0,Withdrawal ACH FLUENT-Gainesvil/TYPE: PAYMENT ID: 1371804719CO: FLUENT-GainesvilNAME: steven chaplinski,32.5
10/9/2024,Withdrawal POS #000020628140/GOOGLE *YouTubePremium 1600 AmphitheatreParkw Mountain View CACard 1231,9.1,Posted,539.81,2024-10-09,9.1,"Withdrawal POS #000020312090/GOOGLE *YouTubePremium 1600 Amphitheatre
Parkw Mountain View CA
Card 1247",9.1
10/7/2024,Recurring Withdrawal Debit Card - MC Debit Seminol/TUBEBUDDYCOM* 8668823239 CADate 10/07/24 0 4281084817 2 5734Card 1231,7.5,Posted,548.91,2024-10-07,7.5,Recurring Withdrawal Debit Card - MC Debit Seminol/TUBEBUDDYCOM* 8668823239 CADate 12/03/24 0 4338443995 0 5045Card 1231,7.5
10/7/2024,Withdrawal Debit Card MC Debit Seminol/SAMSUNG ELECTRONICS RIDGEFIELD P NJDate 10/06/24 0 4280082073 2 5734Card 1231,16.99,Posted,556.41,2024-10-07,16.99,Withdrawal Debit Card MC Debit Seminol/SAMSUNG ELECTRONICS RIDGEFIELD P NJDate 12/27/24 0 4362999827 1 5734Card 1231,16.99
10/7/2024,Withdrawal Debit Card MC Debit Seminol/CIRCLE K # 06782 GAINESVILLE FLDate 10/05/24 0 4279070275 2 5499Card 1231,33.08,Posted,573.4,2024-10-07,33.08,Withdrawal Debit Card MC Debit Seminol/CIRCLE K # 06782 GAINESVILLE FLDate 09/08/24 0 4252889868 0 5499Card 1231,33.08
10/7/2024,Withdrawal Debit Card MC Debit Seminol/GRU/EZ-PAY WEB PYMT 352-334-3434 FLDate 10/06/24 0 4280069927 2 4900Card 1231,179.69,Posted,606.48,2024-10-07,179.69,Withdrawal Debit Card MC Debit Seminol/GRU/EZ-PAY WEB PYMT 352-334-3434 FLDate 12/05/24 0 4340279271 0 4900Card 1231,179.69
10/6/2024,Recurring Withdrawal Debit Card - MC Debit Seminol/OPENAI *CHATGPT SUBSCR SAN FRANCISC CADate 10/05/24 0 4279609183 4 5734Card 1231,20.0,Posted,786.17,2024-10-06,20.0,Recurring Withdrawal Debit Card - MC Debit Seminol/OPENAI *CHATGPT SUBSCR SAN FRANCISC CADate 12/04/24 0 4339869196 0 5734Card 1231,20.0
10/6/2024,Withdrawal Debit Card MC Debit Seminol/IONOS INC. CHESTERBROOK PADate 10/05/24 0 4279888536 2 4816Card 1231,16.0,Posted,806.17,2024-10-06,16.0,Withdrawal Debit Card MC Debit Seminol/IONOS INC. CHESTERBROOK PADate 12/29/24 0 4364954464 0 4816Card 1231,16.0
10/6/2024,Withdrawal Debit Card MC Debit Seminol/WALGREENS #5024 GAINESVILLE FLDate 10/05/24 0 4279879417 2 5912Card 1231,15.0,Posted,822.17,2024-10-06,15.0,Withdrawal Debit Card MC Debit Seminol/WALGREENS #9304 GAINESVILLE FLDate 10/30/24 0 4304125853 1 5912Card 1231,15.0
10/6/2024,Withdrawal Debit Card MC Debit Seminol/COX GAINESVILLE COMM 800-234-3993 FLDate 10/05/24 0 4279871365 2 4899Card 1231,156.13,Posted,837.17,2024-10-06,156.13,Withdrawal Debit Card MC Debit Seminol/COX GAINESVILLE COMM 800-234-3993 FLDate 12/04/24 0 4339376311 0 4899Card 1231,156.13
10/6/2024,Withdrawal POS #000000592618/AMAZON.COM*PF74M5SG3 SEATTLE WACard 1231,10.74,Posted,993.3,2024-10-06,10.74,Withdrawal POS #000000592618/AMAZON.COM*PF74M5SG3 SEATTLE WACard 1231,10.74
10/4/2024,Recurring Withdrawal Debit Card Fee/MASTERCARD ISSUER CROSS-BORDER FEEDate 10/03/24 0 4277044624 1 7399Card 1231,0.47,Posted,1004.04,2024-10-04,0.47,Recurring Withdrawal Debit Card Fee/MASTERCARD ISSUER CROSS-BORDER FEEDate 12/17/24 0 4352700468 1 5734Card 1231,0.47
10/4/2024,Recurring Withdrawal Debit Card - MC Debit Seminol/CREATIVE FABRICA AMSTERDAM NHDate 10/03/24 0 4277044624 1 7399Card 1231,59.16,Posted,1004.51,2024-10-04,59.16,Recurring Withdrawal Debit Card - MC Debit Seminol/CREATIVE FABRICA AMSTERDAM NHDate 10/03/24 0 4277044624 1 7399Card 1231,59.16
10/4/2024,Recurring Withdrawal Debit Card - MC Debit Seminol/APPLE.COM/BILL 866-712-7753 CADate 10/03/24 0 4277938820 0 5818Card 1231,2.99,Posted,1063.67,2024-10-04,2.99,Recurring Withdrawal Debit Card - MC Debit Seminol/APPLE.COM/BILL 866-712-7753 CADate 01/08/24 0 4008756344 0 5818Card 2801,2.99
10/4/2024,Withdrawal POS #000000784928/AMAZON.COM*NG4MN0L33 SEATTLE WACard 1231,32.84,Posted,1066.66,2024-10-04,32.84,Withdrawal POS #000000049785/AMAZON.COM*AV5RE3583 SEATTLE WACard 1231,32.84
10/3/2024,Withdrawal POS #000000757832/SUNOCO 8002212501 4234 SW 20TH AVEGAINESVILLE FLCard 1231,46.35,Posted,1099.5,2024-10-03,46.35,Withdrawal POS #000000778591/SUNOCO 8002212501 4234 SW 20TH AVEGAINESVILLE FLCard 1231,46.35
10/3/2024,Withdrawal Debit Card MC Debit Seminol/IONOS INC. CHESTERBROOK PADate 10/02/24 0 4276189742 1 4816Card 1231,1.0,Posted,1145.85,2024-10-03,1.0,Withdrawal Debit Card MC Debit Seminol/IONOS INC. CHESTERBROOK PADate 12/29/24 0 4364954464 0 4816Card 1231,0.8400000000000001
10/3/2024,"Withdrawal Bill Payment #000000776300/Adobe Park Avenue,345 San Jose CACard 1231",19.99,Posted,1146.85,2024-10-03,19.99,"Withdrawal Bill Payment #000000352498/Adobe Park Avenue,345 San Jose CACard 1247",19.99
10/3/2024,Withdrawal POS #000000772291/INSTACART*159 WWW.INSTACART.COM/ SANFRANCISCO CACard 1231,97.44,Posted,1166.84,2024-10-03,97.44,Withdrawal POS #000000804821/INSTACART*159 WWW.INSTACART.COM/ SANFRANCISCO CACard 1231,97.44
10/2/2024,Recurring Withdrawal Debit Card - MC Debit Seminol/DISNEY PLUS 8889057888 CADate 10/02/24 0 4276239357 1 4899Card 1231,16.11,Posted,1264.28,2024-10-02,16.11,Recurring Withdrawal Debit Card - MC Debit Seminol/DISNEY PLUS 8889057888 CADate 10/02/24 0 4276239357 1 4899Card 1231,16.11
10/2/2024,Withdrawal ACH Watson Realty Co/TYPE: WEB PMTS ID: 9000321157CO: Watson Realty CoNAME: Steven chaplinskiEntry Class Code: WEB,1179.0,Posted,1280.39,2024-10-02,1179.0,"Withdrawal ACH Watson Realty Co/TYPE: WEB PMTS ID: 9000321157
CO: Watson Realty Co
NAME: Steven chaplinskiEntry Class Code: WEB",1179.0
10/2/2024,"Withdrawal ACH AppFolio, Inc. F/TYPE: WEB PMTS ID: 9001406550CO: AppFolio, Inc. FNAME: Steven chaplinskiEntry Class Code: WEB",2.49,Posted,2459.39,2024-10-02,2.49,"Withdrawal ACH AppFolio, Inc. F/TYPE: WEB PMTS ID: 9001406550
CO: AppFolio, Inc. F
NAME: Steven chaplinskiEntry Class Code: WEB",2.49
10/1/2024,Withdrawal POS #000000680755/SUNOCO 8002212501 4234 SW 20TH AVEGAINESVILLE FLCard 1231,34.24,Posted,2461.88,2024-10-01,34.24,Withdrawal POS #000000680755/SUNOCO 8002212501 4234 SW 20TH AVEGAINESVILLE FLCard 1231,34.24
10/1/2024,Withdrawal Debit Card MC Debit Seminol/WALGREENS #9304 GAINESVILLE FLDate 09/30/24 0 4274152821 1 5912Card 1231,10.81,Posted,2496.12,2024-10-01,10.81,Withdrawal Debit Card MC Debit Seminol/WALGREENS #9304 GAINESVILLE FLDate 10/30/24 0 4304125853 1 5912Card 1231,10.81
9/30/2024,Withdrawal POS #000000000001/INSTACART*159 WWW.INSTACART.COM/ SANFRANCISCO CACard 1231,67.0,Posted,2506.93,2024-09-30,67.0,Withdrawal POS #000000804821/INSTACART*159 WWW.INSTACART.COM/ SANFRANCISCO CACard 1231,67.0
9/30/2024,Withdrawal POS #000000604407/SUNOCO 8002212501 4234 SW 20TH AVEGAINESVILLE FLCard 1231,34.24,Posted,2573.93,2024-09-30,34.24,Withdrawal POS #000000680755/SUNOCO 8002212501 4234 SW 20TH AVEGAINESVILLE FLCard 1231,34.24
9/30/2024,Withdrawal POS #000000741900/PUBLIX 3100 SW 35TH BLVD GAINESVILLE FLCard 1231,32.09,Posted,2608.17,2024-09-30,32.09,"Withdrawal POS #000000752480/PUBLIX 3100 SW 35TH BLVD GAINESVILLE FL
Card 1247",32.09
9/30/2024,Withdrawal ACH FLUENT-Gainesvil/TYPE: PAYMENT ID: 1371804719CO: FLUENT-GainesvilNAME: steven chaplinskiEntry Class Code: WEB,56.39,Posted,2640.26,2024-09-30,56.39,Withdrawal ACH FLUENT-Gainesvil/TYPE: PAYMENT ID: 1371804719CO: FLUENT-GainesvilNAME: steven chaplinski,56.39
9/29/2024,Recurring Withdrawal Debit Card - MC Debit Seminol/IC* INSTACART*SUBSCRIP SAN FRANCISC CADate 09/28/24 0 4272959868 0 5411Card 1231,9.99,Posted,2696.65,2024-09-29,9.99,Recurring Withdrawal Debit Card - MC Debit Seminol/IC* INSTACART*SUBSCRIP SAN FRANCISC CADate 11/30/24 0 4335692546 1 5411Card 1231,9.99
9/29/2024,Withdrawal Debit Card MC Debit Seminol/INSTACART*159 SAN FRANCISC CADate 09/28/24 0 4272170453 2 5411Card 1231,75.38,Posted,2706.64,2024-09-29,75.38,Withdrawal Debit Card MC Debit Seminol/INSTACART*159 SAN FRANCISC CADate 12/24/24 0 4359294650 0 5411Card 1231,75.38
9/29/2024,Withdrawal Debit Card MC Debit Seminol/SAMSUNG ELECTRONICS RIDGEFIELD P NJDate 09/27/24 0 4271170159 2 5734Card 1231,8.99,Posted,2782.02,2024-09-29,8.99,Withdrawal Debit Card MC Debit Seminol/SAMSUNG ELECTRONICS RIDGEFIELD P NJDate 12/27/24 0 4362999827 1 5734Card 1231,8.99
9/28/2024,Withdrawal POS #000000527167/SUNOCO 8002212501 4234 SW 20TH AVEGAINESVILLE FLCard 1231,30.7,Posted,2791.01,2024-09-28,30.7,Withdrawal POS #000000555763/SUNOCO 8002212501 4234 SW 20TH AVEGAINESVILLE FLCard 1231,30.7
9/26/2024,Withdrawal Debit Card MC Debit Seminol/CIRCLE K # 06782 GAINESVILLE FLDate 09/24/24 0 4268492649 1 5499Card 1231,18.34,Posted,21.71,2024-09-26,18.34,Withdrawal Debit Card MC Debit Seminol/CIRCLE K # 06782 GAINESVILLE FLDate 09/08/24 0 4252889868 0 5499Card 1231,18.505000000000003
9/26/2024,Withdrawal POS #000000408760/SUNOCO 8002212501 4234 SW 20TH AVEGAINESVILLE FLCard 1231,18.89,Posted,40.05,2024-09-26,18.89,Withdrawal POS #000000488663/SUNOCO 8002212501 4234 SW 20TH AVEGAINESVILLE FLCard 1231,18.89
9/25/2024,Recurring Withdrawal Debit Card - MC Debit Seminol/FS *ADOBE SANTA BARBAR CADate 09/24/24 0 4268906697 0 5734Card 1231,0.95,Posted,58.94,2024-09-25,0.95,Recurring Withdrawal Debit Card - MC Debit Seminol/FS *ADOBE SANTA BARBAR CADate 12/24/24 0 4359034647 1 5734Card 1231,0.95
9/25/2024,Withdrawal POS #000000395026/SUNOCO 8002212501 4234 SW 20TH AVEGAINESVILLE FLCard 1231,22.42,Posted,59.89,2024-09-25,22.42,Withdrawal POS #000000235720/SUNOCO 8002212501 4234 SW 20TH AVEGAINESVILLE FLCard 1231,22.42
9/23/2024,Withdrawal POS #000000786299/INSTACART*159 WWW.INSTACART.COM/ SANFRANCISCO CACard 1231,84.0,Posted,77.44,2024-09-23,84.0,Withdrawal POS #000000804821/INSTACART*159 WWW.INSTACART.COM/ SANFRANCISCO CACard 1231,84.0
9/23/2024,Recurring Withdrawal Bill Payment - #000000980999/Netflix.com NETFLIX.COM LOS GATOS CACard 1231,17.84,Posted,11.44,2024-09-23,17.84,Recurring Withdrawal Bill Payment - #000000864701/Netflix.com NETFLIX.COM LOS GATOS CACard 1231,17.84
9/22/2024,Recurring Withdrawal Debit Card - MC Debit Seminol/CANVA* I04280-41401823 CAMDEN DEDate 09/20/24 0 4264118913 2 7333Card 1231,12.99,Posted,29.28,2024-09-22,12.99,Recurring Withdrawal Debit Card - MC Debit Seminol/CANVA* I04371-41297102 CAMDEN DEDate 12/20/24 0 4355594081 2 7333Card 1231,12.99
9/22/2024,Withdrawal POS #000000764249/PUBLIX 3100 SW 35TH BLVD GAINESVILLE FLCard 1231,10.08,Posted,42.27,2024-09-22,10.08,"Withdrawal POS #000000752480/PUBLIX 3100 SW 35TH BLVD GAINESVILLE FL
Card 1247",10.08
9/22/2024,Withdrawal POS #000000745864/PUBLIX 3930 SW ARCHER ROAD GAINESVILLECard 1231,26.02,Posted,52.35,2024-09-22,26.02,Withdrawal POS #000000753028/PUBLIX 3930 SW ARCHER ROAD GAINESVILLECard 1247,26.02
9/20/2024,Withdrawal POS #000000161599/SUNOCO 8002212501 4234 SW 20TH AVEGAINESVILLE FLCard 1231,34.24,Posted,78.37,2024-09-20,34.24,Withdrawal POS #000000966158/SUNOCO 8002212501 4234 SW 20TH AVEGAINESVILLE FLCard 2801,34.400000000000006
9/19/2024,Withdrawal POS #000000794971/INSTACART*159 WWW.INSTACART.COM/ SANFRANCISCO CACard 1231,41.52,Posted,112.61,2024-09-19,41.52,Withdrawal POS #000000804821/INSTACART*159 WWW.INSTACART.COM/ SANFRANCISCO CACard 1231,41.52
9/19/2024,Recurring Withdrawal Debit Card Fee/MASTERCARD ISSUER CROSS-BORDER FEEDate 09/18/24 0 4262900658 0 5734Card 1231,0.05,Posted,154.13,2024-09-19,0.05,Recurring Withdrawal Debit Card Fee/MASTERCARD ISSUER CROSS-BORDER FEEDate 12/31/23 0 3365740203 0 5734Card 2801,0.10500000000000001
9/19/2024,Recurring Withdrawal Debit Card - MC Debit Seminol/SAVE TO NOTION VAUREAL ILDate 09/18/24 0 4262900658 0 5734Card 1231,5.99,Posted,154.18,2024-09-19,5.99,Recurring Withdrawal Debit Card - MC Debit Seminol/SAVE TO NOTION VAUREAL ILDate 12/18/24 0 4353969048 0 5734Card 1231,5.99
9/18/2024,Recurring Withdrawal Debit Card - MC Debit Seminol/AMAZON PRIME*DG9S32713 AMZN.COM/BIL WADate 09/17/24 0 4261881793 0 5968Card 1231,15.11,Posted,160.17,2024-09-18,15.11,Recurring Withdrawal Debit Card - MC Debit Seminol/AMAZON PRIME*Z97W01ZG2 AMZN.COM/BIL WADate 12/17/24 0 4352950216 0 5968Card 1231,15.120000000000001
9/17/2024,Withdrawal POS #000000794677/INSTACART*159 WWW.INSTACART.COM/ SANFRANCISCO CACard 1231,50.0,Posted,175.28,2024-09-17,50.0,Withdrawal POS #000000792733/INSTACART*159 WWW.INSTACART.COM/ SANFRANCISCO CACard 1231,50.0
9/17/2024,Withdrawal POS #000000607925/AMAZON.COM*796MW6TO3 SEATTLE WACard 1231,12.85,Posted,225.28,2024-09-17,12.85,Withdrawal POS #000000592618/AMAZON.COM*PF74M5SG3 SEATTLE WACard 1231,12.85
9/17/2024,Recurring Withdrawal Debit Card - MC Debit Seminol/SUPERPOWER CHATGPT MIDDLETOWN DEDate 09/17/24 0 4261105994 1 5734Card 1231,15.0,Posted,238.13,2024-09-17,15.0,Recurring Withdrawal Debit Card - MC Debit Seminol/SUPERPOWER CHATGPT MIDDLETOWN DEDate 12/17/24 0 4352703539 1 5734Card 1231,15.0
9/17/2024,Recurring Withdrawal Debit Card - MC Debit Seminol/PADDLE.NET* LEONARDOAI ASTORIA NYDate 09/16/24 0 4260359414 0 5817Card 1231,9.0,Posted,253.13,2024-09-17,9.0,Recurring Withdrawal Debit Card - MC Debit Seminol/PADDLE.NET* LEONARDOAI ASTORIA NYDate 12/16/24 0 4351323834 0 5817Card 1231,9.0
9/17/2024,Recurring Withdrawal Debit Card - MC Debit Seminol/PADDLE.NET* SETAPP ASTORIA NYDate 09/16/24 0 4260853114 0 5817Card 1231,12.49,Posted,262.13,2024-09-17,12.49,Recurring Withdrawal Debit Card - MC Debit Seminol/PADDLE.NET* SETAPP NEW YORK NYDate 10/14/24 0 4288882561 0 5817Card 1231,12.49
9/17/2024,Recurring Withdrawal Debit Card Fee/MASTERCARD ISSUER CROSS-BORDER FEEDate 09/17/24 0 4261103470 1 5734Card 1231,0.06,Posted,274.62,2024-09-17,0.06,Recurring Withdrawal Debit Card Fee/MASTERCARD ISSUER CROSS-BORDER FEEDate 06/15/24 0 4167922806 1 5734Card 1231,0.08
9/17/2024,Recurring Withdrawal Debit Card - MC Debit Seminol/IDEOGRAM AI TORONTO ONDate 09/17/24 0 4261103470 1 5734Card 1231,8.0,Posted,274.68,2024-09-17,8.0,Recurring Withdrawal Debit Card - MC Debit Seminol/IDEOGRAM AI TORONTO ONDate 12/17/24 0 4352700468 1 5734Card 1231,8.0
9/17/2024,Withdrawal POS #000000029377/SUNOCO 8002212501 4234 SW 20TH AVEGAINESVILLE FLCard 1231,34.24,Posted,282.68,2024-09-17,34.24,Withdrawal POS #000000235720/SUNOCO 8002212501 4234 SW 20TH AVEGAINESVILLE FLCard 1231,34.24
9/16/2024,"Recurring Withdrawal Debit Card - MC Debit Seminol/NOTION LABS, INC. SAN FRANCISC CADate 09/15/24 0 4259305128 0 7372Card 1231",10.0,Posted,239.64,2024-09-16,10.0,"Recurring Withdrawal Debit Card - MC Debit Seminol/NOTION LABS, INC. SAN FRANCISC CADate 12/02/24 0 4337878572 0 7372Card 1231",10.0
9/16/2024,Recurring Withdrawal Debit Card - MC Debit Seminol/RUNWAY STANDARD PLAN NEWARK DEDate 09/15/24 0 4259010239 1 5734Card 1231,15.0,Posted,249.64,2024-09-16,15.0,Recurring Withdrawal Debit Card - MC Debit Seminol/RUNWAY STANDARD PLAN NEWARK DEDate 12/15/24 0 4350745942 1 5734Card 1231,15.0
9/16/2024,Withdrawal ACH FLUENT-Gainesvil/TYPE: PAYMENT ID: 1371804719CO: FLUENT-GainesvilNAME: steven chaplinskiEntry Class Code: WEB,30.0,Posted,264.64,2024-09-16,30.0,Withdrawal ACH FLUENT-Gainesvil/TYPE: PAYMENT ID: 1371804719CO: FLUENT-GainesvilNAME: steven chaplinski,30.0
9/15/2024,Recurring Withdrawal Debit Card - MC Debit Seminol/PADDLE.NET* SETAPP NEW YORK NYDate 09/14/24 0 4258038199 1 5817Card 1231,9.99,Posted,294.64,2024-09-15,9.99,Recurring Withdrawal Debit Card - MC Debit Seminol/PADDLE.NET* SETAPP NEW YORK NYDate 10/14/24 0 4288882561 0 5817Card 1231,9.495000000000001
9/15/2024,Recurring Withdrawal Debit Card - MC Debit Seminol/D-ID STUDIO WILMINGTON DEDate 09/13/24 0 4257121975 2 7399Card 1231,2.95,Posted,304.63,2024-09-15,2.95,Recurring Withdrawal Debit Card - MC Debit Seminol/D-ID STUDIO WILMINGTON DEDate 10/13/24 0 4287011811 1 7399Card 1231,2.95
9/15/2024,Withdrawal Debit Card MC Debit Seminol/CIRCLE K # 26146 GAINESVILLE FLDate 09/12/24 0 4256143852 2 5499Card 1231,29.33,Posted,307.58,2024-09-15,29.33,Withdrawal Debit Card MC Debit Seminol/CIRCLE K # 06782 GAINESVILLE FLDate 09/08/24 0 4252889868 0 5499Card 1231,29.083333333333332
9/13/2024,Withdrawal Debit Card MC Debit Seminol/WAWA 5325 GAINESVILLE FLDate 09/12/24 0 4256163151 1 5541Card 1231,20.87,Posted,336.91,2024-09-13,20.87,Withdrawal Debit Card MC Debit Seminol/WAWA 5325 GAINESVILLE FLDate 12/28/24 0 4363858796 0 5541Card 1231,20.87
9/12/2024,Withdrawal POS #000000745537/PUBLIX 3100 SW 35TH BLVD GAINESVILLE FLCard 1231,23.93,Posted,357.78,2024-09-12,23.93,"Withdrawal POS #000000752480/PUBLIX 3100 SW 35TH BLVD GAINESVILLE FL
Card 1247",23.93
9/12/2024,Withdrawal POS #000000000009/AMAZON.COM*139PT8J63 SEATTLE WACard 1231,14.91,Posted,381.71,2024-09-12,14.91,Withdrawal POS #000000000001/AMAZON.COM*TK5HF56S1 SEATTLE WACard 2801,14.91
9/12/2024,Withdrawal Debit Card MC Debit Seminol/CAPCUT WILMINGTON DEDate 09/11/24 0 4255891362 0 5734Card 1231,0.99,Posted,396.62,2024-09-12,0.99,Recurring Withdrawal Debit Card - MC Debit Seminol/CAPCUT WILMINGTON DEDate 11/11/24 0 4316889558 0 5734Card 1231,0.99
9/12/2024,Recurring Withdrawal Debit Card - MC Debit Seminol/MYDESIGNS.IO LAS VEGAS NVDate 09/12/24 0 4256961595 0 5734Card 1231,57.29,Posted,397.61,2024-09-12,57.29,Recurring Withdrawal Debit Card - MC Debit Seminol/MYDESIGNS.IO LAS VEGAS NVDate 10/18/24 0 4292077676 2 5734Card 1231,57.29
9/12/2024,Recurring Withdrawal Debit Card Fee/MASTERCARD ISSUER CROSS-BORDER FEEDate 09/12/24 0 4256890128 0 5817Card 1231,0.08,Posted,454.9,2024-09-12,0.08,Recurring Withdrawal Debit Card Fee/MASTERCARD ISSUER CROSS-BORDER FEEDate 01/06/24 0 4006875269 0 5815Card 2801,0.20272727272727267
9/12/2024,Recurring Withdrawal Debit Card - MC Debit Seminol/CAPCUT SINGAPORE SGDate 09/12/24 0 4256890128 0 5817Card 1231,9.99,Posted,454.98,2024-09-12,9.99,Recurring Withdrawal Debit Card - MC Debit Seminol/CAPCUT SINGAPORE SGDate 10/19/24 0 4293358426 2 5817Card 1231,9.99
9/12/2024,Withdrawal POS #000000651483/AMAZON.COM*I55DY6IV3 SEATTLE WACard 1231,19.12,Posted,464.97,2024-09-12,19.12,Withdrawal POS #000000049785/AMAZON.COM*AV5RE3583 SEATTLE WACard 1231,19.12
9/11/2024,Recurring Withdrawal Debit Card - MC Debit Seminol/AIRTABLE.COM/BILL SAN FRANCISC CADate 09/11/24 0 4255913774 0 7372Card 1231,31.0,Posted,484.09,2024-09-11,31.0,Recurring Withdrawal Debit Card - MC Debit Seminol/AIRTABLE.COM/BILL SAN FRANCISC CADate 09/11/24 0 4255913774 0 7372Card 1231,31.0
9/11/2024,Withdrawal Debit Card MC Debit Seminol/INSTACART*159 SAN FRANCISC CADate 09/10/24 0 4254818709 0 5411Card 1231,43.63,Posted,515.09,2024-09-11,43.63,Withdrawal Debit Card MC Debit Seminol/INSTACART*159 SAN FRANCISC CADate 12/24/24 0 4359294650 0 5411Card 1231,43.63
9/11/2024,Withdrawal Debit Card MC Debit Seminol/AMAZON PRIME*XS2HD1WH3 AMZN.COM/BIL WADate 09/11/24 0 4255908162 0 5818Card 1231,3.4,Posted,558.72,2024-09-11,3.4,Withdrawal Debit Card MC Debit Seminol/AMAZON PRIME*XS2HD1WH3 AMZN.COM/BIL WADate 09/11/24 0 4255908162 0 5818Card 1231,3.4
9/11/2024,Recurring Withdrawal Debit Card - MC Debit Seminol/AMAZON PRIME*Z81YY4CB1 AMZN.COM/BIL WADate 09/10/24 0 4254816559 0 5968Card 1231,2.01,Posted,562.12,2024-09-11,2.01,Recurring Withdrawal Debit Card - MC Debit Seminol/AMAZON PRIME*Z97W01ZG2 AMZN.COM/BIL WADate 12/17/24 0 4352950216 0 5968Card 1231,2.01
9/10/2024,Withdrawal POS #000000049785/AMAZON.COM*AV5RE3583 SEATTLE WACard 1231,9.13,Posted,564.13,2024-09-10,9.13,Withdrawal POS #000000049785/AMAZON.COM*AV5RE3583 SEATTLE WACard 1231,9.13
9/10/2024,Withdrawal POS #000000010894/AMAZON.COM*Z82Y13CR1 SEATTLE WACard 1231,5.36,Posted,573.26,2024-09-10,5.36,Withdrawal POS #000000000021/AMAZON.COM*TQ9TB8YN3 SEATTLE WACard 1231,5.36
9/10/2024,Recurring Withdrawal Debit Card - MC Debit Seminol/OPENAI SAN FRANCISC CADate 09/09/24 0 4253896772 0 5734Card 1231,15.02,Posted,578.62,2024-09-10,15.02,Withdrawal Debit Card MC Debit Seminol/OPENAI SAN FRANCISC CADate 02/16/24 0 4047896474 1 5734Card 1231,15.026
9/10/2024,Withdrawal Debit Card MC Debit Seminol/CIRCLE K # 06782 GAINESVILLE FLDate 09/08/24 0 4252889868 0 5499Card 1231,42.82,Posted,593.64,2024-09-10,42.82,Withdrawal Debit Card MC Debit Seminol/CIRCLE K # 06782 GAINESVILLE FLDate 09/08/24 0 4252889868 0 5499Card 1231,42.82
9/10/2024,Withdrawal ACH VENMO/TYPE: PAYMENT ID: 3264681992 CO: VENMONAME: AVATAR ARTSEntry Class Code: WEB,14.99,Posted,636.46,2024-09-10,14.99,Withdrawal ACH VENMO/TYPE: PAYMENT ID: 3264681992 CO: VENMONAME: AVATAR ARTSEntry Class Code: WEB,14.99
9/10/2024,Withdrawal ACH VENMO/TYPE: PAYMENT ID: 3264681992 CO: VENMONAME: AVATAR ARTSEntry Class Code: WEB,9.99,Posted,651.45,2024-09-10,9.99,Withdrawal ACH VENMO/TYPE: PAYMENT ID: 3264681992 CO: VENMONAME: AVATAR ARTSEntry Class Code: WEB,9.99
9/10/2024,Withdrawal POS #000000000046/CIRCLE K # 06782 5237 GAINESVILLE FLCard 1231,29.18,Posted,661.44,2024-09-10,29.18,Withdrawal POS #000000000343/CIRCLE K # 06782 5237 GAINESVILLE FLCard 1247,28.796666666666667
9/9/2024,Recurring Withdrawal Debit Card - MC Debit Seminol/INVIDEO INC COUNTRY OF S DEDate 09/09/24 0 4253873198 0 5734Card 1231,60.0,Posted,688.29,2024-09-09,60.0,Recurring Withdrawal Debit Card - MC Debit Seminol/INVIDEO INC COUNTRY OF S DEDate 12/09/24 0 4344808122 0 5734Card 1231,60.0
9/9/2024,Recurring Withdrawal Debit Card - MC Debit Seminol/MYDESIGNS - PRO - MON LAS VEGAS NVDate 09/08/24 0 4252079101 1 5734Card 1231,29.99,Posted,748.29,2024-09-09,29.99,Recurring Withdrawal Debit Card - MC Debit Seminol/MYDESIGNS.IO LAS VEGAS NVDate 10/18/24 0 4292077676 2 5734Card 1231,29.99
9/9/2024,Withdrawal POS #000020599152/GOOGLE *YouTubePremium 1600 AmphitheatreParkw Mountain View CACard 1231,9.1,Posted,778.28,2024-09-09,9.1,"Withdrawal POS #000020312090/GOOGLE *YouTubePremium 1600 Amphitheatre
Parkw Mountain View CA
Card 1247",9.1
9/8/2024,Recurring Withdrawal Debit Card - MC Debit Seminol/TUBEBUDDYCOM* 8668823239 CADate 09/07/24 0 4251439681 2 5045Card 1231,7.5,Posted,787.38,2024-09-08,7.5,Recurring Withdrawal Debit Card - MC Debit Seminol/TUBEBUDDYCOM* 8668823239 CADate 12/03/24 0 4338443995 0 5045Card 1231,7.5
9/8/2024,Withdrawal Debit Card MC Debit Seminol/SAMSUNG ELECTRONICS RIDGEFIELD P NJDate 09/06/24 0 4250130158 2 5734Card 1231,16.99,Posted,794.88,2024-09-08,16.99,Withdrawal Debit Card MC Debit Seminol/SAMSUNG ELECTRONICS RIDGEFIELD P NJDate 12/27/24 0 4362999827 1 5734Card 1231,16.99
9/8/2024,Withdrawal Debit Card MC Debit Seminol/WAWA CARD RELOAD MEDIA PADate 09/07/24 0 4251918366 0 6540Card 1231,15.0,Posted,811.87,2024-09-08,15.0,Withdrawal Debit Card MC Debit Seminol/WAWA CARD RELOAD MEDIA PADate 11/03/24 0 4308001823 1 6540Card 1231,15.0
9/8/2024,Withdrawal Debit Card MC Debit Seminol/WALGREENS #5024 GAINESVILLE FLDate 09/06/24 0 4250431555 2 5912Card 1231,33.35,Posted,826.87,2024-09-08,33.35,Withdrawal Debit Card MC Debit Seminol/WALGREENS #9304 GAINESVILLE FLDate 10/30/24 0 4304125853 1 5912Card 1231,33.35
9/8/2024,Recurring Withdrawal Debit Card - MC Debit Seminol/APPLE.COM/BILL 866-712-7753 CADate 09/07/24 0 4251430319 2 5818Card 1231,2.99,Posted,860.22,2024-09-08,2.99,Recurring Withdrawal Debit Card - MC Debit Seminol/APPLE.COM/BILL 866-712-7753 CADate 04/13/24 0 4104933092 1 5818Card 1231,2.99
9/8/2024,Withdrawal POS #000000215944/AMAZON.COM*Z85JQ4LM2 SEATTLE WACard 1231,29.12,Posted,863.21,2024-09-08,29.12,Withdrawal POS #000000914130/AMAZON.COM*ZR50X2ML1 SEATTLE WACard 1231,29.12
9/6/2024,Withdrawal POS #000000000001/AMAZON.COM*ZT6072MV1 SEATTLE WACard 1231,16.11,Posted,892.33,2024-09-06,16.11,Withdrawal POS #000000000001/AMAZON.COM*TK5HF56S1 SEATTLE WACard 2801,16.11
9/6/2024,Withdrawal Debit Card MC Debit Seminol/IONOS INC. CHESTERBROOK PADate 09/05/24 0 4249995627 0 4816Card 1231,16.0,Posted,908.44,2024-09-06,16.0,Withdrawal Debit Card MC Debit Seminol/IONOS INC. CHESTERBROOK PADate 12/29/24 0 4364954464 0 4816Card 1231,16.0
9/6/2024,Recurring Withdrawal Bill Payment - #000000026814/Netflix.com NETFLIX.COM LOS GATOS CACard 1231,8.05,Posted,924.44,2024-09-06,8.05,Recurring Withdrawal Bill Payment - #000000864701/Netflix.com NETFLIX.COM LOS GATOS CACard 1231,8.05
9/5/2024,Recurring Withdrawal Debit Card - MC Debit Seminol/OPENAI *CHATGPT SUBSCR SAN FRANCISC CADate 09/04/24 0 4248036028 1 5734Card 1231,20.0,Posted,932.49,2024-09-05,20.0,Recurring Withdrawal Debit Card - MC Debit Seminol/OPENAI *CHATGPT SUBSCR SAN FRANCISC CADate 12/04/24 0 4339869196 0 5734Card 1231,20.0
9/5/2024,Withdrawal POS #000000438983/SUNOCO 8002212501 4234 SW 20TH AVEGAINESVILLE FLCard 1231,34.24,Posted,952.49,2024-09-05,34.24,Withdrawal POS #000000488663/SUNOCO 8002212501 4234 SW 20TH AVEGAINESVILLE FLCard 1231,34.24
9/4/2024,Withdrawal Debit Card MC Debit Seminol/WALGREENS #5024 GAINESVILLE FLDate 09/03/24 0 4247223801 1 5912Card 1231,10.81,Posted,986.73,2024-09-04,10.81,Withdrawal Debit Card MC Debit Seminol/WALGREENS #9304 GAINESVILLE FLDate 10/30/24 0 4304125853 1 5912Card 1231,10.81
9/4/2024,Withdrawal Debit Card MC Debit Seminol/CIRCLE K # 06782 GAINESVILLE FLDate 09/02/24 0 4246221313 1 5499Card 1231,29.18,Posted,997.54,2024-09-04,29.18,Withdrawal Debit Card MC Debit Seminol/CIRCLE K # 06782 GAINESVILLE FLDate 09/08/24 0 4252889868 0 5499Card 1231,29.083333333333332
9/4/2024,Recurring Withdrawal Debit Card - MC Debit Seminol/APPLE.COM/BILL 866-712-7753 CADate 09/03/24 0 4247844436 0 5818Card 1231,2.99,Posted,1026.72,2024-09-04,2.99,Recurring Withdrawal Debit Card - MC Debit Seminol/APPLE.COM/BILL 866-712-7753 CADate 01/08/24 0 4008756344 0 5818Card 2801,2.99
9/3/2024,Withdrawal POS #000000749495/PUBLIX 3315 W. UNIVERSITY AVE.FLCard 1231,33.1,Posted,923.5,2024-09-03,33.1,Withdrawal POS #000000749495/PUBLIX 3315 W. UNIVERSITY AVE.FLCard 1231,33.1
9/3/2024,Recurring Withdrawal Debit Card - MC Debit Seminol/MYDESIGNS.IO LAS VEGAS NVDate 09/02/24 0 4246904059 0 5734Card 1231,27.26,Posted,956.6,2024-09-03,27.26,Withdrawal Debit Card MC Debit Seminol/MYDESIGNS.IO LAS VEGAS NVDate 01/07/24 0 4007751481 0 5734Card 2801,27.26
9/3/2024,Withdrawal Debit Card MC Debit Seminol/INSTACART*159 SAN FRANCISC CADate 09/02/24 0 4246902876 0 5411Card 1231,61.13,Posted,983.86,2024-09-03,61.13,Withdrawal Debit Card MC Debit Seminol/INSTACART*159 SAN FRANCISC CADate 12/24/24 0 4359294650 0 5411Card 1231,61.13
9/3/2024,Withdrawal ACH Watson Realty Co/TYPE: WEB PMTS ID: 9000321157CO: Watson Realty CoNAME: Steven chaplinskiEntry Class Code: WEB,1179.0,Posted,1044.99,2024-09-03,1179.0,"Withdrawal ACH Watson Realty Co/TYPE: WEB PMTS ID: 9000321157
CO: Watson Realty Co
NAME: Steven chaplinskiEntry Class Code: WEB",1179.0
9/3/2024,Withdrawal ACH FLUENT-Gainesvil/TYPE: PAYMENT ID: 1371804719CO: FLUENT-GainesvilNAME: steven chaplinskiEntry Class Code: WEB,45.0,Posted,2223.99,2024-09-03,45.0,Withdrawal ACH FLUENT-Gainesvil/TYPE: PAYMENT ID: 1371804719CO: FLUENT-GainesvilNAME: steven chaplinski,45.0
9/3/2024,"Withdrawal ACH AppFolio, Inc. F/TYPE: WEB PMTS ID: 9001406550CO: AppFolio, Inc. FNAME: Steven chaplinskiEntry Class Code: WEB",2.49,Posted,2268.99,2024-09-03,2.49,"Withdrawal ACH AppFolio, Inc. F/TYPE: WEB PMTS ID: 9001406550
CO: AppFolio, Inc. F
NAME: Steven chaplinskiEntry Class Code: WEB",2.49
9/3/2024,"Withdrawal Bill Payment #000000786503/Adobe Park Avenue,345 San Jose CACard 1231",19.99,Posted,2271.48,2024-09-03,19.99,"Withdrawal Bill Payment #000000352498/Adobe Park Avenue,345 San Jose CACard 1247",19.99
9/2/2024,Withdrawal Debit Card MC Debit Seminol/GRU/EZ-PAY WEB PYMT 352-334-3434 FLDate 09/01/24 0 4245989258 0 4900Card 1231,189.27,Posted,2291.47,2024-09-02,189.27,Withdrawal Debit Card MC Debit Seminol/GRU/EZ-PAY WEB PYMT 352-334-3434 FLDate 12/05/24 0 4340279271 0 4900Card 1231,189.27
9/2/2024,Withdrawal Debit Card MC Debit Seminol/COX GAINESVILLE COMM 800-234-3993 FLDate 08/31/24 0 4244993156 1 4899Card 1231,156.13,Posted,2480.74,2024-09-02,156.13,Withdrawal Debit Card MC Debit Seminol/COX GAINESVILLE COMM 800-234-3993 FLDate 12/04/24 0 4339376311 0 4899Card 1231,156.13
8/31/2024,Withdrawal POS #000000736143/PUBLIX 3100 SW 35TH BLVD GAINESVILLE FLCard 1231,18.46,Posted,2636.87,2024-08-31,18.46,"Withdrawal POS #000000752480/PUBLIX 3100 SW 35TH BLVD GAINESVILLE FL
Card 1247",18.405
8/31/2024,Withdrawal POS #000000004805/AMAZON.COM*RK4ZA05U1 SEATTLE WACard 1231,25.94,Posted,2655.33,2024-08-31,25.94,Withdrawal POS #000000000006/AMAZON.COM*RJ6HJ7RA2 SEATTLE WACard 1231,25.94
8/31/2024,Withdrawal POS #000000000085/CIRCLE K # 06782 5237 GAINESVILLE FLCard 1231,29.18,Posted,2681.27,2024-08-31,29.18,Withdrawal POS #000000000343/CIRCLE K # 06782 5237 GAINESVILLE FLCard 1247,28.796666666666667
8/30/2024,Recurring Withdrawal Debit Card - MC Debit Seminol/MYDESIGNS.IO LAS VEGAS NVDate 08/29/24 0 4242999544 0 5734Card 1231,64.44,Posted,2710.45,2024-08-30,64.44,Recurring Withdrawal Debit Card - MC Debit Seminol/MYDESIGNS.IO LAS VEGAS NVDate 10/18/24 0 4292077676 2 5734Card 1231,64.44
8/30/2024,Withdrawal Debit Card MC Debit Seminol/AMAZON PRIME*RK8MN8K72 AMZN.COM/BIL WADate 08/30/24 0 4243993934 0 5818Card 1231,3.44,Posted,2774.89,2024-08-30,3.44,Withdrawal Debit Card MC Debit Seminol/AMAZON PRIME*RK8MN8K72 AMZN.COM/BIL WADate 08/30/24 0 4243993934 0 5818Card 1231,3.44
8/29/2024,Withdrawal POS #000000775931/INSTACART*159 WWW.INSTACART.COM/ SANFRANCISCO CACard 1231,68.63,Posted,2778.33,2024-08-29,68.63,Withdrawal POS #000000792733/INSTACART*159 WWW.INSTACART.COM/ SANFRANCISCO CACard 1231,68.63
8/28/2024,Withdrawal POS #000000073608/SUNOCO 8002212501 4234 SW 20TH AVEGAINESVILLE FLCard 1231,34.24,Posted,46.96,2024-08-28,34.24,Withdrawal POS #000000031004/SUNOCO 8002212501 4234 SW 20TH AVEGAINESVILLE FLCard 1231,34.24
8/28/2024,Withdrawal Debit Card MC Debit Seminol/SAMSUNG ELECTRONICS RIDGEFIELD P NJDate 08/27/24 0 4240911144 0 5734Card 1231,8.99,Posted,81.2,2024-08-28,8.99,Withdrawal Debit Card MC Debit Seminol/SAMSUNG ELECTRONICS RIDGEFIELD P NJDate 12/27/24 0 4362999827 1 5734Card 1231,8.99
8/27/2024,Recurring Withdrawal Debit Card - MC Debit Seminol/MYDESIGNS.IO LAS VEGAS NVDate 08/27/24 0 4240080985 1 5734Card 1231,17.03,Posted,90.19,2024-08-27,17.03,Recurring Withdrawal Debit Card - MC Debit Seminol/MYDESIGNS.IO LAS VEGAS NVDate 10/18/24 0 4292077676 2 5734Card 1231,17.03
8/27/2024,Withdrawal Debit Card MC Debit Seminol/IONOS INC. CHESTERBROOK PADate 08/26/24 0 4239887355 0 4816Card 1231,2.0,Posted,107.22,2024-08-27,2.0,Withdrawal Debit Card MC Debit Seminol/IONOS INC. CHESTERBROOK PADate 12/29/24 0 4364954464 0 4816Card 1231,2.0
8/26/2024,Withdrawal POS #000000963385/SUNOCO 8002212501 4234 SW 20TH AVEGAINESVILLE FLCard 1231,34.24,Posted,96.45,2024-08-26,34.24,Withdrawal POS #000000966158/SUNOCO 8002212501 4234 SW 20TH AVEGAINESVILLE FLCard 2801,34.400000000000006
8/25/2024,Withdrawal POS #000000784235/INSTACART*159 WWW.INSTACART.COM/ SANFRANCISCO CACard 1231,58.42,Posted,130.69,2024-08-25,58.42,Withdrawal POS #000000804821/INSTACART*159 WWW.INSTACART.COM/ SANFRANCISCO CACard 1231,58.42
8/25/2024,Recurring Withdrawal Debit Card - MC Debit Seminol/FS *ADOBE SANTA BARBAR CADate 08/24/24 0 4237923935 0 5734Card 1231,0.95,Posted,189.11,2024-08-25,0.95,Recurring Withdrawal Debit Card - MC Debit Seminol/FS *ADOBE SANTA BARBAR CADate 12/24/24 0 4359034647 1 5734Card 1231,0.95
8/25/2024,Recurring Withdrawal Debit Card - MC Debit Seminol/APPLE.COM/BILL 866-712-7753 CADate 08/25/24 0 4238111248 1 5818Card 1231,15.99,Posted,190.06,2024-08-25,15.99,Recurring Withdrawal Debit Card - MC Debit Seminol/APPLE.COM/BILL 866-712-7753 CADate 07/29/24 0 4211570450 0 5818Card 1231,15.99
8/22/2024,Withdrawal POS #000000773230/INSTACART*159 WWW.INSTACART.COM/ SANFRANCISCO CACard 1231,85.99,Posted,206.05,2024-08-22,85.99,Withdrawal POS #000000792733/INSTACART*159 WWW.INSTACART.COM/ SANFRANCISCO CACard 1231,85.995
8/22/2024,Withdrawal POS #000000170815/AMAZON.COM*R456X2LE0 SEATTLE WACard 1231,25.76,Posted,292.04,2024-08-22,25.76,Withdrawal POS #000000049785/AMAZON.COM*AV5RE3583 SEATTLE WACard 1231,25.76
8/22/2024,Withdrawal POS #000000902881/SUNOCO 8002212501 4234 SW 20TH AVEGAINESVILLE FLCard 1231,30.7,Posted,317.8,2024-08-22,30.7,Withdrawal POS #000000028242/SUNOCO 8002212501 4234 SW 20TH AVEGAINESVILLE FLCard 1231,30.7
8/22/2024,Withdrawal POS #000000777262/SUNOCO 8002212501 4234 SW 20TH AVEGAINESVILLE FLCard 1231,18.89,Posted,148.5,2024-08-22,18.89,Withdrawal POS #000000794627/SUNOCO 8002212501 4234 SW 20TH AVEGAINESVILLE FLCard 1231,18.89
8/21/2024,Recurring Withdrawal Debit Card - MC Debit Seminol/CANVA* I04249-43399962 CAMDEN DEDate 08/20/24 0 4233594945 0 7221Card 1231,12.99,Posted,167.39,2024-08-21,12.99,Recurring Withdrawal Debit Card - MC Debit Seminol/CANVA* I04249-43399962 CAMDEN DEDate 08/20/24 0 4233594945 0 7221Card 1231,12.99
8/19/2024,Withdrawal POS #000000670233/SUNOCO 8002212501 4234 SW 20TH AVEGAINESVILLE FLCard 1231,7.02,Posted,160.46,2024-08-19,7.02,Withdrawal POS #000000504303/SUNOCO 8002212501 4234 SW 20TH AVEGAINESVILLE FLCard 1231,7.02
8/19/2024,Withdrawal POS #000000732534/SUNOCO 8002212501 4234 SW 20TH AVEGAINESVILLE FLCard 1231,34.24,Posted,167.48,2024-08-19,34.24,Withdrawal POS #000000175132/SUNOCO 8002212501 4234 SW 20TH AVEGAINESVILLE FLCard 1231,34.24
8/19/2024,Recurring Withdrawal Debit Card Fee/MASTERCARD ISSUER CROSS-BORDER FEEDate 08/18/24 0 4231951752 0 5734Card 1231,0.05,Posted,201.72,2024-08-19,0.05,Recurring Withdrawal Debit Card Fee/MASTERCARD ISSUER CROSS-BORDER FEEDate 12/31/23 0 3365740203 0 5734Card 2801,0.10500000000000001
8/19/2024,Recurring Withdrawal Debit Card - MC Debit Seminol/SAVE TO NOTION VAUREAL ILDate 08/18/24 0 4231951752 0 5734Card 1231,5.99,Posted,201.77,2024-08-19,5.99,Recurring Withdrawal Debit Card - MC Debit Seminol/SAVE TO NOTION VAUREAL ILDate 12/18/24 0 4353969048 0 5734Card 1231,5.99
8/19/2024,Withdrawal ACH FLUENT-Gainesvil/TYPE: PAYMENT ID: 1371804719CO: FLUENT-GainesvilNAME: steven chaplinskiEntry Class Code: WEB,30.0,Posted,207.76,2024-08-19,30.0,Withdrawal ACH FLUENT-Gainesvil/TYPE: PAYMENT ID: 1371804719CO: FLUENT-GainesvilNAME: steven chaplinski,30.0
8/18/2024,Recurring Withdrawal Debit Card - MC Debit Seminol/SUPERPOWER CHATGPT MIDDLETOWN DEDate 08/17/24 0 4230474948 0 5734Card 1231,15.0,Posted,237.76,2024-08-18,15.0,Recurring Withdrawal Debit Card - MC Debit Seminol/SUPERPOWER CHATGPT MIDDLETOWN DEDate 12/17/24 0 4352703539 1 5734Card 1231,15.0
8/18/2024,Recurring Withdrawal Debit Card - MC Debit Seminol/PADDLE.NET* LEONARDOAI ASTORIA NYDate 08/16/24 0 4229015017 1 5817Card 1231,9.0,Posted,252.76,2024-08-18,9.0,Recurring Withdrawal Debit Card - MC Debit Seminol/PADDLE.NET* LEONARDOAI ASTORIA NYDate 12/16/24 0 4351323834 0 5817Card 1231,9.0
8/18/2024,Recurring Withdrawal Debit Card - MC Debit Seminol/PADDLE.NET* SETAPP ASTORIA NYDate 08/16/24 0 4229819554 1 5817Card 1231,12.49,Posted,261.76,2024-08-18,12.49,Recurring Withdrawal Debit Card - MC Debit Seminol/PADDLE.NET* LEONARDOAI ASTORIA NYDate 12/16/24 0 4351323834 0 5817Card 1231,12.49
8/18/2024,Recurring Withdrawal Debit Card Fee/MASTERCARD ISSUER CROSS-BORDER FEEDate 08/17/24 0 4230854170 0 5734Card 1231,0.06,Posted,274.25,2024-08-18,0.06,Recurring Withdrawal Debit Card Fee/MASTERCARD ISSUER CROSS-BORDER FEEDate 12/31/23 0 3365740203 0 5734Card 2801,0.10500000000000001
8/18/2024,Recurring Withdrawal Debit Card - MC Debit Seminol/IDEOGRAM AI TORONTO ONDate 08/17/24 0 4230854170 0 5734Card 1231,8.0,Posted,274.31,2024-08-18,8.0,Withdrawal Debit Card MC Debit Seminol/IDEOGRAM.AI TORONTO ONDate 04/15/24 0 4106835174 0 5734Card 1231,8.190000000000001
8/17/2024,Withdrawal POS #000000000048/CIRCLE K # 26146 3525 GAINESVILLE FLCard 1231,26.0,Posted,282.31,2024-08-17,26.0,Withdrawal POS #000000000343/CIRCLE K # 06782 5237 GAINESVILLE FLCard 1247,26.395
8/16/2024,Recurring Withdrawal Debit Card - MC Debit Seminol/INVIDEO INC COUNTRY OF S DEDate 08/15/24 0 4228943735 0 5734Card 1231,27.67,Posted,308.31,2024-08-16,27.67,Recurring Withdrawal Debit Card - MC Debit Seminol/INVIDEO INC COUNTRY OF S DEDate 12/09/24 0 4344808122 0 5734Card 1231,27.67
8/15/2024,Withdrawal POS #000000773008/Instacart 50 Beal St Suite 600 SanFrancisco CACard 1231,69.88,Posted,335.98,2024-08-15,69.88,Withdrawal POS #000000773008/Instacart 50 Beal St Suite 600 SanFrancisco CACard 1231,69.88
8/15/2024,"Withdrawal Debit Card MC Debit Seminol/NOTION LABS, INC. SAN FRANCISC CADate 08/15/24 0 4228171261 1 7372Card 1231",10.0,Posted,405.86,2024-08-15,10.0,"Recurring Withdrawal Debit Card - MC Debit Seminol/NOTION LABS, INC. SAN FRANCISC CADate 12/02/24 0 4337878572 0 7372Card 1231",10.0
8/15/2024,Recurring Withdrawal Debit Card - MC Debit Seminol/RUNWAY STANDARD PLAN NEWARK DEDate 08/15/24 0 4228171210 1 5734Card 1231,15.0,Posted,415.86,2024-08-15,15.0,Recurring Withdrawal Debit Card - MC Debit Seminol/RUNWAY STANDARD PLAN NEWARK DEDate 12/15/24 0 4350745942 1 5734Card 1231,15.0
8/14/2024,Withdrawal POS #000000623894/SUNOCO 8002212501 4234 SW 20TH AVEGAINESVILLE FLCard 1231,41.2,Posted,430.86,2024-08-14,41.2,Withdrawal POS #000000028242/SUNOCO 8002212501 4234 SW 20TH AVEGAINESVILLE FLCard 1231,40.95
8/14/2024,Recurring Withdrawal Debit Card - MC Debit Seminol/D-ID STUDIO WILMINGTON DEDate 08/13/24 0 4226859392 0 7399Card 1231,2.95,Posted,472.06,2024-08-14,2.95,Recurring Withdrawal Debit Card - MC Debit Seminol/D-ID STUDIO WILMINGTON DEDate 10/13/24 0 4287011811 1 7399Card 1231,2.95
8/14/2024,Recurring Withdrawal Debit Card - MC Debit Seminol/SUNO INC. CAMBRIDGE MADate 08/13/24 0 4226902139 0 5734Card 1231,10.0,Posted,475.01,2024-08-14,10.0,Recurring Withdrawal Debit Card - MC Debit Seminol/SUNO INC. CAMBRIDGE MADate 08/13/24 0 4226902139 0 5734Card 1231,10.0
8/12/2024,Recurring Withdrawal Debit Card - MC Debit Seminol/OPENAI SAN FRANCISC CADate 08/12/24 0 4225899261 0 5734Card 1231,15.03,Posted,475.17,2024-08-12,15.03,Withdrawal Debit Card MC Debit Seminol/OPENAI SAN FRANCISC CADate 02/16/24 0 4047896474 1 5734Card 1231,15.026
8/12/2024,Recurring Withdrawal Debit Card - MC Debit Seminol/PAYPAL *PLAYSTATION 4029357733 CADate 08/09/24 0 4222963102 0 7994Card 1231,14.99,Posted,490.2,2024-08-12,14.99,Recurring Withdrawal Debit Card - MC Debit Seminol/PAYPAL *PLAYSTATION 4029357733 CADate 08/09/24 0 4222963102 0 7994Card 1231,14.99
8/12/2024,Recurring Withdrawal Debit Card - MC Debit Seminol/PAYPAL *PLAYSTATION 4029357733 CADate 08/09/24 0 4222963101 0 7994Card 1231,9.99,Posted,505.19,2024-08-12,9.99,Recurring Withdrawal Debit Card - MC Debit Seminol/PAYPAL *PLAYSTATION 4029357733 CADate 08/09/24 0 4222963102 0 7994Card 1231,9.99
8/12/2024,Withdrawal POS #000000427484/SUNOCO 8002212501 4234 SW 20TH AVEGAINESVILLE FLCard 1231,37.78,Posted,515.18,2024-08-12,37.78,Withdrawal POS #000000028242/SUNOCO 8002212501 4234 SW 20TH AVEGAINESVILLE FLCard 1231,37.78
8/11/2024,Recurring Withdrawal Debit Card - MC Debit Seminol/AIRTABLE.COM/BILL SAN FRANCISC CADate 08/11/24 0 4224906504 2 7372Card 1231,31.0,Posted,552.96,2024-08-11,31.0,Recurring Withdrawal Debit Card - MC Debit Seminol/AIRTABLE.COM/BILL SAN FRANCISC CADate 09/11/24 0 4255913774 0 7372Card 1231,31.0
8/11/2024,Withdrawal Debit Card MC Debit Seminol/IONOS INC. CHESTERBROOK PADate 08/09/24 0 4222244271 1 4816Card 1231,16.0,Posted,583.96,2024-08-11,16.0,Withdrawal Debit Card MC Debit Seminol/IONOS INC. CHESTERBROOK PADate 12/29/24 0 4364954464 0 4816Card 1231,16.0
8/10/2024,Withdrawal POS #000000334497/SUNOCO 8002212501 4234 SW 20TH AVEGAINESVILLE FLCard 1231,42.78,Posted,599.96,2024-08-10,42.78,Withdrawal POS #000000144391/SUNOCO 8002212501 4234 SW 20TH AVEGAINESVILLE FLCard 1231,42.78
8/9/2024,Recurring Withdrawal Debit Card - MC Debit Seminol/INVIDEO INC COUNTRY OF S DEDate 08/09/24 0 4222136862 1 5734Card 1231,25.0,Posted,642.74,2024-08-09,25.0,Recurring Withdrawal Debit Card - MC Debit Seminol/INVIDEO INC COUNTRY OF S DEDate 12/09/24 0 4344808122 0 5734Card 1231,25.0
8/9/2024,Recurring Withdrawal Debit Card - MC Debit Seminol/MYDESIGNS - PRO - MON LAS VEGAS NVDate 08/09/24 0 4222882568 0 5734Card 1231,29.99,Posted,667.74,2024-08-09,29.99,Recurring Withdrawal Debit Card - MC Debit Seminol/MYDESIGNS - PRO - MON LAS VEGAS NVDate 12/08/24 0 4343357881 0 5734Card 1231,29.99
8/9/2024,Recurring Withdrawal Debit Card Fee/MASTERCARD ISSUER CROSS-BORDER FEEDate 08/09/24 0 4222405366 0 5817Card 1231,0.08,Posted,697.73,2024-08-09,0.08,Recurring Withdrawal Debit Card Fee/MASTERCARD ISSUER CROSS-BORDER FEEDate 01/06/24 0 4006875269 0 5815Card 2801,0.20272727272727267
8/9/2024,Recurring Withdrawal Debit Card - MC Debit Seminol/CAPCUT SINGAPORE SGDate 08/09/24 0 4222405366 0 5817Card 1231,9.99,Posted,697.81,2024-08-09,9.99,Recurring Withdrawal Debit Card - MC Debit Seminol/CAPCUT SINGAPORE SGDate 10/19/24 0 4293358426 2 5817Card 1231,9.99
8/9/2024,Withdrawal Debit Card MC Debit Seminol/WALGREENS #5024 GAINESVILLE FLDate 08/08/24 0 4221131985 1 5912Card 1231,28.95,Posted,707.8,2024-08-09,28.95,Withdrawal Debit Card MC Debit Seminol/WALGREENS #9304 GAINESVILLE FLDate 10/30/24 0 4304125853 1 5912Card 1231,28.46
8/9/2024,Recurring Withdrawal Debit Card - MC Debit Seminol/AMAZON PRIME*RM70P9F91 AMZN.COM/BIL WADate 08/08/24 0 4221404019 0 5968Card 1231,15.13,Posted,736.75,2024-08-09,15.13,Recurring Withdrawal Debit Card - MC Debit Seminol/AMAZON PRIME*Z97W01ZG2 AMZN.COM/BIL WADate 12/17/24 0 4352950216 0 5968Card 1231,15.120000000000001
8/9/2024,Withdrawal POS #000020303936/GOOGLE *YouTubePremium 1600 AmphitheatreParkw Mountain View CACard 1231,9.1,Posted,751.88,2024-08-09,9.1,"Withdrawal POS #000020312090/GOOGLE *YouTubePremium 1600 Amphitheatre
Parkw Mountain View CA
Card 1247",9.1
8/9/2024,Withdrawal POS #000000792124/INSTACART*159 WWW.INSTACART.COM/ SANFRANCISCO CACard 1231,72.01,Posted,760.98,2024-08-09,72.01,Withdrawal POS #000000804821/INSTACART*159 WWW.INSTACART.COM/ SANFRANCISCO CACard 1231,72.01
8/7/2024,Withdrawal POS #000000212396/SUNOCO 8002212501 4234 SW 20TH AVEGAINESVILLE FLCard 1231,37.67,Posted,682.99,2024-08-07,37.67,Withdrawal POS #000000221295/SUNOCO 8002212501 4234 SW 20TH AVEGAINESVILLE FLCard 1231,37.67
8/7/2024,Withdrawal Debit Card MC Debit Seminol/SAMSUNG ELECTRONICS RIDGEFIELD P NJDate 08/06/24 0 4219920231 0 5734Card 1231,16.99,Posted,720.66,2024-08-07,16.99,Withdrawal Debit Card MC Debit Seminol/SAMSUNG ELECTRONICS RIDGEFIELD P NJDate 12/27/24 0 4362999827 1 5734Card 1231,16.99
8/7/2024,Withdrawal Debit Card MC Debit Seminol/GRU/EZ-PAY WEB PYMT 352-334-3434 FLDate 08/06/24 0 4219448708 0 4900Card 1231,220.95,Posted,737.65,2024-08-07,220.95,Withdrawal Debit Card MC Debit Seminol/GRU/EZ-PAY WEB PYMT 352-334-3434 FLDate 12/05/24 0 4340279271 0 4900Card 1231,220.95
8/7/2024,Withdrawal Debit Card MC Debit Seminol/COX GAINESVILLE COMM 800-234-3993 FLDate 08/06/24 0 4219854218 0 4899Card 1231,156.13,Posted,958.6,2024-08-07,156.13,Withdrawal Debit Card MC Debit Seminol/COX GAINESVILLE COMM 800-234-3993 FLDate 12/04/24 0 4339376311 0 4899Card 1231,156.13
8/6/2024,Recurring Withdrawal Bill Payment - #000000350295/Netflix.com NETFLIX.COM LOS GATOS CACard 1231,13.81,Posted,1106.69,2024-08-06,13.81,Recurring Withdrawal Bill Payment - #000000864701/Netflix.com NETFLIX.COM LOS GATOS CACard 1231,13.81
8/6/2024,Withdrawal POS #000000239287/SUNOCO 8002212501 4234 SW 20TH AVEGAINESVILLE FLCard 1231,33.06,Posted,1120.5,2024-08-06,33.06,Withdrawal POS #000000235720/SUNOCO 8002212501 4234 SW 20TH AVEGAINESVILLE FLCard 1231,33.06
8/5/2024,Recurring Withdrawal Debit Card - MC Debit Seminol/OPENAI *CHATGPT SUBSCR SAN FRANCISC CADate 08/04/24 0 4217020552 1 5734Card 1231,20.0,Posted,1153.56,2024-08-05,20.0,Recurring Withdrawal Debit Card - MC Debit Seminol/OPENAI *CHATGPT SUBSCR SAN FRANCISC CADate 12/04/24 0 4339869196 0 5734Card 1231,20.0
8/5/2024,Withdrawal ACH FLUENT-Gainesvil/TYPE: PAYMENT ID: 1371804719CO: FLUENT-GainesvilNAME: steven chaplinskiEntry Class Code: WEB,42.5,Posted,1173.56,2024-08-05,42.5,Withdrawal ACH FLUENT-Gainesvil/TYPE: PAYMENT ID: 1371804719CO: FLUENT-GainesvilNAME: steven chaplinski,42.7
8/4/2024,Withdrawal POS #000000786208/INSTACART*159 WWW.INSTACART.COM/ SANFRANCISCO CACard 1231,80.6,Posted,1216.06,2024-08-04,80.6,Withdrawal POS #000000804821/INSTACART*159 WWW.INSTACART.COM/ SANFRANCISCO CACard 1231,80.6
8/4/2024,Withdrawal Debit Card MC Debit Seminol/IONOS INC. CHESTERBROOK PADate 08/03/24 0 4216015505 2 4816Card 1231,17.74,Posted,1296.66,2024-08-04,17.74,Withdrawal Debit Card MC Debit Seminol/IONOS INC. CHESTERBROOK PADate 12/29/24 0 4364954464 0 4816Card 1231,17.74
8/4/2024,Withdrawal Debit Card MC Debit Seminol/WALGREENS #5024 GAINESVILLE FLDate 08/02/24 0 4215626223 4 5912Card 1231,10.81,Posted,1314.4,2024-08-04,10.81,Withdrawal Debit Card MC Debit Seminol/WALGREENS #9304 GAINESVILLE FLDate 10/30/24 0 4304125853 1 5912Card 1231,10.81
8/4/2024,Recurring Withdrawal Debit Card - MC Debit Seminol/APPLE.COM/BILL 866-712-7753 CADate 08/03/24 0 4216623643 4 5818Card 1231,2.99,Posted,1325.21,2024-08-04,2.99,Recurring Withdrawal Debit Card - MC Debit Seminol/APPLE.COM/BILL 866-712-7753 CADate 11/11/24 0 4316616811 0 5818Card 1231,2.99
8/3/2024,Withdrawal POS #000000156204/SUNOCO 8002212501 4234 SW 20TH AVEGAINESVILLE FLCard 1231,30.7,Posted,1328.2,2024-08-03,30.7,Withdrawal POS #000000235720/SUNOCO 8002212501 4234 SW 20TH AVEGAINESVILLE FLCard 1231,30.7
8/3/2024,"Withdrawal Bill Payment #000000783713/Adobe Park Avenue,345 San Jose CACard 1231",19.99,Posted,1358.9,2024-08-03,19.99,"Withdrawal Bill Payment #000000352498/Adobe Park Avenue,345 San Jose CACard 1247",19.99
8/3/2024,Withdrawal POS #000000775244/Instacart 50 Beal St Suite 600 SanFrancisco CACard 1231,66.13,Posted,1378.89,2024-08-03,66.13,Withdrawal POS #000000773008/Instacart 50 Beal St Suite 600 SanFrancisco CACard 1231,66.13
8/2/2024,Withdrawal Debit Card MC Debit Seminol/RANDY'S HAIRCUTS FOR M GAINESVILLE FLDate 08/01/24 0 4214894751 0 7230Card 1231,30.0,Posted,1400.02,2024-08-02,30.0,Withdrawal Debit Card MC Debit Seminol/RANDY'S HAIRCUTS FOR M GAINESVILLE FLDate 08/01/24 0 4214894751 0 7230Card 1231,30.0
8/2/2024,Withdrawal ACH Watson Realty Co/TYPE: WEB PMTS ID: 9000321157CO: Watson Realty CoNAME: Steven chaplinskiEntry Class Code: WEB,1179.0,Posted,1430.02,2024-08-02,1179.0,"Withdrawal ACH Watson Realty Co/TYPE: WEB PMTS ID: 9000321157
CO: Watson Realty Co
NAME: Steven chaplinskiEntry Class Code: WEB",1179.0
8/2/2024,"Withdrawal ACH AppFolio, Inc. F/TYPE: WEB PMTS ID: 9001406550CO: AppFolio, Inc. FNAME: Steven chaplinskiEntry Class Code: WEB",2.49,Posted,2609.02,2024-08-02,2.49,"Withdrawal ACH AppFolio, Inc. F/TYPE: WEB PMTS ID: 9001406550
CO: AppFolio, Inc. F
NAME: Steven chaplinskiEntry Class Code: WEB",2.49
8/1/2024,Withdrawal POS #000000000002/AMAZON.COM*RV6JQ8U41 SEATTLE WACard 1231,28.95,Posted,2611.51,2024-08-01,28.95,Withdrawal POS #000000000001/AMAZON.COM*TK5HF56S1 SEATTLE WACard 2801,28.95
8/1/2024,Withdrawal POS #000000983835/SUNOCO 8002212501 4234 SW 20TH AVEGAINESVILLE FLCard 1231,30.7,Posted,2640.46,2024-08-01,30.7,Withdrawal POS #000000488663/SUNOCO 8002212501 4234 SW 20TH AVEGAINESVILLE FLCard 1231,30.7
8/1/2024,Withdrawal POS #000000735887/PUBLIX 3315 W. UNIVERSITY AVE.FLCard 1231,70.24,Posted,2671.16,2024-08-01,70.24,Withdrawal POS #000000749495/PUBLIX 3315 W. UNIVERSITY AVE.FLCard 1231,70.24
7/31/2024,Withdrawal POS #000000922607/SUNOCO 8002212501 4234 SW 20TH AVEGAINESVILLE FLCard 1231,34.24,Posted,2741.4,2024-07-31,34.24,Withdrawal POS #000000235720/SUNOCO 8002212501 4234 SW 20TH AVEGAINESVILLE FLCard 1231,34.24
7/30/2024,Withdrawal Debit Card MC Debit Seminol/AMAZON DIGIT*RV2ZN2GA1 AMZN.COM/BIL WADate 07/30/24 0 4212878109 0 5818Card 1231,3.44,Posted,2775.64,2024-07-30,3.44,Withdrawal Debit Card MC Debit Seminol/AMAZON DIGIT*RV2ZN2GA1 AMZN.COM/BIL WADate 07/30/24 0 4212878109 0 5818Card 1231,3.44
7/30/2024,Recurring Withdrawal Debit Card - MC Debit Seminol/APPLE.COM/BILL 866-712-7753 CADate 07/29/24 0 4211570450 0 5818Card 1231,7.98,Posted,2779.08,2024-07-30,7.98,Recurring Withdrawal Debit Card - MC Debit Seminol/APPLE.COM/BILL 866-712-7753 CADate 03/27/24 0 4087824766 0 5818Card 1231,7.98
7/29/2024,Withdrawal POS #000000782390/INSTACART*159 WWW.INSTACART.COM/ SANFRANCISCO CACard 1231,60.0,Posted,2785.7,2024-07-29,60.0,Withdrawal POS #000000804821/INSTACART*159 WWW.INSTACART.COM/ SANFRANCISCO CACard 1231,60.0
7/29/2024,Withdrawal Debit Card MC Debit Seminol/WAWA CARD RELOAD MEDIA PADate 07/28/24 0 4210031062 1 6540Card 1231,15.0,Posted,2845.7,2024-07-29,15.0,Withdrawal Debit Card MC Debit Seminol/WAWA CARD RELOAD MEDIA PADate 11/03/24 0 4308001823 1 6540Card 1231,15.0
7/28/2024,Withdrawal POS #000000575942/SUNOCO 8002212501 4234 SW 20TH AVEGAINESVILLE FLCard 1231,22.42,Posted,60.7,2024-07-28,22.42,Withdrawal POS #000000778591/SUNOCO 8002212501 4234 SW 20TH AVEGAINESVILLE FLCard 1231,22.42
7/26/2024,Withdrawal POS #000000665239/SUNOCO 8002212501 4234 SW 20TH AVEGAINESVILLE FLCard 1231,37.67,Posted,83.12,2024-07-26,37.67,Withdrawal POS #000000966158/SUNOCO 8002212501 4234 SW 20TH AVEGAINESVILLE FLCard 2801,37.42
7/25/2024,"Recurring Withdrawal Debit Card - MC Debit Seminol/YVETTE GODET, DMD GAINESVILLE FLDate 07/24/24 0 4206848776 0 8021Card 1231",20.0,Posted,113.29,2024-07-25,20.0,"Recurring Withdrawal Debit Card - MC Debit Seminol/YVETTE GODET, DMD GAINESVILLE FLDate 07/24/24 0 4206848776 0 8021Card 1231",20.0
7/25/2024,Recurring Withdrawal Debit Card - MC Debit Seminol/FS *ADOBE SANTA BARBAR CADate 07/24/24 0 4206889164 0 5734Card 1231,0.95,Posted,133.29,2024-07-25,0.95,Recurring Withdrawal Debit Card - MC Debit Seminol/FS *CONTEXTSFORMAC SANTA BARBAR CADate 02/16/24 0 4047893711 1 5734Card 1231,0.95
7/25/2024,Recurring Withdrawal Debit Card - MC Debit Seminol/APPLE.COM/BILL 866-712-7753 CADate 07/25/24 0 4207172375 1 5818Card 1231,0.29,Posted,134.24,2024-07-25,0.29,Recurring Withdrawal Debit Card - MC Debit Seminol/APPLE.COM/BILL 866-712-7753 CADate 03/27/24 0 4087824766 0 5818Card 1231,0.29
7/25/2024,Withdrawal POS #000000000006/AMAZON.COM*RJ6HJ7RA2 SEATTLE WACard 1231,8.59,Posted,134.53,2024-07-25,8.59,Withdrawal POS #000000000006/AMAZON.COM*RJ6HJ7RA2 SEATTLE WACard 1231,8.86
7/24/2024,Withdrawal POS #000000616677/SUNOCO 8002212501 4234 SW 20TH AVEGAINESVILLE FLCard 1231,21.56,Posted,143.12,2024-07-24,21.56,Withdrawal POS #000000616677/SUNOCO 8002212501 4234 SW 20TH AVEGAINESVILLE FLCard 1231,21.56
7/24/2024,Withdrawal POS #000000803033/IC* INSTACART*159 WWW.INSTACART.COM/ SANFRANCISCO CACard 1231,76.0,Posted,164.68,2024-07-24,76.0,Withdrawal POS #000000794186/IC* INSTACART*159 WWW.INSTACART.COM/ SANFRANCISCO CACard 1231,76.0
7/23/2024,Withdrawal POS #000000524840/SUNOCO 8002212501 4234 SW 20TH AVEGAINESVILLE FLCard 1231,37.78,Posted,40.68,2024-07-23,37.78,Withdrawal POS #000000028242/SUNOCO 8002212501 4234 SW 20TH AVEGAINESVILLE FLCard 1231,37.78
7/21/2024,Recurring Withdrawal Debit Card - MC Debit Seminol/CANVA* I04218-28500872 CAMDEN DEDate 07/20/24 0 4202716426 0 7221Card 1231,12.99,Posted,66.93,2024-07-21,12.99,Recurring Withdrawal Debit Card - MC Debit Seminol/CANVA* I04249-43399962 CAMDEN DEDate 08/20/24 0 4233594945 0 7221Card 1231,12.99
7/21/2024,Recurring Withdrawal Debit Card - MC Debit Seminol/TUBEBUDDYCOM 8668823239 CADate 07/20/24 0 4202875818 0 5734Card 1231,7.5,Posted,79.92,2024-07-21,7.5,Recurring Withdrawal Debit Card - MC Debit Seminol/TUBEBUDDYCOM* 8668823239 CADate 12/03/24 0 4338443995 0 5045Card 1231,7.5
7/21/2024,Withdrawal POS #000000000124/CIRCLE K # 06782 5237 GAINESVILLE FLCard 1231,26.83,Posted,87.42,2024-07-21,26.83,Withdrawal POS #000000000343/CIRCLE K # 06782 5237 GAINESVILLE FLCard 1247,26.395
7/19/2024,Recurring Withdrawal Debit Card Fee/MASTERCARD ISSUER CROSS-BORDER FEEDate 07/18/24 0 4200710264 0 5734Card 1231,0.05,Posted,104.26,2024-07-19,0.05,Recurring Withdrawal Debit Card Fee/MASTERCARD ISSUER CROSS-BORDER FEEDate 01/06/24 0 4006875269 0 5815Card 2801,0.20272727272727267
7/19/2024,Recurring Withdrawal Debit Card - MC Debit Seminol/SAVE TO NOTION VAUREAL ILDate 07/18/24 0 4200710264 0 5734Card 1231,5.99,Posted,104.31,2024-07-19,5.99,Recurring Withdrawal Debit Card - MC Debit Seminol/SAVE TO NOTION VAUREAL ILDate 12/18/24 0 4353969048 0 5734Card 1231,5.99
7/19/2024,Recurring Withdrawal Debit Card - MC Debit Seminol/WORDPRESS YLZK812XJ6 SAN FRANCISC CADate 07/18/24 0 4200709907 0 5734Card 1231,9.0,Posted,110.3,2024-07-19,9.0,Recurring Withdrawal Debit Card - MC Debit Seminol/WORDPRESS YLZK812XJ6 SAN FRANCISC CADate 07/18/24 0 4200709907 0 5734Card 1231,9.0
7/18/2024,Withdrawal POS #000000357918/SUNOCO 8002212501 4234 SW 20TH AVEGAINESVILLE FLCard 1231,34.24,Posted,119.3,2024-07-18,34.24,Withdrawal POS #000000966158/SUNOCO 8002212501 4234 SW 20TH AVEGAINESVILLE FLCard 2801,34.400000000000006
7/18/2024,Recurring Withdrawal Debit Card - MC Debit Seminol/SUPERPOWER CHATGPT MIDDLETOWN DEDate 07/17/24 0 4199660339 0 5734Card 1231,15.0,Posted,153.54,2024-07-18,15.0,Recurring Withdrawal Debit Card - MC Debit Seminol/SUPERPOWER CHATGPT MIDDLETOWN DEDate 12/17/24 0 4352703539 1 5734Card 1231,15.0
7/18/2024,Withdrawal ACH FLUENT-Gainesvil/TYPE: PAYMENT ID: 1371804719CO: FLUENT-GainesvilNAME: steven chaplinskiEntry Class Code: WEB,36.0,Posted,168.54,2024-07-18,36.0,Withdrawal ACH FLUENT-Gainesvil/TYPE: PAYMENT ID: 1371804719CO: FLUENT-GainesvilNAME: steven chaplinski,36.0
7/17/2024,Withdrawal POS #000000976832/AMAZON.COM*RS88T71I1 SEATTLE WACard 1231,16.43,Posted,175.34,2024-07-17,16.43,Withdrawal POS #000000049785/AMAZON.COM*AV5RE3583 SEATTLE WACard 1231,16.43
7/17/2024,Recurring Withdrawal Debit Card - MC Debit Seminol/PADDLE.NET* LEONARDOAI ASTORIA NYDate 07/16/24 0 4198745563 0 5817Card 1231,9.0,Posted,191.77,2024-07-17,9.0,Recurring Withdrawal Debit Card - MC Debit Seminol/PADDLE.NET* LEONARDOAI ASTORIA NYDate 12/16/24 0 4351323834 0 5817Card 1231,9.0
7/17/2024,Recurring Withdrawal Debit Card - MC Debit Seminol/PADDLE.NET* SETAPP ASTORIA NYDate 07/16/24 0 4198606327 0 5817Card 1231,12.49,Posted,200.77,2024-07-17,12.49,Recurring Withdrawal Debit Card - MC Debit Seminol/PADDLE.NET* SETAPP NEW YORK NYDate 10/14/24 0 4288882561 0 5817Card 1231,12.49
7/17/2024,Recurring Withdrawal Debit Card Fee/MASTERCARD ISSUER CROSS-BORDER FEEDate 07/17/24 0 4199108326 1 5734Card 1231,0.06,Posted,213.26,2024-07-17,0.06,Recurring Withdrawal Debit Card Fee/MASTERCARD ISSUER CROSS-BORDER FEEDate 06/15/24 0 4167922806 1 5734Card 1231,0.08
7/17/2024,Recurring Withdrawal Debit Card - MC Debit Seminol/IDEOGRAM AI TORONTO ONDate 07/17/24 0 4199108326 1 5734Card 1231,8.0,Posted,213.32,2024-07-17,8.0,Recurring Withdrawal Debit Card - MC Debit Seminol/IDEOGRAM AI TORONTO ONDate 12/17/24 0 4352700468 1 5734Card 1231,8.0
7/16/2024,Withdrawal POS #000000795251/INSTACART*159 WWW.INSTACART.COM/ SANFRANCISCO CACard 1231,42.92,Posted,221.32,2024-07-16,42.92,Withdrawal POS #000000804821/INSTACART*159 WWW.INSTACART.COM/ SANFRANCISCO CACard 1231,42.96
7/16/2024,Withdrawal POS #000000271518/SUNOCO 8002212501 4234 SW 20TH AVEGAINESVILLE FLCard 1231,37.78,Posted,234.76,2024-07-16,37.78,Withdrawal POS #000000966158/SUNOCO 8002212501 4234 SW 20TH AVEGAINESVILLE FLCard 2801,37.42
7/15/2024,Recurring Withdrawal Debit Card - MC Debit Seminol/RUNWAY STANDARD PLAN NEWARK DEDate 07/15/24 0 4197591427 1 5734Card 1231,15.0,Posted,272.54,2024-07-15,15.0,Recurring Withdrawal Debit Card - MC Debit Seminol/RUNWAY STANDARD PLAN NEWARK DEDate 12/15/24 0 4350745942 1 5734Card 1231,15.0
7/15/2024,Withdrawal POS #000000211548/SUNOCO 8002212501 4234 SW 20TH AVEGAINESVILLE FLCard 1231,37.78,Posted,287.54,2024-07-15,37.78,Withdrawal POS #000000966158/SUNOCO 8002212501 4234 SW 20TH AVEGAINESVILLE FLCard 2801,37.42
7/14/2024,Recurring Withdrawal Debit Card - MC Debit Seminol/OPENAI SAN FRANCISC CADate 07/14/24 0 4196394793 1 5734Card 1231,15.01,Posted,325.32,2024-07-14,15.01,Withdrawal Debit Card MC Debit Seminol/OPENAI SAN FRANCISC CADate 02/16/24 0 4047896474 1 5734Card 1231,15.026
7/14/2024,Recurring Withdrawal Debit Card - MC Debit Seminol/SUPERPOWER CHATGPT MIDDLETOWN DEDate 07/13/24 0 4195402190 0 5734Card 1231,15.0,Posted,340.33,2024-07-14,15.0,Recurring Withdrawal Debit Card - MC Debit Seminol/SUPERPOWER CHATGPT MIDDLETOWN DEDate 12/17/24 0 4352703539 1 5734Card 1231,15.0
7/14/2024,Recurring Withdrawal Debit Card - MC Debit Seminol/D-ID STUDIO WILMINGTON DEDate 07/13/24 0 4195852605 0 7399Card 1231,2.95,Posted,355.33,2024-07-14,2.95,Recurring Withdrawal Debit Card - MC Debit Seminol/D-ID STUDIO WILMINGTON DEDate 10/13/24 0 4287011811 1 7399Card 1231,2.95
7/14/2024,Recurring Withdrawal Debit Card - MC Debit Seminol/SUNO INC. CAMBRIDGE MADate 07/13/24 0 4195401634 0 5734Card 1231,10.0,Posted,358.28,2024-07-14,10.0,Recurring Withdrawal Debit Card - MC Debit Seminol/SUNO INC. CAMBRIDGE MADate 08/13/24 0 4226902139 0 5734Card 1231,10.0
7/14/2024,Recurring Withdrawal Debit Card - MC Debit Seminol/APPLE.COM/BILL 866-712-7753 CADate 07/13/24 0 4195115185 3 5818Card 1231,18.98,Posted,368.28,2024-07-14,18.98,Recurring Withdrawal Debit Card - MC Debit Seminol/APPLE.COM/BILL 866-712-7753 CADate 07/29/24 0 4211570450 0 5818Card 1231,18.98
7/13/2024,Withdrawal POS #000000165380/SUNOCO 8002212501 4234 SW 20TH AVEGAINESVILLE FLCard 1231,36.81,Posted,387.26,2024-07-13,36.81,Withdrawal POS #000000966158/SUNOCO 8002212501 4234 SW 20TH AVEGAINESVILLE FLCard 2801,37.42
7/12/2024,Withdrawal Debit Card MC Debit Seminol/WAWA CARD RELOAD MEDIA PADate 07/11/24 0 4193151203 1 6540Card 1231,15.0,Posted,424.07,2024-07-12,15.0,Withdrawal Debit Card MC Debit Seminol/WAWA CARD RELOAD MEDIA PADate 11/03/24 0 4308001823 1 6540Card 1231,15.0
7/12/2024,Withdrawal Debit Card MC Debit Seminol/WAWA CARD RELOAD MEDIA PADate 07/11/24 0 4193151202 1 6540Card 1231,20.0,Posted,439.07,2024-07-12,20.0,Withdrawal Debit Card MC Debit Seminol/WAWA CARD RELOAD MEDIA PADate 11/03/24 0 4308001823 1 6540Card 1231,20.0
7/12/2024,Withdrawal Debit Card MC Debit Seminol/CIRCLE K # 06782 GAINESVILLE FLDate 07/10/24 0 4192897494 0 5499Card 1231,21.77,Posted,459.07,2024-07-12,21.77,Withdrawal Debit Card MC Debit Seminol/CIRCLE K # 06782 GAINESVILLE FLDate 09/08/24 0 4252889868 0 5499Card 1231,21.405
7/12/2024,Withdrawal POS #000000037228/WAWA 5325 2373 SW ARCHER ROADFLCard 1231,18.03,Posted,480.84,2024-07-12,18.03,Withdrawal POS #000000553411/WAWA 5325 2373 SW ARCHER ROADFLCard 1247,18.03
7/11/2024,Recurring Withdrawal Debit Card - MC Debit Seminol/AIRTABLE.COM/BILL SAN FRANCISC CADate 07/10/24 0 4192868077 0 7372Card 1231,31.0,Posted,448.87,2024-07-11,31.0,Recurring Withdrawal Debit Card - MC Debit Seminol/AIRTABLE.COM/BILL SAN FRANCISC CADate 09/11/24 0 4255913774 0 7372Card 1231,31.0
7/11/2024,Withdrawal Debit Card MC Debit Seminol/WALGREENS #5024 GAINESVILLE FLDate 07/10/24 0 4192117338 1 5912Card 1231,36.44,Posted,479.87,2024-07-11,36.44,Withdrawal Debit Card MC Debit Seminol/WALGREENS #9304 GAINESVILLE FLDate 10/30/24 0 4304125853 1 5912Card 1231,36.44
7/11/2024,Withdrawal Debit Card MC Debit Seminol/B2P* FL OMMU MJ MED CA JACKSONVILLE FLDate 07/10/24 0 4192863496 0 9399Card 1231,77.75,Posted,516.31,2024-07-11,77.75,Withdrawal Debit Card MC Debit Seminol/B2P* FL OMMU MJ MED CA JACKSONVILLE FLDate 07/10/24 0 4192863496 0 9399Card 1231,77.75
7/11/2024,Withdrawal ACH FLUENT-Gainesvil/TYPE: PAYMENT ID: 1371804719CO: FLUENT-GainesvilNAME: steven chaplinskiEntry Class Code: WEB,48.0,Posted,594.06,2024-07-11,48.0,Withdrawal ACH FLUENT-Gainesvil/TYPE: PAYMENT ID: 1371804719CO: FLUENT-GainesvilNAME: steven chaplinski,48.5
7/9/2024,Withdrawal POS #000000041458/SUNOCO 8002212501 4234 SW 20TH AVEGAINESVILLE FLCard 1231,37.78,Posted,642.06,2024-07-09,37.78,Withdrawal POS #000000031004/SUNOCO 8002212501 4234 SW 20TH AVEGAINESVILLE FLCard 1231,37.78
7/8/2024,Recurring Withdrawal Debit Card - MC Debit Seminol/APPLE.COM/BILL 866-712-7753 CADate 07/08/24 0 4190849912 0 5818Card 1231,2.99,Posted,679.84,2024-07-08,2.99,Recurring Withdrawal Debit Card - MC Debit Seminol/APPLE.COM/BILL 866-712-7753 CADate 01/08/24 0 4008756344 0 5818Card 2801,2.99
7/7/2024,Withdrawal Debit Card MC Debit Seminol/SAMSUNG ELECTRONICS RIDGEFIELD P NJDate 07/06/24 0 4188926193 0 5734Card 1231,16.99,Posted,682.83,2024-07-07,16.99,Withdrawal Debit Card MC Debit Seminol/SAMSUNG ELECTRONICS RIDGEFIELD P NJDate 12/27/24 0 4362999827 1 5734Card 1231,16.99
7/7/2024,Withdrawal Debit Card MC Debit Seminol/WALGREENS #5024 GAINESVILLE FLDate 07/05/24 0 4187128964 2 5912Card 1231,24.75,Posted,699.82,2024-07-07,24.75,Withdrawal Debit Card MC Debit Seminol/WALGREENS #9304 GAINESVILLE FLDate 10/30/24 0 4304125853 1 5912Card 1231,24.265
7/7/2024,Withdrawal Debit Card MC Debit Seminol/GRU/EZ-PAY WEB PYMT 352-334-3434 FLDate 07/05/24 0 4187656509 0 4900Card 1231,200.0,Posted,724.57,2024-07-07,200.0,Withdrawal Debit Card MC Debit Seminol/GRU/EZ-PAY WEB PYMT 352-334-3434 FLDate 12/05/24 0 4340279271 0 4900Card 1231,200.0
7/7/2024,Withdrawal Debit Card MC Debit Seminol/COX GAINESVILLE COMM 800-234-3993 FLDate 07/05/24 0 4187656473 0 4899Card 1231,156.13,Posted,924.57,2024-07-07,156.13,Withdrawal Debit Card MC Debit Seminol/COX GAINESVILLE COMM 800-234-3993 FLDate 12/04/24 0 4339376311 0 4899Card 1231,156.13
7/7/2024,Withdrawal POS #000000792733/INSTACART*159 WWW.INSTACART.COM/ SANFRANCISCO CACard 1231,59.07,Posted,1080.7,2024-07-07,59.07,Withdrawal POS #000000792733/INSTACART*159 WWW.INSTACART.COM/ SANFRANCISCO CACard 1231,59.085
7/6/2024,Recurring Withdrawal Bill Payment - #000000404960/NETFLIX COM LOS GATOS CACard 1231,13.81,Posted,1139.77,2024-07-06,13.81,"Recurring Withdrawal Bill Payment - #000000017652/NETFLIX COM LOS GATOS CA
Card 1247",13.504999999999999
7/5/2024,Withdrawal POS #000000828132/SUNOCO 8002212501 4234 SW 20TH AVEGAINESVILLE FLCard 1231,30.7,Posted,1153.58,2024-07-05,30.7,Withdrawal POS #000000028242/SUNOCO 8002212501 4234 SW 20TH AVEGAINESVILLE FLCard 1231,30.7
7/5/2024,Recurring Withdrawal Debit Card - MC Debit Seminol/OPENAI *CHATGPT SUBSCR SAN FRANCISC CADate 07/04/24 0 4186555750 0 5734Card 1231,20.0,Posted,1184.28,2024-07-05,20.0,Recurring Withdrawal Debit Card - MC Debit Seminol/OPENAI *CHATGPT SUBSCR SAN FRANCISC CADate 12/04/24 0 4339869196 0 5734Card 1231,20.0
7/4/2024,Withdrawal POS #000000601921/SUNOCO 8002212501 4234 SW 20TH AVEGAINESVILLE FLCard 1231,37.78,Posted,1204.28,2024-07-04,37.78,Withdrawal POS #000000161599/SUNOCO 8002212501 4234 SW 20TH AVEGAINESVILLE FLCard 1231,37.78
7/4/2024,Withdrawal POS #000000000004/INSTACART*159 WWW.INSTACART.COM/ SANFRANCISCO CACard 1231,95.0,Posted,1242.06,2024-07-04,95.0,Withdrawal POS #000000804821/INSTACART*159 WWW.INSTACART.COM/ SANFRANCISCO CACard 1231,95.0
7/3/2024,"Withdrawal POS #000000784963/ETSY, INC. ADAMS STREET BROOKLYN NYCard 1231",31.06,Posted,1337.06,2024-07-03,31.06,"Withdrawal POS #000000784963/ETSY, INC. ADAMS STREET BROOKLYN NYCard 1231",31.06
7/3/2024,Recurring Withdrawal Debit Card - MC Debit Seminol/DOCSIUM.COM SANTA CLARA CADate 07/02/24 0 4184077595 1 5734Card 1231,10.0,Posted,1368.12,2024-07-03,10.0,Recurring Withdrawal Debit Card - MC Debit Seminol/DOCSIUM.COM SANTA CLARA CADate 07/02/24 0 4184077595 1 5734Card 1231,10.0
7/3/2024,Recurring Withdrawal Debit Card - MC Debit Seminol/INVIDEO INC COUNTRY OF S DEDate 07/02/24 0 4184336533 0 5734Card 1231,50.0,Posted,1378.12,2024-07-03,50.0,Recurring Withdrawal Debit Card - MC Debit Seminol/INVIDEO INC COUNTRY OF S DEDate 12/09/24 0 4344808122 0 5734Card 1231,50.0
7/3/2024,Recurring Withdrawal Debit Card - MC Debit Seminol/APPLE.COM/BILL 866-712-7753 CADate 07/03/24 0 4185191278 1 5818Card 1231,2.99,Posted,1428.12,2024-07-03,2.99,Recurring Withdrawal Debit Card - MC Debit Seminol/APPLE.COM/BILL 866-712-7753 CADate 04/13/24 0 4104933092 1 5818Card 1231,2.99
7/3/2024,"Withdrawal Bill Payment #000000776267/Adobe Park Avenue,345 San Jose CACard 1231",19.99,Posted,1431.11,2024-07-03,19.99,"Withdrawal Bill Payment #000000352498/Adobe Park Avenue,345 San Jose CACard 1247",19.99
7/2/2024,Withdrawal POS #000000636425/WAWA 5325 2373 SW ARCHER ROADFLCard 1231,25.64,Posted,1451.1,2024-07-02,25.64,Withdrawal POS #000000553411/WAWA 5325 2373 SW ARCHER ROADFLCard 1247,25.64
7/2/2024,Withdrawal ACH Watson Realty Co/TYPE: WEB PMTS ID: 9000321157CO: Watson Realty CoNAME: Steven chaplinskiEntry Class Code: WEB,1079.0,Posted,1476.74,2024-07-02,1079.0,"Withdrawal ACH Watson Realty Co/TYPE: WEB PMTS ID: 9000321157
CO: Watson Realty Co
NAME: Steven chaplinskiEntry Class Code: WEB",1079.0
7/2/2024,"Withdrawal ACH AppFolio, Inc. F/TYPE: WEB PMTS ID: 9001406550CO: AppFolio, Inc. FNAME: Steven chaplinskiEntry Class Code: WEB",2.49,Posted,2555.74,2024-07-02,2.49,"Withdrawal ACH AppFolio, Inc. F/TYPE: WEB PMTS ID: 9001406550
CO: AppFolio, Inc. F
NAME: Steven chaplinskiEntry Class Code: WEB",2.49
7/1/2024,Withdrawal POS #000000794215/Etsy.com*US ADAMS STREET BROOKLYN NYCard 1231,19.38,Posted,2558.23,2024-07-01,19.38,Withdrawal POS #000000794215/Etsy.com*US ADAMS STREET BROOKLYN NYCard 1231,19.38
6/30/2024,Withdrawal Debit Card MC Debit Seminol/CIRCLE K # 06782 GAINESVILLE FLDate 06/27/24 0 4179059238 2 5499Card 1231,10.93,Posted,2577.61,2024-06-30,10.93,Withdrawal Debit Card MC Debit Seminol/CIRCLE K # 06782 GAINESVILLE FLDate 09/08/24 0 4252889868 0 5499Card 1231,10.93
6/30/2024,Withdrawal POS #000000585907/SUNOCO 8002212501 4234 SW 20TH AVEGAINESVILLE FLCard 1231,30.7,Posted,2588.54,2024-06-30,30.7,Withdrawal POS #000000778591/SUNOCO 8002212501 4234 SW 20TH AVEGAINESVILLE FLCard 1231,30.39
6/30/2024,Withdrawal POS #000000000002/INSTACART*159 WWW.INSTACART.COM/ SANFRANCISCO CACard 1231,3.0,Posted,2619.24,2024-06-30,3.0,Withdrawal POS #000000804821/INSTACART*159 WWW.INSTACART.COM/ SANFRANCISCO CACard 1231,3.0
6/29/2024,Withdrawal POS #000000794238/INSTACART*159 WWW.INSTACART.COM/ SANFRANCISCO CACard 1231,102.0,Posted,2622.24,2024-06-29,102.0,Withdrawal POS #000000804821/INSTACART*159 WWW.INSTACART.COM/ SANFRANCISCO CACard 1231,102.0
6/28/2024,Withdrawal ATM Fee/EFT 6419 W Newberry Rd Gainesville FLCard 1231,2.0,Posted,2724.24,2024-06-28,2.0,"Withdrawal ATM Fee/EFT 6419 W Newberry Rd Gainesville FL
Card 1247",2.0
6/28/2024,Withdrawal at ATM #000000187788/EFT 6419 W Newberry Rd Gainesville FLCard 1231,58.0,Posted,2726.24,2024-06-28,58.0,"Withdrawal at ATM #000000785755/EFT 6419 W Newberry Rd Gainesville FL
Card 1247",58.0
6/27/2024,Withdrawal POS #000000000163/CIRCLE K # 06782 5237 GAINESVILLE FLCard 1231,10.83,Posted,2784.24,2024-06-27,10.83,Withdrawal POS #000000000343/CIRCLE K # 06782 5237 GAINESVILLE FLCard 1247,10.42
6/25/2024,"Recurring Withdrawal Debit Card - MC Debit Seminol/NOTION LABS, INC. SAN FRANCISC CADate 06/24/24 0 4176845324 0 7372Card 1231",28.0,Posted,-4.93,2024-06-25,28.0,"Recurring Withdrawal Debit Card - MC Debit Seminol/NOTION LABS, INC. SAN FRANCISC CADate 12/02/24 0 4337878572 0 7372Card 1231",27.52
6/25/2024,Recurring Withdrawal Debit Card - MC Debit Seminol/FS *ADOBE SANTA BARBAR CADate 06/24/24 0 4176843252 0 5734Card 1231,0.95,Posted,23.07,2024-06-25,0.95,Recurring Withdrawal Debit Card - MC Debit Seminol/FS *ADOBE SANTA BARBAR CADate 12/24/24 0 4359034647 1 5734Card 1231,0.95
6/24/2024,Recurring Withdrawal Debit Card - MC Debit Seminol/VIDIQ SAN FRANCISC CADate 06/23/24 0 4175962388 0 5734Card 1231,10.0,Posted,24.02,2024-06-24,10.0,Withdrawal Debit Card MC Debit Seminol/VIDIQ SAN FRANCISC CADate 12/03/24 0 4338664809 1 5734Card 1231,10.0
6/22/2024,Withdrawal POS #000000222542/WAWA 5325 2373 SW ARCHER ROADFLCard 1231,21.03,Posted,34.02,2024-06-22,21.03,Withdrawal POS #000000553411/WAWA 5325 2373 SW ARCHER ROADFLCard 1247,21.03
6/22/2024,Withdrawal POS #000000736979/PUBLIX 3100 SW 35TH BLVD GAINESVILLE FLCard 1231,3.57,Posted,55.05,2024-06-22,3.57,"Withdrawal POS #000000752480/PUBLIX 3100 SW 35TH BLVD GAINESVILLE FL
Card 1247",3.57
6/21/2024,Recurring Withdrawal Debit Card - MC Debit Seminol/CANVA* I04188-40633252 CAMDEN DEDate 06/20/24 0 4172950372 0 7221Card 1231,12.99,Posted,58.62,2024-06-21,12.99,Recurring Withdrawal Debit Card - MC Debit Seminol/CANVA* I04249-43399962 CAMDEN DEDate 08/20/24 0 4233594945 0 7221Card 1231,12.99
6/21/2024,Recurring Withdrawal Debit Card - MC Debit Seminol/TUBEBUDDYCOM 8668823239 CADate 06/20/24 0 4172966177 0 5734Card 1231,7.5,Posted,71.61,2024-06-21,7.5,Recurring Withdrawal Debit Card - MC Debit Seminol/TUBEBUDDYCOM* 8668823239 CADate 12/03/24 0 4338443995 0 5045Card 1231,7.5
6/20/2024,Withdrawal POS #000000062103/SUNOCO 8002212501 4234 SW 20TH AVEGAINESVILLE FLCard 1231,27.17,Posted,79.11,2024-06-20,27.17,Withdrawal POS #000000031004/SUNOCO 8002212501 4234 SW 20TH AVEGAINESVILLE FLCard 1231,27.17
6/20/2024,Withdrawal POS #000075513000/WAWA 5325 2373 SW ARCHER ROADFLCard 1231,7.91,Posted,6.28,2024-06-20,7.91,Withdrawal POS #000000553411/WAWA 5325 2373 SW ARCHER ROADFLCard 1247,7.91
6/20/2024,Withdrawal POS #000003380654/GOOGLE *YouTubePremium 1600 AmphitheatreParkw Mountain View CACard 1231,15.92,Posted,14.19,2024-06-20,15.92,"Withdrawal POS #000020312090/GOOGLE *YouTubePremium 1600 Amphitheatre
Parkw Mountain View CA
Card 1247",15.92
6/19/2024,Recurring Withdrawal Debit Card - MC Debit Seminol/OPENAI SAN FRANCISC CADate 06/19/24 0 4171146931 1 5734Card 1231,15.07,Posted,30.11,2024-06-19,15.07,Withdrawal Debit Card MC Debit Seminol/OPENAI SAN FRANCISC CADate 02/16/24 0 4047896474 1 5734Card 1231,15.026
6/19/2024,Recurring Withdrawal Debit Card Fee/MASTERCARD ISSUER CROSS-BORDER FEEDate 06/18/24 0 4170210550 0 5734Card 1231,0.05,Posted,45.18,2024-06-19,0.05,Recurring Withdrawal Debit Card Fee/MASTERCARD ISSUER CROSS-BORDER FEEDate 12/31/23 0 3365740203 0 5734Card 2801,0.10500000000000001
6/19/2024,Recurring Withdrawal Debit Card - MC Debit Seminol/SAVE TO NOTION VAUREAL ILDate 06/18/24 0 4170210550 0 5734Card 1231,5.99,Posted,45.23,2024-06-19,5.99,Recurring Withdrawal Debit Card - MC Debit Seminol/SAVE TO NOTION VAUREAL ILDate 12/18/24 0 4353969048 0 5734Card 1231,5.99
6/19/2024,Recurring Withdrawal Debit Card - MC Debit Seminol/WORDPRESS JTXC3339UX SAN FRANCISC CADate 06/18/24 0 4170210352 0 5734Card 1231,9.0,Posted,51.22,2024-06-19,9.0,Recurring Withdrawal Debit Card - MC Debit Seminol/WORDPRESS YLZK812XJ6 SAN FRANCISC CADate 07/18/24 0 4200709907 0 5734Card 1231,9.0
6/19/2024,Withdrawal Debit Card MC Debit Seminol/MYDESIGNS.IO LAS VEGAS NVDate 06/18/24 0 4170210349 0 5734Card 1231,24.26,Posted,60.22,2024-06-19,24.26,Withdrawal Debit Card MC Debit Seminol/MYDESIGNS.IO LAS VEGAS NVDate 01/07/24 0 4007751481 0 5734Card 2801,24.26
6/19/2024,Withdrawal Debit Card MC Debit Seminol/MYDESIGNS.IO LAS VEGAS NVDate 06/18/24 0 4170210348 0 5734Card 1231,22.77,Posted,84.48,2024-06-19,22.77,Withdrawal Debit Card MC Debit Seminol/MYDESIGNS.IO LAS VEGAS NVDate 01/07/24 0 4007751481 0 5734Card 2801,22.77
6/18/2024,Recurring Withdrawal Debit Card - MC Debit Seminol/SUPERPOWER CHATGPT MIDDLETOWN DEDate 06/17/24 0 4169773640 0 5734Card 1231,15.0,Posted,107.25,2024-06-18,15.0,Recurring Withdrawal Debit Card - MC Debit Seminol/SUPERPOWER CHATGPT MIDDLETOWN DEDate 12/17/24 0 4352703539 1 5734Card 1231,15.0
6/18/2024,Withdrawal POS #000010941641/CIRCLE K # 26146 3525 GAINESVILLE FLCard 1231,32.54,Posted,122.25,2024-06-18,32.54,"Withdrawal POS #000000000047/CIRCLE K # 26146 3525 GAINESVILLE FL
Card 1247",32.54
6/17/2024,Recurring Withdrawal Debit Card - MC Debit Seminol/LINKTREE* LINKTREE VENICE CADate 06/16/24 0 4168933314 0 7399Card 1231,9.0,Posted,-45.21,2024-06-17,9.0,Recurring Withdrawal Debit Card - MC Debit Seminol/LINKTREE* LINKTREE VENICE CADate 06/16/24 0 4168933314 0 7399Card 1231,9.0
6/17/2024,Recurring Withdrawal Debit Card - MC Debit Seminol/MYDESIGNS - PRO - MON LAS VEGAS NVDate 06/16/24 0 4168024493 1 5734Card 1231,29.99,Posted,-36.21,2024-06-17,29.99,Recurring Withdrawal Debit Card - MC Debit Seminol/MYDESIGNS - PRO - MON LAS VEGAS NVDate 12/08/24 0 4343357881 0 5734Card 1231,29.99
6/17/2024,Recurring Withdrawal Debit Card - MC Debit Seminol/PADDLE.NET* LEONARDOAI ASTORIA NYDate 06/16/24 0 4168303365 0 5817Card 1231,9.0,Posted,-6.22,2024-06-17,9.0,Recurring Withdrawal Debit Card - MC Debit Seminol/PADDLE.NET* LEONARDOAI ASTORIA NYDate 12/16/24 0 4351323834 0 5817Card 1231,9.0
6/17/2024,Recurring Withdrawal Debit Card - MC Debit Seminol/PADDLE.NET* SETAPP ASTORIA NYDate 06/16/24 0 4168931750 0 5817Card 1231,12.49,Posted,2.78,2024-06-17,12.49,Recurring Withdrawal Debit Card - MC Debit Seminol/PADDLE.NET* SETAPP NEW YORK NYDate 10/14/24 0 4288882561 0 5817Card 1231,12.49
6/17/2024,Recurring Withdrawal Debit Card - MC Debit Seminol/WWW.EVERBEE.IO AUSTIN TXDate 06/16/24 0 4168931700 0 5734Card 1231,29.99,Posted,15.27,2024-06-17,29.99,Recurring Withdrawal Debit Card - MC Debit Seminol/WWW.EVERBEE.IO AUSTIN TXDate 12/04/24 0 4339869891 0 5734Card 1231,29.99
6/17/2024,Recurring Withdrawal Debit Card Fee/MASTERCARD ISSUER CROSS-BORDER FEEDate 06/17/24 0 4169858722 0 5734Card 1231,0.06,Posted,45.26,2024-06-17,0.06,Recurring Withdrawal Debit Card Fee/MASTERCARD ISSUER CROSS-BORDER FEEDate 12/31/23 0 3365740203 0 5734Card 2801,0.10500000000000001
6/17/2024,Recurring Withdrawal Debit Card - MC Debit Seminol/IDEOGRAM AI TORONTO ONDate 06/17/24 0 4169858722 0 5734Card 1231,8.0,Posted,45.32,2024-06-17,8.0,Withdrawal Debit Card MC Debit Seminol/IDEOGRAM.AI TORONTO ONDate 04/15/24 0 4106835174 0 5734Card 1231,8.190000000000001
6/17/2024,Withdrawal ACH FLUENT-Gainesvil/TYPE: PAYMENT ID: 1371804719CO: FLUENT-GainesvilNAME: steven chaplinskiEntry Class Code: WEB,42.9,Posted,53.32,2024-06-17,42.9,Withdrawal ACH FLUENT-Gainesvil/TYPE: PAYMENT ID: 1371804719CO: FLUENT-GainesvilNAME: steven chaplinski,42.7
6/16/2024,Withdrawal POS #000000909995/SUNOCO 8002212501 4234 SW 20TH AVEGAINESVILLE FLCard 1231,26.42,Posted,96.22,2024-06-16,26.42,Withdrawal POS #000000909995/SUNOCO 8002212501 4234 SW 20TH AVEGAINESVILLE FLCard 1231,26.42
6/16/2024,Recurring Withdrawal Debit Card - MC Debit Seminol/PP*DOORDASH BURGERKIN 4029357733 CADate 06/13/24 0 4165038114 2 5812Card 1231,23.7,Posted,122.64,2024-06-16,23.7,Recurring Withdrawal Debit Card - MC Debit Seminol/PP*DOORDASH BURGERKIN 4029357733 CADate 06/13/24 0 4165038114 2 5812Card 1231,23.7
6/16/2024,Recurring Withdrawal Debit Card Fee/MASTERCARD ISSUER CROSS-BORDER FEEDate 06/15/24 0 4167922806 1 5734Card 1231,0.13,Posted,146.34,2024-06-16,0.13,Recurring Withdrawal Debit Card Fee/MASTERCARD ISSUER CROSS-BORDER FEEDate 06/15/24 0 4167922806 1 5734Card 1231,0.08
6/16/2024,Recurring Withdrawal Debit Card - MC Debit Seminol/VANCEAI CENTRAL HODate 06/15/24 0 4167922806 1 5734Card 1231,15.9,Posted,146.47,2024-06-16,15.9,Recurring Withdrawal Debit Card - MC Debit Seminol/VANCEAI CENTRAL HODate 06/15/24 0 4167922806 1 5734Card 1231,15.9
6/16/2024,Recurring Withdrawal Debit Card - MC Debit Seminol/APPLE.COM/BILL 866-712-7753 CADate 06/15/24 0 4167495198 2 5818Card 1231,9.99,Posted,162.37,2024-06-16,9.99,Recurring Withdrawal Debit Card - MC Debit Seminol/APPLE.COM/BILL 866-712-7753 CADate 04/13/24 0 4104933092 1 5818Card 1231,9.99
6/14/2024,Withdrawal Debit Card MC Debit Seminol/PIKA.ART PALO ALTO CADate 06/13/24 0 4165935401 0 5734Card 1231,10.0,Posted,172.36,2024-06-14,10.0,Withdrawal Debit Card MC Debit Seminol/PIKA.ART PALO ALTO CADate 06/13/24 0 4165935401 0 5734Card 1231,10.0
6/14/2024,Recurring Withdrawal Debit Card - MC Debit Seminol/SUPERPOWER CHATGPT MIDDLETOWN DEDate 06/13/24 0 4165297516 0 5734Card 1231,15.0,Posted,182.36,2024-06-14,15.0,Recurring Withdrawal Debit Card - MC Debit Seminol/SUPERPOWER CHATGPT MIDDLETOWN DEDate 12/17/24 0 4352703539 1 5734Card 1231,15.0
6/14/2024,Recurring Withdrawal Debit Card - MC Debit Seminol/D-ID STUDIO WILMINGTON DEDate 06/13/24 0 4165935259 0 7399Card 1231,5.9,Posted,197.36,2024-06-14,5.9,Recurring Withdrawal Debit Card - MC Debit Seminol/D-ID STUDIO WILMINGTON DEDate 10/13/24 0 4287011811 1 7399Card 1231,5.9
6/14/2024,Recurring Withdrawal Debit Card - MC Debit Seminol/SUNO INC. CAMBRIDGE MADate 06/13/24 0 4165296878 0 5734Card 1231,10.0,Posted,203.26,2024-06-14,10.0,Recurring Withdrawal Debit Card - MC Debit Seminol/SUNO INC. CAMBRIDGE MADate 08/13/24 0 4226902139 0 5734Card 1231,10.0
6/14/2024,Recurring Withdrawal Debit Card Fee/MASTERCARD ISSUER CROSS-BORDER FEEDate 06/14/24 0 4166958438 0 5734Card 1231,0.03,Posted,213.26,2024-06-14,0.03,Recurring Withdrawal Debit Card Fee/MASTERCARD ISSUER CROSS-BORDER FEEDate 12/31/23 0 3365740203 0 5734Card 2801,0.10500000000000001
6/14/2024,Recurring Withdrawal Debit Card - MC Debit Seminol/ETSYHUNT TECH SINGAPORE SGDate 06/14/24 0 4166958438 0 5734Card 1231,3.99,Posted,213.29,2024-06-14,3.99,Recurring Withdrawal Debit Card - MC Debit Seminol/ETSYHUNT TECH SINGAPORE SGDate 06/14/24 0 4166958438 0 5734Card 1231,3.99
6/14/2024,Withdrawal Debit Card MC Debit Seminol/WAWA CARD RELOAD MEDIA PADate 06/12/24 0 4164067788 1 6540Card 1231,20.0,Posted,217.28,2024-06-14,20.0,Withdrawal Debit Card MC Debit Seminol/WAWA CARD RELOAD MEDIA PADate 11/03/24 0 4308001823 1 6540Card 1231,20.0
6/14/2024,Withdrawal POS #000000000069/CIRCLE K # 26146 3525 GAINESVILLE FLCard 1231,28.89,Posted,237.28,2024-06-14,28.89,Withdrawal POS #000000000343/CIRCLE K # 06782 5237 GAINESVILLE FLCard 1247,28.796666666666667
6/13/2024,Withdrawal Debit Card MC Debit Seminol/CANNAMD 855-4209170 FLDate 06/12/24 0 4164913043 0 8011Card 1231,50.0,Posted,266.17,2024-06-13,50.0,Withdrawal Debit Card MC Debit Seminol/CANNAMD 855-4209170 FLDate 12/19/24 0 4354703841 0 8011Card 1231,50.0
6/13/2024,Recurring Withdrawal Debit Card - MC Debit Seminol/APPLE.COM/BILL 866-712-7753 CADate 06/13/24 0 4165138639 1 5818Card 1231,15.99,Posted,316.17,2024-06-13,15.99,Recurring Withdrawal Debit Card - MC Debit Seminol/APPLE.COM/BILL 866-712-7753 CADate 04/13/24 0 4104933092 1 5818Card 1231,15.99
6/13/2024,Recurring Withdrawal Debit Card - MC Debit Seminol/APPLE.COM/BILL 866-712-7753 CADate 06/13/24 0 4165138632 1 5818Card 1231,2.99,Posted,332.16,2024-06-13,2.99,Recurring Withdrawal Debit Card - MC Debit Seminol/APPLE.COM/BILL 866-712-7753 CADate 04/13/24 0 4104933092 1 5818Card 1231,2.99
6/13/2024,Withdrawal ACH Watson Realty Co/TYPE: WEB PMTS ID: 9000321157CO: Watson Realty CoNAME: Steven chaplinskiEntry Class Code: WEB,75.0,Posted,335.15,2024-06-13,75.0,"Withdrawal ACH Watson Realty Co/TYPE: WEB PMTS ID: 9000321157
CO: Watson Realty Co
NAME: Steven chaplinskiEntry Class Code: WEB",75.0
6/13/2024,"Withdrawal ACH AppFolio, Inc. F/TYPE: WEB PMTS ID: 9001406550CO: AppFolio, Inc. FNAME: Steven chaplinskiEntry Class Code: WEB",2.49,Posted,410.15,2024-06-13,2.49,"Withdrawal ACH AppFolio, Inc. F/TYPE: WEB PMTS ID: 9001406550
CO: AppFolio, Inc. F
NAME: Steven chaplinskiEntry Class Code: WEB",2.49
6/12/2024,Withdrawal POS #000000728249/SUNOCO 8002212501 4234 SW 20TH AVEGAINESVILLE FLCard 1231,38.24,Posted,412.64,2024-06-12,38.24,Withdrawal POS #000000778591/SUNOCO 8002212501 4234 SW 20TH AVEGAINESVILLE FLCard 1231,38.010000000000005
6/12/2024,Recurring Withdrawal Debit Card - MC Debit Seminol/OPENAI SAN FRANCISC CADate 06/12/24 0 4164955921 0 5734Card 1231,15.01,Posted,450.88,2024-06-12,15.01,Recurring Withdrawal Debit Card - MC Debit Seminol/OPENAI *CHATGPT SUBSCR SAN FRANCISC CADate 12/04/24 0 4339869196 0 5734Card 1231,15.01
6/12/2024,Recurring Withdrawal Debit Card - MC Debit Seminol/PADDLE.NET* SETAPP NEW YORK NYDate 06/12/24 0 4164955257 0 5817Card 1231,9.99,Posted,465.89,2024-06-12,9.99,Recurring Withdrawal Debit Card - MC Debit Seminol/PADDLE.NET* SETAPP NEW YORK NYDate 10/14/24 0 4288882561 0 5817Card 1231,9.495000000000001
6/11/2024,Withdrawal POS #000009220158/WALGREENS 2415 SW 75TH 2415 SW 75TH STGAINESVILLE FLCard 1231,4.3,Posted,475.88,2024-06-11,4.3,Withdrawal POS #000013340229/WALGREENS 2415 SW 75TH 2415 SW 75TH STGAINESVILLE FLCard 1231,4.3
6/11/2024,Withdrawal POS #000009214940/WALGREENS 2415 SW 75TH 2415 SW 75TH STGAINESVILLE FLCard 1231,29.58,Posted,480.18,2024-06-11,29.58,Withdrawal POS #000013340229/WALGREENS 2415 SW 75TH 2415 SW 75TH STGAINESVILLE FLCard 1231,29.58
6/9/2024,Withdrawal POS #000000794668/INSTACART*159 WWW.INSTACART.COM/ SANFRANCISCO CACard 1231,3.0,Posted,486.5,2024-06-09,3.0,Withdrawal POS #000000804821/INSTACART*159 WWW.INSTACART.COM/ SANFRANCISCO CACard 1231,3.0
6/9/2024,Withdrawal POS #000000000005/INSTACART*159 WWW.INSTACART.COM/ SANFRANCISCO CACard 1231,90.66,Posted,489.5,2024-06-09,90.66,Withdrawal POS #000000000003/INSTACART*159 WWW.INSTACART.COM/ SANFRANCISCO CACard 1231,90.66
6/9/2024,Withdrawal Debit Card MC Debit Seminol/WALGREENS #5024 GAINESVILLE FLDate 06/07/24 0 4159311957 2 5912Card 1231,10.81,Posted,580.16,2024-06-09,10.81,Withdrawal Debit Card MC Debit Seminol/WALGREENS #9304 GAINESVILLE FLDate 10/30/24 0 4304125853 1 5912Card 1231,10.81
6/9/2024,Recurring Withdrawal Debit Card - MC Debit Seminol/APPLE.COM/BILL 866-712-7753 CADate 06/07/24 0 4159617075 1 5818Card 1231,2.99,Posted,590.97,2024-06-09,2.99,Recurring Withdrawal Debit Card - MC Debit Seminol/APPLE.COM/BILL 866-712-7753 CADate 04/13/24 0 4104933092 1 5818Card 1231,2.99
6/9/2024,Withdrawal POS #000000596566/SUNOCO 8002212501 4234 SW 20TH AVEGAINESVILLE FLCard 1231,34.24,Posted,593.96,2024-06-09,34.24,Withdrawal POS #000000555763/SUNOCO 8002212501 4234 SW 20TH AVEGAINESVILLE FLCard 1231,34.24
6/7/2024,Withdrawal Debit Card MC Debit Seminol/COX GAINESVILLE COMM 800-234-3993 FLDate 06/06/24 0 4158037132 1 4899Card 1231,142.13,Posted,628.2,2024-06-07,142.13,Withdrawal Debit Card MC Debit Seminol/COX GAINESVILLE COMM 800-234-3993 FLDate 12/04/24 0 4339376311 0 4899Card 1231,142.465
6/6/2024,Withdrawal POS #000000792685/INSTACART*159 WWW.INSTACART.COM/ SANFRANCISCO CACard 1231,3.0,Posted,770.33,2024-06-06,3.0,Withdrawal POS #000000792733/INSTACART*159 WWW.INSTACART.COM/ SANFRANCISCO CACard 1231,3.0
6/6/2024,Withdrawal POS #000000793127/INSTACART*159 WWW.INSTACART.COM/ SANFRANCISCO CACard 1231,81.0,Posted,773.33,2024-06-06,81.0,Withdrawal POS #000000792733/INSTACART*159 WWW.INSTACART.COM/ SANFRANCISCO CACard 1231,81.0
6/6/2024,Withdrawal Bill Payment #000000144331/GRU EZ PAY 301 SE 4TH AVE 301 SE 4TH AVCard 1231,161.55,Posted,854.33,2024-06-06,161.55,Withdrawal Bill Payment #000000483994/GRU EZ PAY 301 SE 4TH AVE 301 SE 4TH AVCard 1247,161.55
6/6/2024,Withdrawal Debit Card MC Debit Seminol/SAMSUNG ELECTRONICS RIDGEFIELD P NJDate 06/06/24 0 4158976711 0 5734Card 1231,16.99,Posted,1015.88,2024-06-06,16.99,Withdrawal Debit Card MC Debit Seminol/SAMSUNG ELECTRONICS RIDGEFIELD P NJDate 12/27/24 0 4362999827 1 5734Card 1231,16.99
6/6/2024,Withdrawal POS #000000431904/SUNOCO 8002212501 4234 SW 20TH AVEGAINESVILLE FLCard 1231,28.64,Posted,1032.87,2024-06-06,28.64,Withdrawal POS #000000031004/SUNOCO 8002212501 4234 SW 20TH AVEGAINESVILLE FLCard 1231,28.64
6/6/2024,Recurring Withdrawal Bill Payment - #000000178852/NETFLIX COM LOS GATOS CACard 1231,13.81,Posted,1061.51,2024-06-06,13.81,"Recurring Withdrawal Bill Payment - #000000017652/NETFLIX COM LOS GATOS CA
Card 1247",13.504999999999999
6/5/2024,Recurring Withdrawal Debit Card - MC Debit Seminol/OPENAI *CHATGPT SUBSCR SAN FRANCISC CADate 06/04/24 0 4156605279 0 5734Card 1231,20.0,Posted,1075.32,2024-06-05,20.0,Recurring Withdrawal Debit Card - MC Debit Seminol/CHATGPT SUBSCRIPTION SAN FRANCISC CADate 05/04/24 0 4125659188 0 5734Card 1231,20.0
6/5/2024,Withdrawal Debit Card MC Debit Seminol/1473 - QUINN EYE CENTE GAINESVILLE FLDate 06/04/24 0 4156985542 0 8042Card 1231,54.0,Posted,1095.32,2024-06-05,54.0,Withdrawal Debit Card MC Debit Seminol/1473 - QUINN EYE CENTE GAINESVILLE FLDate 06/04/24 0 4156985542 0 8042Card 1231,54.0
6/5/2024,Withdrawal Bill Payment #000009216703/PAYPAL *PARAMNTPLUS 2211 North FirstStreet 8882211161 CACard 1231,13.81,Posted,1149.32,2024-06-05,13.81,Withdrawal Bill Payment #000009216703/PAYPAL *PARAMNTPLUS 2211 North FirstStreet 8882211161 CACard 1231,13.81
6/4/2024,Withdrawal POS #000000775534/INSTACART*159 WWW.INSTACART.COM/ SANFRANCISCO CACard 1231,111.29,Posted,1163.13,2024-06-04,111.29,Withdrawal POS #000000792733/INSTACART*159 WWW.INSTACART.COM/ SANFRANCISCO CACard 1231,111.29
6/4/2024,Withdrawal POS #000000367990/SUNOCO 8002212501 4234 SW 20TH AVEGAINESVILLE FLCard 1231,25.96,Posted,1274.42,2024-06-04,25.96,Withdrawal POS #000000161599/SUNOCO 8002212501 4234 SW 20TH AVEGAINESVILLE FLCard 1231,25.96
6/4/2024,Withdrawal Debit Card MC Debit Seminol/CIRCLE K # 06782 GAINESVILLE FLDate 06/02/24 0 4154170879 1 5499Card 1231,28.74,Posted,1300.38,2024-06-04,28.74,Withdrawal Debit Card MC Debit Seminol/CIRCLE K # 06782 GAINESVILLE FLDate 09/08/24 0 4252889868 0 5499Card 1231,29.083333333333332
6/4/2024,Withdrawal ACH FLUENT-Gainesvil/TYPE: PAYMENT ID: 1371804719CO: FLUENT-GainesvilNAME: steven chaplinskiEntry Class Code: WEB,82.6,Posted,1329.12,2024-06-04,82.6,Withdrawal ACH FLUENT-Gainesvil/TYPE: PAYMENT ID: 1371804719CO: FLUENT-GainesvilNAME: steven chaplinski,82.6
6/3/2024,Recurring Withdrawal Debit Card - MC Debit Seminol/DOCSIUM.COM SANTA CLARA CADate 06/02/24 0 4154586018 1 5734Card 1231,10.0,Posted,1385.68,2024-06-03,10.0,Recurring Withdrawal Debit Card - MC Debit Seminol/DOCSIUM.COM SANTA CLARA CADate 07/02/24 0 4184077595 1 5734Card 1231,10.0
6/3/2024,Recurring Withdrawal Debit Card - MC Debit Seminol/INVIDEO INC COUNTRY OF S DEDate 06/02/24 0 4154049359 0 5734Card 1231,50.0,Posted,1395.68,2024-06-03,50.0,Recurring Withdrawal Debit Card - MC Debit Seminol/INVIDEO INC COUNTRY OF S DEDate 12/09/24 0 4344808122 0 5734Card 1231,50.0
6/3/2024,Withdrawal Debit Card MC Debit Seminol/WAWA CARD RELOAD MEDIA PADate 06/02/24 0 4154531671 1 6540Card 1231,25.0,Posted,1445.68,2024-06-03,25.0,Withdrawal Debit Card MC Debit Seminol/WAWA CARD RELOAD MEDIA PADate 11/03/24 0 4308001823 1 6540Card 1231,25.0
6/3/2024,Recurring Withdrawal Debit Card - MC Debit Seminol/APPLE.COM/BILL 866-712-7753 CADate 06/03/24 0 4155527708 1 5818Card 1231,2.99,Posted,1470.68,2024-06-03,2.99,Recurring Withdrawal Debit Card - MC Debit Seminol/APPLE.COM/BILL 866-712-7753 CADate 04/13/24 0 4104933092 1 5818Card 1231,2.99
6/3/2024,"Withdrawal Bill Payment #000000786071/Adobe Park Avenue,345 San Jose CACard 1231",19.99,Posted,1473.67,2024-06-03,19.99,"Withdrawal Bill Payment #000000352498/Adobe Park Avenue,345 San Jose CACard 1247",19.99
6/3/2024,Withdrawal ACH Watson Realty Co/TYPE: WEB PMTS ID: 9000321157CO: Watson Realty CoNAME: Steven chaplinskiEntry Class Code: WEB,1079.0,Posted,1493.66,2024-06-03,1079.0,"Withdrawal ACH Watson Realty Co/TYPE: WEB PMTS ID: 9000321157
CO: Watson Realty Co
NAME: Steven chaplinskiEntry Class Code: WEB",1079.0
6/3/2024,"Withdrawal ACH AppFolio, Inc. F/TYPE: WEB PMTS ID: 9001406550CO: AppFolio, Inc. FNAME: Steven chaplinskiEntry Class Code: WEB",2.49,Posted,2572.66,2024-06-03,2.49,"Withdrawal ACH AppFolio, Inc. F/TYPE: WEB PMTS ID: 9001406550
CO: AppFolio, Inc. F
NAME: Steven chaplinskiEntry Class Code: WEB",2.49
6/2/2024,Withdrawal POS #000000278995/SUNOCO 8002212501 4234 SW 20TH AVEGAINESVILLE FLCard 1231,22.42,Posted,2575.15,2024-06-02,22.42,Withdrawal POS #000000778591/SUNOCO 8002212501 4234 SW 20TH AVEGAINESVILLE FLCard 1231,22.42
6/2/2024,Withdrawal Bill Payment #000011385521/PAYPAL *SPOTIFYUSAI 2211 North FirstStreet 8882211161 CACard 1231,6.82,Posted,2597.57,2024-06-02,6.82,Withdrawal Bill Payment #000009216703/PAYPAL *PARAMNTPLUS 2211 North FirstStreet 8882211161 CACard 1231,6.82
6/1/2024,Withdrawal POS #000000774843/ETSY.COM*US WWW.ETSY.COM/ BROOKLYN NYCard 1231,28.29,Posted,2604.39,2024-06-01,28.29,"Withdrawal POS #000000804240/ETSY, INC. WWW.ETSY.COM/ BROOKLYN NYCard 1231",28.29
5/31/2024,Withdrawal POS #000000786599/INSTACART*159 WWW.INSTACART.COM/ SANFRANCISCO CACard 1231,5.0,Posted,2632.68,2024-05-31,5.0,Withdrawal POS #000000359086/INSTACART*159 WWW.INSTACART.COM/ SANFRANCISCO CACard 1231,5.0
5/31/2024,Withdrawal POS #000000000006/INSTACART*159 WWW.INSTACART.COM/ SANFRANCISCO CACard 1231,75.0,Posted,2637.68,2024-05-31,75.0,Withdrawal POS #000000000003/INSTACART*159 WWW.INSTACART.COM/ SANFRANCISCO CACard 1231,75.0
5/30/2024,Withdrawal Debit Card MC Debit Seminol/WALGREENS #5024 GAINESVILLE FLDate 05/29/24 0 4150067031 1 5912Card 1231,22.65,Posted,2712.68,2024-05-30,22.65,Withdrawal Debit Card MC Debit Seminol/WALGREENS #5024 GAINESVILLE FLDate 12/27/24 0 4362000611 2 5912Card 1231,22.65
5/29/2024,Withdrawal POS #000000803191/INSTACART*159 WWW.INSTACART.COM/ SANFRANCISCO CACard 1231,5.0,Posted,2735.33,2024-05-29,5.0,Withdrawal POS #000000804821/INSTACART*159 WWW.INSTACART.COM/ SANFRANCISCO CACard 1231,5.0
5/29/2024,Withdrawal POS #000000795511/INSTACART*159 WWW.INSTACART.COM/ SANFRANCISCO CACard 1231,60.0,Posted,2740.33,2024-05-29,60.0,Withdrawal POS #000000772291/INSTACART*159 WWW.INSTACART.COM/ SANFRANCISCO CACard 1231,60.0
5/29/2024,Withdrawal POS #000000131389/SUNOCO 8002212501 4234 SW 20TH AVEGAINESVILLE FLCard 1231,37.78,Posted,2800.33,2024-05-29,37.78,Withdrawal POS #000000161599/SUNOCO 8002212501 4234 SW 20TH AVEGAINESVILLE FLCard 1231,37.78
5/28/2024,Withdrawal POS #000000102672/SUNOCO 8002212501 4234 SW 20TH AVEGAINESVILLE FLCard 1231,10.61,Posted,38.11,2024-05-28,10.61,Withdrawal POS #000000028242/SUNOCO 8002212501 4234 SW 20TH AVEGAINESVILLE FLCard 1231,10.61
5/28/2024,Recurring Withdrawal Debit Card - MC Debit Seminol/APPLE.COM/BILL 866-712-7753 CADate 05/27/24 0 4148755967 0 5818Card 1231,9.99,Posted,48.72,2024-05-28,9.99,Recurring Withdrawal Debit Card - MC Debit Seminol/APPLE.COM/BILL 866-712-7753 CADate 01/08/24 0 4008756344 0 5818Card 2801,10.49
5/27/2024,Recurring Withdrawal Debit Card - MC Debit Seminol/BLAZE TODAY SUNNYVALE CADate 05/26/24 0 4147283808 0 5734Card 1231,8.39,Posted,58.71,2024-05-27,8.39,Recurring Withdrawal Debit Card - MC Debit Seminol/BLAZE TODAY SUNNYVALE CADate 05/26/24 0 4147283808 0 5734Card 1231,8.39
5/27/2024,Withdrawal POS #000000000000/IC* INSTACART*159 WWW.INSTACART.COM/ SANFRANCISCO CACard 1231,3.0,Posted,67.1,2024-05-27,3.0,Withdrawal POS #000000803033/IC* INSTACART*159 WWW.INSTACART.COM/ SANFRANCISCO CACard 1231,3.0
5/27/2024,Withdrawal POS #000000794186/IC* INSTACART*159 WWW.INSTACART.COM/ SANFRANCISCO CACard 1231,37.72,Posted,70.1,2024-05-27,37.72,Withdrawal POS #000000794186/IC* INSTACART*159 WWW.INSTACART.COM/ SANFRANCISCO CACard 1231,37.72
5/27/2024,Withdrawal Bill Payment #000007088724/PAYPAL *IONOS INC 2211 North First8882211161 CACard 1231,17.0,Posted,107.82,2024-05-27,17.0,Withdrawal Bill Payment #000007088724/PAYPAL *IONOS INC 2211 North First8882211161 CACard 1231,17.0
5/26/2024,"Recurring Withdrawal Debit Card - MC Debit Seminol/NOTION LABS, INC. SAN FRANCISC CADate 05/24/24 0 4145017161 2 7372Card 1231",28.0,Posted,124.82,2024-05-26,28.0,"Recurring Withdrawal Debit Card - MC Debit Seminol/NOTION LABS, INC. SAN FRANCISC CADate 12/02/24 0 4337878572 0 7372Card 1231",27.52
5/26/2024,Recurring Withdrawal Debit Card - MC Debit Seminol/FS *ADOBE SANTA BARBAR CADate 05/24/24 0 4145014325 2 5734Card 1231,0.95,Posted,152.82,2024-05-26,0.95,Recurring Withdrawal Debit Card - MC Debit Seminol/FS *ADOBE SANTA BARBAR CADate 12/24/24 0 4359034647 1 5734Card 1231,0.95
5/26/2024,Withdrawal POS #000000000001/INSTACART*159 WWW.INSTACART.COM/ SANFRANCISCO CACard 1231,3.0,Posted,153.77,2024-05-26,3.0,Withdrawal POS #000000804821/INSTACART*159 WWW.INSTACART.COM/ SANFRANCISCO CACard 1231,3.0
5/26/2024,Withdrawal POS #000000782598/INSTACART*159 WWW.INSTACART.COM/ SANFRANCISCO CACard 1231,60.0,Posted,156.77,2024-05-26,60.0,Withdrawal POS #000000804821/INSTACART*159 WWW.INSTACART.COM/ SANFRANCISCO CACard 1231,60.0
5/25/2024,Withdrawal Bill Payment #000006272109/PAYPAL *IONOS INC 2211 North First8882211161 CACard 1231,7.0,Posted,16.77,2024-05-25,7.0,Withdrawal Bill Payment #000007088724/PAYPAL *IONOS INC 2211 North First8882211161 CACard 1231,7.0
5/24/2024,Recurring Withdrawal Debit Card - MC Debit Seminol/AIRTABLE.COM/BILL SAN FRANCISC CADate 05/24/24 0 4145150548 1 7372Card 1231,32.8,Posted,23.77,2024-05-24,32.8,Recurring Withdrawal Debit Card - MC Debit Seminol/AIRTABLE.COM/BILL SAN FRANCISC CADate 09/11/24 0 4255913774 0 7372Card 1231,32.8
5/24/2024,Recurring Withdrawal Debit Card - MC Debit Seminol/VIDIQ SAN FRANCISC CADate 05/23/24 0 4144928316 0 5734Card 1231,10.0,Posted,56.57,2024-05-24,10.0,Recurring Withdrawal Debit Card - MC Debit Seminol/KREA.AI SAN FRANCISC CADate 12/06/24 0 4341842673 0 5734Card 1231,10.0
5/21/2024,Withdrawal POS #000000797901/SUNOCO 8002212501 4234 SW 20TH AVEGAINESVILLE FLCard 1231,25.96,Posted,66.57,2024-05-21,25.96,Withdrawal POS #000000778591/SUNOCO 8002212501 4234 SW 20TH AVEGAINESVILLE FLCard 1231,25.96
5/21/2024,Withdrawal Bill Payment #000007101908/PAYPAL *IONOS INC 2211 North First8882211161 CACard 1231,7.0,Posted,92.53,2024-05-21,7.0,Withdrawal Bill Payment #000007088724/PAYPAL *IONOS INC 2211 North First8882211161 CACard 1231,7.0
5/21/2024,Recurring Withdrawal Debit Card - MC Debit Seminol/CANVA* I04157-41978019 CAMDEN DEDate 05/20/24 0 4141808212 0 7221Card 1231,12.99,Posted,99.53,2024-05-21,12.99,Recurring Withdrawal Debit Card - MC Debit Seminol/CANVA* I04249-43399962 CAMDEN DEDate 08/20/24 0 4233594945 0 7221Card 1231,12.99
5/21/2024,Recurring Withdrawal Debit Card - MC Debit Seminol/TUBEBUDDYCOM 8668823239 CADate 05/20/24 0 4141845145 0 5734Card 1231,7.5,Posted,112.52,2024-05-21,7.5,Recurring Withdrawal Debit Card - MC Debit Seminol/TUBEBUDDYCOM* 8668823239 CADate 12/03/24 0 4338443995 0 5045Card 1231,7.5
5/20/2024,Recurring Withdrawal Debit Card Fee/MASTERCARD ISSUER CROSS-BORDER FEEDate 05/19/24 0 4140937257 0 5734Card 1231,0.07,Posted,120.02,2024-05-20,0.07,Recurring Withdrawal Debit Card Fee/MASTERCARD ISSUER CROSS-BORDER FEEDate 02/25/24 0 4056812425 0 4816Card 1231,0.04
5/20/2024,Recurring Withdrawal Debit Card - MC Debit Seminol/PAYPAL *PADDLE.NET 35314369001 GBDate 05/19/24 0 4140937257 0 5734Card 1231,9.0,Posted,120.09,2024-05-20,9.0,Recurring Withdrawal Debit Card - MC Debit Seminol/PAYPAL *PADDLE.NET 35314369001 GBDate 05/19/24 0 4140937257 0 5734Card 1231,9.0
5/20/2024,Withdrawal POS #000003232252/GOOGLE *YouTubePremium 1600 AmphitheatreParkw Mountain View CACard 1231,15.92,Posted,129.09,2024-05-20,15.92,"Withdrawal POS #000020312090/GOOGLE *YouTubePremium 1600 Amphitheatre
Parkw Mountain View CA
Card 1247",15.92
5/19/2024,Withdrawal POS #000000680126/WAWA 5325 2373 SW ARCHER ROADFLCard 1231,18.03,Posted,145.01,2024-05-19,18.03,Withdrawal POS #000000553411/WAWA 5325 2373 SW ARCHER ROADFLCard 1247,18.03
5/19/2024,Recurring Withdrawal Debit Card - MC Debit Seminol/SUPERPOWER CHATGPT MIDDLETOWN DEDate 05/17/24 0 4138018304 2 5734Card 1231,15.0,Posted,163.04,2024-05-19,15.0,Recurring Withdrawal Debit Card - MC Debit Seminol/SUPERPOWER CHATGPT MIDDLETOWN DEDate 12/17/24 0 4352703539 1 5734Card 1231,15.0
5/19/2024,Recurring Withdrawal Debit Card Fee/MASTERCARD ISSUER CROSS-BORDER FEEDate 05/18/24 0 4139958413 0 5734Card 1231,0.05,Posted,178.04,2024-05-19,0.05,Recurring Withdrawal Debit Card Fee/MASTERCARD ISSUER CROSS-BORDER FEEDate 12/31/23 0 3365740203 0 5734Card 2801,0.10500000000000001
5/19/2024,Recurring Withdrawal Debit Card - MC Debit Seminol/SAVE TO NOTION VAUREAL ILDate 05/18/24 0 4139958413 0 5734Card 1231,5.99,Posted,178.09,2024-05-19,5.99,Recurring Withdrawal Debit Card - MC Debit Seminol/SAVE TO NOTION VAUREAL ILDate 12/18/24 0 4353969048 0 5734Card 1231,5.99
5/19/2024,Recurring Withdrawal Debit Card - MC Debit Seminol/WORDPRESS ZMTWVYVHAL SAN FRANCISC CADate 05/18/24 0 4139958144 0 7372Card 1231,9.0,Posted,184.08,2024-05-19,9.0,Recurring Withdrawal Debit Card - MC Debit Seminol/WORDPRESS YLZK812XJ6 SAN FRANCISC CADate 07/18/24 0 4200709907 0 5734Card 1231,9.0
5/19/2024,Withdrawal Debit Card Fee/MASTERCARD ISSUER CROSS-BORDER FEEDate 05/16/24 0 4137015306 2 4816Card 1231,0.12,Posted,193.08,2024-05-19,0.12,Withdrawal Debit Card Fee/MASTERCARD ISSUER CROSS-BORDER FEEDate 05/13/24 0 4134864561 0 5734Card 1231,0.19142857142857142
5/19/2024,Withdrawal Debit Card MC Debit Seminol/PAYPAL *2CO.COM 35314369001 NLDate 05/16/24 0 4137015306 2 4816Card 1231,14.99,Posted,193.2,2024-05-19,14.99,Withdrawal Debit Card MC Debit Seminol/PAYPAL *2CO.COM 35314369001 NLDate 05/16/24 0 4137015306 2 4816Card 1231,14.99
5/19/2024,Withdrawal POS #000000795687/IC* INSTACART*159 WWW.INSTACART.COM/ SANFRANCISCO CACard 1231,3.0,Posted,208.19,2024-05-19,3.0,Withdrawal POS #000000794186/IC* INSTACART*159 WWW.INSTACART.COM/ SANFRANCISCO CACard 1231,3.0
5/19/2024,Withdrawal POS #000000784752/IC* INSTACART*159 WWW.INSTACART.COM/ SANFRANCISCO CACard 1231,46.0,Posted,211.19,2024-05-19,46.0,Withdrawal POS #000000794186/IC* INSTACART*159 WWW.INSTACART.COM/ SANFRANCISCO CACard 1231,46.0
5/17/2024,Recurring Withdrawal Debit Card - MC Debit Seminol/LINKTREE* LINKTREE DOVER DEDate 05/16/24 0 4137933466 0 7399Card 1231,9.0,Posted,257.19,2024-05-17,9.0,Recurring Withdrawal Debit Card - MC Debit Seminol/LINKTREE* LINKTREE DOVER DEDate 04/16/24 0 4107289275 0 7399Card 1231,9.0
5/17/2024,Recurring Withdrawal Debit Card - MC Debit Seminol/MYDESIGNS - PRO - MON LAS VEGAS NVDate 05/16/24 0 4137953308 0 5734Card 1231,29.99,Posted,266.19,2024-05-17,29.99,Recurring Withdrawal Debit Card - MC Debit Seminol/MYDESIGNS - PRO - MON LAS VEGAS NVDate 12/08/24 0 4343357881 0 5734Card 1231,29.99
5/17/2024,Recurring Withdrawal Debit Card - MC Debit Seminol/PADDLE.NET* LEONARDOAI ASTORIA NYDate 05/16/24 0 4137285984 0 5817Card 1231,9.0,Posted,296.18,2024-05-17,9.0,Recurring Withdrawal Debit Card - MC Debit Seminol/PADDLE.NET* LEONARDOAI ASTORIA NYDate 12/16/24 0 4351323834 0 5817Card 1231,9.0
5/17/2024,Recurring Withdrawal Debit Card - MC Debit Seminol/PADDLE.NET* SETAPP ASTORIA NYDate 05/16/24 0 4137932128 0 5817Card 1231,12.49,Posted,305.18,2024-05-17,12.49,Recurring Withdrawal Debit Card - MC Debit Seminol/PADDLE.NET* SETAPP NEW YORK NYDate 10/14/24 0 4288882561 0 5817Card 1231,12.49
5/17/2024,Recurring Withdrawal Debit Card - MC Debit Seminol/WWW.EVERBEE.IO AUSTIN TXDate 05/16/24 0 4137932088 0 5734Card 1231,29.99,Posted,317.67,2024-05-17,29.99,Recurring Withdrawal Debit Card - MC Debit Seminol/WWW.EVERBEE.IO AUSTIN TXDate 12/04/24 0 4339869891 0 5734Card 1231,29.99
5/17/2024,Recurring Withdrawal Debit Card Fee/MASTERCARD ISSUER CROSS-BORDER FEEDate 05/17/24 0 4138070362 1 5734Card 1231,0.06,Posted,347.66,2024-05-17,0.06,Recurring Withdrawal Debit Card Fee/MASTERCARD ISSUER CROSS-BORDER FEEDate 06/15/24 0 4167922806 1 5734Card 1231,0.08
5/17/2024,Recurring Withdrawal Debit Card - MC Debit Seminol/IDEOGRAM.AI TORONTO ONDate 05/17/24 0 4138070362 1 5734Card 1231,8.0,Posted,347.72,2024-05-17,8.0,Withdrawal Debit Card MC Debit Seminol/IDEOGRAM.AI TORONTO ONDate 04/15/24 0 4106835174 0 5734Card 1231,8.190000000000001
5/17/2024,Withdrawal POS #000000585746/SUNOCO 8002212501 4234 SW 20TH AVEGAINESVILLE FLCard 1231,37.78,Posted,355.72,2024-05-17,37.78,Withdrawal POS #000000555763/SUNOCO 8002212501 4234 SW 20TH AVEGAINESVILLE FLCard 1231,38.21
5/16/2024,Withdrawal Debit Card Fee/MASTERCARD ISSUER CROSS-BORDER FEEDate 05/13/24 0 4134864561 0 5734Card 1231,0.62,Posted,393.5,2024-05-16,0.62,Withdrawal Debit Card Fee/MASTERCARD ISSUER CROSS-BORDER FEEDate 05/13/24 0 4134864561 0 5734Card 1231,0.19142857142857142
5/16/2024,Withdrawal Debit Card MC Debit Seminol/PAYPAL *PADDLE.NET 07790810231 GBDate 05/13/24 0 4134864561 0 5734Card 1231,77.07,Posted,394.12,2024-05-16,77.07,Withdrawal Debit Card MC Debit Seminol/PAYPAL *PADDLE.NET 07790810231 GBDate 05/13/24 0 4134864561 0 5734Card 1231,77.07
5/15/2024,Withdrawal POS #000000534382/SUNOCO 8002212501 4234 SW 20TH AVEGAINESVILLE FLCard 1231,37.78,Posted,386.19,2024-05-15,37.78,Withdrawal POS #000000175132/SUNOCO 8002212501 4234 SW 20TH AVEGAINESVILLE FLCard 1231,37.78
5/15/2024,Recurring Withdrawal Debit Card - MC Debit Seminol/MIDJOURNEY INC. SOUTH SAN FR CADate 05/14/24 0 4135994595 0 5734Card 1231,10.0,Posted,423.97,2024-05-15,10.0,Recurring Withdrawal Debit Card - MC Debit Seminol/MIDJOURNEY INC. SOUTH SAN FR CADate 05/14/24 0 4135994595 0 5734Card 1231,10.0
5/15/2024,Recurring Withdrawal Debit Card Fee/MASTERCARD ISSUER CROSS-BORDER FEEDate 05/15/24 0 4136993433 0 5734Card 1231,0.13,Posted,433.97,2024-05-15,0.13,Recurring Withdrawal Debit Card Fee/MASTERCARD ISSUER CROSS-BORDER FEEDate 12/31/23 0 3365740203 0 5734Card 2801,0.10500000000000001
5/15/2024,Recurring Withdrawal Debit Card - MC Debit Seminol/VANCEAI CENTRAL HODate 05/15/24 0 4136993433 0 5734Card 1231,15.9,Posted,434.1,2024-05-15,15.9,Recurring Withdrawal Debit Card - MC Debit Seminol/VANCEAI CENTRAL HODate 06/15/24 0 4167922806 1 5734Card 1231,15.9
5/15/2024,Withdrawal Debit Card MC Debit Seminol/CHIPOTLE ONLINE CHIPOTLE.COM CADate 05/14/24 0 4135921741 0 5814Card 1231,41.0,Posted,450.0,2024-05-15,41.0,Withdrawal Debit Card MC Debit Seminol/CHIPOTLE ONLINE CHIPOTLE.COM CADate 05/14/24 0 4135921741 0 5814Card 1231,41.0
5/15/2024,Withdrawal POS #000004117844/PAYPAL *PLAYSTATION 2211 North FirstStreet 8882211161 CACard 1231,9.99,Posted,491.0,2024-05-15,9.99,Withdrawal POS #000004117844/PAYPAL *PLAYSTATION 2211 North FirstStreet 8882211161 CACard 1231,9.99
5/14/2024,Recurring Withdrawal Debit Card - MC Debit Seminol/OPENAI SAN FRANCISC CADate 05/14/24 0 4135914307 0 5734Card 1231,15.02,Posted,500.99,2024-05-14,15.02,Withdrawal Debit Card MC Debit Seminol/OPENAI SAN FRANCISC CADate 02/16/24 0 4047896474 1 5734Card 1231,15.026
5/14/2024,Recurring Withdrawal Debit Card - MC Debit Seminol/SUPERPOWER CHATGPT MIDDLETOWN DEDate 05/13/24 0 4134368690 0 5734Card 1231,15.0,Posted,516.01,2024-05-14,15.0,Recurring Withdrawal Debit Card - MC Debit Seminol/SUPERPOWER CHATGPT MIDDLETOWN DEDate 12/17/24 0 4352703539 1 5734Card 1231,15.0
5/14/2024,Recurring Withdrawal Debit Card Fee/MASTERCARD ISSUER CROSS-BORDER FEEDate 05/14/24 0 4135869366 0 5734Card 1231,0.03,Posted,531.01,2024-05-14,0.03,Withdrawal Debit Card Fee/MASTERCARD ISSUER CROSS-BORDER FEEDate 05/13/24 0 4134864561 0 5734Card 1231,0.19142857142857142
5/14/2024,Recurring Withdrawal Debit Card - MC Debit Seminol/ETSYHUNT TECH SINGAPORE SGDate 05/14/24 0 4135869366 0 5734Card 1231,3.99,Posted,531.04,2024-05-14,3.99,Recurring Withdrawal Debit Card - MC Debit Seminol/ETSYHUNT TECH SINGAPORE SGDate 06/14/24 0 4166958438 0 5734Card 1231,3.99
5/14/2024,Withdrawal Debit Card MC Debit Seminol/WALGREENS #5024 GAINESVILLE FLDate 05/13/24 0 4134909562 0 5912Card 1231,15.0,Posted,535.03,2024-05-14,15.0,Withdrawal Debit Card MC Debit Seminol/WALGREENS #9304 GAINESVILLE FLDate 10/30/24 0 4304125853 1 5912Card 1231,15.0
5/13/2024,Withdrawal POS #000014536880/WALGREENS 2415 SW 75TH 2415 SW 75TH STGAINESVILLE FLCard 1231,27.24,Posted,550.03,2024-05-13,27.24,Withdrawal POS #000013340229/WALGREENS 2415 SW 75TH 2415 SW 75TH STGAINESVILLE FLCard 1231,27.24
5/13/2024,Withdrawal POS #000000293405/WAL-MART #1081 Wal-Mart Super CenterGAINESVILLE FLCard 1231,74.97,Posted,577.27,2024-05-13,74.97,Withdrawal POS #000000293405/WAL-MART #1081 Wal-Mart Super CenterGAINESVILLE FLCard 1231,74.97
5/13/2024,Withdrawal POS #000000450318/SUNOCO 8002212501 4234 SW 20TH AVEGAINESVILLE FLCard 1231,37.78,Posted,652.24,2024-05-13,37.78,Withdrawal POS #000000031004/SUNOCO 8002212501 4234 SW 20TH AVEGAINESVILLE FLCard 1231,37.78
5/13/2024,Recurring Withdrawal Debit Card - MC Debit Seminol/APPLE.COM/BILL 866-712-7753 CADate 05/13/24 0 4134846731 0 5818Card 1231,23.98,Posted,690.02,2024-05-13,23.98,Recurring Withdrawal Debit Card - MC Debit Seminol/APPLE.COM/BILL 866-712-7753 CADate 03/27/24 0 4087824766 0 5818Card 1231,23.98
5/12/2024,Withdrawal Debit Card MC Debit Seminol/CHIPOTLE ONLINE CHIPOTLE.COM CADate 05/11/24 0 4132095312 1 5814Card 1231,17.14,Posted,714.0,2024-05-12,17.14,Withdrawal Debit Card MC Debit Seminol/CHIPOTLE ONLINE CHIPOTLE.COM CADate 05/14/24 0 4135921741 0 5814Card 1231,17.66
5/12/2024,Recurring Withdrawal Debit Card - MC Debit Seminol/APPLE.COM/BILL 866-712-7753 CADate 05/10/24 0 4131679078 1 5818Card 1231,7.99,Posted,731.14,2024-05-12,7.99,Recurring Withdrawal Debit Card - MC Debit Seminol/APPLE.COM/BILL 866-712-7753 CADate 04/13/24 0 4104933092 1 5818Card 1231,7.99
5/12/2024,Recurring Withdrawal Debit Card - MC Debit Seminol/APPLE.COM/BILL 866-712-7753 CADate 05/10/24 0 4131679029 1 5818Card 1231,18.97,Posted,739.13,2024-05-12,18.97,Recurring Withdrawal Debit Card - MC Debit Seminol/APPLE.COM/BILL 866-712-7753 CADate 04/13/24 0 4104933092 1 5818Card 1231,18.97
5/10/2024,Withdrawal POS #000000000004/INSTACART*159 WWW.INSTACART.COM/ SANFRANCISCO CACard 1231,5.0,Posted,758.1,2024-05-10,5.0,Withdrawal POS #000000804821/INSTACART*159 WWW.INSTACART.COM/ SANFRANCISCO CACard 1231,5.0
5/10/2024,Withdrawal POS #000000805593/INSTACART*159 WWW.INSTACART.COM/ SANFRANCISCO CACard 1231,92.46,Posted,763.1,2024-05-10,92.46,Withdrawal POS #000000000003/INSTACART*159 WWW.INSTACART.COM/ SANFRANCISCO CACard 1231,92.46
5/10/2024,Withdrawal ACH FLUENT-Gainesvil/TYPE: PAYMENT ID: 1371804719CO: FLUENT-GainesvilNAME: steven chaplinskiEntry Class Code: WEB,68.0,Posted,855.56,2024-05-10,68.0,Withdrawal ACH FLUENT-Gainesvil/TYPE: PAYMENT ID: 1371804719CO: FLUENT-GainesvilNAME: steven chaplinski,68.0
5/9/2024,Withdrawal Debit Card MC Debit Seminol/WALGREENS #5024 GAINESVILLE FLDate 05/08/24 0 4129217598 1 5912Card 1231,10.81,Posted,923.56,2024-05-09,10.81,Withdrawal Debit Card MC Debit Seminol/WALGREENS #9304 GAINESVILLE FLDate 10/30/24 0 4304125853 1 5912Card 1231,10.81
5/8/2024,Withdrawal POS #000000246839/SUNOCO 8002212501 4234 SW 20TH AVEGAINESVILLE FLCard 1231,34.24,Posted,934.37,2024-05-08,34.24,Withdrawal POS #000000488663/SUNOCO 8002212501 4234 SW 20TH AVEGAINESVILLE FLCard 1231,34.24
5/8/2024,Withdrawal POS #000011384494/PAYPAL *PLAYSTATION 2211 North FirstStreet 8882211161 CACard 1231,14.99,Posted,968.61,2024-05-08,14.99,Withdrawal POS #000004117844/PAYPAL *PLAYSTATION 2211 North FirstStreet 8882211161 CACard 1231,14.99
5/7/2024,Withdrawal POS #000000786829/INSTACART*159 WWW.INSTACART.COM/ SANFRANCISCO CACard 1231,5.0,Posted,983.6,2024-05-07,5.0,Withdrawal POS #000000804821/INSTACART*159 WWW.INSTACART.COM/ SANFRANCISCO CACard 1231,5.0
5/7/2024,Withdrawal POS #000000792260/INSTACART*159 WWW.INSTACART.COM/ SANFRANCISCO CACard 1231,86.0,Posted,988.6,2024-05-07,86.0,Withdrawal POS #000000792733/INSTACART*159 WWW.INSTACART.COM/ SANFRANCISCO CACard 1231,85.995
5/6/2024,Recurring Withdrawal Bill Payment - #000000343444/NETFLIX COM LOS GATOS CACard 1231,13.81,Posted,1074.6,2024-05-06,13.81,"Recurring Withdrawal Bill Payment - #000000017652/NETFLIX COM LOS GATOS CA
Card 1247",13.504999999999999
5/6/2024,Withdrawal POS #000000171901/SUNOCO 8002212501 4234 SW 20TH AVEGAINESVILLE FLCard 1231,37.78,Posted,1088.41,2024-05-06,37.78,Withdrawal POS #000000778591/SUNOCO 8002212501 4234 SW 20TH AVEGAINESVILLE FLCard 1231,38.010000000000005
5/5/2024,Recurring Withdrawal Debit Card - MC Debit Seminol/CHATGPT SUBSCRIPTION SAN FRANCISC CADate 05/04/24 0 4125659188 0 5734Card 1231,20.0,Posted,1126.19,2024-05-05,20.0,Recurring Withdrawal Debit Card - MC Debit Seminol/CHATGPT SUBSCRIPTION SAN FRANCISC CADate 05/04/24 0 4125659188 0 5734Card 1231,20.0
5/5/2024,Withdrawal Debit Card MC Debit Seminol/CANNAMD 855-4209170 FLDate 05/03/24 0 4124568142 1 8011Card 1231,195.0,Posted,1146.19,2024-05-05,195.0,Withdrawal Debit Card MC Debit Seminol/CANNAMD 855-4209170 FLDate 12/19/24 0 4354703841 0 8011Card 1231,195.0
5/5/2024,Recurring Withdrawal Debit Card - MC Debit Seminol/APPLE.COM/BILL CUPERTINO CADate 05/03/24 0 4124646881 1 5735Card 1231,2.99,Posted,1341.19,2024-05-05,2.99,Recurring Withdrawal Debit Card - MC Debit Seminol/APPLE.COM/BILL CUPERTINO CADate 05/03/24 0 4124646881 1 5735Card 1231,2.99
5/5/2024,Recurring Withdrawal Debit Card - MC Debit Seminol/APPLE.COM/BILL 866-712-7753 CADate 05/04/24 0 4125577568 0 5818Card 1231,2.99,Posted,1344.18,2024-05-05,2.99,Recurring Withdrawal Debit Card - MC Debit Seminol/APPLE.COM/BILL 866-712-7753 CADate 01/08/24 0 4008756344 0 5818Card 2801,2.99
5/5/2024,Withdrawal Bill Payment #000009057953/PAYPAL *PARAMNTPLUS 2211 North FirstStreet 8882211161 CACard 1231,13.81,Posted,1347.17,2024-05-05,13.81,Withdrawal Bill Payment #000009216703/PAYPAL *PARAMNTPLUS 2211 North FirstStreet 8882211161 CACard 1231,13.81
5/3/2024,Recurring Withdrawal Debit Card - MC Debit Seminol/DOCSIUM.COM SANTA CLARA CADate 05/02/24 0 4123905624 0 5734Card 1231,10.0,Posted,1360.98,2024-05-03,10.0,Recurring Withdrawal Debit Card - MC Debit Seminol/DOCSIUM.COM SANTA CLARA CADate 07/02/24 0 4184077595 1 5734Card 1231,10.0
5/3/2024,Recurring Withdrawal Debit Card - MC Debit Seminol/INVIDEO INC COUNTRY OF S DEDate 05/02/24 0 4123988858 0 5734Card 1231,50.0,Posted,1370.98,2024-05-03,50.0,Recurring Withdrawal Debit Card - MC Debit Seminol/INVIDEO INC COUNTRY OF S DEDate 12/09/24 0 4344808122 0 5734Card 1231,50.0
5/3/2024,Withdrawal Debit Card MC Debit Seminol/COX GAINESVILLE COMM 800-234-3993 FLDate 05/02/24 0 4123982882 0 4899Card 1231,126.13,Posted,1420.98,2024-05-03,126.13,Withdrawal Debit Card MC Debit Seminol/COX GAINESVILLE COMM 800-234-3993 FLDate 12/04/24 0 4339376311 0 4899Card 1231,126.13
5/3/2024,"Withdrawal Bill Payment #000000774654/Adobe Park Avenue,345 San Jose CACard 1231",19.99,Posted,1547.11,2024-05-03,19.99,"Withdrawal Bill Payment #000000352498/Adobe Park Avenue,345 San Jose CACard 1247",19.99
5/3/2024,Withdrawal ACH Watson Realty Co/TYPE: WEB PMTS ID: 9000321157CO: Watson Realty CoNAME: Steven chaplinskiEntry Class Code: WEB,1079.0,Posted,1567.1,2024-05-03,1079.0,"Withdrawal ACH Watson Realty Co/TYPE: WEB PMTS ID: 9000321157
CO: Watson Realty Co
NAME: Steven chaplinskiEntry Class Code: WEB",1079.0
5/3/2024,"Withdrawal ACH AppFolio, Inc. F/TYPE: WEB PMTS ID: 9001406550CO: AppFolio, Inc. FNAME: Steven chaplinskiEntry Class Code: WEB",2.49,Posted,2646.1,2024-05-03,2.49,"Withdrawal ACH AppFolio, Inc. F/TYPE: WEB PMTS ID: 9001406550
CO: AppFolio, Inc. F
NAME: Steven chaplinskiEntry Class Code: WEB",2.49
5/2/2024,Withdrawal Bill Payment #000000284847/GRU EZ PAY 301 SE 4TH AVE 301 SE 4TH AVCard 1231,132.23,Posted,2648.59,2024-05-02,132.23,Withdrawal Bill Payment #000000483994/GRU EZ PAY 301 SE 4TH AVE 301 SE 4TH AVCard 1247,132.23
5/2/2024,Withdrawal Bill Payment #050211031354/PAYPAL *SPOTIFYUSAI 2211 North FirstStreet San Jose CACard 1231,6.82,Posted,2780.82,2024-05-02,6.82,Withdrawal Bill Payment #050211031354/PAYPAL *SPOTIFYUSAI 2211 North FirstStreet San Jose CACard 1231,6.82
5/2/2024,Withdrawal POS #000000804821/INSTACART*159 WWW.INSTACART.COM/ SANFRANCISCO CACard 1231,3.0,Posted,2787.64,2024-05-02,3.0,Withdrawal POS #000000804821/INSTACART*159 WWW.INSTACART.COM/ SANFRANCISCO CACard 1231,3.0
5/2/2024,Withdrawal POS #000000793624/INSTACART*159 WWW.INSTACART.COM/ SANFRANCISCO CACard 1231,94.95,Posted,2790.64,2024-05-02,94.95,Withdrawal POS #000000792733/INSTACART*159 WWW.INSTACART.COM/ SANFRANCISCO CACard 1231,94.95
5/1/2024,Withdrawal POS #000000217221/SUNOCO 8002212501 4234 SW 20TH AVEGAINESVILLE FLCard 1231,37.78,Posted,2885.59,2024-05-01,37.78,Withdrawal POS #000000028242/SUNOCO 8002212501 4234 SW 20TH AVEGAINESVILLE FLCard 1231,37.78
4/28/2024,Recurring Withdrawal Debit Card - MC Debit Seminol/BLAZE TODAY SUNNYVALE CADate 04/26/24 0 4117285439 0 5734Card 1231,8.39,Posted,123.37,2024-04-28,8.39,Recurring Withdrawal Debit Card - MC Debit Seminol/BLAZE TODAY SUNNYVALE CADate 05/26/24 0 4147283808 0 5734Card 1231,8.39
4/27/2024,Withdrawal Bill Payment #000008086025/PAYPAL *IONOS INC 2211 North FirstSan Jose CACard 1231,17.0,Posted,131.76,2024-04-27,17.0,Withdrawal Bill Payment #000003047046/PAYPAL *HOSTGATOR 2211 North FirstSan Jose CACard 1231,17.0
4/26/2024,Withdrawal POS #000000031004/SUNOCO 8002212501 4234 SW 20TH AVEGAINESVILLE FLCard 1231,37.78,Posted,148.76,2024-04-26,37.78,Withdrawal POS #000000031004/SUNOCO 8002212501 4234 SW 20TH AVEGAINESVILLE FLCard 1231,37.78
4/26/2024,Recurring Withdrawal Debit Card - MC Debit Seminol/FS *RAINDROP.IO SANTA BARBAR CADate 04/25/24 0 4116899101 0 5734Card 1231,3.0,Posted,186.54,2024-04-26,3.0,Recurring Withdrawal Debit Card - MC Debit Seminol/FS *ADOBE SANTA BARBAR CADate 12/24/24 0 4359034647 1 5734Card 1231,3.0
4/26/2024,Withdrawal Debit Card MC Debit Seminol/CIRCLE K # 06782 GAINESVILLE FLDate 04/24/24 0 4115893649 0 5499Card 1231,21.04,Posted,189.54,2024-04-26,21.04,Withdrawal Debit Card MC Debit Seminol/CIRCLE K # 06782 GAINESVILLE FLDate 09/08/24 0 4252889868 0 5499Card 1231,21.405
4/26/2024,Recurring Withdrawal Debit Card - MC Debit Seminol/APPLE.COM/BILL 866-712-7753 CADate 04/25/24 0 4116886532 0 5818Card 1231,5.99,Posted,210.58,2024-04-26,5.99,Recurring Withdrawal Debit Card - MC Debit Seminol/APPLE.COM/BILL 866-712-7753 CADate 03/27/24 0 4087824766 0 5818Card 1231,5.99
4/25/2024,Withdrawal POS #000000772089/INSTACART*159 WWW.INSTACART.COM/ SANFRANCISCO CACard 1231,1.0,Posted,216.57,2024-04-25,1.0,Withdrawal POS #000000772291/INSTACART*159 WWW.INSTACART.COM/ SANFRANCISCO CACard 1231,1.0
4/25/2024,Withdrawal POS #000000000765/INSTACART*159 WWW.INSTACART.COM/ SANFRANCISCO CACard 1231,65.4,Posted,217.57,2024-04-25,65.4,Withdrawal POS #000000000003/INSTACART*159 WWW.INSTACART.COM/ SANFRANCISCO CACard 1231,65.4
4/25/2024,"Recurring Withdrawal Debit Card - MC Debit Seminol/NOTION LABS, INC. SAN FRANCISC CADate 04/24/24 0 4115372320 0 7372Card 1231",27.04,Posted,282.97,2024-04-25,27.04,"Recurring Withdrawal Debit Card - MC Debit Seminol/NOTION LABS, INC. SAN FRANCISC CADate 12/02/24 0 4337878572 0 7372Card 1231",27.52
4/25/2024,Recurring Withdrawal Debit Card - MC Debit Seminol/FS *ADOBE SANTA BARBAR CADate 04/24/24 0 4115901267 0 5734Card 1231,0.95,Posted,310.01,2024-04-25,0.95,Recurring Withdrawal Debit Card - MC Debit Seminol/FS *ADOBE SANTA BARBAR CADate 12/24/24 0 4359034647 1 5734Card 1231,0.95
4/25/2024,Withdrawal Debit Card MC Debit Seminol/CHIPOTLE ONLINE CHIPOTLE.COM CADate 04/24/24 0 4115958339 0 5814Card 1231,18.0,Posted,310.96,2024-04-25,18.0,Withdrawal Debit Card MC Debit Seminol/CHIPOTLE ONLINE CHIPOTLE.COM CADate 05/14/24 0 4135921741 0 5814Card 1231,17.66
4/24/2024,Withdrawal POS #000002059014/PAYPAL *ETSY INC 2211 North First StreetSan Jose CACard 1231,19.76,Posted,328.96,2024-04-24,19.76,Withdrawal POS #000002059014/PAYPAL *ETSY INC 2211 North First StreetSan Jose CACard 1231,19.76
4/24/2024,Recurring Withdrawal Debit Card - MC Debit Seminol/GUMROAD.COM/C* AUCTOR SAN FRANCISC CADate 04/24/24 0 4115942524 0 5192Card 1231,5.35,Posted,348.72,2024-04-24,5.35,Recurring Withdrawal Debit Card - MC Debit Seminol/GUMROAD.COM/C* AUCTOR SAN FRANCISC CADate 04/24/24 0 4115942524 0 5192Card 1231,5.35
4/24/2024,Recurring Withdrawal Debit Card - MC Debit Seminol/GUMROAD.COM/C* AUCTOR SAN FRANCISC CADate 04/24/24 0 4115942523 0 5192Card 1231,5.35,Posted,354.07,2024-04-24,5.35,Recurring Withdrawal Debit Card - MC Debit Seminol/GUMROAD.COM/C* AUCTOR SAN FRANCISC CADate 04/24/24 0 4115942524 0 5192Card 1231,5.35
4/24/2024,Recurring Withdrawal Debit Card - MC Debit Seminol/VIDIQ SAN FRANCISC CADate 04/23/24 0 4114819971 0 5734Card 1231,10.0,Posted,359.42,2024-04-24,10.0,Withdrawal Debit Card MC Debit Seminol/VIDIQ SAN FRANCISC CADate 12/03/24 0 4338664809 1 5734Card 1231,10.0
4/24/2024,Withdrawal Debit Card Fee/MASTERCARD ISSUER CROSS-BORDER FEEDate 04/23/24 0 4114819674 0 7392Card 1231,0.08,Posted,369.42,2024-04-24,0.08,Withdrawal Debit Card Fee/MASTERCARD ISSUER CROSS-BORDER FEEDate 05/13/24 0 4134864561 0 5734Card 1231,0.19142857142857142
4/24/2024,Withdrawal Debit Card MC Debit Seminol/WWW.GLH-GR* BUSINESS A LONDON LNDate 04/23/24 0 4114819674 0 7392Card 1231,10.0,Posted,369.5,2024-04-24,10.0,Withdrawal Debit Card MC Debit Seminol/WWW.GLH-GR* BUSINESS A LONDON LNDate 04/23/24 0 4114819674 0 7392Card 1231,10.0
4/24/2024,Withdrawal Debit Card Fee/MASTERCARD ISSUER CROSS-BORDER FEEDate 04/23/24 0 4114819673 0 7392Card 1231,0.04,Posted,379.5,2024-04-24,0.04,Withdrawal Debit Card Fee/MASTERCARD ISSUER CROSS-BORDER FEEDate 05/13/24 0 4134864561 0 5734Card 1231,0.19142857142857142
4/24/2024,Withdrawal Debit Card MC Debit Seminol/WWW.GLH-GR* BUSINESS A LONDON LNDate 04/23/24 0 4114819673 0 7392Card 1231,5.0,Posted,379.54,2024-04-24,5.0,Withdrawal Debit Card MC Debit Seminol/WWW.GLH-GR* BUSINESS A LONDON LNDate 04/23/24 0 4114819674 0 7392Card 1231,5.0
4/23/2024,Withdrawal Debit Card MC Debit Seminol/AIRTABLE.COM/BILL SAN FRANCISC CADate 04/23/24 0 4114941463 0 7372Card 1231,24.0,Posted,384.54,2024-04-23,24.0,Recurring Withdrawal Debit Card - MC Debit Seminol/AIRTABLE.COM/BILL SAN FRANCISC CADate 09/11/24 0 4255913774 0 7372Card 1231,24.0
4/23/2024,Recurring Withdrawal Debit Card - MC Debit Seminol/OPENAI SAN FRANCISC CADate 04/23/24 0 4114941406 0 5734Card 1231,15.03,Posted,408.54,2024-04-23,15.03,Withdrawal Debit Card MC Debit Seminol/OPENAI SAN FRANCISC CADate 02/16/24 0 4047896474 1 5734Card 1231,15.026
4/23/2024,Recurring Withdrawal Debit Card - MC Debit Seminol/RUNWAY STANDARD PLAN NEWARK DEDate 04/22/24 0 4113848879 0 5734Card 1231,15.0,Posted,423.57,2024-04-23,15.0,Recurring Withdrawal Debit Card - MC Debit Seminol/RUNWAY STANDARD PLAN NEWARK DEDate 12/15/24 0 4350745942 1 5734Card 1231,15.0
4/23/2024,Withdrawal POS #000000851229/SUNOCO 8002212501 4234 SW 20TH AVEGAINESVILLE FLCard 1231,27.17,Posted,438.57,2024-04-23,27.17,Withdrawal POS #000000778591/SUNOCO 8002212501 4234 SW 20TH AVEGAINESVILLE FLCard 1231,27.17
4/22/2024,Withdrawal ACH FLUENT-Gainesvil/TYPE: PAYMENT ID: 1371804719CO: FLUENT-GainesvilNAME: steven chaplinskiEntry Class Code: WEB,65.0,Posted,465.74,2024-04-22,65.0,Withdrawal ACH FLUENT-Gainesvil/TYPE: PAYMENT ID: 1371804719CO: FLUENT-GainesvilNAME: steven chaplinski,65.0
4/22/2024,Withdrawal Bill Payment #000007322712/PAYPAL *IONOS INC 2211 North FirstSan Jose CACard 1231,7.0,Posted,530.74,2024-04-22,7.0,Withdrawal Bill Payment #000003047046/PAYPAL *HOSTGATOR 2211 North FirstSan Jose CACard 1231,7.0
4/21/2024,Recurring Withdrawal Debit Card - MC Debit Seminol/CANVA* I04127-28722894 CAMDEN DEDate 04/20/24 0 4111985987 0 7221Card 1231,12.99,Posted,537.74,2024-04-21,12.99,Recurring Withdrawal Debit Card - MC Debit Seminol/CANVA* I04249-43399962 CAMDEN DEDate 08/20/24 0 4233594945 0 7221Card 1231,12.99
4/21/2024,Withdrawal Debit Card MC Debit Seminol/CIRCLE K # 26146 GAINESVILLE FLDate 04/18/24 0 4109064505 2 5499Card 1231,9.02,Posted,550.73,2024-04-21,9.02,Withdrawal Debit Card MC Debit Seminol/CIRCLE K # 06782 GAINESVILLE FLDate 09/08/24 0 4252889868 0 5499Card 1231,9.02
4/21/2024,Recurring Withdrawal Debit Card - MC Debit Seminol/TUBEBUDDYCOM 8668823239 CADate 04/20/24 0 4111932836 0 5734Card 1231,7.5,Posted,559.75,2024-04-21,7.5,Recurring Withdrawal Debit Card - MC Debit Seminol/TUBEBUDDYCOM* 8668823239 CADate 12/03/24 0 4338443995 0 5045Card 1231,7.5
4/20/2024,Withdrawal POS #000003089132/GOOGLE *YouTubePremium 1600 AmphitheatreParkw Mountain View CACard 1231,15.92,Posted,567.25,2024-04-20,15.92,"Withdrawal POS #000020312090/GOOGLE *YouTubePremium 1600 Amphitheatre
Parkw Mountain View CA
Card 1247",15.92
4/19/2024,Recurring Withdrawal Debit Card - MC Debit Seminol/WORDPRESS 6ZJ0S7Z01P SAN FRANCISC CADate 04/18/24 0 4109333578 0 7372Card 1231,9.0,Posted,583.17,2024-04-19,9.0,Recurring Withdrawal Debit Card - MC Debit Seminol/WORDPRESS YLZK812XJ6 SAN FRANCISC CADate 07/18/24 0 4200709907 0 5734Card 1231,9.0
4/19/2024,Withdrawal Bill Payment #000003047046/PAYPAL *HOSTGATOR 2211 North FirstSan Jose CACard 1231,15.99,Posted,592.17,2024-04-19,15.99,Withdrawal Bill Payment #000003047046/PAYPAL *HOSTGATOR 2211 North FirstSan Jose CACard 1231,15.995000000000001
4/18/2024,Withdrawal POS #000000051270/SUNOCO 8002212501 4234 SW 20TH AVEGAINESVILLE FLCard 1231,34.24,Posted,608.16,2024-04-18,34.24,Withdrawal POS #000000031004/SUNOCO 8002212501 4234 SW 20TH AVEGAINESVILLE FLCard 1231,34.24
4/18/2024,"Recurring Withdrawal Debit Card - MC Debit Seminol/PROMPT HUNT, INC. LOS ANGELES CADate 04/18/24 0 4109016478 1 5734Card 1231",1.99,Posted,642.4,2024-04-18,1.99,"Recurring Withdrawal Debit Card - MC Debit Seminol/PROMPT HUNT, INC. LOS ANGELES CADate 04/18/24 0 4109016478 1 5734Card 1231",1.99
4/18/2024,Recurring Withdrawal Debit Card - MC Debit Seminol/ELEVENLABS.IO NEW YORK NYDate 04/17/24 0 4108862142 0 5734Card 1231,22.0,Posted,644.39,2024-04-18,22.0,Recurring Withdrawal Debit Card - MC Debit Seminol/ELEVENLABS.IO NEW YORK NYDate 04/17/24 0 4108862142 0 5734Card 1231,22.0
4/18/2024,Withdrawal Debit Card MC Debit Seminol/CHIPOTLE ONLINE CHIPOTLE.COM CADate 04/17/24 0 4108013128 1 5814Card 1231,18.0,Posted,666.39,2024-04-18,18.0,Withdrawal Debit Card MC Debit Seminol/CHIPOTLE ONLINE CHIPOTLE.COM CADate 05/14/24 0 4135921741 0 5814Card 1231,17.66
4/18/2024,Withdrawal POS #000000805331/IC* INSTACART*159 WWW.INSTACART.COM/ SANFRANCISCO CACard 1231,77.14,Posted,684.39,2024-04-18,77.14,Withdrawal POS #000000794186/IC* INSTACART*159 WWW.INSTACART.COM/ SANFRANCISCO CACard 1231,77.14
4/17/2024,Recurring Withdrawal Debit Card - MC Debit Seminol/LINKTREE* LINKTREE DOVER DEDate 04/16/24 0 4107289275 0 7399Card 1231,9.0,Posted,759.32,2024-04-17,9.0,Recurring Withdrawal Debit Card - MC Debit Seminol/LINKTREE* LINKTREE DOVER DEDate 04/16/24 0 4107289275 0 7399Card 1231,9.0
4/17/2024,Recurring Withdrawal Debit Card - MC Debit Seminol/SUPERPOWER CHATGPT MIDDLETOWN DEDate 04/17/24 0 4108980411 0 5734Card 1231,15.0,Posted,768.32,2024-04-17,15.0,Recurring Withdrawal Debit Card - MC Debit Seminol/SUPERPOWER CHATGPT MIDDLETOWN DEDate 12/17/24 0 4352703539 1 5734Card 1231,15.0
4/17/2024,Recurring Withdrawal Debit Card - MC Debit Seminol/OPENAI SAN FRANCISC CADate 04/16/24 0 4107145993 0 5734Card 1231,10.0,Posted,783.32,2024-04-17,10.0,Withdrawal Debit Card MC Debit Seminol/OPENAI SAN FRANCISC CADate 02/16/24 0 4047896474 1 5734Card 1231,10.0
4/17/2024,Withdrawal Debit Card Fee/MASTERCARD ISSUER CROSS-BORDER FEEDate 04/16/24 0 4107738492 1 5815Card 1231,0.06,Posted,793.32,2024-04-17,0.06,Withdrawal Debit Card Fee/MASTERCARD ISSUER CROSS-BORDER FEEDate 05/13/24 0 4134864561 0 5734Card 1231,0.19142857142857142
4/17/2024,Withdrawal Debit Card MC Debit Seminol/PHOTOPEA.COM KOSTELEC NAD CZDate 04/16/24 0 4107738492 1 5815Card 1231,7.68,Posted,793.38,2024-04-17,7.68,Withdrawal Debit Card MC Debit Seminol/PHOTOPEA.COM KOSTELEC NAD CZDate 04/16/24 0 4107738492 1 5815Card 1231,7.765
4/17/2024,Recurring Withdrawal Debit Card - MC Debit Seminol/MYDESIGNS - PRO - MON LAS VEGAS NVDate 04/16/24 0 4107736414 1 5734Card 1231,29.99,Posted,801.06,2024-04-17,29.99,Recurring Withdrawal Debit Card - MC Debit Seminol/MYDESIGNS.IO LAS VEGAS NVDate 10/18/24 0 4292077676 2 5734Card 1231,29.99
4/17/2024,Recurring Withdrawal Debit Card - MC Debit Seminol/PADDLE.NET* LEONARDOAI ASTORIA NYDate 04/16/24 0 4107288953 0 5817Card 1231,9.0,Posted,831.05,2024-04-17,9.0,Recurring Withdrawal Debit Card - MC Debit Seminol/PADDLE.NET* LEONARDOAI ASTORIA NYDate 12/16/24 0 4351323834 0 5817Card 1231,9.0
4/17/2024,Recurring Withdrawal Debit Card Fee/MASTERCARD ISSUER CROSS-BORDER FEEDate 04/17/24 0 4108978436 0 5734Card 1231,0.16,Posted,840.05,2024-04-17,0.16,Recurring Withdrawal Debit Card Fee/MASTERCARD ISSUER CROSS-BORDER FEEDate 01/06/24 0 4006875269 0 5815Card 2801,0.20272727272727267
4/17/2024,Recurring Withdrawal Debit Card - MC Debit Seminol/IDEOGRAM.AI TORONTO ONDate 04/17/24 0 4108978436 0 5734Card 1231,20.0,Posted,840.21,2024-04-17,20.0,Withdrawal Debit Card MC Debit Seminol/IDEOGRAM.AI TORONTO ONDate 04/15/24 0 4106835174 0 5734Card 1231,20.0
4/17/2024,Recurring Withdrawal Debit Card Fee/MASTERCARD ISSUER CROSS-BORDER FEEDate 04/17/24 0 4108978435 0 5734Card 1231,0.39,Posted,860.21,2024-04-17,0.39,Recurring Withdrawal Debit Card Fee/MASTERCARD ISSUER CROSS-BORDER FEEDate 01/06/24 0 4006875269 0 5815Card 2801,0.20272727272727267
4/17/2024,Recurring Withdrawal Debit Card - MC Debit Seminol/BROWSE.AI PLAN BURNABY BCDate 04/17/24 0 4108978435 0 5734Card 1231,48.75,Posted,860.6,2024-04-17,48.75,Recurring Withdrawal Debit Card - MC Debit Seminol/BROWSE.AI PLAN BURNABY BCDate 04/17/24 0 4108978435 0 5734Card 1231,48.75
4/17/2024,Recurring Withdrawal Debit Card - MC Debit Seminol/APPLE.COM/BILL 866-712-7753 CADate 04/17/24 0 4108973709 0 5818Card 1231,6.99,Posted,909.35,2024-04-17,6.99,Recurring Withdrawal Debit Card - MC Debit Seminol/APPLE.COM/BILL 866-712-7753 CADate 01/08/24 0 4008756344 0 5818Card 2801,7.49
4/17/2024,Recurring Withdrawal Debit Card - MC Debit Seminol/APPLE.COM/BILL 866-712-7753 CADate 04/17/24 0 4108973707 0 5818Card 1231,10.99,Posted,916.34,2024-04-17,10.99,Recurring Withdrawal Debit Card - MC Debit Seminol/APPLE.COM/BILL 866-712-7753 CADate 01/08/24 0 4008756344 0 5818Card 2801,10.49
4/17/2024,Withdrawal POS #041705070341/PAYPAL *FASTSPRING 2211 North FirstSan Jose CACard 1231,15.0,Posted,927.33,2024-04-17,15.0,Withdrawal POS #041705070341/PAYPAL *FASTSPRING 2211 North FirstSan Jose CACard 1231,15.0
4/17/2024,Withdrawal POS #000000796638/SUNOCO 8002212501 4234 SW 20TH AVEGAINESVILLE FLCard 1231,41.1,Posted,942.33,2024-04-17,41.1,Withdrawal POS #000000966158/SUNOCO 8002212501 4234 SW 20TH AVEGAINESVILLE FLCard 2801,41.1
4/16/2024,Recurring Withdrawal Debit Card - MC Debit Seminol/PADDLE.NET* SETAPP ASTORIA NYDate 04/15/24 0 4106277865 0 5817Card 1231,12.49,Posted,983.43,2024-04-16,12.49,Recurring Withdrawal Debit Card - MC Debit Seminol/PADDLE.NET* SETAPP NEW YORK NYDate 10/14/24 0 4288882561 0 5817Card 1231,12.49
4/16/2024,Withdrawal Debit Card MC Debit Seminol/LYFT *2 RIDES 04-14 SAN FRANCISC CADate 04/15/24 0 4106835374 0 4121Card 1231,31.52,Posted,995.92,2024-04-16,31.52,Withdrawal Debit Card MC Debit Seminol/LYFT *2 RIDES 04-14 SAN FRANCISC CADate 04/15/24 0 4106835374 0 4121Card 1231,31.52
4/16/2024,Withdrawal Debit Card MC Debit Seminol/IDEOGRAM.AI TORONTO ONDate 04/15/24 0 4106835174 0 5734Card 1231,0.58,Posted,1027.44,2024-04-16,0.58,Withdrawal Debit Card MC Debit Seminol/IDEOGRAM.AI TORONTO ONDate 04/15/24 0 4106835174 0 5734Card 1231,0.58
4/16/2024,Withdrawal POS #000006227588/PAYPAL *SOCIALBLADE 2211 North FirstStreet San Jose CACard 1231,3.99,Posted,1028.02,2024-04-16,3.99,Withdrawal POS #000006227588/PAYPAL *SOCIALBLADE 2211 North FirstStreet San Jose CACard 1231,3.99
4/16/2024,Withdrawal POS #000000665593/SUNOCO 8002212501 4234 SW 20TH AVEGAINESVILLE FLCard 1231,37.42,Posted,1032.01,2024-04-16,37.42,Withdrawal POS #000000488663/SUNOCO 8002212501 4234 SW 20TH AVEGAINESVILLE FLCard 1231,37.42
4/15/2024,Recurring Withdrawal Debit Card - MC Debit Seminol/MIDJOURNEY INC. SOUTH SAN FR CADate 04/14/24 0 4105078963 1 5734Card 1231,10.0,Posted,1069.43,2024-04-15,10.0,Recurring Withdrawal Debit Card - MC Debit Seminol/MIDJOURNEY INC. SOUTH SAN FR CADate 05/14/24 0 4135994595 0 5734Card 1231,10.0
4/15/2024,Recurring Withdrawal Debit Card Fee/MASTERCARD ISSUER CROSS-BORDER FEEDate 04/15/24 0 4106077756 1 5734Card 1231,0.13,Posted,1079.43,2024-04-15,0.13,Recurring Withdrawal Debit Card Fee/MASTERCARD ISSUER CROSS-BORDER FEEDate 06/15/24 0 4167922806 1 5734Card 1231,0.08
4/15/2024,Recurring Withdrawal Debit Card - MC Debit Seminol/VANCEAI CENTRAL HODate 04/15/24 0 4106077756 1 5734Card 1231,15.9,Posted,1079.56,2024-04-15,15.9,Recurring Withdrawal Debit Card - MC Debit Seminol/VANCEAI CENTRAL HODate 06/15/24 0 4167922806 1 5734Card 1231,15.9
4/15/2024,Withdrawal Debit Card MC Debit Seminol/WALGREENS #5024 GAINESVILLE FLDate 04/14/24 0 4105827629 0 5912Card 1231,16.39,Posted,1095.46,2024-04-15,16.39,Withdrawal Debit Card MC Debit Seminol/WALGREENS #9304 GAINESVILLE FLDate 10/30/24 0 4304125853 1 5912Card 1231,16.39
4/15/2024,Withdrawal POS #000001042040/PAYPAL *PLAYSTATION 2211 North FirstStreet San Jose CACard 1231,14.99,Posted,1111.85,2024-04-15,14.99,Withdrawal POS #000001042040/PAYPAL *PLAYSTATION 2211 North FirstStreet San Jose CACard 1231,14.99
4/15/2024,Withdrawal POS #000012007844/PAYPAL *PLAYSTATION 2211 North FirstStreet San Jose CACard 1231,24.99,Posted,1126.84,2024-04-15,24.99,Withdrawal POS #000001042040/PAYPAL *PLAYSTATION 2211 North FirstStreet San Jose CACard 1231,24.99
4/14/2024,Withdrawal POS #000000590860/SUNOCO 8002212501 4234 SW 20TH AVEGAINESVILLE FLCard 1231,25.96,Posted,1151.83,2024-04-14,25.96,Withdrawal POS #000000900121/SUNOCO 8002212501 4234 SW 20TH AVEGAINESVILLE FLCard 1231,25.96
4/14/2024,Withdrawal Debit Card MC Debit Seminol/LYFT *2 RIDES 04-11 SAN FRANCISC CADate 04/12/24 0 4103370191 0 4121Card 1231,38.92,Posted,1177.79,2024-04-14,38.92,Withdrawal Debit Card MC Debit Seminol/LYFT *2 RIDES 04-14 SAN FRANCISC CADate 04/15/24 0 4106835374 0 4121Card 1231,38.92
4/14/2024,Recurring Withdrawal Debit Card - MC Debit Seminol/APPLE.COM/BILL 866-712-7753 CADate 04/13/24 0 4104933092 1 5818Card 1231,22.47,Posted,1216.71,2024-04-14,22.47,Recurring Withdrawal Debit Card - MC Debit Seminol/APPLE.COM/BILL 866-712-7753 CADate 04/13/24 0 4104933092 1 5818Card 1231,22.47
4/12/2024,Withdrawal POS #000000773144/INSTACART*159 WWW.INSTACART.COM/ SANFRANCISCO CACard 1231,5.0,Posted,1239.18,2024-04-12,5.0,Withdrawal POS #000000792733/INSTACART*159 WWW.INSTACART.COM/ SANFRANCISCO CACard 1231,5.0
4/12/2024,Withdrawal POS #000000772370/INSTACART*159 WWW.INSTACART.COM/ SANFRANCISCO CACard 1231,90.0,Posted,1244.18,2024-04-12,90.0,Withdrawal POS #000000792733/INSTACART*159 WWW.INSTACART.COM/ SANFRANCISCO CACard 1231,90.0
4/12/2024,Withdrawal POS #000000518066/SUNOCO 8002212501 4234 SW 20TH AVEGAINESVILLE FLCard 1231,30.7,Posted,1334.18,2024-04-12,30.7,Withdrawal POS #000000488663/SUNOCO 8002212501 4234 SW 20TH AVEGAINESVILLE FLCard 1231,30.7
4/10/2024,Withdrawal POS #000000618024/SUNOCO 8002212501 4234 SW 20TH AVEGAINESVILLE FLCard 1231,37.78,Posted,1364.88,2024-04-10,37.78,Withdrawal POS #000000028242/SUNOCO 8002212501 4234 SW 20TH AVEGAINESVILLE FLCard 1231,37.78
4/10/2024,Withdrawal Debit Card MC Debit Seminol/LYFT *1 RIDE 04-08 SAN FRANCISC CADate 04/09/24 0 4100802332 0 4121Card 1231,8.67,Posted,902.66,2024-04-10,8.67,Withdrawal Debit Card MC Debit Seminol/LYFT *2 RIDES 04-14 SAN FRANCISC CADate 04/15/24 0 4106835374 0 4121Card 1231,8.67
4/10/2024,Withdrawal ACH FLUENT-Gainesvil/TYPE: PAYMENT ID: 1371804719CO: FLUENT-GainesvilNAME: steven chaplinskiEntry Class Code: WEB,49.0,Posted,911.33,2024-04-10,49.0,Withdrawal ACH FLUENT-Gainesvil/TYPE: PAYMENT ID: 1371804719CO: FLUENT-GainesvilNAME: steven chaplinski,48.5
4/9/2024,Withdrawal POS #000000000009/INSTACART*159 WWW.INSTACART.COM/ SANFRANCISCO CACard 1231,3.0,Posted,960.33,2024-04-09,3.0,Withdrawal POS #000000000003/INSTACART*159 WWW.INSTACART.COM/ SANFRANCISCO CACard 1231,3.0
4/9/2024,Withdrawal POS #000000804440/INSTACART*159 WWW.INSTACART.COM/ SANFRANCISCO CACard 1231,89.91,Posted,963.33,2024-04-09,89.91,Withdrawal POS #000000804821/INSTACART*159 WWW.INSTACART.COM/ SANFRANCISCO CACard 1231,89.91
4/8/2024,Withdrawal ATM Fee/FLUENT DISPE-375207 3400 SW 34TH STREETGAINESVILLE FLCard 1231,2.0,Posted,1053.24,2024-04-08,2.0,Withdrawal ATM Fee/FLUENT DISPE-375207 3400 SW 34TH STREETGAINESVILLE FLCard 1231,1.5
4/8/2024,Withdrawal at ATM #000000001720/FLUENT DISPE-375207 3400 SW 34TH STREETGAINESVILLE FLCard 1231,23.0,Posted,1055.24,2024-04-08,23.0,Withdrawal at ATM #000000001720/FLUENT DISPE-375207 3400 SW 34TH STREETGAINESVILLE FLCard 1231,23.0
4/8/2024,Withdrawal ATM Fee/INQ FLUENT DISPE-375207 3400 SW 34THSTREET GAINESVILLE FLCard 1231,1.0,Posted,1078.24,2024-04-08,1.0,Withdrawal ATM Fee/FLUENT DISPE-375207 3400 SW 34TH STREETGAINESVILLE FLCard 1231,1.5
4/8/2024,Withdrawal Debit Card MC Debit Seminol/WALGREENS #5024 GAINESVILLE FLDate 04/07/24 0 4098790166 0 5912Card 1231,23.78,Posted,1079.24,2024-04-08,23.78,Withdrawal Debit Card MC Debit Seminol/WALGREENS #9304 GAINESVILLE FLDate 10/30/24 0 4304125853 1 5912Card 1231,24.265
4/7/2024,Withdrawal POS #000000000072/IC* INSTACART*159 WWW.INSTACART.COM/ SANFRANCISCO CACard 1231,5.0,Posted,1103.02,2024-04-07,5.0,Withdrawal POS #000000803033/IC* INSTACART*159 WWW.INSTACART.COM/ SANFRANCISCO CACard 1231,5.0
4/7/2024,Withdrawal POS #000000000004/IC* INSTACART*159 WWW.INSTACART.COM/ SANFRANCISCO CACard 1231,56.68,Posted,1108.02,2024-04-07,56.68,Withdrawal POS #000000803033/IC* INSTACART*159 WWW.INSTACART.COM/ SANFRANCISCO CACard 1231,56.68
4/7/2024,Withdrawal POS #000000372860/SUNOCO 8002212501 4234 SW 20TH AVEGAINESVILLE FLCard 1231,37.78,Posted,1164.7,2024-04-07,37.78,Withdrawal POS #000000235720/SUNOCO 8002212501 4234 SW 20TH AVEGAINESVILLE FLCard 1231,37.78
4/6/2024,Recurring Withdrawal Bill Payment - #000000078357/NETFLIX COM LOS GATOS CACard 1231,13.81,Posted,1202.48,2024-04-06,13.81,"Recurring Withdrawal Bill Payment - #000000017652/NETFLIX COM LOS GATOS CA
Card 1247",13.504999999999999
4/5/2024,Recurring Withdrawal Debit Card - MC Debit Seminol/CHATGPT SUBSCRIPTION SAN FRANCISC CADate 04/04/24 0 4095278410 0 5734Card 1231,20.0,Posted,1216.29,2024-04-05,20.0,Recurring Withdrawal Debit Card - MC Debit Seminol/CHATGPT SUBSCRIPTION SAN FRANCISC CADate 05/04/24 0 4125659188 0 5734Card 1231,20.0
4/5/2024,Withdrawal Debit Card MC Debit Seminol/COX GAINESVILLE COMM 800-234-3993 FLDate 04/04/24 0 4095901317 0 4899Card 1231,126.13,Posted,1236.29,2024-04-05,126.13,Withdrawal Debit Card MC Debit Seminol/COX GAINESVILLE COMM 800-234-3993 FLDate 12/04/24 0 4339376311 0 4899Card 1231,126.13
4/5/2024,Withdrawal Bill Payment #000009078159/PAYPAL *PARAMNTPLUS 2211 North FirstStreet San Jose CACard 1231,13.81,Posted,1362.42,2024-04-05,13.81,Withdrawal Bill Payment #050211031354/PAYPAL *SPOTIFYUSAI 2211 North FirstStreet San Jose CACard 1231,13.81
4/4/2024,Recurring Withdrawal Debit Card - MC Debit Seminol/APPLE.COM/BILL CUPERTINO CADate 04/03/24 0 4094830660 0 5735Card 1231,2.99,Posted,1376.23,2024-04-04,2.99,Recurring Withdrawal Debit Card - MC Debit Seminol/APPLE.COM/BILL CUPERTINO CADate 05/03/24 0 4124646881 1 5735Card 1231,2.99
4/4/2024,Withdrawal Bill Payment #000000253521/GRU EZ PAY 301 SE 4TH AVE US GAINESVILLEFLCard 1231,137.08,Posted,1379.22,2024-04-04,137.08,Withdrawal Bill Payment #000000253521/GRU EZ PAY 301 SE 4TH AVE US GAINESVILLEFLCard 1231,137.08
4/3/2024,Recurring Withdrawal Debit Card - MC Debit Seminol/DOCSIUM.COM SANTA CLARA CADate 04/02/24 0 4093105111 1 5734Card 1231,10.0,Posted,1516.3,2024-04-03,10.0,Recurring Withdrawal Debit Card - MC Debit Seminol/DOCSIUM.COM SANTA CLARA CADate 07/02/24 0 4184077595 1 5734Card 1231,10.0
4/3/2024,Recurring Withdrawal Debit Card - MC Debit Seminol/INVIDEO INC COUNTRY OF S DEDate 04/02/24 0 4093284762 0 5734Card 1231,50.0,Posted,1526.3,2024-04-03,50.0,Recurring Withdrawal Debit Card - MC Debit Seminol/INVIDEO INC COUNTRY OF S DEDate 12/09/24 0 4344808122 0 5734Card 1231,50.0
4/3/2024,"Recurring Withdrawal Bill Payment - #000000782876/ADOBE PARK AVENUE,345 SAN JOSE CACard 1231",19.99,Posted,1576.3,2024-04-03,19.99,"Recurring Withdrawal Bill Payment - #000000782876/ADOBE PARK AVENUE,345 SAN JOSE CACard 1231",19.99
4/3/2024,Withdrawal ACH Watson Realty Co/TYPE: WEB PMTS ID: 9000321157CO: Watson Realty CoNAME: Steven chaplinskiEntry Class Code: WEB,1079.0,Posted,1596.29,2024-04-03,1079.0,"Withdrawal ACH Watson Realty Co/TYPE: WEB PMTS ID: 9000321157
CO: Watson Realty Co
NAME: Steven chaplinskiEntry Class Code: WEB",1079.0
4/3/2024,"Withdrawal ACH AppFolio, Inc. F/TYPE: WEB PMTS ID: 9001406550CO: AppFolio, Inc. FNAME: Steven chaplinskiEntry Class Code: WEB",2.49,Posted,2675.29,2024-04-03,2.49,"Withdrawal ACH AppFolio, Inc. F/TYPE: WEB PMTS ID: 9001406550
CO: AppFolio, Inc. F
NAME: Steven chaplinskiEntry Class Code: WEB",2.49
4/2/2024,Withdrawal Bill Payment #000011239590/PAYPAL *SPOTIFYUSAI 2211 North FirstStreet San Jose CACard 1231,6.82,Posted,2677.78,2024-04-02,6.82,Withdrawal Bill Payment #050211031354/PAYPAL *SPOTIFYUSAI 2211 North FirstStreet San Jose CACard 1231,6.82
4/1/2024,Withdrawal POS #000000776580/IC* INSTACART*159 WWW.INSTACART.COM/ SANFRANCISCO CACard 1231,5.0,Posted,2684.6,2024-04-01,5.0,Withdrawal POS #000000794186/IC* INSTACART*159 WWW.INSTACART.COM/ SANFRANCISCO CACard 1231,5.0
4/1/2024,Withdrawal POS #000000000006/IC* INSTACART*159 WWW.INSTACART.COM/ SANFRANCISCO CACard 1231,103.0,Posted,2689.6,2024-04-01,103.0,Withdrawal POS #000000803033/IC* INSTACART*159 WWW.INSTACART.COM/ SANFRANCISCO CACard 1231,103.0
4/1/2024,"Withdrawal POS #000000804240/ETSY, INC. WWW.ETSY.COM/ BROOKLYN NYCard 1231",24.62,Posted,2792.6,2024-04-01,24.62,"Withdrawal POS #000000804240/ETSY, INC. WWW.ETSY.COM/ BROOKLYN NYCard 1231",24.62
3/31/2024,Withdrawal POS #000000313260/SUNOCO 8002212501 4234 SW 20TH AVEGAINESVILLE FLCard 1231,37.78,Posted,2817.22,2024-03-31,37.78,Withdrawal POS #000000031004/SUNOCO 8002212501 4234 SW 20TH AVEGAINESVILLE FLCard 1231,37.78
3/29/2024,Withdrawal POS #000000210024/SUNOCO 8002212501 4234 SW 20TH AVEGAINESVILLE FLCard 1231,29.39,Posted,55.0,2024-03-29,29.39,Withdrawal POS #000000028242/SUNOCO 8002212501 4234 SW 20TH AVEGAINESVILLE FLCard 1231,29.39
3/29/2024,Recurring Withdrawal Debit Card - MC Debit Seminol/APPLE.COM/BILL 866-712-7753 CADate 03/28/24 0 4088852714 0 5818Card 1231,2.99,Posted,84.39,2024-03-29,2.99,Recurring Withdrawal Debit Card - MC Debit Seminol/APPLE.COM/BILL 866-712-7753 CADate 01/08/24 0 4008756344 0 5818Card 2801,2.99
3/28/2024,Withdrawal Debit Card MC Debit Seminol/ZAPIER.COM/CHARGE SAN FRANCISC CADate 03/28/24 0 4088973131 0 5734Card 1231,59.87,Posted,87.38,2024-03-28,59.87,Withdrawal Debit Card MC Debit Seminol/ZAPIER.COM/CHARGE SAN FRANCISC CADate 03/28/24 0 4088973131 0 5734Card 1231,59.87
3/28/2024,"Recurring Withdrawal Debit Card - MC Debit Seminol/NOTION LABS, INC. SAN FRANCISC CADate 03/27/24 0 4087303943 0 7372Card 1231",10.0,Posted,147.25,2024-03-28,10.0,"Recurring Withdrawal Debit Card - MC Debit Seminol/NOTION LABS, INC. SAN FRANCISC CADate 12/02/24 0 4337878572 0 7372Card 1231",10.0
3/28/2024,Recurring Withdrawal Debit Card - MC Debit Seminol/APPLE.COM/BILL 866-712-7753 CADate 03/27/24 0 4087824766 0 5818Card 1231,7.99,Posted,157.25,2024-03-28,7.99,Recurring Withdrawal Debit Card - MC Debit Seminol/APPLE.COM/BILL 866-712-7753 CADate 01/08/24 0 4008756344 0 5818Card 2801,7.49
3/27/2024,Withdrawal POS #000000030230/SUNOCO 8002212501 4234 SW 20TH AVEGAINESVILLE FLCard 1231,34.24,Posted,165.24,2024-03-27,34.24,Withdrawal POS #000000031004/SUNOCO 8002212501 4234 SW 20TH AVEGAINESVILLE FLCard 1231,34.24
3/27/2024,Withdrawal Bill Payment #000010368568/PAYPAL *IONOS INC 2211 North FirstSan Jose CACard 1231,17.0,Posted,-0.52,2024-03-27,17.0,Withdrawal Bill Payment #000003047046/PAYPAL *HOSTGATOR 2211 North FirstSan Jose CACard 1231,17.0
3/26/2024,Recurring Withdrawal Debit Card - MC Debit Seminol/OPENAI SAN FRANCISC CADate 03/25/24 0 4085797776 0 5734Card 1231,7.0,Posted,16.48,2024-03-26,7.0,Withdrawal Debit Card MC Debit Seminol/OPENAI SAN FRANCISC CADate 02/16/24 0 4047896474 1 5734Card 1231,7.37
3/25/2024,Withdrawal POS #000000050354/SUNOCO 8002212501 4234 SW 20TH AVEGAINESVILLE FLCard 1231,7.07,Posted,23.48,2024-03-25,7.07,Withdrawal POS #000000031004/SUNOCO 8002212501 4234 SW 20TH AVEGAINESVILLE FLCard 1231,7.07
3/25/2024,Recurring Withdrawal Debit Card - MC Debit Seminol/FS *ADOBE SANTA BARBAR CADate 03/24/24 0 4084969709 0 5734Card 1231,0.95,Posted,30.55,2024-03-25,0.95,Recurring Withdrawal Debit Card - MC Debit Seminol/FS *CONTEXTSFORMAC SANTA BARBAR CADate 02/16/24 0 4047893711 1 5734Card 1231,0.95
3/24/2024,Withdrawal POS #000000933167/SUNOCO 8002212501 4234 SW 20TH AVEGAINESVILLE FLCard 1231,11.81,Posted,31.5,2024-03-24,11.81,Withdrawal POS #000000616677/SUNOCO 8002212501 4234 SW 20TH AVEGAINESVILLE FLCard 1231,11.81
3/24/2024,Recurring Withdrawal Debit Card - MC Debit Seminol/RUNWAY STANDARD PLAN NEWARK DEDate 03/22/24 0 4082877888 1 5734Card 1231,15.0,Posted,43.31,2024-03-24,15.0,Recurring Withdrawal Debit Card - MC Debit Seminol/RUNWAY STANDARD PLAN NEWARK DEDate 12/15/24 0 4350745942 1 5734Card 1231,15.0
3/24/2024,Recurring Withdrawal Debit Card - MC Debit Seminol/VIDIQ SAN FRANCISC CADate 03/23/24 0 4083879208 0 5734Card 1231,10.0,Posted,58.31,2024-03-24,10.0,Withdrawal Debit Card MC Debit Seminol/VIDIQ SAN FRANCISC CADate 12/03/24 0 4338664809 1 5734Card 1231,10.0
3/24/2024,Withdrawal POS #000000892167/SUNOCO 8002212501 4234 SW 20TH AVEGAINESVILLE FLCard 1231,12.07,Posted,68.31,2024-03-24,12.07,Withdrawal POS #000000778591/SUNOCO 8002212501 4234 SW 20TH AVEGAINESVILLE FLCard 1231,12.07
3/22/2024,"Recurring Withdrawal Debit Card - MC Debit Seminol/AIPRM, CORP. WILMINGTON DEDate 03/21/24 0 4081866631 0 5734Card 1231",9.71,Posted,80.38,2024-03-22,9.71,"Withdrawal Debit Card MC Debit Seminol/AIPRM, CORP. WILMINGTON DEDate 01/26/24 0 4026718596 1 5734Card 1231",9.71
3/22/2024,Withdrawal Bill Payment #000009082470/PAYPAL *IONOS INC 2211 North FirstSan Jose CACard 1231,7.0,Posted,90.09,2024-03-22,7.0,Withdrawal Bill Payment #000003047046/PAYPAL *HOSTGATOR 2211 North FirstSan Jose CACard 1231,7.0
3/21/2024,Withdrawal ATM Fee/EFT 3401 W University Ave Gainesville FLCard 1231,2.0,Posted,97.09,2024-03-21,2.0,"Withdrawal ATM Fee/EFT 3401 W University Ave Gainesville FL
Card 1247",2.0
3/21/2024,Withdrawal at ATM #000000029376/EFT 3401 W University Ave Gainesville FLCard 1231,8.0,Posted,99.09,2024-03-21,8.0,"Withdrawal at ATM #000000776623/EFT 3401 W University Ave Gainesville FL
Card 1247",8.0
3/21/2024,Withdrawal POS #000000731021/SUNOCO 8002212501 4234 SW 20TH AVEGAINESVILLE FLCard 1231,37.78,Posted,107.09,2024-03-21,37.78,Withdrawal POS #000000031004/SUNOCO 8002212501 4234 SW 20TH AVEGAINESVILLE FLCard 1231,37.78
3/21/2024,Recurring Withdrawal Debit Card - MC Debit Seminol/CANVA* I04096-42257036 CAMDEN DEDate 03/20/24 0 4080874207 0 7221Card 1231,12.99,Posted,144.87,2024-03-21,12.99,Recurring Withdrawal Debit Card - MC Debit Seminol/CANVA* I04249-43399962 CAMDEN DEDate 08/20/24 0 4233594945 0 7221Card 1231,12.99
3/21/2024,Recurring Withdrawal Debit Card - MC Debit Seminol/TUBEBUDDYCOM 8668823239 CADate 03/20/24 0 4080896528 0 5045Card 1231,7.5,Posted,157.86,2024-03-21,7.5,Recurring Withdrawal Debit Card - MC Debit Seminol/TUBEBUDDYCOM* 8668823239 CADate 12/03/24 0 4338443995 0 5045Card 1231,7.5
3/20/2024,Withdrawal Debit Card MC Debit Seminol/PRINTIFY.COM WILMINGTON DEDate 03/19/24 0 4079795188 0 7333Card 1231,12.74,Posted,65.36,2024-03-20,12.74,Withdrawal Debit Card MC Debit Seminol/PRINTIFY.COM WILMINGTON DEDate 03/19/24 0 4079795188 0 7333Card 1231,12.74
3/20/2024,Withdrawal POS #000003210549/GOOGLE *YouTubePremium 1600 AmphitheatreParkw Mountain View CACard 1231,15.92,Posted,78.1,2024-03-20,15.92,"Withdrawal POS #000020312090/GOOGLE *YouTubePremium 1600 Amphitheatre
Parkw Mountain View CA
Card 1247",15.92
3/19/2024,Withdrawal POS #000000736878/SUNOCO 8002212501 4234 SW 20TH AVEGAINESVILLE FLCard 1231,37.78,Posted,94.02,2024-03-19,37.78,Withdrawal POS #000000778591/SUNOCO 8002212501 4234 SW 20TH AVEGAINESVILLE FLCard 1231,38.010000000000005
3/19/2024,Withdrawal Debit Card MC Debit Seminol/CHIPOTLE ONLINE CHIPOTLE.COM CADate 03/18/24 0 4078974465 0 5814Card 1231,17.84,Posted,131.8,2024-03-19,17.84,Withdrawal Debit Card MC Debit Seminol/CHIPOTLE ONLINE CHIPOTLE.COM CADate 05/14/24 0 4135921741 0 5814Card 1231,17.66
3/19/2024,Withdrawal ACH FLUENT-Gainesvil/TYPE: PAYMENT ID: 1371804719CO: FLUENT-GainesvilNAME: steven chaplinskiEntry Class Code: WEB,34.0,Posted,149.64,2024-03-19,34.0,Withdrawal ACH FLUENT-Gainesvil/TYPE: PAYMENT ID: 1371804719CO: FLUENT-GainesvilNAME: steven chaplinski,34.5
3/19/2024,Withdrawal Bill Payment #000003021539/PAYPAL *HOSTGATOR 2211 North FirstSan Jose CACard 1231,15.99,Posted,183.64,2024-03-19,15.99,Withdrawal Bill Payment #000003047046/PAYPAL *HOSTGATOR 2211 North FirstSan Jose CACard 1231,15.995000000000001
3/18/2024,Withdrawal Debit Card Fee/MASTERCARD ISSUER CROSS-BORDER FEEDate 03/17/24 0 4077994868 0 5815Card 1231,0.06,Posted,199.63,2024-03-18,0.06,Withdrawal Debit Card Fee/MASTERCARD ISSUER CROSS-BORDER FEEDate 05/13/24 0 4134864561 0 5734Card 1231,0.19142857142857142
3/18/2024,Withdrawal Debit Card MC Debit Seminol/PHOTOPEA.COM KOSTELEC NAD CZDate 03/17/24 0 4077994868 0 5815Card 1231,7.85,Posted,199.69,2024-03-18,7.85,Withdrawal Debit Card MC Debit Seminol/PHOTOPEA.COM KOSTELEC NAD CZDate 04/16/24 0 4107738492 1 5815Card 1231,7.765
3/18/2024,Withdrawal Debit Card MC Debit Seminol/ELEVENLABS.IO NEW YORK NYDate 03/17/24 0 4077908969 0 5734Card 1231,11.0,Posted,207.54,2024-03-18,11.0,Recurring Withdrawal Debit Card - MC Debit Seminol/ELEVENLABS.IO NEW YORK NYDate 04/17/24 0 4108862142 0 5734Card 1231,11.0
3/17/2024,Withdrawal POS #000000000082/CIRCLE K # 26146 3525 GAINESVILLE FLCard 1231,26.57,Posted,218.54,2024-03-17,26.57,Withdrawal POS #000000000343/CIRCLE K # 06782 5237 GAINESVILLE FLCard 1247,26.395
3/17/2024,Withdrawal Debit Card MC Debit Seminol/LINKTREE* LINKTREE DOVER DEDate 03/17/24 0 4077836772 0 7399Card 1231,9.0,Posted,245.11,2024-03-17,9.0,Recurring Withdrawal Debit Card - MC Debit Seminol/LINKTREE* LINKTREE DOVER DEDate 04/16/24 0 4107289275 0 7399Card 1231,9.0
3/17/2024,Recurring Withdrawal Debit Card - MC Debit Seminol/MYDESIGNS - PRO - MON LAS VEGAS NVDate 03/16/24 0 4076835673 0 5734Card 1231,29.99,Posted,254.11,2024-03-17,29.99,Recurring Withdrawal Debit Card - MC Debit Seminol/MYDESIGNS.IO LAS VEGAS NVDate 10/18/24 0 4292077676 2 5734Card 1231,29.99
3/17/2024,Recurring Withdrawal Debit Card - MC Debit Seminol/PADDLE.NET* LEONARDOAI ASTORIA NYDate 03/16/24 0 4076599401 0 5817Card 1231,9.0,Posted,284.1,2024-03-17,9.0,Recurring Withdrawal Debit Card - MC Debit Seminol/PADDLE.NET* LEONARDOAI ASTORIA NYDate 12/16/24 0 4351323834 0 5817Card 1231,9.0
3/17/2024,Recurring Withdrawal Debit Card Fee/MASTERCARD ISSUER CROSS-BORDER FEEDate 03/17/24 0 4077006794 1 5734Card 1231,0.06,Posted,293.1,2024-03-17,0.06,Recurring Withdrawal Debit Card Fee/MASTERCARD ISSUER CROSS-BORDER FEEDate 06/15/24 0 4167922806 1 5734Card 1231,0.08
3/17/2024,Recurring Withdrawal Debit Card - MC Debit Seminol/IDEOGRAM.AI TORONTO ONDate 03/17/24 0 4077006794 1 5734Card 1231,8.0,Posted,293.16,2024-03-17,8.0,Withdrawal Debit Card MC Debit Seminol/IDEOGRAM.AI TORONTO ONDate 04/15/24 0 4106835174 0 5734Card 1231,8.190000000000001
3/17/2024,Withdrawal Debit Card Fee/MASTERCARD ISSUER CROSS-BORDER FEEDate 03/17/24 0 4077006793 1 5734Card 1231,0.39,Posted,301.16,2024-03-17,0.39,Withdrawal Debit Card Fee/MASTERCARD ISSUER CROSS-BORDER FEEDate 05/13/24 0 4134864561 0 5734Card 1231,0.19142857142857142
3/17/2024,Withdrawal Debit Card MC Debit Seminol/BROWSE.AI PLAN BURNABY BCDate 03/17/24 0 4077006793 1 5734Card 1231,48.75,Posted,301.55,2024-03-17,48.75,Recurring Withdrawal Debit Card - MC Debit Seminol/BROWSE.AI PLAN BURNABY BCDate 04/17/24 0 4108978435 0 5734Card 1231,48.75
3/17/2024,Withdrawal Debit Card MC Debit Seminol/WALGREENS #5024 GAINESVILLE FLDate 03/16/24 0 4076002444 1 5912Card 1231,19.99,Posted,350.3,2024-03-17,19.99,Withdrawal Debit Card MC Debit Seminol/WALGREENS #5024 GAINESVILLE FLDate 12/27/24 0 4362000611 2 5912Card 1231,19.99
3/17/2024,Withdrawal POS #031705851390/PAYPAL *FASTSPRING 2211 North FirstSan Jose CACard 1231,15.0,Posted,370.29,2024-03-17,15.0,Withdrawal POS #041705070341/PAYPAL *FASTSPRING 2211 North FirstSan Jose CACard 1231,15.0
3/17/2024,Withdrawal POS #000006228614/PAYPAL *HAVOCMARKET HAVOC 2211 NorthStreet San Jose CACard 1231,1.49,Posted,385.29,2024-03-17,1.49,Withdrawal POS #000006228614/PAYPAL *HAVOCMARKET HAVOC 2211 NorthStreet San Jose CACard 1231,1.49
3/17/2024,Withdrawal POS #000001014760/PAYPAL *PLAYSTATION 2211 North FirstStreet San Jose CACard 1231,14.99,Posted,386.78,2024-03-17,14.99,Withdrawal POS #000001042040/PAYPAL *PLAYSTATION 2211 North FirstStreet San Jose CACard 1231,14.99
3/17/2024,Withdrawal POS #000009276996/PAYPAL *PLAYSTATION 2211 North FirstStreet San Jose CACard 1231,39.99,Posted,401.77,2024-03-17,39.99,Withdrawal POS #000001042040/PAYPAL *PLAYSTATION 2211 North FirstStreet San Jose CACard 1231,39.99
3/16/2024,Withdrawal POS #000000697185/SUNOCO 8002212501 4234 SW 20TH AVEGAINESVILLE FLCard 1231,14.15,Posted,441.76,2024-03-16,14.15,Withdrawal POS #000000778591/SUNOCO 8002212501 4234 SW 20TH AVEGAINESVILLE FLCard 1231,14.15
3/16/2024,Withdrawal POS #000006245883/PAYPAL *SOCIALBLADE 2211 North FirstStreet San Jose CACard 1231,3.99,Posted,455.91,2024-03-16,3.99,Withdrawal POS #000006227588/PAYPAL *SOCIALBLADE 2211 North FirstStreet San Jose CACard 1231,3.99
3/16/2024,Withdrawal POS #000065583144/URGENT VET- GAINESVILL 2680 CLARK BUTLERBLVD. GAINESVILLE FLCard 1231,154.0,Posted,309.9,2024-03-16,154.0,Withdrawal POS #000065583144/URGENT VET- GAINESVILL 2680 CLARK BUTLERBLVD. GAINESVILLE FLCard 1231,154.0
3/14/2024,Withdrawal POS #000015057686/WALGREENS 2415 SW 75TH GAINESVILLE FLCard 1231,9.66,Posted,463.9,2024-03-14,9.66,Withdrawal POS #000015057686/WALGREENS 2415 SW 75TH GAINESVILLE FLCard 1231,9.66
3/14/2024,Withdrawal POS #000000555763/SUNOCO 8002212501 4234 SW 20TH AVEGAINESVILLE FLCard 1231,37.78,Posted,473.56,2024-03-14,37.78,Withdrawal POS #000000555763/SUNOCO 8002212501 4234 SW 20TH AVEGAINESVILLE FLCard 1231,38.21
3/13/2024,Withdrawal POS #000000803119/IC* INSTACART*159 WWW.INSTACART.COM/ SANFRANCISCO CACard 1231,3.0,Posted,511.34,2024-03-13,3.0,Withdrawal POS #000000803033/IC* INSTACART*159 WWW.INSTACART.COM/ SANFRANCISCO CACard 1231,3.0
3/13/2024,Withdrawal POS #000000782038/Instacart 50 Beal St Suite 600 SanFrancisco CACard 1231,24.94,Posted,514.34,2024-03-13,24.94,Withdrawal POS #000000773008/Instacart 50 Beal St Suite 600 SanFrancisco CACard 1231,24.94
3/13/2024,Withdrawal POS #000000782026/IC* INSTACART*159 WWW.INSTACART.COM/ SANFRANCISCO CACard 1231,125.0,Posted,539.28,2024-03-13,125.0,Withdrawal POS #000000794186/IC* INSTACART*159 WWW.INSTACART.COM/ SANFRANCISCO CACard 1231,125.0
3/13/2024,Withdrawal POS #000000488663/SUNOCO 8002212501 4234 SW 20TH AVEGAINESVILLE FLCard 1231,29.5,Posted,664.28,2024-03-13,29.5,Withdrawal POS #000000488663/SUNOCO 8002212501 4234 SW 20TH AVEGAINESVILLE FLCard 1231,29.5
3/13/2024,Recurring Withdrawal Debit Card - MC Debit Seminol/APPLE.COM/BILL 866-712-7753 CADate 03/13/24 0 4073882836 0 5818Card 1231,18.98,Posted,693.78,2024-03-13,18.98,Recurring Withdrawal Debit Card - MC Debit Seminol/APPLE.COM/BILL 866-712-7753 CADate 03/27/24 0 4087824766 0 5818Card 1231,18.98
3/12/2024,Recurring Withdrawal Debit Card - MC Debit Seminol/MIDJOURNEY INC. SOUTH SAN FR CADate 03/11/24 0 4071281515 0 5734Card 1231,30.0,Posted,712.76,2024-03-12,30.0,Recurring Withdrawal Debit Card - MC Debit Seminol/MIDJOURNEY INC. SOUTH SAN FR CADate 05/14/24 0 4135994595 0 5734Card 1231,30.0
3/12/2024,Withdrawal Debit Card MC Debit Seminol/SCRUBS CARWASH - GAINE GAINESVILLE FLDate 03/11/24 0 4071879202 0 7542Card 1231,3.5,Posted,742.76,2024-03-12,3.5,Withdrawal Debit Card MC Debit Seminol/SCRUBS CARWASH - GAINE GAINESVILLE FLDate 11/29/24 0 4334403825 2 7542Card 1231,3.5
3/11/2024,Withdrawal POS #000000514197/SUNOCO 8002212501 4234 SW 20TH AVEGAINESVILLE FLCard 1231,37.78,Posted,746.26,2024-03-11,37.78,Withdrawal POS #000000161599/SUNOCO 8002212501 4234 SW 20TH AVEGAINESVILLE FLCard 1231,37.78
3/10/2024,Withdrawal Debit Card MC Debit Seminol/CHIPOTLE ONLINE CHIPOTLE.COM CADate 03/08/24 0 4068694631 2 5814Card 1231,34.68,Posted,784.04,2024-03-10,34.68,Withdrawal Debit Card MC Debit Seminol/CHIPOTLE ONLINE CHIPOTLE.COM CADate 05/14/24 0 4135921741 0 5814Card 1231,34.68
3/10/2024,Withdrawal Debit Card MC Debit Seminol/WALGREENS #5024 GAINESVILLE FLDate 03/08/24 0 4068690235 2 5912Card 1231,10.81,Posted,818.72,2024-03-10,10.81,Withdrawal Debit Card MC Debit Seminol/WALGREENS #5024 GAINESVILLE FLDate 12/27/24 0 4362000611 2 5912Card 1231,10.81
3/9/2024,Withdrawal POS #000000000008/IC* INSTACART*159 WWW.INSTACART.COM/ SANFRANCISCO CACard 1231,5.0,Posted,829.53,2024-03-09,5.0,Withdrawal POS #000000803033/IC* INSTACART*159 WWW.INSTACART.COM/ SANFRANCISCO CACard 1231,5.0
3/9/2024,Withdrawal POS #000000000065/IC* INSTACART*159 WWW.INSTACART.COM/ SANFRANCISCO CACard 1231,163.69,Posted,834.53,2024-03-09,163.69,Withdrawal POS #000000803033/IC* INSTACART*159 WWW.INSTACART.COM/ SANFRANCISCO CACard 1231,163.69
3/8/2024,Withdrawal POS #000000221295/SUNOCO 8002212501 4234 SW 20TH AVEGAINESVILLE FLCard 1231,40.7,Posted,998.22,2024-03-08,40.7,Withdrawal POS #000000028242/SUNOCO 8002212501 4234 SW 20TH AVEGAINESVILLE FLCard 1231,40.95
3/8/2024,Recurring Withdrawal Debit Card - MC Debit Seminol/APPLE.COM/BILL 866-712-7753 CADate 03/08/24 0 4068976803 0 5818Card 1231,2.99,Posted,1038.92,2024-03-08,2.99,Recurring Withdrawal Debit Card - MC Debit Seminol/APPLE.COM/BILL 866-712-7753 CADate 01/08/24 0 4008756344 0 5818Card 2801,2.99
3/7/2024,Recurring Withdrawal Debit Card - MC Debit Seminol/OPENAI SAN FRANCISC CADate 03/07/24 0 4067912809 0 5734Card 1231,7.74,Posted,1041.91,2024-03-07,7.74,Withdrawal Debit Card MC Debit Seminol/OPENAI SAN FRANCISC CADate 02/16/24 0 4047896474 1 5734Card 1231,7.37
3/6/2024,Recurring Withdrawal Debit Card - MC Debit Seminol/PIKA.ART MOUNTAIN VIE CADate 03/05/24 0 4065950684 0 5734Card 1231,10.0,Posted,1049.65,2024-03-06,10.0,Recurring Withdrawal Debit Card - MC Debit Seminol/PIKA.ART MOUNTAIN VIE CADate 03/05/24 0 4065950684 0 5734Card 1231,10.0
3/6/2024,Withdrawal ACH FLUENT-Gainesvil/TYPE: PAYMENT ID: 1371804719CO: FLUENT-GainesvilNAME: steven chaplinskiEntry Class Code: WEB,51.5,Posted,1059.65,2024-03-06,51.5,Withdrawal ACH FLUENT-Gainesvil/TYPE: PAYMENT ID: 1371804719CO: FLUENT-GainesvilNAME: steven chaplinski,51.75
3/6/2024,Recurring Withdrawal Bill Payment - #000000134816/NETFLIX COM LOS GATOS CACard 1231,13.81,Posted,1111.15,2024-03-06,13.81,"Recurring Withdrawal Bill Payment - #000000017652/NETFLIX COM LOS GATOS CA
Card 1247",13.504999999999999
3/5/2024,Withdrawal POS #000000783607/IC* INSTACART*159 WWW.INSTACART.COM/ SANFRANCISCO CACard 1231,5.0,Posted,1124.96,2024-03-05,5.0,Withdrawal POS #000000794186/IC* INSTACART*159 WWW.INSTACART.COM/ SANFRANCISCO CACard 1231,5.0
3/5/2024,Withdrawal POS #000000000040/IC* INSTACART*159 WWW.INSTACART.COM/ SANFRANCISCO CACard 1231,136.27,Posted,1129.96,2024-03-05,136.27,Withdrawal POS #000000803033/IC* INSTACART*159 WWW.INSTACART.COM/ SANFRANCISCO CACard 1231,136.27
3/5/2024,Recurring Withdrawal Debit Card - MC Debit Seminol/CHATGPT SUBSCRIPTION SAN FRANCISC CADate 03/04/24 0 4064324144 0 5734Card 1231,20.0,Posted,1266.23,2024-03-05,20.0,Recurring Withdrawal Debit Card - MC Debit Seminol/CHATGPT SUBSCRIPTION SAN FRANCISC CADate 05/04/24 0 4125659188 0 5734Card 1231,20.0
3/5/2024,Withdrawal Debit Card MC Debit Seminol/COX GAINESVILLE COMM 800-234-3993 FLDate 03/04/24 0 4064754380 0 4899Card 1231,142.8,Posted,1286.23,2024-03-05,142.8,Withdrawal Debit Card MC Debit Seminol/COX GAINESVILLE COMM 800-234-3993 FLDate 12/04/24 0 4339376311 0 4899Card 1231,142.465
3/4/2024,Withdrawal Bill Payment #000000378137/GRU EZ PAY 301 SE 4TH AVE US GAINESVILLEFLCard 1231,165.01,Posted,1429.03,2024-03-04,165.01,Withdrawal Bill Payment #000000253521/GRU EZ PAY 301 SE 4TH AVE US GAINESVILLEFLCard 1231,165.01
3/4/2024,Withdrawal POS #000000246748/SUNOCO 8002212501 4234 SW 20TH AVEGAINESVILLE FLCard 1231,34.24,Posted,1594.04,2024-03-04,34.24,Withdrawal POS #000000794627/SUNOCO 8002212501 4234 SW 20TH AVEGAINESVILLE FLCard 1231,34.24
3/4/2024,Recurring Withdrawal Debit Card - MC Debit Seminol/APPLE.COM/BILL 866-712-7753 CADate 03/03/24 0 4063943695 0 5818Card 1231,2.99,Posted,1628.28,2024-03-04,2.99,Recurring Withdrawal Debit Card - MC Debit Seminol/APPLE.COM/BILL 866-712-7753 CADate 01/08/24 0 4008756344 0 5818Card 2801,2.99
3/4/2024,Withdrawal ACH Watson Realty Co/TYPE: WEB PMTS ID: 9000321157CO: Watson Realty CoNAME: Steven chaplinskiEntry Class Code: WEB,1079.0,Posted,1631.27,2024-03-04,1079.0,"Withdrawal ACH Watson Realty Co/TYPE: WEB PMTS ID: 9000321157
CO: Watson Realty Co
NAME: Steven chaplinskiEntry Class Code: WEB",1079.0
3/4/2024,"Withdrawal ACH AppFolio, Inc. F/TYPE: WEB PMTS ID: 9001406550CO: AppFolio, Inc. FNAME: Steven chaplinskiEntry Class Code: WEB",2.49,Posted,2710.27,2024-03-04,2.49,"Withdrawal ACH AppFolio, Inc. F/TYPE: WEB PMTS ID: 9001406550
CO: AppFolio, Inc. F
NAME: Steven chaplinskiEntry Class Code: WEB",2.49
3/3/2024,Recurring Withdrawal Debit Card - MC Debit Seminol/INVIDEO INC COUNTRY OF S DEDate 03/02/24 0 4062554503 0 5734Card 1231,50.0,Posted,2712.76,2024-03-03,50.0,Recurring Withdrawal Debit Card - MC Debit Seminol/INVIDEO INC COUNTRY OF S DEDate 12/09/24 0 4344808122 0 5734Card 1231,50.0
3/3/2024,Recurring Withdrawal Debit Card - MC Debit Seminol/DOCSIUM.COM SANTA CLARA CADate 03/02/24 0 4062554502 0 5734Card 1231,10.0,Posted,2762.76,2024-03-03,10.0,Recurring Withdrawal Debit Card - MC Debit Seminol/DOCSIUM.COM SANTA CLARA CADate 07/02/24 0 4184077595 1 5734Card 1231,10.0
3/3/2024,"Withdrawal Bill Payment #000000795978/Adobe Park Avenue,345 San Jose CACard 1231",19.99,Posted,2772.76,2024-03-03,19.99,"Withdrawal Bill Payment #000000352498/Adobe Park Avenue,345 San Jose CACard 1247",19.99
3/2/2024,Withdrawal Bill Payment #030210607517/PAYPAL *SPOTIFYUSAI 2211 North FirstStreet San Jose CACard 1231,6.82,Posted,2792.75,2024-03-02,6.82,Withdrawal Bill Payment #050211031354/PAYPAL *SPOTIFYUSAI 2211 North FirstStreet San Jose CACard 1231,6.82
3/1/2024,"Withdrawal POS #000000784744/ETSY, INC. WWW.ETSY.COM/ BROOKLYN NYCard 1231",17.44,Posted,2799.57,2024-03-01,17.44,"Withdrawal POS #000000804240/ETSY, INC. WWW.ETSY.COM/ BROOKLYN NYCard 1231",17.44
2/29/2024,Withdrawal POS #000000785940/IC* INSTACART*159 WWW.INSTACART.COM/ SANFRANCISCO CACard 1231,3.0,Posted,2817.01,2024-02-29,3.0,Withdrawal POS #000000794186/IC* INSTACART*159 WWW.INSTACART.COM/ SANFRANCISCO CACard 1231,3.0
2/29/2024,Withdrawal POS #000000804013/IC* INSTACART*159 WWW.INSTACART.COM/ SANFRANCISCO CACard 1231,122.37,Posted,2820.01,2024-02-29,122.37,Withdrawal POS #000000794186/IC* INSTACART*159 WWW.INSTACART.COM/ SANFRANCISCO CACard 1231,122.37
2/28/2024,Withdrawal Debit Card MC Debit Seminol/ZAPIER.COM/CHARGE SAN FRANCISC CADate 02/27/24 0 4058887137 0 5734Card 1231,29.99,Posted,2942.38,2024-02-28,29.99,Withdrawal Debit Card MC Debit Seminol/ZAPIER.COM/CHARGE SAN FRANCISC CADate 03/28/24 0 4088973131 0 5734Card 1231,29.99
2/28/2024,Recurring Withdrawal Debit Card Fee/MASTERCARD ISSUER CROSS-BORDER FEEDate 02/25/24 0 4056812425 0 4816Card 1231,0.12,Posted,2972.37,2024-02-28,0.12,Recurring Withdrawal Debit Card Fee/MASTERCARD ISSUER CROSS-BORDER FEEDate 01/06/24 0 4006875269 0 5815Card 2801,0.20272727272727267
2/28/2024,Recurring Withdrawal Debit Card - MC Debit Seminol/PAYPAL *HOSTINGER 35314369001 CYDate 02/25/24 0 4056812425 0 4816Card 1231,14.98,Posted,2972.49,2024-02-28,14.98,Recurring Withdrawal Debit Card - MC Debit Seminol/PAYPAL *HOSTINGER 35314369001 CYDate 02/25/24 0 4056812425 0 4816Card 1231,14.98
2/28/2024,Recurring Withdrawal Debit Card Fee/MASTERCARD ISSUER CROSS-BORDER FEEDate 02/25/24 0 4056812424 0 4816Card 1231,0.02,Posted,2987.47,2024-02-28,0.02,Recurring Withdrawal Debit Card Fee/MASTERCARD ISSUER CROSS-BORDER FEEDate 01/06/24 0 4006875269 0 5815Card 2801,0.20272727272727267
2/28/2024,Recurring Withdrawal Debit Card - MC Debit Seminol/PAYPAL *HOSTINGER 35314369001 CYDate 02/25/24 0 4056812424 0 4816Card 1231,2.17,Posted,2987.49,2024-02-28,2.17,Recurring Withdrawal Debit Card - MC Debit Seminol/PAYPAL *HOSTINGER 35314369001 CYDate 02/25/24 0 4056812425 0 4816Card 1231,2.17
2/28/2024,Withdrawal Debit Card MC Debit Seminol/CHIPOTLE ONLINE CHIPOTLE.COM CADate 02/27/24 0 4058906372 0 5814Card 1231,32.37,Posted,2989.66,2024-02-28,32.37,Withdrawal Debit Card MC Debit Seminol/CHIPOTLE ONLINE CHIPOTLE.COM CADate 05/14/24 0 4135921741 0 5814Card 1231,32.56
2/28/2024,Recurring Withdrawal Debit Card - MC Debit Seminol/APPLE.COM/BILL 866-712-7753 CADate 02/28/24 0 4059902873 0 5818Card 1231,14.98,Posted,3022.03,2024-02-28,14.98,Recurring Withdrawal Debit Card - MC Debit Seminol/APPLE.COM/BILL 866-712-7753 CADate 01/08/24 0 4008756344 0 5818Card 2801,14.98
2/27/2024,Withdrawal POS #000000965925/SUNOCO 8002212501 4234 SW 20TH AVEGAINESVILLE FLCard 1231,22.42,Posted,237.01,2024-02-27,22.42,Withdrawal POS #000000909995/SUNOCO 8002212501 4234 SW 20TH AVEGAINESVILLE FLCard 1231,22.42
2/27/2024,Withdrawal Bill Payment #000009017556/PAYPAL *IONOS INC 2211 North FirstSan Jose CACard 1231,17.0,Posted,259.43,2024-02-27,17.0,Withdrawal Bill Payment #000003047046/PAYPAL *HOSTGATOR 2211 North FirstSan Jose CACard 1231,17.0
2/25/2024,Recurring Withdrawal Debit Card - MC Debit Seminol/SHOPIFY* 218664050 ELK GROVE VI ILDate 02/24/24 0 4055933818 1 5734Card 1231,1.0,Posted,276.43,2024-02-25,1.0,Recurring Withdrawal Debit Card - MC Debit Seminol/SHOPIFY* 218664050 ELK GROVE VI ILDate 02/24/24 0 4055933818 1 5734Card 1231,1.0
2/25/2024,Recurring Withdrawal Debit Card - MC Debit Seminol/VIDIQ SAN FRANCISC CADate 02/23/24 0 4054865006 1 5734Card 1231,10.0,Posted,277.43,2024-02-25,10.0,Withdrawal Debit Card MC Debit Seminol/VIDIQ SAN FRANCISC CADate 12/03/24 0 4338664809 1 5734Card 1231,10.0
2/25/2024,Recurring Withdrawal Debit Card - MC Debit Seminol/FS *ADOBE SANTA BARBAR CADate 02/24/24 0 4055835597 0 5734Card 1231,0.95,Posted,287.43,2024-02-25,0.95,Recurring Withdrawal Debit Card - MC Debit Seminol/FS *CONTEXTSFORMAC SANTA BARBAR CADate 02/16/24 0 4047893711 1 5734Card 1231,0.95
2/23/2024,Recurring Withdrawal Debit Card - MC Debit Seminol/RUNWAY STANDARD PLAN NEWARK DEDate 02/22/24 0 4053857135 0 5734Card 1231,15.0,Posted,288.38,2024-02-23,15.0,Recurring Withdrawal Debit Card - MC Debit Seminol/RUNWAY STANDARD PLAN NEWARK DEDate 12/15/24 0 4350745942 1 5734Card 1231,15.0
2/23/2024,Withdrawal Debit Card MC Debit Seminol/IC* INSTACART*159 SAN FRANCISC CADate 02/23/24 0 4054872144 0 5411Card 1231,108.76,Posted,303.38,2024-02-23,108.76,Withdrawal Debit Card MC Debit Seminol/IC* INSTACART*159 SAN FRANCISC CADate 02/23/24 0 4054872144 0 5411Card 1231,108.76
2/23/2024,Withdrawal Debit Card MC Debit Seminol/APPLE.COM/BILL CUPERTINO CADate 02/22/24 0 4053853179 0 5735Card 1231,6.99,Posted,412.14,2024-02-23,6.99,Recurring Withdrawal Debit Card - MC Debit Seminol/APPLE.COM/BILL CUPERTINO CADate 05/03/24 0 4124646881 1 5735Card 1231,6.99
2/23/2024,Withdrawal POS #000000000006/IC* INSTACART*159 WWW.INSTACART.COM/ SANFRANCISCO CACard 1231,5.0,Posted,419.13,2024-02-23,5.0,Withdrawal POS #000000803033/IC* INSTACART*159 WWW.INSTACART.COM/ SANFRANCISCO CACard 1231,5.0
2/23/2024,Withdrawal POS #000000768640/SUNOCO 8002212501 4234 SW 20TH AVEGAINESVILLE FLCard 1231,34.24,Posted,424.13,2024-02-23,34.24,Withdrawal POS #000000680755/SUNOCO 8002212501 4234 SW 20TH AVEGAINESVILLE FLCard 1231,34.24
2/22/2024,"Recurring Withdrawal Debit Card - MC Debit Seminol/AIPRM, CORP. WILMINGTON DEDate 02/21/24 0 4052801927 0 5734Card 1231",9.71,Posted,258.37,2024-02-22,9.71,"Withdrawal Debit Card MC Debit Seminol/AIPRM, CORP. WILMINGTON DEDate 01/26/24 0 4026718596 1 5734Card 1231",9.71
2/21/2024,Recurring Withdrawal Debit Card - MC Debit Seminol/OPENAI SAN FRANCISC CADate 02/21/24 0 4052816296 0 5734Card 1231,15.0,Posted,268.08,2024-02-21,15.0,Withdrawal Debit Card MC Debit Seminol/OPENAI SAN FRANCISC CADate 02/16/24 0 4047896474 1 5734Card 1231,15.026
2/21/2024,Recurring Withdrawal Debit Card - MC Debit Seminol/CANVA* I04067-39730644 CAMDEN DEDate 02/20/24 0 4051830672 0 7221Card 1231,12.99,Posted,283.08,2024-02-21,12.99,Recurring Withdrawal Debit Card - MC Debit Seminol/CANVA* I04249-43399962 CAMDEN DEDate 08/20/24 0 4233594945 0 7221Card 1231,12.99
2/21/2024,Withdrawal Debit Card MC Debit Seminol/CHIPOTLE ONLINE CHIPOTLE.COM CADate 02/20/24 0 4051813723 0 5814Card 1231,17.14,Posted,296.07,2024-02-21,17.14,Withdrawal Debit Card MC Debit Seminol/CHIPOTLE ONLINE CHIPOTLE.COM CADate 05/14/24 0 4135921741 0 5814Card 1231,17.66
2/21/2024,Withdrawal POS #000000710759/SUNOCO 8002212501 4234 SW 20TH AVEGAINESVILLE FLCard 1231,41.31,Posted,313.21,2024-02-21,41.31,Withdrawal POS #000000778591/SUNOCO 8002212501 4234 SW 20TH AVEGAINESVILLE FLCard 1231,41.31
2/20/2024,Withdrawal POS #000003336793/GOOGLE *YouTubePremium 1600 AmphitheatreParkw Mountain View CACard 1231,15.92,Posted,354.52,2024-02-20,15.92,"Withdrawal POS #000020312090/GOOGLE *YouTubePremium 1600 Amphitheatre
Parkw Mountain View CA
Card 1247",15.92
2/19/2024,Withdrawal Debit Card MC Debit Seminol/IC* INSTACART*159 SAN FRANCISC CADate 02/18/24 0 4049816277 0 5411Card 1231,80.0,Posted,370.44,2024-02-19,80.0,Withdrawal Debit Card MC Debit Seminol/IC* INSTACART*159 SAN FRANCISC CADate 02/23/24 0 4054872144 0 5411Card 1231,80.0
2/19/2024,Withdrawal Bill Payment #000003063817/PAYPAL *HOSTGATOR 2211 North FirstSan Jose CACard 1231,15.99,Posted,404.46,2024-02-19,15.99,Withdrawal Bill Payment #000003047046/PAYPAL *HOSTGATOR 2211 North FirstSan Jose CACard 1231,15.995000000000001
2/18/2024,Withdrawal POS #000005360799/PAYPAL *ETSY INC 2211 North First StreetSan Jose CACard 1231,15.0,Posted,420.45,2024-02-18,15.0,Withdrawal POS #000002059014/PAYPAL *ETSY INC 2211 North First StreetSan Jose CACard 1231,15.0
2/18/2024,Withdrawal POS #000000564527/SUNOCO 8002212501 4234 SW 20TH AVEGAINESVILLE FLCard 1231,37.78,Posted,435.45,2024-02-18,37.78,Withdrawal POS #000000555763/SUNOCO 8002212501 4234 SW 20TH AVEGAINESVILLE FLCard 1231,38.21
2/18/2024,Withdrawal POS #000000793050/IC* INSTACART*159 WWW.INSTACART.COM/ SANFRANCISCO CACard 1231,5.0,Posted,473.23,2024-02-18,5.0,Withdrawal POS #000000794186/IC* INSTACART*159 WWW.INSTACART.COM/ SANFRANCISCO CACard 1231,5.0
2/18/2024,Withdrawal Debit Card MC Debit Seminol/OPENAI SAN FRANCISC CADate 02/16/24 0 4047896474 1 5734Card 1231,35.09,Posted,478.23,2024-02-18,35.09,Withdrawal Debit Card MC Debit Seminol/OPENAI SAN FRANCISC CADate 02/16/24 0 4047896474 1 5734Card 1231,35.09
2/18/2024,Withdrawal Debit Card MC Debit Seminol/INVIDEO INC COUNTRY OF S DEDate 02/16/24 0 4047895344 1 5734Card 1231,20.38,Posted,513.32,2024-02-18,20.38,Recurring Withdrawal Debit Card - MC Debit Seminol/INVIDEO INC COUNTRY OF S DEDate 12/09/24 0 4344808122 0 5734Card 1231,20.38
2/18/2024,Withdrawal Debit Card Fee/MASTERCARD ISSUER CROSS-BORDER FEEDate 02/17/24 0 4048895127 1 5734Card 1231,0.06,Posted,533.7,2024-02-18,0.06,Withdrawal Debit Card Fee/MASTERCARD ISSUER CROSS-BORDER FEEDate 05/13/24 0 4134864561 0 5734Card 1231,0.19142857142857142
2/18/2024,Withdrawal Debit Card MC Debit Seminol/IDEOGRAM.AI TORONTO ONDate 02/17/24 0 4048895127 1 5734Card 1231,8.0,Posted,533.76,2024-02-18,8.0,Withdrawal Debit Card MC Debit Seminol/IDEOGRAM.AI TORONTO ONDate 04/15/24 0 4106835174 0 5734Card 1231,8.190000000000001
2/18/2024,Recurring Withdrawal Debit Card - MC Debit Seminol/FS *CONTEXTSFORMAC SANTA BARBAR CADate 02/16/24 0 4047893711 1 5734Card 1231,9.99,Posted,541.76,2024-02-18,9.99,Recurring Withdrawal Debit Card - MC Debit Seminol/FS *CONTEXTSFORMAC SANTA BARBAR CADate 02/16/24 0 4047893711 1 5734Card 1231,9.99
2/18/2024,Withdrawal Debit Card MC Debit Seminol/WALGREENS #5024 GAINESVILLE FLDate 02/16/24 0 4047928029 1 5912Card 1231,27.97,Posted,551.75,2024-02-18,27.97,Withdrawal Debit Card MC Debit Seminol/WALGREENS #5024 GAINESVILLE FLDate 12/27/24 0 4362000611 2 5912Card 1231,27.97
2/18/2024,"Withdrawal Bill Payment #000000783899/Adobe Park Avenue,345 San Jose CACard 1231",19.99,Posted,556.73,2024-02-18,19.99,"Withdrawal Bill Payment #000000352498/Adobe Park Avenue,345 San Jose CACard 1247",19.99
2/18/2024,"Withdrawal Bill Payment #000000795070/Adobe Park Avenue,345 San Jose CACard 1231",22.99,Posted,576.72,2024-02-18,22.99,"Withdrawal Bill Payment #000000352498/Adobe Park Avenue,345 San Jose CACard 1247",22.99
2/17/2024,Withdrawal POS #021701718368/PAYPAL *FASTSPRING 2211 North FirstSan Jose CACard 1231,15.0,Posted,599.71,2024-02-17,15.0,Withdrawal POS #041705070341/PAYPAL *FASTSPRING 2211 North FirstSan Jose CACard 1231,15.0
2/17/2024,Withdrawal Bill Payment #021702810023/PAYPAL *HOSTGATOR 2211 North FirstSan Jose CACard 1231,15.99,Posted,614.71,2024-02-17,15.99,Withdrawal Bill Payment #000003047046/PAYPAL *HOSTGATOR 2211 North FirstSan Jose CACard 1231,15.995000000000001
2/17/2024,Withdrawal POS #000009211307/PAYPAL *SOCIALBLADE 2211 North FirstStreet San Jose CACard 1231,3.99,Posted,630.7,2024-02-17,3.99,Withdrawal POS #000006227588/PAYPAL *SOCIALBLADE 2211 North FirstStreet San Jose CACard 1231,3.99
2/17/2024,Withdrawal Bill Payment #000008014696/PAYPAL *IONOS INC 2211 North FirstSan Jose CACard 1231,16.0,Posted,634.69,2024-02-17,16.0,Withdrawal Bill Payment #000003047046/PAYPAL *HOSTGATOR 2211 North FirstSan Jose CACard 1231,15.995000000000001
2/16/2024,Withdrawal POS #000000570329/SUNOCO 8002212501 4234 SW 20TH AVEGAINESVILLE FLCard 1231,41.31,Posted,650.69,2024-02-16,41.31,Withdrawal POS #000000555763/SUNOCO 8002212501 4234 SW 20TH AVEGAINESVILLE FLCard 1231,41.31
2/16/2024,Withdrawal Bill Payment #000008363326/PAYPAL *MEDIUM.COM 2211 North FirstSan Jose CACard 1231,50.0,Posted,692.0,2024-02-16,50.0,Withdrawal Bill Payment #000003047046/PAYPAL *HOSTGATOR 2211 North FirstSan Jose CACard 1231,50.0
2/15/2024,Withdrawal Debit Card MC Debit Seminol/IC* INSTACART*159 SAN FRANCISC CADate 02/14/24 0 4045833788 0 5411Card 1231,97.56,Posted,742.0,2024-02-15,97.56,Withdrawal Debit Card MC Debit Seminol/IC* INSTACART*159 SAN FRANCISC CADate 02/23/24 0 4054872144 0 5411Card 1231,97.56
2/15/2024,Withdrawal Debit Card MC Debit Seminol/LYFT 2 RIDES 02-13 8558659553 CADate 02/14/24 0 4045828699 0 4121Card 1231,31.88,Posted,839.56,2024-02-15,31.88,Withdrawal Debit Card MC Debit Seminol/LYFT 2 RIDES 02-13 8558659553 CADate 02/14/24 0 4045828699 0 4121Card 1231,31.88
2/14/2024,Withdrawal POS #000000000001/IC* INSTACART*159 WWW.INSTACART.COM/ SANFRANCISCO CACard 1231,3.0,Posted,871.44,2024-02-14,3.0,Withdrawal POS #000000803033/IC* INSTACART*159 WWW.INSTACART.COM/ SANFRANCISCO CACard 1231,3.0
2/14/2024,Recurring Withdrawal Debit Card - MC Debit Seminol/APPLE.COM/BILL CUPERTINO CADate 02/13/24 0 4044890161 0 5735Card 1231,15.99,Posted,874.44,2024-02-14,15.99,Recurring Withdrawal Debit Card - MC Debit Seminol/APPLE.COM/BILL CUPERTINO CADate 05/03/24 0 4124646881 1 5735Card 1231,15.99
2/13/2024,Withdrawal Debit Card MC Debit Seminol/LYFT 2 RIDES 02-11 8558659553 CADate 02/12/24 0 4043681210 0 4121Card 1231,26.29,Posted,890.43,2024-02-13,26.29,Withdrawal Debit Card MC Debit Seminol/LYFT 2 RIDES 02-13 8558659553 CADate 02/14/24 0 4045828699 0 4121Card 1231,26.29
2/13/2024,Withdrawal ACH FLUENT-Gainesvil/TYPE: PAYMENT ID: 1371804719CO: FLUENT-GainesvilNAME: steven chaplinskiEntry Class Code: WEB,73.0,Posted,916.72,2024-02-13,73.0,Withdrawal ACH FLUENT-Gainesvil/TYPE: PAYMENT ID: 1371804719CO: FLUENT-GainesvilNAME: steven chaplinski,73.0
2/12/2024,Withdrawal POS #000000325837/SUNOCO 8002212501 4234 SW 20TH AVEGAINESVILLE FLCard 1231,37.78,Posted,989.72,2024-02-12,37.78,Withdrawal POS #000000383621/SUNOCO 8002212501 4234 SW 20TH AVEGAINESVILLE FLCard 1231,37.78
2/12/2024,Recurring Withdrawal Debit Card - MC Debit Seminol/MIDJOURNEY INC. SOUTH SAN FR CADate 02/11/24 0 4042266296 0 5734Card 1231,30.0,Posted,1027.5,2024-02-12,30.0,Recurring Withdrawal Debit Card - MC Debit Seminol/MIDJOURNEY INC. SOUTH SAN FR CADate 05/14/24 0 4135994595 0 5734Card 1231,30.0
2/11/2024,Withdrawal Debit Card MC Debit Seminol/IC* INSTACART*159 SAN FRANCISC CADate 02/09/24 0 4040832330 0 5411Card 1231,130.36,Posted,1057.5,2024-02-11,130.36,Withdrawal Debit Card MC Debit Seminol/IC* INSTACART*159 SAN FRANCISC CADate 02/23/24 0 4054872144 0 5411Card 1231,130.36
2/11/2024,Withdrawal Debit Card MC Debit Seminol/LYFT 1 RIDE 02-08 8558659553 CADate 02/09/24 0 4040200188 1 4121Card 1231,14.99,Posted,1187.86,2024-02-11,14.99,Withdrawal Debit Card MC Debit Seminol/LYFT 2 RIDES 02-13 8558659553 CADate 02/14/24 0 4045828699 0 4121Card 1231,14.99
2/9/2024,Withdrawal POS #000000341143/SUNOCO 8002212501 4234 SW 20TH AVEGAINESVILLE FLCard 1231,36.53,Posted,1202.85,2024-02-09,36.53,Withdrawal POS #000000144391/SUNOCO 8002212501 4234 SW 20TH AVEGAINESVILLE FLCard 1231,36.53
2/9/2024,Recurring Withdrawal Debit Card - MC Debit Seminol/APPLE.COM/BILL CUPERTINO CADate 02/08/24 0 4039766268 0 5735Card 1231,2.99,Posted,1239.38,2024-02-09,2.99,Recurring Withdrawal Debit Card - MC Debit Seminol/APPLE.COM/BILL CUPERTINO CADate 05/03/24 0 4124646881 1 5735Card 1231,2.99
2/9/2024,Withdrawal Debit Card MC Debit Seminol/WALGREENS #5024 GAINESVILLE FLDate 02/08/24 0 4039910522 0 5912Card 1231,10.81,Posted,1242.37,2024-02-09,10.81,Withdrawal Debit Card MC Debit Seminol/WALGREENS #9304 GAINESVILLE FLDate 10/30/24 0 4304125853 1 5912Card 1231,10.81
2/9/2024,Recurring Withdrawal Debit Card - MC Debit Seminol/NETFLIX.COM CADate 02/09/24 0 4040905249 0 4899Card 1231,13.2,Posted,1253.18,2024-02-09,13.2,Recurring Withdrawal Debit Card - MC Debit Seminol/NETFLIX.COM CADate 02/09/24 0 4040905249 0 4899Card 1231,13.2
2/9/2024,Withdrawal POS #000000804934/IC* INSTACART*159 WWW.INSTACART.COM/ SANFRANCISCO CACard 1231,5.0,Posted,1266.38,2024-02-09,5.0,Withdrawal POS #000000794186/IC* INSTACART*159 WWW.INSTACART.COM/ SANFRANCISCO CACard 1231,5.0
2/6/2024,Withdrawal Debit Card MC Debit Seminol/PIKA.ART MOUNTAIN VIE CADate 02/05/24 0 4036916837 0 5734Card 1231,10.0,Posted,1149.71,2024-02-06,10.0,Recurring Withdrawal Debit Card - MC Debit Seminol/PIKA.ART MOUNTAIN VIE CADate 03/05/24 0 4065950684 0 5734Card 1231,10.0
2/6/2024,Withdrawal Debit Card MC Debit Seminol/IC* INSTACART*159 SAN FRANCISC CADate 02/05/24 0 4036668571 0 5411Card 1231,76.44,Posted,1159.71,2024-02-06,76.44,Withdrawal Debit Card MC Debit Seminol/IC* INSTACART*159 SAN FRANCISC CADate 02/23/24 0 4054872144 0 5411Card 1231,76.44
2/5/2024,Withdrawal POS #000000235720/SUNOCO 8002212501 4234 SW 20TH AVEGAINESVILLE FLCard 1231,36.53,Posted,1236.15,2024-02-05,36.53,Withdrawal POS #000000235720/SUNOCO 8002212501 4234 SW 20TH AVEGAINESVILLE FLCard 1231,36.53
2/5/2024,Recurring Withdrawal Debit Card - MC Debit Seminol/CHATGPT SUBSCRIPTION SAN FRANCISC CADate 02/04/24 0 4035267699 0 5734Card 1231,20.0,Posted,1272.68,2024-02-05,20.0,Recurring Withdrawal Debit Card - MC Debit Seminol/CHATGPT SUBSCRIPTION SAN FRANCISC CADate 05/04/24 0 4125659188 0 5734Card 1231,20.0
2/5/2024,Withdrawal POS #000000795274/IC* INSTACART*159 WWW.INSTACART.COM/ SANFRANCISCO CACard 1231,3.0,Posted,1292.68,2024-02-05,3.0,Withdrawal POS #000000794186/IC* INSTACART*159 WWW.INSTACART.COM/ SANFRANCISCO CACard 1231,3.0
2/5/2024,Withdrawal ACH Watson Realty Co/TYPE: WEB PMTS ID: 9000321157CO: Watson Realty CoNAME: Steven chaplinskiEntry Class Code: WEB,1079.0,Posted,1295.68,2024-02-05,1079.0,"Withdrawal ACH Watson Realty Co/TYPE: WEB PMTS ID: 9000321157
CO: Watson Realty Co
NAME: Steven chaplinskiEntry Class Code: WEB",1079.0
2/5/2024,"Withdrawal ACH AppFolio, Inc. F/TYPE: WEB PMTS ID: 9001406550CO: AppFolio, Inc. FNAME: Steven chaplinskiEntry Class Code: WEB",2.49,Posted,2374.68,2024-02-05,2.49,"Withdrawal ACH AppFolio, Inc. F/TYPE: WEB PMTS ID: 9001406550
CO: AppFolio, Inc. F
NAME: Steven chaplinskiEntry Class Code: WEB",2.49
2/4/2024,Recurring Withdrawal Debit Card - MC Debit Seminol/INVIDEO INC COUNTRY OF S DEDate 02/02/24 0 4033532725 0 5734Card 1231,10.0,Posted,2377.17,2024-02-04,10.0,Recurring Withdrawal Debit Card - MC Debit Seminol/INVIDEO INC COUNTRY OF S DEDate 12/09/24 0 4344808122 0 5734Card 1231,10.0
2/4/2024,Withdrawal Debit Card MC Debit Seminol/DOCSIUM.COM SANTA CLARA CADate 02/02/24 0 4033532724 0 5734Card 1231,10.0,Posted,2387.17,2024-02-04,10.0,Recurring Withdrawal Debit Card - MC Debit Seminol/DOCSIUM.COM SANTA CLARA CADate 07/02/24 0 4184077595 1 5734Card 1231,10.0
2/4/2024,Withdrawal Debit Card MC Debit Seminol/CHIPOTLE ONLINE CHIPOTLE.COM CADate 02/04/24 0 4035900306 0 5814Card 1231,32.75,Posted,2397.17,2024-02-04,32.75,Withdrawal Debit Card MC Debit Seminol/CHIPOTLE ONLINE CHIPOTLE.COM CADate 05/14/24 0 4135921741 0 5814Card 1231,32.56
2/4/2024,Recurring Withdrawal Debit Card - MC Debit Seminol/APPLE.COM/BILL 866-712-7753 CADate 02/03/24 0 4034901682 1 5818Card 1231,2.99,Posted,2429.92,2024-02-04,2.99,Recurring Withdrawal Debit Card - MC Debit Seminol/APPLE.COM/BILL 866-712-7753 CADate 04/13/24 0 4104933092 1 5818Card 1231,2.99
2/4/2024,Withdrawal Debit Card MC Debit Seminol/COX GAINESVILLE COMM 800-234-3993 FLDate 02/03/24 0 4034928536 0 4899Card 1231,76.13,Posted,2432.91,2024-02-04,76.13,Withdrawal Debit Card MC Debit Seminol/COX GAINESVILLE COMM 800-234-3993 FLDate 12/04/24 0 4339376311 0 4899Card 1231,76.13
2/4/2024,"Withdrawal Bill Payment #000000776451/Adobe Park Avenue,345 San Jose CACard 1231",29.99,Posted,2509.04,2024-02-04,29.99,"Withdrawal Bill Payment #000000352498/Adobe Park Avenue,345 San Jose CACard 1247",29.99
2/3/2024,Withdrawal Bill Payment #000000317514/GRU EZ PAY 301 SE 4TH AVE US GAINESVILLEFLCard 1231,211.5,Posted,2539.03,2024-02-03,211.5,Withdrawal Bill Payment #000000253521/GRU EZ PAY 301 SE 4TH AVE US GAINESVILLEFLCard 1231,211.5
2/2/2024,Withdrawal POS #000000028242/SUNOCO 8002212501 4234 SW 20TH AVEGAINESVILLE FLCard 1231,36.53,Posted,2750.53,2024-02-02,36.53,Withdrawal POS #000000028242/SUNOCO 8002212501 4234 SW 20TH AVEGAINESVILLE FLCard 1231,36.53
2/2/2024,Withdrawal Bill Payment #000010087462/PAYPAL *SPOTIFYUSAI 2211 North FirstStreet San Jose CACard 1231,6.82,Posted,2787.06,2024-02-02,6.82,Withdrawal Bill Payment #050211031354/PAYPAL *SPOTIFYUSAI 2211 North FirstStreet San Jose CACard 1231,6.82
2/1/2024,Withdrawal Debit Card MC Debit Seminol/IC* INSTACART*159 SAN FRANCISC CADate 02/01/24 0 4032880893 0 5411Card 1231,54.75,Posted,2793.88,2024-02-01,54.75,Withdrawal Debit Card MC Debit Seminol/IC* INSTACART*159 SAN FRANCISC CADate 02/23/24 0 4054872144 0 5411Card 1231,54.75
2/1/2024,Withdrawal POS #000000795959/IC* INSTACART*159 WWW.INSTACART.COM/ SANFRANCISCO CACard 1231,5.0,Posted,2848.63,2024-02-01,5.0,Withdrawal POS #000000794186/IC* INSTACART*159 WWW.INSTACART.COM/ SANFRANCISCO CACard 1231,5.0
1/29/2024,Recurring Withdrawal Debit Card - MC Debit Seminol/APPLE.COM/BILL 866-712-7753 CADate 01/29/24 0 4029763045 0 5818Card 1231,2.99,Posted,53.63,2024-01-29,2.99,Recurring Withdrawal Debit Card - MC Debit Seminol/APPLE.COM/BILL 866-712-7753 CADate 01/08/24 0 4008756344 0 5818Card 2801,2.99
1/28/2024,Withdrawal Debit Card MC Debit Seminol/RUNWAY NEWARK DEDate 01/26/24 0 4026573341 0 5734Card 1231,10.0,Posted,56.62,2024-01-28,10.0,Withdrawal Debit Card MC Debit Seminol/RUNWAY NEWARK DEDate 01/26/24 0 4026573341 0 5734Card 1231,10.0
1/28/2024,"Withdrawal Debit Card MC Debit Seminol/AIPRM, CORP. WILMINGTON DEDate 01/26/24 0 4026718596 1 5734Card 1231",9.71,Posted,66.62,2024-01-28,9.71,"Withdrawal Debit Card MC Debit Seminol/AIPRM, CORP. WILMINGTON DEDate 01/26/24 0 4026718596 1 5734Card 1231",9.71
1/28/2024,Recurring Withdrawal Debit Card - MC Debit Seminol/SHOPIFY* 214299651 ELK GROVE VI ILDate 01/26/24 0 4026855967 1 5734Card 1231,1.0,Posted,76.33,2024-01-28,1.0,Recurring Withdrawal Debit Card - MC Debit Seminol/SHOPIFY* 218664050 ELK GROVE VI ILDate 02/24/24 0 4055933818 1 5734Card 1231,1.0
1/28/2024,Withdrawal Debit Card MC Debit Seminol/VIDIQ SAN FRANCISC CADate 01/26/24 0 4026717498 1 5734Card 1231,10.0,Posted,77.33,2024-01-28,10.0,Withdrawal Debit Card MC Debit Seminol/OPENAI SAN FRANCISC CADate 02/16/24 0 4047896474 1 5734Card 1231,10.0
1/28/2024,Recurring Withdrawal Debit Card - MC Debit Seminol/FS *ADOBE SANTA BARBAR CADate 01/27/24 0 4027835930 0 5734Card 1231,0.95,Posted,87.33,2024-01-28,0.95,Recurring Withdrawal Debit Card - MC Debit Seminol/FS *CONTEXTSFORMAC SANTA BARBAR CADate 02/16/24 0 4047893711 1 5734Card 1231,0.95
1/28/2024,Recurring Withdrawal Debit Card - MC Debit Seminol/APPLE.COM/BILL 866-712-7753 CADate 01/28/24 0 4028896141 0 5818Card 1231,4.99,Posted,88.28,2024-01-28,4.99,Recurring Withdrawal Debit Card - MC Debit Seminol/APPLE.COM/BILL 866-712-7753 CADate 01/08/24 0 4008756344 0 5818Card 2801,4.99
1/27/2024,Withdrawal POS #000000330624/SUNOCO 8002212501 4234 SW 20TH AVEGAINESVILLE FLCard 1231,39.21,Posted,93.27,2024-01-27,39.21,Withdrawal POS #000000028242/SUNOCO 8002212501 4234 SW 20TH AVEGAINESVILLE FLCard 1231,39.21
1/26/2024,Withdrawal Bill Payment #000000737187/EIG*HOSTGATOR.COM WEB*HOSTGATOR.COMBURLINGTON MACard 1231,15.99,Posted,132.48,2024-01-26,15.99,Withdrawal Bill Payment #000000737187/EIG*HOSTGATOR.COM WEB*HOSTGATOR.COMBURLINGTON MACard 1231,15.99
1/26/2024,Withdrawal POS #000000000001/IC* INSTACART*159 WWW.INSTACART.COM/ SANFRANCISCO CACard 1231,5.0,Posted,148.47,2024-01-26,5.0,Withdrawal POS #000000803033/IC* INSTACART*159 WWW.INSTACART.COM/ SANFRANCISCO CACard 1231,5.0
1/26/2024,Withdrawal POS #000000772467/IC* INSTACART*159 WWW.INSTACART.COM/ SANFRANCISCO CACard 1231,83.79,Posted,153.47,2024-01-26,83.79,Withdrawal POS #000000794186/IC* INSTACART*159 WWW.INSTACART.COM/ SANFRANCISCO CACard 1231,83.79
1/25/2024,Withdrawal POS #000000778591/SUNOCO 8002212501 4234 SW 20TH AVEGAINESVILLE FLCard 1231,30.08,Posted,237.26,2024-01-25,30.08,Withdrawal POS #000000778591/SUNOCO 8002212501 4234 SW 20TH AVEGAINESVILLE FLCard 1231,30.39
1/23/2024,Withdrawal POS #000000735703/SUNOCO 8002212501 4234 SW 20TH AVEGAINESVILLE FLCard 1231,15.35,Posted,67.34,2024-01-23,15.35,Withdrawal POS #000000235720/SUNOCO 8002212501 4234 SW 20TH AVEGAINESVILLE FLCard 1231,15.135
1/22/2024,Recurring Withdrawal Debit Card - MC Debit Seminol/RUNWAYML PRO PLAN NEWARK DEDate 01/22/24 0 4022751687 0 5734Card 1231,15.0,Posted,82.69,2024-01-22,15.0,Recurring Withdrawal Debit Card - MC Debit Seminol/RUNWAY STANDARD PLAN NEWARK DEDate 12/15/24 0 4350745942 1 5734Card 1231,15.0
1/22/2024,Recurring Withdrawal Debit Card - MC Debit Seminol/APPLE.COM/BILL 866-712-7753 CADate 01/21/24 0 4021893834 0 5818Card 1231,42.98,Posted,97.69,2024-01-22,42.98,Recurring Withdrawal Debit Card - MC Debit Seminol/APPLE.COM/BILL 866-712-7753 CADate 01/08/24 0 4008756344 0 5818Card 2801,42.98
1/22/2024,Withdrawal Debit Card MC Debit Seminol/LYFT 2 RIDES 01-20 8558659553 CADate 01/21/24 0 4021891955 0 4121Card 1231,21.14,Posted,140.67,2024-01-22,21.14,Withdrawal Debit Card MC Debit Seminol/LYFT 2 RIDES 02-13 8558659553 CADate 02/14/24 0 4045828699 0 4121Card 1231,21.14
1/21/2024,Withdrawal Debit Card MC Debit Seminol/CANVA* I04036-26173350 CAMDEN DEDate 01/20/24 0 4020778238 0 7221Card 1231,12.99,Posted,161.81,2024-01-21,12.99,Withdrawal Debit Card MC Debit Seminol/CANVA* I04036-26173350 CAMDEN DEDate 01/20/24 0 4020778238 0 7221Card 1231,12.99
1/21/2024,Withdrawal POS #000000806756/IC* INSTACART*159 WWW.INSTACART.COM/ SANFRANCISCO CACard 1231,3.0,Posted,174.8,2024-01-21,3.0,Withdrawal POS #000000794186/IC* INSTACART*159 WWW.INSTACART.COM/ SANFRANCISCO CACard 1231,3.0
1/21/2024,Withdrawal POS #000000782726/IC* INSTACART*159 WWW.INSTACART.COM/ SANFRANCISCO CACard 1231,65.09,Posted,177.8,2024-01-21,65.09,Withdrawal POS #000000794186/IC* INSTACART*159 WWW.INSTACART.COM/ SANFRANCISCO CACard 1231,65.09
1/21/2024,Withdrawal POS #000000000119/CIRCLE K # 26146 3525 GAINESVILLE FLCard 1231,32.07,Posted,242.89,2024-01-21,32.07,Withdrawal POS #000000000343/CIRCLE K # 06782 5237 GAINESVILLE FLCard 1247,32.015
1/20/2024,Withdrawal POS #000006039863/GOOGLE *YouTubePremium 1600 AmphitheatreParkw Mountain View CACard 1231,15.92,Posted,74.96,2024-01-20,15.92,"Withdrawal POS #000020312090/GOOGLE *YouTubePremium 1600 Amphitheatre
Parkw Mountain View CA
Card 1247",15.92
1/19/2024,Withdrawal Debit Card MC Debit Seminol/WALGREENS #5024 GAINESVILLE FLDate 01/18/24 0 4018883934 0 5912Card 1231,15.0,Posted,90.88,2024-01-19,15.0,Withdrawal Debit Card MC Debit Seminol/WALGREENS #9304 GAINESVILLE FLDate 10/30/24 0 4304125853 1 5912Card 1231,15.0
1/18/2024,Withdrawal POS #000020839973/SUNOCO 80022125 GAINESVILLE GAINESVILLECard 1231,36.53,Posted,105.88,2024-01-18,36.53,Withdrawal POS #000020839973/SUNOCO 80022125 GAINESVILLE GAINESVILLECard 1231,36.53
1/16/2024,Withdrawal POS #000000000000/IC* INSTACART*159 WWW.INSTACART.COM/ SANFRANCISCO CACard 1231,3.0,Posted,136.11,2024-01-16,3.0,Withdrawal POS #000000803033/IC* INSTACART*159 WWW.INSTACART.COM/ SANFRANCISCO CACard 1231,3.0
1/16/2024,Withdrawal POS #000000000071/IC* INSTACART*159 WWW.INSTACART.COM/ SANFRANCISCO CACard 1231,59.11,Posted,139.11,2024-01-16,59.11,Withdrawal POS #000000794186/IC* INSTACART*159 WWW.INSTACART.COM/ SANFRANCISCO CACard 1231,59.11
1/16/2024,Withdrawal POS #000020836462/SUNOCO 80022125 GAINESVILLE GAINESVILLECard 1231,10.0,Posted,198.22,2024-01-16,10.0,Withdrawal POS #000020839973/SUNOCO 80022125 GAINESVILLE GAINESVILLECard 1231,10.0
1/15/2024,Withdrawal POS #000020834526/SUNOCO 80022125 GAINESVILLE GAINESVILLECard 1231,36.53,Posted,208.22,2024-01-15,36.53,Withdrawal POS #000020839973/SUNOCO 80022125 GAINESVILLE GAINESVILLECard 1231,36.53
1/14/2024,Withdrawal POS #000000792113/IC* INSTACART*159 WWW.INSTACART.COM/ SANFRANCISCO CACard 1231,3.0,Posted,244.75,2024-01-14,3.0,Withdrawal POS #000000794186/IC* INSTACART*159 WWW.INSTACART.COM/ SANFRANCISCO CACard 1231,3.0
1/14/2024,Withdrawal POS #000000783971/IC* INSTACART*159 WWW.INSTACART.COM/ SANFRANCISCO CACard 1231,62.0,Posted,247.75,2024-01-14,62.0,Withdrawal POS #000000794186/IC* INSTACART*159 WWW.INSTACART.COM/ SANFRANCISCO CACard 1231,62.0
1/14/2024,Withdrawal POS #000000000017/CIRCLE K # 06782 5237 GAINESVILLE FLCard 1231,31.96,Posted,309.75,2024-01-14,31.96,Withdrawal POS #000000000343/CIRCLE K # 06782 5237 GAINESVILLE FLCard 1247,32.015
1/12/2024,Withdrawal Debit Card MC Debit Seminol/MIDJOURNEY INC. SOUTH SAN FR CADate 01/11/24 0 4011746894 0 5734Card 1231,30.0,Posted,341.71,2024-01-12,30.0,Recurring Withdrawal Debit Card - MC Debit Seminol/MIDJOURNEY INC. SOUTH SAN FR CADate 05/14/24 0 4135994595 0 5734Card 1231,30.0
1/11/2024,Withdrawal POS #000000000113/CIRCLE K # 26162 7302 GAINESVILLE FLCard 1231,28.32,Posted,371.71,2024-01-11,28.32,Withdrawal POS #000000000343/CIRCLE K # 06782 5237 GAINESVILLE FLCard 1247,28.796666666666667
1/11/2024,Withdrawal Debit Card Fee/MASTERCARD ISSUER CROSS-BORDER FEEDate 01/10/24 0 4010873277 0 8999Card 2801,0.57,Posted,400.03,2024-01-11,0.57,Recurring Withdrawal Debit Card Fee/MASTERCARD ISSUER CROSS-BORDER FEEDate 01/06/24 0 4006875269 0 5815Card 2801,0.20272727272727267
1/11/2024,Withdrawal Debit Card MC Debit Seminol/MERCADOPAGO*SUPERBUPER CAP.FEDERAL AVDate 01/10/24 0 4010873277 0 8999Card 2801,71.46,Posted,400.6,2024-01-11,71.46,Withdrawal Debit Card MC Debit Seminol/MERCADOPAGO*SUPERBUPER CAP.FEDERAL AVDate 01/10/24 0 4010873277 0 8999Card 2801,71.46
1/11/2024,Withdrawal Debit Card Fee/MASTERCARD ISSUER CROSS-BORDER FEEDate 01/10/24 0 4010868194 0 5571Card 2801,0.4,Posted,472.06,2024-01-11,0.4,Recurring Withdrawal Debit Card Fee/MASTERCARD ISSUER CROSS-BORDER FEEDate 01/06/24 0 4006875269 0 5815Card 2801,0.20272727272727267
1/11/2024,Withdrawal Debit Card MC Debit Seminol/HAULMER*VENTA DE MALL SANTIAGO CLDate 01/10/24 0 4010868194 0 5571Card 2801,50.21,Posted,472.46,2024-01-11,50.21,Withdrawal Debit Card MC Debit Seminol/HAULMER*VENTA DE MALL SANTIAGO CLDate 01/10/24 0 4010868194 0 5571Card 2801,50.21
1/11/2024,Withdrawal ACH KLARNA/TYPE: E4F7Z8C ID: 0514670203 CO: KLARNANAME: steven chaplinskiEntry Class Code: WEB,66.92,Posted,522.67,2024-01-11,66.92,Withdrawal ACH KLARNA/TYPE: E4F7Z8C ID: 0514670203 CO: KLARNANAME: steven chaplinskiEntry Class Code: WEB,66.92
1/9/2024,Recurring Withdrawal Debit Card - MC Debit Seminol/KDP AUTOMATION LAS VEGAS NVDate 01/09/24 0 4009846213 0 7392Card 2801,14.99,Posted,570.04,2024-01-09,14.99,Recurring Withdrawal Debit Card - MC Debit Seminol/KDP AUTOMATION LAS VEGAS NVDate 01/09/24 0 4009846213 0 7392Card 2801,14.99
1/9/2024,Recurring Withdrawal Debit Card - MC Debit Seminol/OPENAI SAN FRANCISC CADate 01/08/24 0 4008760800 0 5734Card 2801,5.83,Posted,585.03,2024-01-09,5.83,Recurring Withdrawal Debit Card - MC Debit Seminol/PARAMOUNT+ SAN FRANCISC CADate 01/02/24 0 4002821550 0 4899Card 2801,5.83
1/9/2024,Withdrawal Debit Card MC Debit Seminol/PAYPAL *PHOTOPEA 4029357733 CADate 01/08/24 0 4008760242 0 5734Card 2801,8.8,Posted,590.86,2024-01-09,8.8,Withdrawal Debit Card MC Debit Seminol/PAYPAL *PHOTOPEA 4029357733 CADate 01/08/24 0 4008760242 0 5734Card 2801,8.8
1/9/2024,Recurring Withdrawal Debit Card - MC Debit Seminol/MYDESIGNS.IO LAS VEGAS NVDate 01/08/24 0 4008793270 0 5734Card 2801,16.76,Posted,599.66,2024-01-09,16.76,Withdrawal Debit Card MC Debit Seminol/MYDESIGNS.IO LAS VEGAS NVDate 01/07/24 0 4007751481 0 5734Card 2801,16.76
1/9/2024,Withdrawal Debit Card MC Debit Seminol/ETSY.COM*AIAVATAR BROOKLYN NYDate 01/08/24 0 4008758895 0 5699Card 2801,11.55,Posted,616.42,2024-01-09,11.55,Withdrawal Debit Card MC Debit Seminol/ETSY.COM*AIAVATAR BROOKLYN NYDate 01/08/24 0 4008758895 0 5699Card 2801,11.55
1/9/2024,Recurring Withdrawal Debit Card - MC Debit Seminol/ETSY.COM*AIAVATAR BROOKLYN NYDate 01/08/24 0 4008758894 0 5699Card 2801,14.97,Posted,627.97,2024-01-09,14.97,Withdrawal Debit Card MC Debit Seminol/ETSY.COM*AIAVATAR BROOKLYN NYDate 01/08/24 0 4008758895 0 5699Card 2801,14.52
1/9/2024,Recurring Withdrawal Debit Card - MC Debit Seminol/AMAZON PRIME*RT0NZ30U0 AMZN.COM/BIL WADate 01/08/24 0 4008298648 0 5968Card 2801,15.13,Posted,642.94,2024-01-09,15.13,Recurring Withdrawal Debit Card - MC Debit Seminol/AMAZON PRIME*Z97W01ZG2 AMZN.COM/BIL WADate 12/17/24 0 4352950216 0 5968Card 1231,15.120000000000001
1/9/2024,Recurring Withdrawal Debit Card - MC Debit Seminol/APPLE.COM/BILL 866-712-7753 CADate 01/08/24 0 4008756344 0 5818Card 2801,2.99,Posted,658.07,2024-01-09,2.99,Recurring Withdrawal Debit Card - MC Debit Seminol/APPLE.COM/BILL 866-712-7753 CADate 01/08/24 0 4008756344 0 5818Card 2801,2.99
1/9/2024,Withdrawal POS #000000000001/AMAZON.COM*TK5HF56S1 SEATTLE WACard 2801,36.99,Posted,661.06,2024-01-09,36.99,Withdrawal POS #000000000001/AMAZON.COM*TK5HF56S1 SEATTLE WACard 2801,36.99
1/8/2024,Recurring Withdrawal Debit Card Fee/MASTERCARD ISSUER CROSS-BORDER FEEDate 01/08/24 0 4008859029 0 5734Card 2801,0.24,Posted,698.05,2024-01-08,0.24,Recurring Withdrawal Debit Card Fee/MASTERCARD ISSUER CROSS-BORDER FEEDate 12/31/23 0 3365740203 0 5734Card 2801,0.10500000000000001
1/8/2024,Recurring Withdrawal Debit Card - MC Debit Seminol/ALURA SUBSCRIPTION OSLO DUDate 01/08/24 0 4008859029 0 5734Card 2801,29.99,Posted,698.29,2024-01-08,29.99,Recurring Withdrawal Debit Card - MC Debit Seminol/ALURA SUBSCRIPTION OSLO DUDate 01/08/24 0 4008859029 0 5734Card 2801,29.99
1/8/2024,Withdrawal Debit Card MC Debit Seminol/PRINTIFY.COM WILMINGTON DEDate 01/07/24 0 4007751687 0 7333Card 2801,26.85,Posted,728.28,2024-01-08,26.85,Withdrawal Debit Card MC Debit Seminol/PRINTIFY.COM WILMINGTON DEDate 03/19/24 0 4079795188 0 7333Card 1231,26.85
1/8/2024,Withdrawal Debit Card MC Debit Seminol/MYDESIGNS.IO LAS VEGAS NVDate 01/07/24 0 4007751481 0 5734Card 2801,50.0,Posted,755.13,2024-01-08,50.0,Withdrawal Debit Card MC Debit Seminol/MYDESIGNS.IO LAS VEGAS NVDate 01/07/24 0 4007751481 0 5734Card 2801,50.0
1/8/2024,Withdrawal Debit Card Fee/MASTERCARD ISSUER CROSS-BORDER FEEDate 01/07/24 0 4007255515 0 5734Card 2801,0.07,Posted,805.13,2024-01-08,0.07,Recurring Withdrawal Debit Card Fee/MASTERCARD ISSUER CROSS-BORDER FEEDate 01/06/24 0 4006875269 0 5815Card 2801,0.20272727272727267
1/8/2024,Withdrawal Debit Card MC Debit Seminol/IDEOGRAM.AI TORONTO ONDate 01/07/24 0 4007255515 0 5734Card 2801,8.38,Posted,805.2,2024-01-08,8.38,Withdrawal Debit Card MC Debit Seminol/IDEOGRAM.AI TORONTO ONDate 04/15/24 0 4106835174 0 5734Card 1231,8.190000000000001
1/8/2024,Withdrawal Debit Card MC Debit Seminol/ETSY.COM*AIAVATAR BROOKLYN NYDate 01/07/24 0 4007750413 0 5699Card 2801,19.55,Posted,813.58,2024-01-08,19.55,Withdrawal Debit Card MC Debit Seminol/ETSY.COM*AIAVATAR BROOKLYN NYDate 01/08/24 0 4008758895 0 5699Card 2801,19.55
1/8/2024,Withdrawal POS #000000000026/INSTACART*159 WWW.INSTACART.COM/ SANFRANCISCO CACard 2801,81.9,Posted,833.13,2024-01-08,81.9,Withdrawal POS #000000000003/INSTACART*159 WWW.INSTACART.COM/ SANFRANCISCO CACard 1231,81.9
1/7/2024,Withdrawal POS #000020838579/SUNOCO 80022125 GAINESVILLE GAINESVILLECard 2801,36.53,Posted,915.03,2024-01-07,36.53,Withdrawal POS #000020839973/SUNOCO 80022125 GAINESVILLE GAINESVILLECard 1231,36.53
1/7/2024,Recurring Withdrawal Debit Card - MC Debit Seminol/D-ID STUDIO WILMINGTON DEDate 01/06/24 0 4006082355 1 7399Card 2801,49.0,Posted,951.56,2024-01-07,49.0,Recurring Withdrawal Debit Card - MC Debit Seminol/D-ID STUDIO WILMINGTON DEDate 10/13/24 0 4287011811 1 7399Card 1231,49.0
1/7/2024,Recurring Withdrawal Debit Card - MC Debit Seminol/LINKTREE* LINKTREE DOVER DEDate 01/05/24 0 4005830282 1 5734Card 2801,14.99,Posted,1000.56,2024-01-07,14.99,Recurring Withdrawal Debit Card - MC Debit Seminol/LINKTREE* LINKTREE DOVER DEDate 04/16/24 0 4107289275 0 7399Card 1231,14.99
1/7/2024,Recurring Withdrawal Debit Card Fee/MASTERCARD ISSUER CROSS-BORDER FEEDate 01/06/24 0 4006875269 0 5815Card 2801,0.31,Posted,1015.55,2024-01-07,0.31,Recurring Withdrawal Debit Card Fee/MASTERCARD ISSUER CROSS-BORDER FEEDate 01/06/24 0 4006875269 0 5815Card 2801,0.20272727272727267
1/7/2024,Recurring Withdrawal Debit Card - MC Debit Seminol/PLAY.HT BANGALORE BEDate 01/06/24 0 4006875269 0 5815Card 2801,39.0,Posted,1015.86,2024-01-07,39.0,Recurring Withdrawal Debit Card - MC Debit Seminol/PLAY.HT BANGALORE BEDate 01/06/24 0 4006875269 0 5815Card 2801,39.0
1/7/2024,Recurring Withdrawal Debit Card - MC Debit Seminol/ELEVENLABS.IO NEW YORK NYDate 01/07/24 0 4007080576 1 5734Card 2801,5.0,Posted,1054.86,2024-01-07,5.0,Recurring Withdrawal Debit Card - MC Debit Seminol/ELEVENLABS.IO NEW YORK NYDate 04/17/24 0 4108862142 0 5734Card 1231,5.0
1/7/2024,"Recurring Withdrawal Debit Card - MC Debit Seminol/MARMALEAD, LLC 4079065736 FLDate 01/05/24 0 4005822541 1 5045Card 2801",19.0,Posted,1059.86,2024-01-07,19.0,"Recurring Withdrawal Debit Card - MC Debit Seminol/MARMALEAD, LLC 4079065736 FLDate 01/05/24 0 4005822541 1 5045Card 2801",19.0
1/6/2024,Recurring Withdrawal Bill Payment - #000000166582/NETFLIX COM LOS GATOS CACard 2801,13.2,Posted,1078.86,2024-01-06,13.2,"Recurring Withdrawal Bill Payment - #000000017652/NETFLIX COM LOS GATOS CA
Card 1247",13.504999999999999
1/5/2024,Recurring Withdrawal Debit Card - MC Debit Seminol/CHATGPT SUBSCRIPTION SAN FRANCISC CADate 01/04/24 0 4004307990 0 5734Card 2801,20.0,Posted,1092.06,2024-01-05,20.0,Recurring Withdrawal Debit Card - MC Debit Seminol/CHATGPT SUBSCRIPTION SAN FRANCISC CADate 05/04/24 0 4125659188 0 5734Card 1231,20.0
1/5/2024,Recurring Withdrawal Debit Card - MC Debit Seminol/WWW.EVERBEE.IO SANTEE CADate 01/05/24 0 4005834841 0 5734Card 2801,29.99,Posted,1112.06,2024-01-05,29.99,Recurring Withdrawal Debit Card - MC Debit Seminol/WWW.EVERBEE.IO SANTEE CADate 01/05/24 0 4005834841 0 5734Card 2801,29.99
1/5/2024,Recurring Withdrawal Debit Card - MC Debit Seminol/DISNEY PLUS 8889057888 CADate 01/04/24 0 4004768661 0 4899Card 2801,16.11,Posted,1142.05,2024-01-05,16.11,Recurring Withdrawal Debit Card - MC Debit Seminol/DISNEY PLUS 8889057888 CADate 10/02/24 0 4276239357 1 4899Card 1231,16.11
1/5/2024,Withdrawal Debit Card MC Debit Seminol/MAIL.COM 005802235076- PHILADELPHIA PADate 01/04/24 0 4004909282 0 4816Card 2801,14.95,Posted,1158.16,2024-01-05,14.95,Withdrawal Debit Card MC Debit Seminol/MAIL.COM 005802235076- PHILADELPHIA PADate 01/04/24 0 4004909282 0 4816Card 2801,14.95
1/5/2024,Recurring Withdrawal Debit Card - MC Debit Seminol/ADOBE *STOCK 4085366000 CADate 01/04/24 0 4004903002 0 5734Card 2801,29.99,Posted,1173.11,2024-01-05,29.99,Recurring Withdrawal Debit Card - MC Debit Seminol/ADOBE *STOCK 4085366000 CADate 01/04/24 0 4004903002 0 5734Card 2801,29.99
1/4/2024,Recurring Withdrawal Debit Card - MC Debit Seminol/MINDRENDERS.COM LAPEER MIDate 01/04/24 0 4004883312 0 5734Card 2801,5.0,Posted,1203.1,2024-01-04,5.0,Recurring Withdrawal Debit Card - MC Debit Seminol/MINDRENDERS.COM LAPEER MIDate 01/04/24 0 4004883312 0 5734Card 2801,5.0
1/4/2024,Withdrawal Debit Card MC Debit Seminol/IONOS INC. CHESTERBROOK PADate 01/03/24 0 4003951251 0 4816Card 2801,1.0,Posted,1208.1,2024-01-04,1.0,Withdrawal Debit Card MC Debit Seminol/IONOS INC. CHESTERBROOK PADate 12/29/24 0 4364954464 0 4816Card 1231,0.8400000000000001
1/4/2024,Recurring Withdrawal Debit Card - MC Debit Seminol/APPLE.COM/BILL CUPERTINO CADate 01/03/24 0 4003843327 0 5735Card 2801,2.99,Posted,1209.1,2024-01-04,2.99,Recurring Withdrawal Debit Card - MC Debit Seminol/APPLE.COM/BILL CUPERTINO CADate 05/03/24 0 4124646881 1 5735Card 1231,2.99
1/4/2024,Recurring Withdrawal Debit Card - MC Debit Seminol/ADOBE *CREATIVE CLOUD 4085366000 CADate 01/03/24 0 4003945121 0 5734Card 2801,19.99,Posted,1212.09,2024-01-04,19.99,Recurring Withdrawal Debit Card - MC Debit Seminol/ADOBE *STOCK 4085366000 CADate 01/04/24 0 4004903002 0 5734Card 2801,19.99
1/4/2024,Withdrawal ACH FLUENT-Gainesvil/TYPE: PAYMENT ID: 1371804719CO: FLUENT-GainesvilNAME: steven chaplinskiEntry Class Code: WEB,52.0,Posted,1232.08,2024-01-04,52.0,Withdrawal ACH FLUENT-Gainesvil/TYPE: PAYMENT ID: 1371804719CO: FLUENT-GainesvilNAME: steven chaplinski,51.75
1/3/2024,Recurring Withdrawal Debit Card - MC Debit Seminol/PARAMOUNT+ SAN FRANCISC CADate 01/02/24 0 4002821550 0 4899Card 2801,13.81,Posted,1284.08,2024-01-03,13.81,Recurring Withdrawal Debit Card - MC Debit Seminol/PARAMOUNT+ SAN FRANCISC CADate 01/02/24 0 4002821550 0 4899Card 2801,13.81
1/3/2024,Recurring Withdrawal Debit Card Fee/MASTERCARD ISSUER CROSS-BORDER FEEDate 01/02/24 0 4002821343 0 7399Card 2801,0.07,Posted,1297.89,2024-01-03,0.07,Recurring Withdrawal Debit Card Fee/MASTERCARD ISSUER CROSS-BORDER FEEDate 12/31/23 0 3365740203 0 5734Card 2801,0.10500000000000001
1/3/2024,Recurring Withdrawal Debit Card - MC Debit Seminol/CREATIVE FABRICA AMSTERDAM NHDate 01/02/24 0 4002821343 0 7399Card 2801,9.0,Posted,1297.96,2024-01-03,9.0,Recurring Withdrawal Debit Card - MC Debit Seminol/CREATIVE FABRICA AMSTERDAM NHDate 10/03/24 0 4277044624 1 7399Card 1231,9.0
1/2/2024,Withdrawal POS #010210787460/PAYPAL *SPOTIFYUSAI 2211 North FirstStreet San Jose CACard 2801,6.82,Posted,1301.62,2024-01-02,6.82,Withdrawal POS #010210787460/PAYPAL *SPOTIFYUSAI 2211 North FirstStreet San Jose CACard 2801,6.82
1/2/2024,Withdrawal POS #000000966158/SUNOCO 8002212501 4234 SW 20TH AVEGAINESVILLE FLCard 2801,34.56,Posted,1308.44,2024-01-02,34.56,Withdrawal POS #000000966158/SUNOCO 8002212501 4234 SW 20TH AVEGAINESVILLE FLCard 2801,34.400000000000006
1/2/2024,Withdrawal POS #000012002801/WALGREENS 3455 SW ARCH GAINESVILLE FLCard 2801,20.38,Posted,1343.0,2024-01-02,20.38,Withdrawal POS #000012002801/WALGREENS 3455 SW ARCH GAINESVILLE FLCard 2801,20.38
1/2/2024,Recurring Withdrawal Debit Card - MC Debit Seminol/NAME-CHEAP.COM* NNMBEK PHOENIX AZDate 01/01/24 0 4001676508 0 7372Card 2801,10.46,Posted,1363.38,2024-01-02,10.46,Recurring Withdrawal Debit Card - MC Debit Seminol/NAME-CHEAP.COM* NNMBEK PHOENIX AZDate 01/01/24 0 4001676508 0 7372Card 2801,10.46
1/2/2024,Recurring Withdrawal Debit Card - MC Debit Seminol/WPDEVELOPER MILTON DEDate 01/02/24 0 4002616374 0 7372Card 2801,39.0,Posted,1373.84,2024-01-02,39.0,Recurring Withdrawal Debit Card - MC Debit Seminol/WPDEVELOPER MILTON DEDate 01/02/24 0 4002616374 0 7372Card 2801,39.0
1/2/2024,Recurring Withdrawal Debit Card - MC Debit Seminol/PADDLE.NET* KAIBER AI ASTORIA NYDate 01/01/24 0 4001675678 0 5817Card 2801,15.0,Posted,1412.84,2024-01-02,15.0,Recurring Withdrawal Debit Card - MC Debit Seminol/PADDLE.NET* LEONARDOAI ASTORIA NYDate 12/16/24 0 4351323834 0 5817Card 1231,15.0
1/2/2024,Withdrawal Debit Card MC Debit Seminol/PRINTIFY.COM WILMINGTON DEDate 01/01/24 0 4001649319 0 7333Card 2801,11.21,Posted,1427.84,2024-01-02,11.21,Withdrawal Debit Card MC Debit Seminol/PRINTIFY.COM WILMINGTON DEDate 03/19/24 0 4079795188 0 7333Card 1231,11.21
1/2/2024,Recurring Withdrawal Debit Card - MC Debit Seminol/FS *ADOBE SANTA BARBAR CADate 01/01/24 0 4001674859 0 5734Card 2801,9.99,Posted,1439.05,2024-01-02,9.99,Recurring Withdrawal Debit Card - MC Debit Seminol/FS *ADOBE SANTA BARBAR CADate 12/24/24 0 4359034647 1 5734Card 1231,9.99
1/2/2024,Withdrawal Debit Card MC Debit Seminol/CHIPOTLE ONLINE CHIPOTLE.COM CADate 01/02/24 0 4002615532 0 5814Card 2801,45.0,Posted,1449.04,2024-01-02,45.0,Withdrawal Debit Card MC Debit Seminol/CHIPOTLE ONLINE CHIPOTLE.COM CADate 05/14/24 0 4135921741 0 5814Card 1231,45.0
1/2/2024,Recurring Withdrawal Debit Card - MC Debit Seminol/ADOBE *PS CREATIVE CL 4085366000 CADate 01/01/24 0 4001644620 0 5734Card 2801,22.99,Posted,1494.04,2024-01-02,22.99,Recurring Withdrawal Debit Card - MC Debit Seminol/ADOBE *STOCK 4085366000 CADate 01/04/24 0 4004903002 0 5734Card 2801,22.99
1/2/2024,Withdrawal ACH Watson Realty Co/TYPE: WEB PMTS ID: 9000321157CO: Watson Realty CoNAME: Steven chaplinskiEntry Class Code: WEB,1079.0,Posted,1517.03,2024-01-02,1079.0,"Withdrawal ACH Watson Realty Co/TYPE: WEB PMTS ID: 9000321157
CO: Watson Realty Co
NAME: Steven chaplinskiEntry Class Code: WEB",1079.0
1/2/2024,"Withdrawal ACH AppFolio, Inc. F/TYPE: WEB PMTS ID: 9001406550CO: AppFolio, Inc. FNAME: Steven chaplinskiEntry Class Code: WEB",2.49,Posted,2596.03,2024-01-02,2.49,"Withdrawal ACH AppFolio, Inc. F/TYPE: WEB PMTS ID: 9001406550
CO: AppFolio, Inc. F
NAME: Steven chaplinskiEntry Class Code: WEB",2.49
1/1/2024,Withdrawal Debit Card MC Debit Seminol/INTERNET MARKETING SOL PARKERSBURG WVDate 12/31/23 0 3365856927 0 7392Card 2801,37.0,Posted,2598.52,2024-01-01,37.0,Withdrawal Debit Card MC Debit Seminol/INTERNET MARKETING SOL PARKERSBURG WVDate 12/31/23 0 3365856927 0 7392Card 2801,37.0
1/1/2024,Recurring Withdrawal Debit Card - MC Debit Seminol/LEMSQZY* KWESTIFY SALT LAKE CI UTDate 12/31/23 0 3365856866 0 5734Card 2801,12.0,Posted,2635.52,2024-01-01,12.0,Recurring Withdrawal Debit Card - MC Debit Seminol/LEMSQZY* KWESTIFY SALT LAKE CI UTDate 12/31/23 0 3365856866 0 5734Card 2801,12.0
1/1/2024,Withdrawal Debit Card MC Debit Seminol/INTERNET MARKETING SOL PARKERSBURG WVDate 12/31/23 0 3365227002 0 7392Card 2801,12.0,Posted,2647.52,2024-01-01,12.0,Withdrawal Debit Card MC Debit Seminol/INTERNET MARKETING SOL PARKERSBURG WVDate 12/31/23 0 3365856927 0 7392Card 2801,12.0
1/1/2024,"Withdrawal Debit Card MC Debit Seminol/PIXEL ML, INC. LAS VEGAS NVDate 12/31/23 0 3365226971 0 5734Card 2801",9.0,Posted,2659.52,2024-01-01,9.0,"Withdrawal Debit Card MC Debit Seminol/PIXEL ML, INC. LAS VEGAS NVDate 12/31/23 0 3365226971 0 5734Card 2801",9.0
1/1/2024,Withdrawal Debit Card Fee/MASTERCARD ISSUER CROSS-BORDER FEEDate 01/01/24 0 4001856471 0 5734Card 2801,0.12,Posted,2668.52,2024-01-01,0.12,Recurring Withdrawal Debit Card Fee/MASTERCARD ISSUER CROSS-BORDER FEEDate 01/06/24 0 4006875269 0 5815Card 2801,0.20272727272727267
1/1/2024,Withdrawal Debit Card MC Debit Seminol/HOSTINGER.COM LARNAKA CYDate 01/01/24 0 4001856471 0 5734Card 2801,14.98,Posted,2668.64,2024-01-01,14.98,Withdrawal Debit Card MC Debit Seminol/HOSTINGER.COM LARNAKA CYDate 01/01/24 0 4001856471 0 5734Card 2801,14.98
1/1/2024,Recurring Withdrawal Debit Card - MC Debit Seminol/MYDESIGNS - PRO - MON LAS VEGAS NVDate 01/01/24 0 4001780983 0 5734Card 2801,29.99,Posted,2683.62,2024-01-01,29.99,Recurring Withdrawal Debit Card - MC Debit Seminol/MYDESIGNS - PRO - MON LAS VEGAS NVDate 12/08/24 0 4343357881 0 5734Card 1231,29.99
1/1/2024,Recurring Withdrawal Debit Card Fee/MASTERCARD ISSUER CROSS-BORDER FEEDate 12/31/23 0 3365740203 0 5734Card 2801,0.2,Posted,2713.61,2024-01-01,0.2,Recurring Withdrawal Debit Card Fee/MASTERCARD ISSUER CROSS-BORDER FEEDate 12/31/23 0 3365740203 0 5734Card 2801,0.10500000000000001
1/1/2024,Recurring Withdrawal Debit Card - MC Debit Seminol/MERCHDOMINATOR.COM LONDON LNDate 12/31/23 0 3365740203 0 5734Card 2801,24.5,Posted,2713.81,2024-01-01,24.5,Recurring Withdrawal Debit Card - MC Debit Seminol/MERCHDOMINATOR.COM LONDON LNDate 12/31/23 0 3365740203 0 5734Card 2801,24.5
1/1/2024,Recurring Withdrawal Debit Card - MC Debit Seminol/ETSY.COM*AIAVATAR BROOKLYN NYDate 01/01/24 0 4001780812 0 5970Card 2801,21.2,Posted,2738.31,2024-01-01,21.2,Withdrawal Debit Card MC Debit Seminol/ETSY.COM*AIAVATAR BROOKLYN NYDate 01/08/24 0 4008758895 0 5699Card 2801,21.2
1/1/2024,Withdrawal Debit Card MC Debit Seminol/ETSY.COM*AIAVATAR BROOKLYN NYDate 01/01/24 0 4001780748 0 5699Card 2801,14.07,Posted,2759.51,2024-01-01,14.07,Withdrawal Debit Card MC Debit Seminol/ETSY.COM*AIAVATAR BROOKLYN NYDate 01/08/24 0 4008758895 0 5699Card 2801,14.52
1/1/2024,Withdrawal Debit Card MC Debit Seminol/GRU/EZ-PAY WEB PYMT 352-334-3434 FLDate 12/31/23 0 3365848981 0 4900Card 2801,149.11,Posted,2773.58,2024-01-01,149.11,Withdrawal Debit Card MC Debit Seminol/GRU/EZ-PAY WEB PYMT 352-334-3434 FLDate 12/05/24 0 4340279271 0 4900Card 1231,149.11
1/1/2024,Withdrawal POS #000000890165/SUNOCO 8002212501 4234 SW 20TH AVEGAINESVILLE FLCard 2801,29.5,Posted,2922.69,2024-01-01,29.5,Withdrawal POS #000000966158/SUNOCO 8002212501 4234 SW 20TH AVEGAINESVILLE FLCard 2801,29.5
