"Post Date","Check","Description","Debit","Credit","Status","Balance"
"6/6/2025","","Recurring Withdrawal Debit Card - MC Debit Gator/SUPERPOWER CHATGPT MIDDLETOWN DE

Date 06/05/25 0 5156229550 1 5734

Card 1247","15","","Posted","847.61"
"6/6/2025","","Recurring Withdrawal Debit Card - MC Debit Gator/SUPERPOWER CHATGPT MIDDLETOWN DE

Date 06/05/25 0 5156229549 1 5734

Card 1247","15","","Posted","862.61"
"6/6/2025","","Withdrawal Debit Card MC Debit Gator/IONOS INC. CHESTERBROOK PA

Date 06/05/25 0 5156041339 1 4816

Card 1247","60","","Posted","877.61"
"6/5/2025","","Recurring Withdrawal Debit Card - MC Debit Gator/OPENAI *CHATGPT SUBSCR SAN FRANCISC CA

Date 06/04/25 0 5155335474 0 5734

Card 1247","20","","Posted","937.61"
"6/4/2025","","Recurring Withdrawal Debit Card - MC Debit Gator/APPLE.COM/BILL 866-712-7753 CA

Date 06/03/25 0 5154093226 1 5818

Card 1247","6.98","","Posted","957.61"
"6/4/2025","","Withdrawal Bill Payment #000000229775/ADOBE INC ADOBE ADOBE.COM SAN JOSE CA

Card 1247","19.99","","Posted","964.59"
"6/4/2025","","Withdrawal POS #000000580851/SUNOCO 8002212501 4234 SW 20TH AVE

GAINESVILLE FL

Card 1247","26.86","","Posted","984.58"
"6/3/2025","","Recurring Withdrawal Debit Card - MC Debit Gator/OPENAI SAN FRANCISC CA

Date 06/02/25 0 5153238318 1 5734

Card 1247","6.06","","Posted","1011.44"
"6/3/2025","","Recurring Withdrawal Debit Card - MC Debit Gator/NOTION LABS, INC. SAN FRANCISC CA

Date 06/02/25 0 5153210973 1 7372

Card 1247","22","","Posted","1017.5"
"6/3/2025","","Recurring Withdrawal Debit Card - MC Debit Gator/OPENAI SAN FRANCISC CA

Date 06/02/25 0 5153210920 1 5734

Card 1247","6.06","","Posted","1039.5"
"6/3/2025","","Recurring Withdrawal Debit Card - MC Debit Gator/APPLE.COM/BILL 866-712-7753 CA

Date 06/03/25 0 5154230337 1 5818

Card 1247","2.99","","Posted","1045.56"
"6/3/2025","","Withdrawal Bill Payment #000000197457/ADOBE INC ADOBE ADOBE.COM SAN JOSE CA

Card 1247","19.99","","Posted","1048.55"
"6/3/2025","","Recurring Withdrawal Bill Payment - #000000000059/ADOBE INC CS ADDTL STORAG ADOBE.COM SAN

JOSE CA

Card 1247","9.99","","Posted","1068.54"
"6/3/2025","","Recurring Withdrawal Bill Payment - #000000362823/ADOBE INC ADOBE ADOBE.COM SAN JOSE CA

Card 1247","19.99","","Posted","1078.53"
"6/2/2025","","Withdrawal POS #000000572320/SUNOCO 8002212501 4234 SW 20TH AVE

GAINESVILLE FL

Card 1247","22.17","","Posted","1098.52"
"6/2/2025","","Recurring Withdrawal Debit Card - MC Debit Gator/MYDESIGNS - PRO - MON LAS VEGAS NV

Date 06/01/25 0 5152146505 1 5734

Card 1247","49.99","","Posted","1120.69"
"6/2/2025","","Recurring Withdrawal Debit Card - MC Debit Gator/OPENAI SAN FRANCISC CA

Date 06/02/25 0 5153117531 1 5734

Card 1247","6.04","","Posted","1170.68"
"6/2/2025","","Recurring Withdrawal Debit Card - MC Debit Gator/OPENAI SAN FRANCISC CA

Date 05/31/25 0 5151282040 2 5734

Card 1247","6.27","","Posted","1176.72"
"6/2/2025","","Recurring Withdrawal Debit Card - MC Debit Gator/OPENAI SAN FRANCISC CA

Date 06/01/25 0 5152295185 0 5734

Card 1247","6.24","","Posted","1182.99"
"6/2/2025","","Recurring Withdrawal Debit Card - MC Debit Gator/OPENAI SAN FRANCISC CA

Date 05/31/25 0 5151556312 2 5734

Card 1247","6.22","","Posted","1189.23"
"6/2/2025","","Recurring Withdrawal Debit Card - MC Debit Gator/PARAMOUNT+ WEST HOLLYWO CA

Date 06/01/25 0 5152328615 1 4899

Card 1247","14.96","","Posted","1195.45"
"6/2/2025","","Recurring Withdrawal Debit Card - MC Debit Gator/PADDLE.NET* SETAPP NEW YORK NY

Date 05/31/25 0 5151555568 2 5817

Card 1247","9.99","","Posted","1210.41"
"6/2/2025","","Withdrawal Debit Card MC Debit Gator/INVIDEO INC COUNTRY OF S DE

Date 06/01/25 0 5152143829 1 5734

Card 1247","33.04","","Posted","1220.4"
"6/2/2025","","Withdrawal Debit Card MC Debit Gator/VIDIQ SAN FRANCISC CA

Date 05/31/25 0 5151573162 0 5734

Card 1247","19","","Posted","1253.44"
"6/2/2025","","Withdrawal Debit Card MC Debit Gator/INVIDEO INC COUNTRY OF S DE

Date 05/31/25 0 5151554623 2 5734

Card 1247","25","","Posted","1272.44"
"6/2/2025","","Withdrawal Debit Card MC Debit Gator/INSTACART*159 SAN FRANCISC CA

Date 05/31/25 0 5151554560 2 5411

Card 1247","3","","Posted","1297.44"
"6/2/2025","","Withdrawal Debit Card MC Debit Gator/INSTACART*159 SAN FRANCISC CA

Date 05/31/25 0 5151554551 2 5411

Card 1247","39.76","","Posted","1300.44"
"6/2/2025","","Recurring Withdrawal Debit Card Fee/MASTERCARD ISSUER CROSS-BORDER FEE

Date 06/01/25 0 5152326251 1 5734

Card 1247","0.1","","Posted","1340.2"
"6/2/2025","","Recurring Withdrawal Debit Card - MC Debit Gator/LEONARDO.AI NORTH SYDNEY NS

Date 06/01/25 0 5152326251 1 5734

Card 1247","12","","Posted","1340.3"
"6/2/2025","","Recurring Withdrawal Debit Card Fee/MASTERCARD ISSUER CROSS-BORDER FEE

Date 05/31/25 0 5151375863 2 5817

Card 1247","0.08","","Posted","1352.3"
"6/2/2025","","Recurring Withdrawal Debit Card - MC Debit Gator/OBSIDIAN.MD OAKVILLE ON

Date 05/31/25 0 5151375863 2 5817

Card 1247","10","","Posted","1352.38"
"6/2/2025","","Withdrawal Debit Card Fee/MASTERCARD ISSUER CROSS-BORDER FEE

Date 05/31/25 0 5151554310 2 5734

Card 1247","0.16","","Posted","1362.38"
"6/2/2025","","Withdrawal Debit Card MC Debit Gator/IDEOGRAM AI TORONTO ON

Date 05/31/25 0 5151554310 2 5734

Card 1247","20","","Posted","1362.54"
"6/2/2025","","Recurring Withdrawal Debit Card Fee/MASTERCARD ISSUER CROSS-BORDER FEE

Date 05/31/25 0 5151554309 2 5734

Card 1247","0.03","","Posted","1382.54"
"6/2/2025","","Recurring Withdrawal Debit Card - MC Debit Gator/IDEOGRAM AI TORONTO ON

Date 05/31/25 0 5151554309 2 5734

Card 1247","3.2","","Posted","1382.57"
"6/2/2025","","Withdrawal ACH Watson Realty Co/TYPE: WEB PMTS ID: 9000321157

CO: Watson Realty Co

NAME: Steven chaplinskiEntry Class Code: WEB","1179","","Posted","1385.77"
"6/2/2025","","Withdrawal ACH AppFolio, Inc. F/TYPE: WEB PMTS ID: 9001406550

CO: AppFolio, Inc. F

NAME: Steven chaplinskiEntry Class Code: WEB","2.49","","Posted","2564.77"
"6/1/2025","","Withdrawal POS #000000000002/ETSY.COM*US ETSY.COM*AIAV WWW.ETSY.COM/

BROOKLYN NY

Card 1247","0.6","","Posted","2567.26"
"6/1/2025","","Withdrawal POS #000020312090/GOOGLE *YouTubePremium 1600 Amphitheatre

Parkw Mountain View CA

Card 1247","15.92","","Posted","2567.86"
"5/31/2025","","Recurring Withdrawal Debit Card - MC Debit Gator/OPENAI SAN FRANCISC CA

Date 05/31/25 0 5151240922 1 5734

Card 1247","6.71","","Posted","2583.78"
"5/31/2025","","Recurring Withdrawal Debit Card - MC Debit Gator/OPENAI SAN FRANCISC CA

Date 05/30/25 0 5150240921 1 5734

Card 1247","6.63","","Posted","2590.49"
"5/31/2025","","Recurring Withdrawal Debit Card - MC Debit Gator/OPENAI SAN FRANCISC CA

Date 05/30/25 0 5150059225 1 5734

Card 1247","6.24","","Posted","2597.12"
"5/31/2025","","Withdrawal Debit Card MC Debit Gator/WALGREENS #9304 GAINESVILLE FL

Date 05/30/25 0 5150232309 1 5912

Card 1247","23.78","","Posted","2603.36"
"5/31/2025","","Withdrawal Debit Card MC Debit Gator/WALGREENS #5024 GAINESVILLE FL

Date 05/30/25 0 5150232278 1 5912

Card 1247","15","","Posted","2627.14"
"5/31/2025","","Withdrawal POS #000000256943/AMAZON.COM*NN6201DU0 SEATTLE WA

Card 1247","30.34","","Posted","2642.14"
"5/30/2025","","Withdrawal POS #000000347331/SUNOCO 8002212501 4234 SW 20TH AVE

GAINESVILLE FL

Card 1247","39.5","","Posted","2672.48"
"5/30/2025","","Withdrawal ATM Fee/EFT 6419 W Newberry Rd Gainesville FL

Card 1247","2","","Posted","2711.98"
"5/30/2025","","Withdrawal at ATM #000000785755/EFT 6419 W Newberry Rd Gainesville FL

Card 1247","128","","Posted","2713.98"
"5/30/2025","","Deposit Home Banking Transfer/From CHAPLINSKI,LEON 3496297 Share 0090

Funds Transfer via Mobile","","3000","Posted","2841.98"
"5/30/2025","","Withdrawal CourtesyFeeDebit","35","","Posted","-158.02"
"5/30/2025","","Recurring Withdrawal Debit Card - MC Debit Gator/SUPERPOWER CHATGPT MIDDLETOWN DE

Date 05/29/25 0 5149990977 0 5734

Card 1247","15","","Posted","-123.02"
"5/28/2025","","Withdrawal CourtesyFeeDebit","35","","Posted","-108.02"
"5/28/2025","","Recurring Withdrawal Debit Card - MC Debit Gator/IC* INSTACART*SUBSCRIP SAN FRANCISC CA

Date 05/27/25 0 5147989663 0 5411

Card 1247","9.99","","Posted","-73.02"
"5/26/2025","","Withdrawal CourtesyFeeDebit","35","","Posted","-63.03"
"5/26/2025","","Withdrawal POS #000000216148/SUNOCO 8002212501 4234 SW 20TH AVE

GAINESVILLE FL

Card 1247","20.76","","Posted","-28.03"
"5/26/2025","","Withdrawal Debit Card MC Debit Gator/CIRCLE K # 26146 GAINESVILLE FL

Date 05/24/25 0 5144137268 1 5499

Card 1247","7.72","","Posted","-7.27"
"5/26/2025","","Withdrawal Debit Card MC Debit Gator/CIRCLE K # 06782 GAINESVILLE FL

Date 05/24/25 0 5144137005 1 5499

Card 1247","19.54","","Posted","0.45"
"5/25/2025","","Recurring Withdrawal Debit Card - MC Debit Gator/NETFLIX.COM LOS GATOS CA

Date 05/23/25 0 5143471019 2 4899

Card 1247","20.71","","Posted","19.99"
"5/25/2025","","Withdrawal POS #000000133422/SUNOCO 8002212501 4234 SW 20TH AVE

GAINESVILLE FL

Card 1247","20.76","","Posted","40.7"
"5/24/2025","","Withdrawal ATM Fee/EFT 6419 W Newberry Rd Gainesville FL

Card 1247","2","","Posted","61.46"
"5/24/2025","","Withdrawal at ATM #000000478783/EFT 6419 W Newberry Rd Gainesville FL

Card 1247","63","","Posted","63.46"
"5/24/2025","","Deposit Home Banking Transfer/From CHAPLINSKI,LEON 3496297 Share 0090

Funds Transfer via Mobile","","125","Posted","126.46"
"5/21/2025","","Withdrawal POS #000000059286/SUNOCO 8002212501 4234 SW 20TH AVE

GAINESVILLE FL

Card 1247","16.79","","Posted","1.46"
"5/21/2025","","Deposit Home Banking Transfer/From CHAPLINSKI,LEON 3496297 Share 0090

Funds Transfer via Mobile","","100","Posted","18.25"
"5/21/2025","","Withdrawal Debit Card MC Debit Gator/INSTACART*159 SAN FRANCISC CA

Date 05/20/25 0 5140325944 0 5411

Card 1247","62","","Posted","-81.75"
"5/21/2025","","Recurring Withdrawal Debit Card - MC Debit Gator/CANVA* I04522-50593645 CAMDEN DE

Date 05/20/25 0 5140963894 0 7333

Card 1247","12.99","","Posted","-19.75"
"5/21/2025","","Withdrawal Debit Card MC Debit Gator/CIRCLE K # 06782 GAINESVILLE FL

Date 05/19/25 0 5139975993 0 5499

Card 1247","19.54","","Posted","-6.76"
"5/20/2025","","Withdrawal ATM Transaction","20","","Posted","12.78"
"5/20/2025","","Withdrawal Debit Card MC Debit Gator/SUNOCO 8002212501 QPS GAINESVILLE FL

Date 05/19/25 0 5139082313 1 5541

Card 1247","22.17","","Posted","32.78"
"5/19/2025","","Withdrawal Debit Card MC Debit Gator/INSTACART*159 SAN FRANCISC CA

Date 05/18/25 0 5138957555 0 5411

Card 1247","45.67","","Posted","54.95"
"5/19/2025","","Withdrawal Debit Card MC Debit Gator/SUNOCO 8002212501 QPS GAINESVILLE FL

Date 05/18/25 0 5138961883 0 5541

Card 1247","20.76","","Posted","100.62"
"5/19/2025","","Withdrawal ACH FLUENT-Gainesvil/TYPE: PAYMENT ID: 1371804719

CO: FLUENT-Gainesvil

NAME: steven chaplinskiEntry Class Code: WEB","55","","Posted","121.38"
"5/18/2025","","Withdrawal Debit Card MC Debit Gator/UBER *TRIP 8005928996 CA

Date 05/17/25 0 5137425800 0 4121

Card 1247","12.93","","Posted","176.38"
"5/18/2025","","Withdrawal Debit Card MC Debit Gator/UBER TRIP* TRIP SAN FRANCISC CA

Date 05/17/25 0 5137032195 1 4121

Card 1247","7.84","","Posted","189.31"
"5/18/2025","","Withdrawal Debit Card MC Debit Gator/SUNOCO 8002212501 QPS GAINESVILLE FL

Date 05/17/25 0 5137923930 0 5541

Card 1247","20.33","","Posted","197.15"
"5/18/2025","","Withdrawal Debit Card MC Debit Gator/SUNOCO 8002212501 QPS GAINESVILLE FL

Date 05/17/25 0 5137923929 0 5541

Card 1247","17.28","","Posted","217.48"
"5/18/2025","","Recurring Withdrawal Debit Card - MC Debit Gator/CHIPOTLE ONLINE CHIPOTLE.COM CA

Date 05/17/25 0 5137923085 0 5814

Card 1247","20","","Posted","234.76"
"5/18/2025","","Recurring Withdrawal Debit Card - MC Debit Gator/AMAZON PRIME*NZ72M6V92 AMZN.COM/BIL WA

Date 05/17/25 0 5137026065 1 5968

Card 1247","15.13","","Posted","254.76"
"5/16/2025","","Withdrawal Debit Card MC Debit Gator/UBER *TRIP 8005928996 CA

Date 05/15/25 0 5135067572 1 4121

Card 1247","18.97","","Posted","269.89"
"5/16/2025","","Withdrawal Debit Card MC Debit Gator/SUNOCO 8002212501 QPS GAINESVILLE FL

Date 05/15/25 0 5135215071 1 5541

Card 1247","34.99","","Posted","288.86"
"5/16/2025","","Withdrawal ACH FLUENT-Gainesvil/TYPE: PAYMENT ID: 1371804719

CO: FLUENT-Gainesvil

NAME: steven chaplinskiEntry Class Code: WEB","25","","Posted","323.85"
"5/15/2025","","Withdrawal Debit Card MC Debit Gator/INSTACART*159 SAN FRANCISC CA

Date 05/14/25 0 5134998729 0 5411

Card 1247","3.41","","Posted","348.85"
"5/15/2025","","Withdrawal Debit Card MC Debit Gator/INSTACART*159 SAN FRANCISC CA

Date 05/14/25 0 5134998723 0 5411

Card 1247","55.08","","Posted","352.26"
"5/15/2025","","Withdrawal Debit Card MC Debit Gator/SUNOCO 8002212501 QPS GAINESVILLE FL

Date 05/14/25 0 5134204005 1 5541

Card 1247","24.19","","Posted","407.34"
"5/14/2025","","Withdrawal Debit Card MC Debit Gator/SUNOCO 8002212501 QPS GAINESVILLE FL

Date 05/13/25 0 5133133164 1 5541

Card 1247","24.19","","Posted","431.53"
"5/14/2025","","Recurring Withdrawal Debit Card Fee/MASTERCARD ISSUER CROSS-BORDER FEE

Date 05/13/25 0 5133953606 0 5734

Card 1247","0.08","","Posted","455.72"
"5/14/2025","","Recurring Withdrawal Debit Card - MC Debit Gator/RAYCAST.COM CHESHIRE LN

Date 05/13/25 0 5133953606 0 5734

Card 1247","10","","Posted","455.8"
"5/14/2025","","Recurring Withdrawal Debit Card Fee/MASTERCARD ISSUER CROSS-BORDER FEE

Date 05/13/25 0 5133953605 0 5734

Card 1247","0.08","","Posted","465.8"
"5/14/2025","","Recurring Withdrawal Debit Card - MC Debit Gator/RAYCAST.COM CHESHIRE LN

Date 05/13/25 0 5133953605 0 5734

Card 1247","10","","Posted","465.88"
"5/14/2025","","Withdrawal Debit Card MC Debit Gator/CIRCLE K # 26146 GAINESVILLE FL

Date 05/12/25 0 5132947482 0 5499

Card 1247","19.75","","Posted","475.88"
"5/11/2025","","Withdrawal POS #000000000047/CIRCLE K # 26146 3525 GAINESVILLE FL

Card 1247","19.75","","Posted","495.63"
"5/11/2025","","Withdrawal Debit Card MC Debit Gator/INSTACART*159 SAN FRANCISC CA

Date 05/09/25 0 5129018006 2 5411

Card 1247","38","","Posted","515.38"
"5/11/2025","","Withdrawal Debit Card MC Debit Gator/SUNOCO 8002212501 QPS GAINESVILLE FL

Date 05/09/25 0 5129469564 2 5541

Card 1247","23.01","","Posted","553.38"
"5/11/2025","","Withdrawal Debit Card MC Debit Gator/AMAZON PRIME*NI9490PZ1 AMZN.COM/BIL WA

Date 05/11/25 0 5131126852 1 5818

Card 1247","3.4","","Posted","576.39"
"5/10/2025","","Withdrawal POS #000000000052/CIRCLE K # 26146 3525 GAINESVILLE FL

Card 1247","19.75","","Posted","579.79"
"5/9/2025","","Recurring Withdrawal Debit Card Fee/MASTERCARD ISSUER CROSS-BORDER FEE

Date 05/08/25 0 5128330209 0 5734

Card 1247","0.06","","Posted","599.54"
"5/9/2025","","Recurring Withdrawal Debit Card - MC Debit Gator/IDEOGRAM AI TORONTO ON

Date 05/08/25 0 5128330209 0 5734

Card 1247","8","","Posted","599.6"
"5/9/2025","","Withdrawal Debit Card MC Debit Gator/IONOS INC. CHESTERBROOK PA

Date 05/08/25 0 5128032400 1 4816

Card 1247","23","","Posted","607.6"
"5/9/2025","","Withdrawal ACH FLUENT-Gainesvil/TYPE: PAYMENT ID: 1371804719

CO: FLUENT-Gainesvil

NAME: steven chaplinskiEntry Class Code: WEB","20","","Posted","630.6"
"5/8/2025","","Withdrawal ACH SUNO INC./TYPE: SUNO INC. ID: 1800948598

CO: SUNO INC. NAME: STEVEN J CHAPLINSKI

Entry Class Code: WEB","10","","Posted","650.6"
"5/8/2025","","Recurring Withdrawal Debit Card - MC Debit Gator/TUBEBUDDYCOM* 8668823239 CA

Date 05/07/25 0 5127999675 0 5734

Card 1247","7.5","","Posted","660.6"
"5/8/2025","","Recurring Withdrawal Debit Card Fee/MASTERCARD ISSUER CROSS-BORDER FEE

Date 05/08/25 0 5128978432 0 5734

Card 1247","0.23","","Posted","668.1"
"5/8/2025","","Recurring Withdrawal Debit Card - MC Debit Gator/NOTEGPT.IO ADMIRALTY KO

Date 05/08/25 0 5128978432 0 5734

Card 1247","29","","Posted","668.33"
"5/8/2025","","Withdrawal Debit Card MC Debit Gator/GRU/EZ-PAY WEB PYMT 352-334-3434 FL

Date 05/07/25 0 5127319905 0 4900

Card 1247","143.13","","Posted","697.33"
"5/8/2025","","Withdrawal Debit Card MC Debit Gator/COX GAINESVILLE COMM 800-234-3993 FL

Date 05/07/25 0 5127973169 0 4899

Card 1247","156.13","","Posted","840.46"
"5/8/2025","","Withdrawal Bill Payment #000000176250/APPLE COM ONE APPLE PARK WAY ONE APPLE

CA

Card 1247","13.98","","Posted","996.59"
"5/8/2025","","Withdrawal POS #000000752480/PUBLIX 3100 SW 35TH BLVD GAINESVILLE FL

Card 1247","37.56","","Posted","1010.57"
"5/7/2025","","Withdrawal POS #000000000025/CIRCLE K # 26146 3525 GAINESVILLE FL

Card 1247","19.75","","Posted","1048.13"
"5/7/2025","","Withdrawal Debit Card MC Debit Gator/SUNOCO 8002212501 QPS GAINESVILLE FL

Date 05/06/25 0 5126182193 1 5541

Card 1247","20.33","","Posted","1067.88"
"5/7/2025","","Withdrawal Debit Card MC Debit Gator/IONOS INC. CHESTERBROOK PA

Date 05/06/25 0 5126989315 0 4816

Card 1247","25","","Posted","1088.21"
"5/6/2025","","Withdrawal POS #000000248532/AMAZON.COM*NI55D0DC2 SEATTLE WA

Card 1247","20.23","","Posted","1113.21"
"5/6/2025","","Recurring Withdrawal Debit Card - MC Debit Gator/SUPERPOWER CHATGPT MIDDLETOWN DE

Date 05/05/25 0 5125205338 1 5734

Card 1247","15","","Posted","1133.44"
"5/6/2025","","Recurring Withdrawal Debit Card - MC Debit Gator/SUPERPOWER CHATGPT MIDDLETOWN DE

Date 05/05/25 0 5125957245 0 5734

Card 1247","15","","Posted","1148.44"
"5/6/2025","","Withdrawal Debit Card MC Debit Gator/SUNOCO 8002212501 QPS GAINESVILLE FL

Date 05/05/25 0 5125202951 1 5541

Card 1247","22.17","","Posted","1163.44"
"5/6/2025","","Withdrawal Debit Card MC Debit Gator/IONOS INC. CHESTERBROOK PA

Date 05/05/25 0 5125954539 0 4816

Card 1247","60","","Posted","1185.61"
"5/5/2025","","Recurring Withdrawal Debit Card - MC Debit Gator/OPENAI *CHATGPT SUBSCR SAN FRANCISC CA

Date 05/04/25 0 5124280497 0 5734

Card 1247","20","","Posted","1245.61"
"5/5/2025","","Recurring Withdrawal Debit Card - MC Debit Gator/HOSTINGER* HOSTINGER.C WILMINGTON DE

Date 05/05/25 0 5125011239 1 7372

Card 1247","4.68","","Posted","1265.61"
"5/5/2025","","Recurring Withdrawal Debit Card - MC Debit Gator/HOSTINGER* HOSTINGER.C WILMINGTON DE

Date 05/04/25 0 5124144321 1 7372

Card 1247","9.99","","Posted","1270.29"
"5/5/2025","","Withdrawal ACH FLUENT-Gainesvil/TYPE: PAYMENT ID: 1371804719

CO: FLUENT-Gainesvil

NAME: steven chaplinskiEntry Class Code: WEB","65","","Posted","1280.28"
"5/4/2025","","Withdrawal POS #000000330773/SUNOCO 8002212501 4234 SW 20TH AVE

GAINESVILLE FL

Card 1247","18.74","","Posted","1345.28"
"5/4/2025","","Recurring Withdrawal Debit Card - MC Debit Gator/NOTION LABS, INC. SAN FRANCISC CA

Date 05/02/25 0 5122358621 2 7372

Card 1247","22","","Posted","1364.02"
"5/4/2025","","Withdrawal Debit Card MC Debit Gator/INSTACART*159 SAN FRANCISC CA

Date 05/02/25 0 5122356706 2 5411

Card 1247","3.01","","Posted","1386.02"
"5/4/2025","","Withdrawal Debit Card MC Debit Gator/INSTACART*159 SAN FRANCISC CA

Date 05/02/25 0 5122356703 2 5411

Card 1247","65.28","","Posted","1389.03"
"5/4/2025","","Recurring Withdrawal Debit Card - MC Debit Gator/CS ADDTL STORAGE SAN JOSE CA

Date 05/03/25 0 5123478481 2 5817

Card 1247","9.99","","Posted","1454.31"
"5/4/2025","","Recurring Withdrawal Debit Card - MC Debit Gator/ADOBE SAN JOSE CA

Date 05/03/25 0 5123478479 2 5817

Card 1247","19.99","","Posted","1464.3"
"5/4/2025","","Withdrawal Debit Card MC Debit Gator/WALGREENS #9304 GAINESVILLE FL

Date 05/02/25 0 5122473217 2 5912

Card 1247","10.81","","Posted","1484.29"
"5/4/2025","","Recurring Withdrawal Debit Card - MC Debit Gator/APPLE.COM/BILL 866-712-7753 CA

Date 05/03/25 0 5123472314 2 5818

Card 1247","2.99","","Posted","1495.1"
"5/4/2025","","Withdrawal Debit Card MC Debit Gator/CIRCLE K # 06782 GAINESVILLE FL

Date 05/01/25 0 5121349634 2 5499

Card 1247","27.2","","Posted","1498.09"
"5/2/2025","","Recurring Withdrawal Debit Card - MC Debit Gator/MYDESIGNS - PRO - MON LAS VEGAS NV

Date 05/01/25 0 5121260380 1 5734

Card 1247","49.99","","Posted","1525.29"
"5/2/2025","","Recurring Withdrawal Debit Card - MC Debit Gator/PARAMOUNT+ WEST HOLLYWO CA

Date 05/01/25 0 5121277574 1 4899

Card 1247","14.96","","Posted","1575.28"
"5/2/2025","","Recurring Withdrawal Debit Card - MC Debit Gator/APPLE.COM/BILL 866-712-7753 CA

Date 05/01/25 0 5121270888 1 5818

Card 1247","27.98","","Posted","1590.24"
"5/2/2025","","Withdrawal ACH Watson Realty Co/TYPE: WEB PMTS ID: 9000321157

CO: Watson Realty Co

NAME: Steven chaplinskiEntry Class Code: WEB","1179","","Posted","1618.22"
"5/2/2025","","Withdrawal ACH FLUENT-Gainesvil/TYPE: PAYMENT ID: 1371804719

CO: FLUENT-Gainesvil

NAME: steven chaplinskiEntry Class Code: WEB","18","","Posted","2797.22"
"5/2/2025","","Withdrawal ACH AppFolio, Inc. F/TYPE: WEB PMTS ID: 9001406550

CO: AppFolio, Inc. F

NAME: Steven chaplinskiEntry Class Code: WEB","2.49","","Posted","2815.22"
"5/1/2025","","Recurring Withdrawal Debit Card - MC Debit Gator/OPENAI SAN FRANCISC CA

Date 04/30/25 0 5120971870 0 5734

Card 1247","7.39","","Posted","2817.71"
"5/1/2025","","Recurring Withdrawal Debit Card - MC Debit Gator/PADDLE.NET* SETAPP NEW YORK NY

Date 05/01/25 0 5121349771 0 5817

Card 1247","9.99","","Posted","2825.1"
"5/1/2025","","Withdrawal Debit Card MC Debit Gator/SUNOCO 8002212501 QPS GAINESVILLE FL

Date 04/30/25 0 5120175998 1 5541

Card 1247","21.84","","Posted","2835.09"
"5/1/2025","","Recurring Withdrawal Debit Card Fee/MASTERCARD ISSUER CROSS-BORDER FEE

Date 05/01/25 0 5121175942 1 5817

Card 1247","0.08","","Posted","2856.93"
"5/1/2025","","Recurring Withdrawal Debit Card - MC Debit Gator/OBSIDIAN.MD OAKVILLE ON

Date 05/01/25 0 5121175942 1 5817

Card 1247","10","","Posted","2857.01"
"5/1/2025","","Recurring Withdrawal Debit Card - MC Debit Gator/FS *RAINDROP.IO SANTA BARBAR CA

Date 04/30/25 0 5120038015 1 5734

Card 1247","3","","Posted","2867.01"
"5/1/2025","","Withdrawal POS #000000876017/AMAZON.COM*N26MU72P0 SEATTLE WA

Card 1247","32","","Posted","2870.01"
"5/1/2025","","Withdrawal POS #000000684070/AMAZON.COM*NB6J799P2 SEATTLE WA

Card 1247","21.36","","Posted","2902.01"
"5/1/2025","","Withdrawal POS #000000680759/AMAZON.COM*N26B91SP0 SEATTLE WA

Card 1247","13.1","","Posted","2923.37"
"5/1/2025","","Withdrawal POS #000000194578/Etsy.com*US Etsy.com*AiAv ADAMS STREET

www.etsy.com/ NY

Card 1247","0.2","","Posted","2936.47"
"5/1/2025","","Withdrawal POS #000020035046/GOOGLE *YouTubePremium 1600 Amphitheatre

Parkw Mountain View CA

Card 1247","15.92","","Posted","2936.67"
"4/30/2025","","Recurring Withdrawal Debit Card - MC Debit Gator/SUPERPOWER CHATGPT MIDDLETOWN DE

Date 04/29/25 0 5119982716 0 5734

Card 1247","15","","Posted","2952.59"
"4/30/2025","","Withdrawal Debit Card MC Debit Gator/IONOS INC. CHESTERBROOK PA

Date 04/29/25 0 5119979985 0 4816

Card 1247","2.5","","Posted","2967.59"
"4/30/2025","","Deposit Home Banking Transfer/From CHAPLINSKI,LEON 3496297 Share 0090

Funds Transfer via Mobile","","3000","Posted","2970.09"
"4/29/2025","","Withdrawal Debit Card MC Debit Gator/SUNOCO 8002212501 QPS GAINESVILLE FL

Date 04/28/25 0 5118116540 1 5541

Card 1247","28.44","","Posted","-29.91"
"4/29/2025","","Withdrawal Debit Card MC Debit Gator/WALGREENS #5024 GAINESVILLE FL

Date 04/28/25 0 5118112027 1 5912

Card 1247","15","","Posted","-1.47"
"4/29/2025","","Withdrawal POS #000000085932/SUNOCO 8002212501 4234 SW 20TH AVE

GAINESVILLE FL

Card 1247","19.47","","Posted","13.53"
"4/28/2025","","Deposit Faster Payments/zel* MILLICENTCHAPLINSKI JFR07NPR4BL9","","30","Posted","33"
"4/28/2025","","Withdrawal ATM Fee/EFT 6419 W Newberry Rd Gainesville FL

Card 1247","2","","Posted","3"
"4/28/2025","","Withdrawal at ATM #000000105254/EFT 6419 W Newberry Rd Gainesville FL

Card 1247","13","","Posted","5"
"4/28/2025","","Withdrawal Debit Card MC Debit Gator/INSTACART*159 SAN FRANCISC CA

Date 04/27/25 0 5117311838 1 5411

Card 1247","58","","Posted","18"
"4/28/2025","","Withdrawal Adjustment 0428252942791701","","35","Posted","76"
"4/28/2025","","Deposit Faster Payments/zel* MILLICENTCHAPLINSKI JFR07N6PNC5Z","","100","Posted","41"
"4/28/2025","","Withdrawal Courtesy Pay Fee/Entry Class Code: WEB","35","","Posted","-59"
"4/28/2025","","Withdrawal ACH FLUENT-Gainesvil/TYPE: PAYMENT ID: 1371804719

CO: FLUENT-Gainesvil

NAME: steven chaplinski","18","","Posted","-24"
"4/27/2025","","Withdrawal Debit Card MC Debit Gator/IC* INSTACART*SUBSCRIP SAN FRANCISC CA

Date 04/26/25 0 5116980985 0 5411

Card 1247","9.99","","Posted","-6"
"4/27/2025","","Withdrawal POS #000000045037/SUNOCO 8002212501 4234 SW 20TH AVE

GAINESVILLE FL

Card 1247","21.84","","Posted","3.99"
"4/26/2025","","Withdrawal POS #000000977612/SUNOCO 8002212501 4234 SW 20TH AVE

GAINESVILLE FL

Card 1247","21.84","","Posted","25.83"
"4/25/2025","","Withdrawal POS #000080196760/SMOKE CITY 2120 SW 34TH ST GAINESVILLE

Card 1247","6.34","","Posted","47.67"
"4/25/2025","","Withdrawal POS #000000940381/SUNOCO 8002212501 4234 SW 20TH AVE

GAINESVILLE FL

Card 1247","21.84","","Posted","54.01"
"4/25/2025","","Withdrawal ACH FLUENT-Gainesvil/TYPE: PAYMENT ID: 1371804719

CO: FLUENT-Gainesvil

NAME: steven chaplinskiEntry Class Code: WEB","28.5","","Posted","75.85"
"4/24/2025","","Withdrawal POS #000000912703/SUNOCO 8002212501 4234 SW 20TH AVE

GAINESVILLE FL

Card 1247","24.52","","Posted","104.35"
"4/24/2025","","Withdrawal ACH FLUENT-Gainesvil/TYPE: PAYMENT ID: 1371804719

CO: FLUENT-Gainesvil

NAME: steven chaplinskiEntry Class Code: WEB","21","","Posted","128.87"
"4/23/2025","","Withdrawal POS #000000767866/PUBLIX 3100 SW 35TH BLVD GAINESVILLE FL

Card 1247","18.35","","Posted","149.87"
"4/23/2025","","Withdrawal POS #000000880006/SUNOCO 8002212501 4234 SW 20TH AVE

GAINESVILLE FL

Card 1247","21.84","","Posted","168.22"
"4/23/2025","","Recurring Withdrawal Debit Card - MC Debit Gator/NETFLIX.COM CA

Date 04/23/25 0 5113169724 1 4899

Card 1247","20.71","","Posted","190.06"
"4/23/2025","","Withdrawal ACH FLUENT-Gainesvil/TYPE: PAYMENT ID: 1371804719

CO: FLUENT-Gainesvil

NAME: steven chaplinskiEntry Class Code: WEB","15","","Posted","210.77"
"4/22/2025","","Withdrawal POS #000000788429/SUNOCO 8002212501 4234 SW 20TH AVE

GAINESVILLE FL

Card 1247","21.84","","Posted","225.77"
"4/22/2025","","Withdrawal Debit Card MC Debit Gator/INSTACART*159 SAN FRANCISC CA

Date 04/21/25 0 5111802992 0 5411

Card 1247","55","","Posted","247.61"
"4/22/2025","","Withdrawal ACH FLUENT-Gainesvil/TYPE: PAYMENT ID: 1371804719

CO: FLUENT-Gainesvil

NAME: steven chaplinskiEntry Class Code: WEB","17.5","","Posted","302.61"
"4/22/2025","","Withdrawal POS #000000773256/SUNOCO 8002212501 4234 SW 20TH AVE

GAINESVILLE FL

Card 1247","21.84","","Posted","320.11"
"4/21/2025","","Recurring Withdrawal Debit Card - MC Debit Gator/CANVA* I04492-37655487 CAMDEN DE

Date 04/20/25 0 5110064939 1 7333

Card 1247","12.99","","Posted","341.95"
"4/21/2025","","Withdrawal POS #000028288185/WAWA 5325 GAINESVILLE GAINESVILLE FL

Card 1247","15.54","","Posted","354.94"
"4/21/2025","","Withdrawal ACH FLUENT-Gainesvil/TYPE: PAYMENT ID: 1371804719

CO: FLUENT-Gainesvil

NAME: steven chaplinskiEntry Class Code: WEB","42","","Posted","370.48"
"4/20/2025","","Withdrawal POS #000000732586/SUNOCO 8002212501 4234 SW 20TH AVE

GAINESVILLE FL

Card 1247","18.41","","Posted","412.48"
"4/20/2025","","Withdrawal Debit Card MC Debit Gator/INSTACART*159 SAN FRANCISC CA

Date 04/19/25 0 5109159889 1 5411

Card 1247","48.79","","Posted","430.89"
"4/20/2025","","Withdrawal POS #000000752843/SUNOCO 8002212501 4234 SW 20TH AVE

GAINESVILLE FL

Card 1247","18.41","","Posted","479.68"
"4/19/2025","","Withdrawal POS #000000000007/CIRCLE K # 06782 5237 GAINESVILLE FL

Card 1247","16.99","","Posted","498.09"
"4/18/2025","","Recurring Withdrawal Debit Card - MC Debit Gator/AMAZON PRIME*TG93S4M53 AMZN.COM/BIL WA

Date 04/17/25 0 5107336159 0 5968

Card 1247","15.13","","Posted","515.08"
"4/18/2025","","Withdrawal POS #000000736804/PUBLIX 3100 SW 35TH BLVD GAINESVILLE FL

Card 1247","25.01","","Posted","530.21"
"4/17/2025","","Withdrawal POS #000000597264/SUNOCO 8002212501 4234 SW 20TH AVE

GAINESVILLE FL

Card 1247","23.65","","Posted","555.22"
"4/17/2025","","Recurring Withdrawal Debit Card - MC Debit Gator/APPLE.COM/BILL 866-712-7753 CA

Date 04/16/25 0 5106955527 0 5818

Card 1247","36.98","","Posted","578.87"
"4/17/2025","","Withdrawal ACH FLUENT-Gainesvil/TYPE: PAYMENT ID: 1371804719

CO: FLUENT-Gainesvil

NAME: steven chaplinskiEntry Class Code: WEB","42","","Posted","615.85"
"4/16/2025","","Withdrawal POS #000000560579/SUNOCO 8002212501 4234 SW 20TH AVE

GAINESVILLE FL

Card 1247","18.41","","Posted","657.85"
"4/16/2025","","Withdrawal Debit Card MC Debit Gator/INSTACART*159 SAN FRANCISC CA

Date 04/15/25 0 5105953159 0 5411

Card 1247","70","","Posted","676.26"
"4/15/2025","","Withdrawal POS #000000515552/SUNOCO 8002212501 4234 SW 20TH AVE

GAINESVILLE FL

Card 1247","21.84","","Posted","746.26"
"4/14/2025","","Withdrawal POS #000000500473/SUNOCO 8002212501 4234 SW 20TH AVE

GAINESVILLE FL

Card 1247","21.84","","Posted","768.1"
"4/14/2025","","Recurring Withdrawal Debit Card Fee/MASTERCARD ISSUER CROSS-BORDER FEE

Date 04/13/25 0 5103998380 0 5734

Card 1247","0.08","","Posted","789.94"
"4/14/2025","","Recurring Withdrawal Debit Card - MC Debit Gator/RAYCAST.COM CHESHIRE LN

Date 04/13/25 0 5103998380 0 5734

Card 1247","10","","Posted","790.02"
"4/14/2025","","Recurring Withdrawal Debit Card Fee/MASTERCARD ISSUER CROSS-BORDER FEE

Date 04/13/25 0 5103998379 0 5734

Card 1247","0.08","","Posted","800.02"
"4/14/2025","","Recurring Withdrawal Debit Card - MC Debit Gator/RAYCAST.COM CHESHIRE LN

Date 04/13/25 0 5103998379 0 5734

Card 1247","10","","Posted","800.1"
"4/13/2025","","Withdrawal POS #000000406174/SUNOCO 8002212501 4234 SW 20TH AVE

GAINESVILLE FL

Card 1247","23.44","","Posted","810.1"
"4/11/2025","","Withdrawal Debit Card MC Debit Gator/IONOS INC. CHESTERBROOK PA

Date 04/10/25 0 5100985699 0 4816

Card 1247","7","","Posted","833.54"
"4/11/2025","","Withdrawal Debit Card MC Debit Gator/AMAZON PRIME*GN80C1F53 AMZN.COM/BIL WA

Date 04/11/25 0 5101982298 0 5818

Card 1247","3.4","","Posted","840.54"
"4/11/2025","","Withdrawal Debit Card MC Debit Gator/CIRCLE K # 06782 GAINESVILLE FL

Date 04/09/25 0 5099980889 0 5499

Card 1247","19.33","","Posted","843.94"
"4/11/2025","","Withdrawal POS #000000375291/SUNOCO 8002212501 4234 SW 20TH AVE

GAINESVILLE FL

Card 1247","23.87","","Posted","863.27"
"4/10/2025","","Withdrawal Debit Card MC Debit Gator/INSTACART*159 SAN FRANCISC CA

Date 04/09/25 0 5099942565 0 5411

Card 1247","49.14","","Posted","887.14"
"4/10/2025","","Deposit Home Banking Transfer/From CHAPLINSKI,LEON 3496297 Share 0000

Funds Transfer via Mobile","","451","Posted","936.28"
"4/9/2025","","Recurring Withdrawal Debit Card Fee/MASTERCARD ISSUER CROSS-BORDER FEE

Date 04/08/25 0 5098321266 0 5734

Card 1247","0.06","","Posted","485.28"
"4/9/2025","","Recurring Withdrawal Debit Card - MC Debit Gator/IDEOGRAM AI TORONTO ON

Date 04/08/25 0 5098321266 0 5734

Card 1247","8","","Posted","485.34"
"4/9/2025","","Withdrawal Debit Card MC Debit Gator/IONOS INC. CHESTERBROOK PA

Date 04/08/25 0 5098011593 1 4816

Card 1247","23","","Posted","493.34"
"4/9/2025","","Withdrawal Debit Card MC Debit Gator/COX GAINESVILLE COMM 800-234-3993 FL

Date 04/08/25 0 5098319723 0 4899

Card 1247","156.13","","Posted","516.34"
"4/8/2025","","Withdrawal ACH SUNO INC./TYPE: SUNO INC. ID: 1800948598

CO: SUNO INC. NAME: STEVEN J CHAPLINSKI

Entry Class Code: WEB","10","","Posted","672.47"
"4/8/2025","","Recurring Withdrawal Debit Card - MC Debit Gator/OPENAI SAN FRANCISC CA

Date 04/07/25 0 5097912116 0 5734

Card 1247","6.87","","Posted","682.47"
"4/8/2025","","Recurring Withdrawal Debit Card - MC Debit Gator/TUBEBUDDYCOM* 8668823239 CA

Date 04/07/25 0 5097928096 0 5734

Card 1247","7.5","","Posted","689.34"
"4/8/2025","","Recurring Withdrawal Debit Card Fee/MASTERCARD ISSUER CROSS-BORDER FEE

Date 04/08/25 0 5098910705 0 5734

Card 1247","0.23","","Posted","696.84"
"4/8/2025","","Recurring Withdrawal Debit Card - MC Debit Gator/NOTEGPT.IO ADMIRALTY KO

Date 04/08/25 0 5098910705 0 5734

Card 1247","29","","Posted","697.07"
"4/8/2025","","Withdrawal Debit Card MC Debit Gator/GRU/EZ-PAY WEB PYMT 352-334-3434 FL

Date 04/07/25 0 5097325360 0 4900

Card 1247","133.69","","Posted","726.07"
"4/8/2025","","Withdrawal POS #000000112784/SUNOCO 8002212501 4234 SW 20TH AVE

GAINESVILLE FL

Card 1247","21.84","","Posted","859.76"
"4/7/2025","","Withdrawal POS #000000134088/AMAZON.COM*N888H1072 SEATTLE WA

Card 1247","10.18","","Posted","881.6"
"4/7/2025","","Withdrawal POS #000000000003/AMAZON.COM*1U8092W83 SEATTLE WA

Card 1247","44.65","","Posted","891.78"
"4/7/2025","","Withdrawal POS #000000000032/AMAZON.COM*EO01Y18N3 SEATTLE WA

Card 1247","20.36","","Posted","936.43"
"4/7/2025","","Recurring Withdrawal Debit Card - MC Debit Gator/SUPERPOWER CHATGPT MIDDLETOWN DE

Date 04/05/25 0 5095135373 1 5734

Card 1247","15","","Posted","956.79"
"4/7/2025","","Recurring Withdrawal Debit Card - MC Debit Gator/SUPERPOWER CHATGPT MIDDLETOWN DE

Date 04/05/25 0 5095135372 1 5734

Card 1247","15","","Posted","971.79"
"4/7/2025","","Withdrawal Debit Card MC Debit Gator/IONOS INC. CHESTERBROOK PA

Date 04/06/25 0 5096139388 1 4816

Card 1247","1","","Posted","986.79"
"4/7/2025","","Withdrawal Debit Card MC Debit Gator/CIRCLE K # 06782 GAINESVILLE FL

Date 04/05/25 0 5095133634 1 5499

Card 1247","26.99","","Posted","987.79"
"4/7/2025","","Recurring Withdrawal Debit Card - MC Debit Gator/APPLE.COM/BILL 866-712-7753 CA

Date 04/06/25 0 5096127456 1 5818

Card 1247","2.99","","Posted","1014.78"
"4/7/2025","","Withdrawal ACH FLUENT-Gainesvil/TYPE: PAYMENT ID: 1371804719

CO: FLUENT-Gainesvil

NAME: steven chaplinskiEntry Class Code: WEB","45","","Posted","1017.77"
"4/7/2025","","Withdrawal ACH AIRTABLE.com/bil/TYPE: AIRTABLE.c ID: 4270465600

CO: AIRTABLE.com/bil

NAME: STEVEN CHAPLINSKIEntry Class Code: WEB","31","","Posted","1062.77"
"4/7/2025","","Withdrawal POS #000000204012/SUNOCO 8002212501 4234 SW 20TH AVE

GAINESVILLE FL

Card 1247","21.84","","Posted","1093.77"
"4/6/2025","","Recurring Withdrawal Debit Card - MC Debit Gator/OPENAI *CHATGPT SUBSCR SAN FRANCISC CA

Date 04/04/25 0 5094561526 0 5734

Card 1247","20","","Posted","1115.61"
"4/6/2025","","Recurring Withdrawal Debit Card - MC Debit Gator/OPENAI SAN FRANCISC CA

Date 04/04/25 0 5094381115 2 5734

Card 1247","6.09","","Posted","1135.61"
"4/6/2025","","Withdrawal Debit Card MC Debit Gator/HOSTINGER* HOSTINGER.C WILMINGTON DE

Date 04/04/25 0 5094291695 2 7372

Card 1247","14.98","","Posted","1141.7"
"4/6/2025","","Withdrawal Debit Card MC Debit Gator/INSTACART*159 SAN FRANCISC CA

Date 04/05/25 0 5095016197 1 5411

Card 1247","38.02","","Posted","1156.68"
"4/6/2025","","Withdrawal Debit Card MC Debit Gator/IONOS INC. CHESTERBROOK PA

Date 04/05/25 0 5095015218 1 4816

Card 1247","18","","Posted","1194.7"
"4/4/2025","","Withdrawal ACH XAI LLC/TYPE: XAI LLC ID: 1800948598 CO: XAI LLC

NAME: STEVEN J CHAPLINSKI

Entry Class Code: WEB","5","","Posted","1212.7"
"4/4/2025","","Withdrawal Debit Card MC Debit Gator/HOSTINGER* HOSTINGER.C WILMINGTON DE

Date 04/04/25 0 5094028682 1 7372

Card 1247","13.17","","Posted","1217.7"
"4/4/2025","","Recurring Withdrawal Debit Card - MC Debit Gator/APPLE.COM/BILL 866-712-7753 CA

Date 04/03/25 0 5093962196 0 5818

Card 1247","2.99","","Posted","1230.87"
"4/3/2025","","Withdrawal Bill Payment #000000362529/CS Addtl Storage Park Avenue,345

CA

Card 1247","9.99","","Posted","1233.86"
"4/3/2025","","Withdrawal Bill Payment #000000366741/Adobe Park Avenue,345 adobe.com CA

Card 1247","19.99","","Posted","1243.85"
"4/3/2025","","Withdrawal POS #000000995800/SUNOCO 8002212501 4234 SW 20TH AVE

GAINESVILLE FL

Card 1247","18.41","","Posted","1263.84"
"4/3/2025","","Recurring Withdrawal Debit Card - MC Debit Gator/NOTION LABS, INC. SAN FRANCISC CA

Date 04/02/25 0 5092100172 1 7372

Card 1247","22","","Posted","1282.25"
"4/2/2025","","Recurring Withdrawal Debit Card - MC Debit Gator/MYDESIGNS - PRO - MON LAS VEGAS NV

Date 04/01/25 0 5091214195 1 5734

Card 1247","49.99","","Posted","1304.25"
"4/2/2025","","Recurring Withdrawal Debit Card - MC Debit Gator/PARAMOUNT+ WEST HOLLYWO CA

Date 04/01/25 0 5091067744 1 4899

Card 1247","14.96","","Posted","1354.24"
"4/2/2025","","Withdrawal ACH Watson Realty Co/TYPE: WEB PMTS ID: 9000321157

CO: Watson Realty Co

NAME: Steven chaplinskiEntry Class Code: WEB","1179","","Posted","1369.2"
"4/2/2025","","Withdrawal ACH FLUENT-Gainesvil/TYPE: PAYMENT ID: 1371804719

CO: FLUENT-Gainesvil

NAME: steven chaplinskiEntry Class Code: WEB","25","","Posted","2548.2"
"4/2/2025","","Withdrawal ACH AppFolio, Inc. F/TYPE: WEB PMTS ID: 9001406550

CO: AppFolio, Inc. F

NAME: Steven chaplinskiEntry Class Code: WEB","2.49","","Posted","2573.2"
"4/1/2025","","Recurring Withdrawal Debit Card - MC Debit Gator/PADDLE.NET* SETAPP NEW YORK NY

Date 04/01/25 0 5091930268 0 5817

Card 1247","9.99","","Posted","2575.69"
"4/1/2025","","Withdrawal Debit Card MC Debit Gator/INSTACART*159 SAN FRANCISC CA

Date 03/31/25 0 5090929413 0 5411

Card 1247","52","","Posted","2585.68"
"4/1/2025","","Withdrawal Debit Card Fee/MASTERCARD ISSUER CROSS-BORDER FEE

Date 03/31/25 0 5090929332 0 5817

Card 1247","0.08","","Posted","2637.68"
"4/1/2025","","Withdrawal Debit Card MC Debit Gator/OBSIDIAN.MD OAKVILLE NOR ON

Date 03/31/25 0 5090929332 0 5817

Card 1247","10","","Posted","2637.76"
"4/1/2025","","Recurring Withdrawal Debit Card - MC Debit Gator/FS *RAINDROP.IO SANTA BARBAR CA

Date 03/31/25 0 5090928275 0 5734

Card 1247","3","","Posted","2647.76"
"4/1/2025","","Deposit ACH ETSY, INC./TYPE: PAYOUT ID: 1357612331

CO: ETSY, INC.

Entry Class Code: PPD","","4.07","Posted","2650.76"
"4/1/2025","","Withdrawal POS #000020856446/GOOGLE *YouTubePremium 1600 Amphitheatre

Parkw Mountain View CA

Card 1247","15.92","","Posted","2646.69"
"4/1/2025","","Withdrawal POS #000000904370/SUNOCO 8002212501 4234 SW 20TH AVE

GAINESVILLE FL

Card 1247","18.41","","Posted","2662.61"
"3/31/2025","","Withdrawal Debit Card MC Debit Gator/ANTHROPIC SAN FRANCISC CA

Date 03/30/25 0 5089101571 1 5734

Card 1247","5","","Posted","2681.02"
"3/31/2025","","Withdrawal Debit Card Fee/MASTERCARD ISSUER CROSS-BORDER FEE

Date 03/30/25 0 5089099408 1 5817

Card 1247","0.08","","Posted","2686.02"
"3/31/2025","","Withdrawal Debit Card MC Debit Gator/HAILUOAI.VIDEO SINGAPORE SG

Date 03/30/25 0 5089099408 1 5817

Card 1247","9.99","","Posted","2686.1"
"3/31/2025","","Withdrawal Debit Card Fee/MASTERCARD ISSUER CROSS-BORDER FEE

Date 03/30/25 0 5089270441 0 4816

Card 1247","0.04","","Posted","2696.09"
"3/31/2025","","Withdrawal Debit Card MC Debit Gator/PAYPAL *SHENDUQRWEA 4029357733 HK

Date 03/30/25 0 5089270441 0 4816

Card 1247","5.3","","Posted","2696.13"
"3/31/2025","","Withdrawal ACH FLUENT-Gainesvil/TYPE: PAYMENT ID: 1371804719

CO: FLUENT-Gainesvil

NAME: steven chaplinskiEntry Class Code: WEB","35","","Posted","2701.43"
"3/31/2025","","Withdrawal ACH FLUENT-Gainesvil/TYPE: PAYMENT ID: 1371804719

CO: FLUENT-Gainesvil

NAME: steven chaplinskiEntry Class Code: WEB","25","","Posted","2736.43"
"3/30/2025","","Withdrawal POS #000000828055/SUNOCO 8002212501 4234 SW 20TH AVE

GAINESVILLE FL

Card 1247","18.41","","Posted","2761.43"
"3/30/2025","","Withdrawal POS #000000362248/AMAZON.COM*S368X2NI3 SEATTLE WA

Card 1247","10.74","","Posted","2779.84"
"3/30/2025","","Recurring Withdrawal Debit Card - MC Debit Gator/OPENAI SAN FRANCISC CA

Date 03/29/25 0 5088560328 2 5734

Card 1247","6.36","","Posted","2790.58"
"3/30/2025","","Recurring Withdrawal Debit Card - MC Debit Gator/SUPERPOWER CHATGPT MIDDLETOWN DE

Date 03/29/25 0 5088037830 1 5734

Card 1247","15","","Posted","2796.94"
"3/30/2025","","Withdrawal Debit Card MC Debit Gator/IONOS INC. CHESTERBROOK PA

Date 03/29/25 0 5088910148 0 4816

Card 1247","3.5","","Posted","2811.94"
"3/30/2025","","Withdrawal Debit Card MC Debit Gator/WALGREENS #5024 GAINESVILLE FL

Date 03/28/25 0 5087551811 2 5912

Card 1247","15","","Posted","2815.44"
"3/30/2025","","Withdrawal Debit Card MC Debit Gator/CIRCLE K # 06782 GAINESVILLE FL

Date 03/28/25 0 5087904842 0 5499

Card 1247","19.33","","Posted","2830.44"
"3/30/2025","","Withdrawal POS #000000000089/AMAZON.COM*NF6Z16BF3 SEATTLE WA

Card 1247","20.36","","Posted","2849.77"
"3/28/2025","","Withdrawal POS #000000721608/SUNOCO 8002212501 4234 SW 20TH AVE

GAINESVILLE FL

Card 1247","18.41","","Posted","2870.13"
"3/28/2025","","Withdrawal Debit Card MC Debit Gator/INSTACART*159 SAN FRANCISC CA

Date 03/27/25 0 5086352176 0 5411

Card 1247","63.11","","Posted","2888.54"
"3/28/2025","","Withdrawal Debit Card MC Debit Gator/CIRCLE K # 06782 GAINESVILLE FL

Date 03/26/25 0 5085313150 1 5499

Card 1247","3.86","","Posted","2951.65"
"3/28/2025","","Withdrawal POS #000010144479/WALGREENS 2415 SW 75TH 2415 SW 75TH ST

GAINESVILLE FL

Card 1247","17.03","","Posted","2955.51"
"3/27/2025","","Withdrawal Debit Card MC Debit Gator/INSTACART*159 SAN FRANCISC CA

Date 03/26/25 0 5085947835 0 5411

Card 1247","35.13","","Posted","2972.54"
"3/27/2025","","Recurring Withdrawal Debit Card - MC Debit Gator/APPLE.COM/BILL 866-712-7753 CA

Date 03/26/25 0 5085687073 0 5818

Card 1247","15.99","","Posted","3007.67"
"3/27/2025","","Withdrawal POS #000000666979/SUNOCO 8002212501 4234 SW 20TH AVE

GAINESVILLE FL

Card 1247","18.41","","Posted","3023.66"
"3/27/2025","","Deposit Home Banking Transfer/From CHAPLINSKI,LEON 3496297 Share 0090

Funds Transfer via Mobile","","3000","Posted","3042.07"
"3/27/2025","","Deposit Faster Payments/zel* MILLICENTCHAPLINSKI JFR05ZXQTB5B","","50","Posted","42.07"
"3/26/2025","","Recurring Withdrawal Debit Card - MC Debit Gator/IC* INSTACART*SUBSCRIP SAN FRANCISC CA

Date 03/25/25 0 5084015896 1 5411

Card 1247","9.99","","Posted","-7.93"
"3/26/2025","","Withdrawal ACH FLUENT-Gainesvil/TYPE: PAYMENT ID: 1371804719

CO: FLUENT-Gainesvil

NAME: steven chaplinskiEntry Class Code: WEB","20","","Posted","2.06"
"3/26/2025","","Withdrawal POS #000096294989/FAST TRACK #200 GAINESVILLE GAINESVILLE

Card 1247","11.35","","Posted","22.06"
"3/25/2025","","Withdrawal Debit Card MC Debit Gator/INSTACART*159 SAN FRANCISC CA

Date 03/24/25 0 5083900436 0 5411

Card 1247","29","","Posted","33.41"
"3/24/2025","","Deposit Faster Payments/zel* MILLICENTCHAPLINSKI JFR05UG1BHFX","","50","Posted","62.41"
"3/24/2025","","Withdrawal POS #000000564898/WAWA 5325 2373 SW ARCHER ROAD

FL

Card 1247","14.71","","Posted","12.41"
"3/23/2025","","Withdrawal POS #000000519848/SUNOCO 8002212501 4234 SW 20TH AVE

GAINESVILLE FL

Card 1247","19.9","","Posted","27.12"
"3/23/2025","","Withdrawal Debit Card MC Debit Gator/INSTACART*159 SAN FRANCISC CA

Date 03/22/25 0 5081791779 0 5411

Card 1247","1.25","","Posted","47.02"
"3/23/2025","","Withdrawal Debit Card MC Debit Gator/INSTACART*159 SAN FRANCISC CA

Date 03/22/25 0 5081281165 0 5411

Card 1247","52.02","","Posted","48.27"
"3/23/2025","","Recurring Withdrawal Bill Payment - #000000017652/NETFLIX COM LOS GATOS CA

Card 1247","20.71","","Posted","100.29"
"3/22/2025","","Withdrawal POS #000000936870/AMAZON.COM*V86L723P3 SEATTLE WA

Card 1247","20.36","","Posted","121"
"3/22/2025","","Withdrawal ATM Fee/EFT 3401 W University Ave Gainesville FL

Card 1247","2","","Posted","141.36"
"3/22/2025","","Withdrawal at ATM #000000776623/EFT 3401 W University Ave Gainesville FL

Card 1247","23","","Posted","143.36"
"3/22/2025","","Withdrawal POS #000000470173/SUNOCO 8002212501 4234 SW 20TH AVE

GAINESVILLE FL

Card 1247","21.84","","Posted","166.36"
"3/22/2025","","Deposit Faster Payments/zel* MILLICENTCHAPLINSKI JFR05QXNLAX0","","200","Posted","188.2"
"3/21/2025","","Recurring Withdrawal Debit Card - MC Debit Gator/CANVA* I04461-36076553 CAMDEN DE

Date 03/20/25 0 5079931674 0 7333

Card 1247","12.99","","Posted","-11.8"
"3/21/2025","","Withdrawal Debit Card MC Debit Gator/INSTACART*159 SAN FRANCISC CA

Date 03/20/25 0 5079931393 0 5411

Card 1247","36","","Posted","1.19"
"3/20/2025","","Withdrawal POS #000000402629/SUNOCO 8002212501 4234 SW 20TH AVE

GAINESVILLE FL

Card 1247","19.9","","Posted","37.19"
"3/20/2025","","Withdrawal ACH FLUENT-Gainesvil/TYPE: PAYMENT ID: 1371804719

CO: FLUENT-Gainesvil

NAME: steven chaplinskiEntry Class Code: WEB","15","","Posted","57.09"
"3/19/2025","","Withdrawal POS #000000336821/SUNOCO 8002212501 4234 SW 20TH AVE

GAINESVILLE FL

Card 1247","23.87","","Posted","72.09"
"3/19/2025","","Withdrawal Debit Card MC Debit Gator/INSTACART*159 SAN FRANCISC CA

Date 03/18/25 0 5077362198 0 5411

Card 1247","43","","Posted","95.96"
"3/19/2025","","Withdrawal Debit Card MC Debit Gator/WAWA 5325 GAINESVILLE FL

Date 03/18/25 0 5077155043 1 5541

Card 1247","16.64","","Posted","138.96"
"3/18/2025","","Recurring Withdrawal Debit Card - MC Debit Gator/AMAZON PRIME*RT81V9UJ3 AMZN.COM/BIL WA

Date 03/17/25 0 5076013448 1 5968

Card 1247","15.13","","Posted","155.6"
"3/18/2025","","Withdrawal POS #000000293182/SUNOCO 8002212501 4234 SW 20TH AVE

GAINESVILLE FL

Card 1247","23.44","","Posted","170.73"
"3/17/2025","","Recurring Withdrawal Debit Card - MC Debit Gator/OPENAI SAN FRANCISC CA

Date 03/17/25 0 5076063070 1 5734

Card 1247","6.06","","Posted","194.17"
"3/17/2025","","Recurring Withdrawal Debit Card - MC Debit Gator/APPLE.COM/BILL 866-712-7753 CA

Date 03/16/25 0 5075055681 1 5818

Card 1247","21.99","","Posted","200.23"
"3/17/2025","","Withdrawal POS #000000237561/SUNOCO 8002212501 4234 SW 20TH AVE

GAINESVILLE FL

Card 1247","21.84","","Posted","222.22"
"3/16/2025","","Withdrawal POS #000000209606/SUNOCO 8002212501 4234 SW 20TH AVE

GAINESVILLE FL

Card 1247","18.41","","Posted","244.06"
"3/16/2025","","Withdrawal Bill Payment #000000406377/APPLE COM ONE APPLE PARK WAY ONE APPLE

CA

Card 1247","0.99","","Posted","262.47"
"3/14/2025","","Withdrawal Debit Card MC Debit Gator/INSTACART*159 SAN FRANCISC CADate 03/13/25 0 5072883709 0 5411Card 1247","72","","Posted","263.46"
"3/14/2025","","Withdrawal POS #000000138065/SUNOCO 8002212501 4234 SW 20TH AVEGAINESVILLE FLCard 1247","23.65","","Posted","335.46"
"3/12/2025","","Withdrawal POS #000000029649/SUNOCO 8002212501 4234 SW 20TH AVEGAINESVILLE FLCard 1247","19.9","","Posted","359.11"
"3/11/2025","","Withdrawal Debit Card MC Debit Gator/AMAZON PRIME*CU90U9EJ3 AMZN.COM/BIL WADate 03/11/25 0 5070388912 1 5818Card 1247","3.4","","Posted","379.01"
"3/10/2025","","Withdrawal Debit Card MC Debit Gator/GRU/EZ-PAY WEB PYMT 352-334-3434 FLDate 03/09/25 0 5068009425 1 4900Card 1247","182.55","","Posted","382.41"
"3/10/2025","","Withdrawal Debit Card MC Debit Gator/COX GAINESVILLE COMM 800-234-3993 FLDate 03/09/25 0 5068137922 1 4899Card 1247","156.13","","Posted","564.96"
"3/10/2025","","Withdrawal ACH FLUENT-Gainesvil/TYPE: PAYMENT ID: 1371804719CO: FLUENT-GainesvilNAME: steven chaplinskiEntry Class Code: WEB","75","","Posted","721.09"
"3/10/2025","","Withdrawal ACH SUNO INC./TYPE: SUNO INC. ID: 1800948598CO: SUNO INC. NAME: STEVEN J CHAPLINSKIEntry Class Code: WEB","10","","Posted","796.09"
"3/10/2025","","Withdrawal ACH QUORA.COM/TYPE: QUORA.COM ID: 4270465600CO: QUORA.COM NAME: STEVEN J CHAPLINSKIEntry Class Code: WEB","4.99","","Posted","806.09"
"3/10/2025","","Withdrawal POS #000000160477/SUNOCO 8002212501 4234 SW 20TH AVEGAINESVILLE FLCard 1247","34.84","","Posted","811.08"
"3/9/2025","","Withdrawal Adjustment Debit Card - Credit Voucher/APPLE.COM/BILL 866-712-7753 CADate 03/08/25 0 5067337806 0 5818Card 1247","","1.99","Posted","845.92"
"3/9/2025","","Withdrawal Debit Card MC Debit Gator/I-BLOCKLIST/PEERBLOCK MIAMI FLDate 03/08/25 0 5067675779 3 5734Card 1247","9.99","","Posted","843.93"
"3/9/2025","","Recurring Withdrawal Debit Card - MC Debit Gator/OPENAI SAN FRANCISC CADate 03/08/25 0 5067339145 0 5734Card 1247","6.1","","Posted","853.92"
"3/9/2025","","Recurring Withdrawal Debit Card - MC Debit Gator/TUBEBUDDYCOM* 8668823239 CADate 03/07/25 0 5066672774 3 5045Card 1247","7.5","","Posted","860.02"
"3/9/2025","","Recurring Withdrawal Debit Card - MC Debit Gator/INVIDEO INC COUNTRY OF S DEDate 03/07/25 0 5066671640 3 5734Card 1247","35","","Posted","867.52"
"3/9/2025","","Recurring Withdrawal Debit Card Fee/MASTERCARD ISSUER CROSS-BORDER FEEDate 03/08/25 0 5067338695 0 5734Card 1247","0.06","","Posted","902.52"
"3/9/2025","","Recurring Withdrawal Debit Card - MC Debit Gator/IDEOGRAM AI TORONTO ONDate 03/08/25 0 5067338695 0 5734Card 1247","8","","Posted","902.58"
"3/9/2025","","Recurring Withdrawal Debit Card Fee/MASTERCARD ISSUER CROSS-BORDER FEEDate 03/08/25 0 5067744961 0 5734Card 1247","0.23","","Posted","910.58"
"3/9/2025","","Recurring Withdrawal Debit Card - MC Debit Gator/NOTEGPT.IO ADMIRALTY KODate 03/08/25 0 5067744961 0 5734Card 1247","29","","Posted","910.81"
"3/9/2025","","Withdrawal Debit Card MC Debit Gator/IONOS INC. CHESTERBROOK PADate 03/08/25 0 5067522264 1 4816Card 1247","23","","Posted","939.81"
"3/9/2025","","Recurring Withdrawal Debit Card - MC Debit Gator/APPLE.COM/BILL 866-712-7753 CADate 03/08/25 0 5067516617 1 5818Card 1247","14.97","","Posted","962.81"
"3/9/2025","","Withdrawal POS #000000571139/AMAZON.COM*BI6JD3LZ3 SEATTLE WACard 1247","18.2","","Posted","977.78"
"3/9/2025","","Withdrawal POS #000000000099/AMAZON.COM*VA0IZ8DO3 SEATTLE WACard 1247","33.84","","Posted","995.98"
"3/8/2025","","Withdrawal POS #000000117409/SUNOCO 8002212501 4234 SW 20TH AVEGAINESVILLE FLCard 1247","18.41","","Posted","1029.82"
"3/8/2025","","Withdrawal POS #000061190506/SMOKE CITY 2120 SW 34TH ST GAINESVILLECard 1247","6.34","","Posted","1048.23"
"3/8/2025","","Withdrawal POS #000000788547/PUBLIX 3100 SW 35TH BLVD GAINESVILLE FLCard 1247","26.8","","Posted","1054.57"
"3/7/2025","","Withdrawal POS #000000956289/SUNOCO 8002212501 4234 SW 20TH AVEGAINESVILLE FLCard 1247","21.84","","Posted","1081.37"
"3/6/2025","","Withdrawal Debit Card MC Debit Gator/WWW.PERPLEXITY.AI SAN FRANCISC CADate 03/06/25 0 5065324957 1 5815Card 1247","4","","Posted","1103.21"
"3/6/2025","","Recurring Withdrawal Debit Card - MC Debit Gator/OPENAI SAN FRANCISC CADate 03/06/25 0 5065324949 1 5734Card 1247","10","","Posted","1107.21"
"3/6/2025","","Recurring Withdrawal Debit Card - MC Debit Gator/SUPERPOWER CHATGPT MIDDLETOWN DEDate 03/06/25 0 5065760660 0 5734Card 1247","15","","Posted","1117.21"
"3/6/2025","","Recurring Withdrawal Debit Card - MC Debit Gator/SUPERPOWER CHATGPT MIDDLETOWN DEDate 03/06/25 0 5065760659 0 5734Card 1247","15","","Posted","1132.21"
"3/6/2025","","Withdrawal Debit Card MC Debit Gator/INSTACART*159 SAN FRANCISC CADate 03/05/25 0 5064759595 0 5411Card 1247","4.09","","Posted","1147.21"
"3/6/2025","","Withdrawal Debit Card MC Debit Gator/INSTACART*159 SAN FRANCISC CADate 03/05/25 0 5064759594 0 5411Card 1247","49.98","","Posted","1151.3"
"3/6/2025","","Withdrawal Debit Card MC Debit Gator/IONOS INC. CHESTERBROOK PADate 03/05/25 0 5064758543 0 4816Card 1247","17","","Posted","1201.28"
"3/5/2025","","Recurring Withdrawal Debit Card - MC Debit Gator/OPENAI *CHATGPT SUBSCR SAN FRANCISC CADate 03/04/25 0 5063322854 0 5734Card 1247","20","","Posted","1218.28"
"3/5/2025","","Withdrawal Debit Card MC Debit Gator/IONOS INC. CHESTERBROOK PADate 03/04/25 0 5063027389 1 4816Card 1247","1","","Posted","1238.28"
"3/5/2025","","Withdrawal POS #000000403709/SUNOCO 8002212501 4234 SW 20TH AVEGAINESVILLE FLCard 1247","21.84","","Posted","1239.28"
"3/4/2025","","Withdrawal Bill Payment #000000352498/Adobe Park Avenue,345 San Jose CACard 1247","19.99","","Posted","1261.12"
"3/4/2025","","Withdrawal POS #000000897140/SUNOCO 8002212501 4234 SW 20TH AVEGAINESVILLE FLCard 1247","21.84","","Posted","1281.11"
"3/3/2025","","Recurring Withdrawal Debit Card - MC Debit Gator/NOTION LABS, INC. SAN FRANCISC CADate 03/02/25 0 5061145246 1 7372Card 1247","22","","Posted","1302.95"
"3/3/2025","","Recurring Withdrawal Debit Card - MC Debit Gator/APPLE.COM/BILL 866-712-7753 CADate 03/03/25 0 5062986121 0 5818Card 1247","2.99","","Posted","1324.95"
"3/3/2025","","Withdrawal ACH Watson Realty Co/TYPE: WEB PMTS ID: 9000321157CO: Watson Realty CoNAME: Steven chaplinskiEntry Class Code: WEB","1179","","Posted","1327.94"
"3/3/2025","","Withdrawal ACH FLUENT-Gainesvil/TYPE: PAYMENT ID: 1371804719CO: FLUENT-GainesvilNAME: steven chaplinskiEntry Class Code: WEB","30","","Posted","2506.94"
"3/3/2025","","Withdrawal ACH AppFolio, Inc. F/TYPE: WEB PMTS ID: 9001406550CO: AppFolio, Inc. FNAME: Steven chaplinskiEntry Class Code: WEB","2.49","","Posted","2536.94"
"3/2/2025","","Withdrawal Debit Card Fee/MASTERCARD ISSUER CROSS-BORDER FEEDate 03/01/25 0 5060117430 2 5967Card 1247","0.03","","Posted","2539.43"
"3/2/2025","","Withdrawal Debit Card MC Debit Gator/SEEMYHELP.COM 15143341887 NLDate 03/01/25 0 5060117430 2 5967Card 1247","3.17","","Posted","2539.46"
"3/2/2025","","Recurring Withdrawal Debit Card - MC Debit Gator/MYDESIGNS - PRO - MON LAS VEGAS NVDate 03/01/25 0 5060117238 2 5734Card 1247","49.99","","Posted","2542.63"
"3/2/2025","","Recurring Withdrawal Debit Card - MC Debit Gator/SUPERPOWER CHATGPT MIDDLETOWN DEDate 03/01/25 0 5060800147 3 5734Card 1247","15","","Posted","2592.62"
"3/2/2025","","Recurring Withdrawal Debit Card - MC Debit Gator/PARAMOUNT+ WEST HOLLYWO CADate 03/01/25 0 5060115089 2 4899Card 1247","14.96","","Posted","2607.62"
"3/2/2025","","Recurring Withdrawal Debit Card - MC Debit Gator/PADDLE.NET* SETAPP NEW YORK NYDate 03/01/25 0 5060337134 0 5817Card 1247","9.99","","Posted","2622.58"
"3/2/2025","","Withdrawal Debit Card MC Debit Gator/CIRCLE K # 06782 GAINESVILLE FLDate 02/27/25 0 5058785660 3 5499Card 1247","15.47","","Posted","2632.57"
"3/2/2025","","Withdrawal POS #000000754970/SUNOCO 8002212501 4234 SW 20TH AVEGAINESVILLE FLCard 1247","18.41","","Posted","2648.04"
"3/1/2025","","Withdrawal POS #000000764400/SUNOCO 8002212501 4234 SW 20TH AVEGAINESVILLE FLCard 1247","18.41","","Posted","2666.45"
"3/1/2025","","Withdrawal POS #000019039802/GOOGLE *YouTubePremium 1600 AmphitheatreParkw Mountain View CACard 1247","15.92","","Posted","2684.86"
"3/1/2025","","Withdrawal POS #000000774167/PUBLIX 3100 SW 35TH BLVD GAINESVILLE FLCard 1247","45.09","","Posted","2700.78"
"2/28/2025","","Withdrawal Debit Card MC Debit Gator/WALGREENS #5024 GAINESVILLE FLDate 02/27/25 0 5058715205 1 5912Card 1247","15","","Posted","2745.87"
"2/28/2025","","Withdrawal Debit Card MC Debit Gator/WALGREENS #5024 GAINESVILLE FLDate 02/27/25 0 5058715204 1 5912Card 1247","36.66","","Posted","2760.87"
"2/28/2025","","Withdrawal Debit Card MC Debit Gator/CIRCLE K # 26146 GAINESVILLE FLDate 02/26/25 0 5057712171 1 5499Card 1247","15.38","","Posted","2797.53"
"2/27/2025","","Deposit Home Banking Transfer/From CHAPLINSKI,LEON 3496297 Share 0090Funds Transfer via Mobile","","1000","Posted","2812.91"
"2/27/2025","","Withdrawal ATM Fee/EFT 3401 W University Ave Gainesville FLCard 1247","2","","Posted","1812.91"
"2/27/2025","","Withdrawal at ATM #000000570838/EFT 3401 W University Ave Gainesville FLCard 1247","23","","Posted","1814.91"
"2/26/2025","","Withdrawal POS #000000584528/SUNOCO 8002212501 4234 SW 20TH AVEGAINESVILLE FLCard 1247","21.84","","Posted","1837.91"
"2/26/2025","","Withdrawal Debit Card MC Debit Gator/INSTACART*159 SAN FRANCISC CADate 02/25/25 0 5056880216 0 5411Card 1247","45.23","","Posted","1859.75"
"2/25/2025","","Recurring Withdrawal Debit Card - MC Debit Gator/IC* INSTACART*SUBSCRIP SAN FRANCISC CADate 02/24/25 0 5055823500 0 5411Card 1247","9.99","","Posted","1904.98"
"2/25/2025","","Withdrawal POS #000000509694/SUNOCO 8002212501 4234 SW 20TH AVEGAINESVILLE FLCard 1247","21.84","","Posted","1914.97"
"2/24/2025","","Withdrawal ATM Fee/EFT 3401 W University Ave Gainesville FLCard 1247","2","","Posted","1936.81"
"2/24/2025","","Withdrawal at ATM #000000359753/EFT 3401 W University Ave Gainesville FLCard 1247","33","","Posted","1938.81"
"2/24/2025","","Withdrawal POS #000000517746/SUNOCO 8002212501 4234 SW 20TH AVEGAINESVILLE FLCard 1247","21.84","","Posted","1971.81"
"2/24/2025","","Deposit Home Banking Transfer/From CHAPLINSKI,LEON 3496297 Share 0090Funds Transfer via Mobile","","1800","Posted","1993.65"
"2/24/2025","","Deposit Faster Payments/zel* MILLICENTCHAPLINSKI JFR04F2R0F03","","200","Posted","193.65"
"2/23/2025","","Withdrawal Debit Card MC Debit Gator/INSTACART*159 SAN FRANCISC CADate 02/22/25 0 5053321628 0 5411Card 1247","50","","Posted","-6.35"
"2/23/2025","","Withdrawal Debit Card MC Debit Gator/CIRCLE K # 26146 GAINESVILLE FLDate 02/21/25 0 5052836319 0 5499Card 1247","17.19","","Posted","43.65"
"2/23/2025","","Recurring Withdrawal Bill Payment - #000000331607/NETFLIX COM LOS GATOS CACard 1247","20.71","","Posted","60.84"
"2/22/2025","","Withdrawal ATM Fee/EFT 3401 W University Ave Gainesville FLCard 1247","2","","Posted","81.55"
"2/22/2025","","Withdrawal at ATM #000000068777/EFT 3401 W University Ave Gainesville FLCard 1247","33","","Posted","83.55"
"2/21/2025","","Recurring Withdrawal Debit Card - MC Debit Gator/CANVA* I04433-39431369 CAMDEN DEDate 02/20/25 0 5051832939 0 7333Card 1247","12.99","","Posted","116.55"
"2/21/2025","","Withdrawal POS #000000938881/SUNOCO 8002212501 4234 SW 20TH AVEGAINESVILLE FLCard 1247","21.84","","Posted","129.54"
"2/20/2025","","Withdrawal POS #000000393434/SUNOCO 8002212501 4234 SW 20TH AVEGAINESVILLE FLCard 1247","18.41","","Posted","151.38"
"2/19/2025","","Withdrawal ATM Fee/SOUTH STATE BK 3535 SW 34TH STREETGAINESVILLE FLCard 1247","2","","Posted","169.79"
"2/19/2025","","Withdrawal at ATM #000000002102/SOUTH STATE BK 3535 SW 34TH STREETGAINESVILLE FLCard 1247","63.5","","Posted","171.79"
"2/19/2025","","Withdrawal POS #000000879769/SUNOCO 8002212501 4234 SW 20TH AVEGAINESVILLE FLCard 1247","21.41","","Posted","235.29"
"2/19/2025","","Withdrawal Debit Card MC Debit Gator/INSTACART*159 SAN FRANCISC CADate 02/18/25 0 5049873156 0 5411Card 1247","45","","Posted","256.7"
"2/18/2025","","Withdrawal POS #000000324063/SUNOCO 8002212501 4234 SW 20TH AVEGAINESVILLE FLCard 1247","21.84","","Posted","301.7"
"2/18/2025","","Recurring Withdrawal Debit Card - MC Debit Gator/AMAZON PRIME*U74BM3BG3 AMZN.COM/BIL WADate 02/17/25 0 5048844767 0 5968Card 1247","15.13","","Posted","323.54"
"2/17/2025","","Withdrawal POS #000000203758/SUNOCO 8002212501 4234 SW 20TH AVEGAINESVILLE FLCard 1247","20.01","","Posted","338.67"
"2/16/2025","","Withdrawal Debit Card MC Debit Gator/INSTACART*159 SAN FRANCISC CADate 02/14/25 0 5045264835 0 5411Card 1247","49","","Posted","358.68"
"2/16/2025","","Withdrawal POS #000000193415/SUNOCO 8002212501 4234 SW 20TH AVEGAINESVILLE FLCard 1247","23.44","","Posted","407.68"
"2/15/2025","","Withdrawal POS #000000267044/SUNOCO 8002212501 4234 SW 20TH AVEGAINESVILLE FLCard 1247","21.41","","Posted","431.12"
"2/13/2025","","Withdrawal POS #000000159674/SUNOCO 8002212501 4234 SW 20TH AVEGAINESVILLE FLCard 1247","23.65","","Posted","452.53"
"2/12/2025","","Withdrawal ATM Fee/EFT 6419 W Newberry Rd Gainesville FLCard 1247","2","","Posted","476.18"
"2/12/2025","","Withdrawal at ATM #000000160796/EFT 6419 W Newberry Rd Gainesville FLCard 1247","48","","Posted","478.18"
"2/12/2025","","Withdrawal POS #000000126612/SUNOCO 8002212501 4234 SW 20TH AVEGAINESVILLE FLCard 1247","21.84","","Posted","526.18"
"2/11/2025","","Withdrawal Debit Card MC Debit Gator/AMAZON PRIME*B45DR82X3 AMZN.COM/BIL WADate 02/11/25 0 5042051984 1 5818Card 1247","3.4","","Posted","548.02"
"2/11/2025","","Withdrawal POS #000000072493/SUNOCO 8002212501 4234 SW 20TH AVEGAINESVILLE FLCard 1247","18.41","","Posted","551.42"
"2/11/2025","","Withdrawal POS #000000446485/AMAZON.COM*XN90T43R3 SEATTLE WACard 1247","20.38","","Posted","569.83"
"2/11/2025","","Withdrawal POS #000000000004/AMAZON.COM*Q443411V3 SEATTLE WACard 1247","20.38","","Posted","590.21"
"2/10/2025","","Withdrawal Debit Card MC Debit Gator/GRU/EZ-PAY WEB PYMT 352-334-3434 FLDate 02/09/25 0 5040010734 1 4900Card 1247","172.98","","Posted","610.59"
"2/9/2025","","Withdrawal POS #000000943545/SUNOCO 8002212501 4234 SW 20TH AVEGAINESVILLE FLCard 1247","20.88","","Posted","783.57"
"2/9/2025","","Withdrawal Debit Card MC Debit Gator/INSTACART*159 SAN FRANCISC CADate 02/08/25 0 5039877461 0 5411Card 1247","1","","Posted","804.45"
"2/9/2025","","Withdrawal Debit Card MC Debit Gator/INSTACART*159 SAN FRANCISC CADate 02/08/25 0 5039378930 0 5411Card 1247","46","","Posted","805.45"
"2/9/2025","","Recurring Withdrawal Debit Card Fee/MASTERCARD ISSUER CROSS-BORDER FEEDate 02/08/25 0 5039378735 0 5734Card 1247","0.06","","Posted","851.45"
"2/9/2025","","Recurring Withdrawal Debit Card - MC Debit Gator/IDEOGRAM AI TORONTO ONDate 02/08/25 0 5039378735 0 5734Card 1247","8","","Posted","851.51"
"2/9/2025","","Recurring Withdrawal Debit Card Fee/MASTERCARD ISSUER CROSS-BORDER FEEDate 02/08/25 0 5039144067 2 5734Card 1247","0.23","","Posted","859.51"
"2/9/2025","","Recurring Withdrawal Debit Card - MC Debit Gator/NOTEGPT.IO ADMIRALTY KODate 02/08/25 0 5039144067 2 5734Card 1247","29","","Posted","859.74"
"2/9/2025","","Withdrawal Debit Card MC Debit Gator/IONOS INC. CHESTERBROOK PADate 02/08/25 0 5039876633 0 4816Card 1247","23","","Posted","888.74"
"2/9/2025","","Recurring Withdrawal Debit Card - MC Debit Gator/APPLE.COM/BILL 866-712-7753 CADate 02/08/25 0 5039325895 2 5818Card 1247","12.99","","Posted","911.74"
"2/9/2025","","Withdrawal Debit Card MC Debit Gator/COX GAINESVILLE COMM 800-234-3993 FLDate 02/08/25 0 5039376753 0 4899Card 1247","156.13","","Posted","924.73"
"2/8/2025","","Withdrawal POS #000000957137/SUNOCO 8002212501 4234 SW 20TH AVEGAINESVILLE FLCard 1247","21.84","","Posted","1080.86"
"2/7/2025","","Withdrawal Debit Card MC Debit Gator/IONOS INC. CHESTERBROOK PADate 02/06/25 0 5037921337 0 4816Card 1247","16","","Posted","1102.7"
"2/7/2025","","Withdrawal POS #000000827056/SUNOCO 8002212501 4234 SW 20TH AVEGAINESVILLE FLCard 1247","18.41","","Posted","1118.7"
"2/6/2025","","Withdrawal Adjustment Debit Card - Credit Voucher/APPLE.COM/BILL 866-712-7753 CADate 02/05/25 0 5036986565 0 5818Card 1247","","29.99","Posted","1137.11"
"2/6/2025","","Withdrawal Debit Card MC Debit Gator/IONOS INC. CHESTERBROOK PADate 02/05/25 0 5036019016 1 4816Card 1247","1","","Posted","1107.12"
"2/5/2025","","Recurring Withdrawal Debit Card - MC Debit Gator/OPENAI SAN FRANCISC CADate 02/04/25 0 5035991425 0 5734Card 1247","0.63","","Posted","1108.12"
"2/5/2025","","Recurring Withdrawal Debit Card - MC Debit Gator/OPENAI *CHATGPT SUBSCR SAN FRANCISC CADate 02/04/25 0 5035323752 0 5734Card 1247","20","","Posted","1108.75"
"2/5/2025","","Withdrawal Debit Card Fee/MASTERCARD ISSUER CROSS-BORDER FEEDate 02/03/25 0 5034323004 0 5967Card 1247","0.03","","Posted","1128.75"
"2/5/2025","","Withdrawal Debit Card MC Debit Gator/ZUBBHELP.COM HAARLEM NLDate 02/03/25 0 5034323004 0 5967Card 1247","3.17","","Posted","1128.78"
"2/5/2025","","Withdrawal Debit Card MC Debit Gator/YVETTE GODET DMD GAINESVILLE FLDate 02/04/25 0 5035835029 0 8021Card 1247","56.8","","Posted","1131.95"
"2/5/2025","","Withdrawal Debit Card MC Debit Gator/CIRCLE K # 06782 GAINESVILLE FLDate 02/03/25 0 5034984751 0 5499Card 1247","20.84","","Posted","1188.75"
"2/5/2025","","Withdrawal POS #000000734068/PUBLIX 3100 SW 35TH BLVD GAINESVILLE FLCard 1247","60.92","","Posted","1209.59"
"2/5/2025","","Withdrawal ATM Fee/EFT 3401 W University Ave Gainesville FLCard 1247","2","","Posted","1270.51"
"2/5/2025","","Withdrawal at ATM #000000464773/EFT 3401 W University Ave Gainesville FLCard 1247","43","","Posted","1272.51"
"2/4/2025","","Withdrawal POS #000000646864/AMAZON.COM*MZ5BC8D43 SEATTLE WACard 1247","10.19","","Posted","1315.51"
"2/4/2025","","Recurring Withdrawal Debit Card - MC Debit Gator/APPLE.COM/BILL 866-712-7753 CADate 02/04/25 0 5035127693 1 5818Card 1247","29.99","","Posted","1325.7"
"2/4/2025","","Withdrawal Bill Payment #000000199905/Adobe Park Avenue,345 San Jose CACard 1247","19.99","","Posted","1355.69"
"2/3/2025","","Recurring Withdrawal Debit Card - MC Debit Gator/NOTION LABS, INC. SAN FRANCISC CADate 02/02/25 0 5033134219 1 7372Card 1247","22","","Posted","1375.68"
"2/3/2025","","Recurring Withdrawal Debit Card - MC Debit Gator/OPENAI SAN FRANCISC CADate 02/02/25 0 5033247681 1 5734Card 1247","5","","Posted","1397.68"
"2/3/2025","","Recurring Withdrawal Debit Card - MC Debit Gator/OPENAI SAN FRANCISC CADate 02/02/25 0 5033247680 1 5734Card 1247","5","","Posted","1402.68"
"2/3/2025","","Recurring Withdrawal Debit Card - MC Debit Gator/APPLE.COM/BILL 866-712-7753 CADate 02/03/25 0 5034963465 0 5818Card 1247","2.99","","Posted","1407.68"
"2/3/2025","","Recurring Withdrawal Debit Card - MC Debit Gator/APPLE.COM/BILL 866-712-7753 CADate 02/02/25 0 5033127007 1 5818Card 1247","29.99","","Posted","1410.67"
"2/3/2025","","Withdrawal ACH Watson Realty Co/TYPE: WEB PMTS ID: 9000321157CO: Watson Realty CoNAME: Steven chaplinskiEntry Class Code: WEB","1179","","Posted","1440.66"
"2/3/2025","","Withdrawal ACH AppFolio, Inc. F/TYPE: WEB PMTS ID: 9001406550CO: AppFolio, Inc. FNAME: Steven chaplinskiEntry Class Code: WEB","2.49","","Posted","2619.66"
"2/2/2025","","Withdrawal POS #000000781738/SUNOCO 8002212501 4234 SW 20TH AVEGAINESVILLE FLCard 1247","17.08","","Posted","2622.15"
"2/2/2025","","Recurring Withdrawal Debit Card - MC Debit Gator/PARAMOUNT+ WEST HOLLYWO CADate 02/01/25 0 5032847059 0 4899Card 1247","14.96","","Posted","2639.23"
"2/2/2025","","Withdrawal Debit Card MC Debit Gator/INSTACART*159 SAN FRANCISC CADate 01/31/25 0 5031931716 1 5411Card 1247","52","","Posted","2654.19"
"2/2/2025","","Recurring Withdrawal Debit Card Fee/MASTERCARD ISSUER CROSS-BORDER FEEDate 02/01/25 0 5032990634 0 5967Card 1247","0.01","","Posted","2706.19"
"2/2/2025","","Recurring Withdrawal Debit Card - MC Debit Gator/PROBILLER.COM 855-232-9555 CYDate 02/01/25 0 5032990634 0 5967Card 1247","1.14","","Posted","2706.2"
"2/2/2025","","Withdrawal Debit Card Fee/MASTERCARD ISSUER CROSS-BORDER FEEDate 02/01/25 0 5032990633 0 5967Card 1247","0.01","","Posted","2707.34"
"2/2/2025","","Withdrawal Debit Card MC Debit Gator/PROBILLER.COM 855-232-9555 CYDate 02/01/25 0 5032990633 0 5967Card 1247","1.14","","Posted","2707.35"
"2/2/2025","","Withdrawal Debit Card MC Debit Gator/IONOS INC. CHESTERBROOK PADate 01/31/25 0 5031845289 0 4816Card 1247","40","","Posted","2708.49"
"2/2/2025","","Withdrawal Debit Card MC Debit Gator/CIRCLE K # 06782 GAINESVILLE FLDate 01/31/25 0 5031331003 1 5499Card 1247","16.99","","Posted","2748.49"
"2/1/2025","","Withdrawal POS #000000675669/SUNOCO 8002212501 4234 SW 20TH AVEGAINESVILLE FLCard 1247","17.08","","Posted","2765.48"
"2/1/2025","","Withdrawal POS #000000364287/ETSY.COM*US WWW.ETSY.COM/ BROOKLYN NYCard 1247","0.6","","Posted","2782.56"
"2/1/2025","","Deposit Home Banking Transfer/From CHAPLINSKI,LEON 3496297 Share 0090Funds Transfer via Mobile","","1000","Posted","2783.16"
"1/31/2025","","Recurring Withdrawal Debit Card - MC Debit Gator/APPLE.COM/BILL 866-712-7753 CADate 01/31/25 0 5031045448 1 5818Card 1247","2.99","","Posted","1783.16"
"1/31/2025","","Recurring Withdrawal Debit Card - MC Debit Gator/APPLE.COM/BILL 866-712-7753 CADate 01/31/25 0 5031045443 1 5818Card 1247","24.99","","Posted","1786.15"
"1/31/2025","","Recurring Withdrawal Debit Card - MC Debit Gator/NETFLIX.COM CADate 01/30/25 0 5030869462 0 4899Card 1247","17.84","","Posted","1811.14"
"1/31/2025","","Withdrawal POS #000000000043/AMAZON.COM*ZC1UW3U40 SEATTLE WACard 1247","10.19","","Posted","1828.98"
"1/31/2025","","Withdrawal POS #000000000343/CIRCLE K # 06782 5237 GAINESVILLE FLCard 1247","10.01","","Posted","1839.17"
"1/30/2025","","Withdrawal POS #000019353777/GOOGLE *YouTubePremium 1600 AmphitheatreParkw Mountain View CACard 1247","9.1","","Posted","1849.18"
"1/30/2025","","Recurring Withdrawal Debit Card - MC Debit Gator/MYDESIGNS - PRO - MON LAS VEGAS NVDate 01/29/25 0 5029913031 0 5734Card 1247","49.99","","Posted","1858.28"
"1/30/2025","","Recurring Withdrawal Debit Card - MC Debit Gator/SUPERPOWER CHATGPT MIDDLETOWN DEDate 01/29/25 0 5029912376 0 5734Card 1247","15","","Posted","1908.27"
"1/30/2025","","Recurring Withdrawal Debit Card - MC Debit Gator/PADDLE.NET* SETAPP NEW YORK NYDate 01/29/25 0 5029860662 0 5817Card 1247","14.5","","Posted","1923.27"
"1/30/2025","","Withdrawal Debit Card MC Debit Gator/CANVA* I04402-39206221 CAMDEN DEDate 01/29/25 0 5029860414 0 7333Card 1247","12.99","","Posted","1937.77"
"1/30/2025","","Withdrawal Debit Card MC Debit Gator/COPYTONOTI WILMINGTON DEDate 01/29/25 0 5029909612 0 5817Card 1247","47","","Posted","1950.76"
"1/30/2025","","Withdrawal Debit Card MC Debit Gator/WALGREENS #5024 GAINESVILLE FLDate 01/29/25 0 5029087400 1 5912Card 1247","15","","Posted","1997.76"
"1/30/2025","","Withdrawal Debit Card MC Debit Gator/CIRCLE K # 06782 GAINESVILLE FLDate 01/28/25 0 5028905568 0 5499Card 1247","15.47","","Posted","2012.76"
"1/29/2025","","Deposit Home Banking Transfer/From CHAPLINSKI,LEON 3496297 Share 0090Funds Transfer via Mobile","","2000","Posted","2028.23"
"1/29/2025","","Withdrawal POS #000000525481/SUNOCO 8002212501 4234 SW 20TH AVEGAINESVILLE FLCard 1247","17.08","","Posted","28.23"
"1/29/2025","","Withdrawal Debit Card MC Debit Gator/WALGREENS #5024 GAINESVILLE FLDate 01/28/25 0 5028088379 1 5912Card 1247","10.81","","Posted","45.31"
"1/27/2025","","Withdrawal Debit Card MC Debit Gator/INSTACART*159 SAN FRANCISC CADate 01/26/25 0 5026250026 0 5411Card 1247","50.23","","Posted","56.12"
"1/27/2025","","Withdrawal ATM Fee/EFT 6419 W Newberry Rd Gainesville FLCard 1247","2","","Posted","106.35"
"1/27/2025","","Withdrawal at ATM #000000618599/EFT 6419 W Newberry Rd Gainesville FLCard 1247","53","","Posted","108.35"
"1/27/2025","","Withdrawal POS #000000553411/WAWA 5325 2373 SW ARCHER ROADFLCard 1247","14.71","","Posted","161.35"
"1/26/2025","","Withdrawal ATM Fee/EFT 6419 W Newberry Rd Gainesville FLCard 1247","2","","Posted","176.06"
"1/26/2025","","Withdrawal at ATM #000000554718/EFT 6419 W Newberry Rd Gainesville FLCard 1247","23","","Posted","178.06"
"1/26/2025","","Deposit Faster Payments/zel* MILLICENTCHAPLINSKI JFRTe5rHpBlq","","200","Posted","201.06"
"1/26/2025","","Withdrawal POS #000097243000/WAWA 5325 2373 SW ARCHER ROADFLCard 1247","10.98","","Posted","1.06"
"1/26/2025","","Deposit ATM Transaction","","2","Posted","12.04"
"1/25/2025","","Withdrawal POS #000000455581/SUNOCO 8002212501 4234 SW 20TH AVEGAINESVILLE FLCard 1247","20.51","","Posted","10.04"
"1/24/2025","","Withdrawal ATM Fee/EFT 6419 W Newberry Rd Gainesville FLCard 1247","2","","Posted","30.55"
"1/24/2025","","Withdrawal at ATM #000000365727/EFT 6419 W Newberry Rd Gainesville FLCard 1247","28","","Posted","32.55"
"1/24/2025","","Recurring Withdrawal Debit Card - MC Debit Gator/IC* INSTACART*SUBSCRIP SAN FRANCISC CADate 01/24/25 0 5024009804 1 5411Card 1247","9.99","","Posted","60.55"
"1/24/2025","","Withdrawal POS #000000439538/SUNOCO 8002212501 4234 SW 20TH AVEGAINESVILLE FLCard 1247","22.87","","Posted","70.54"
"1/24/2025","","Withdrawal POS #000000507326/AMAZON.COM*ZG65P87B0 SEATTLE WACard 1247","44.65","","Posted","93.41"
"1/24/2025","","Deposit Faster Payments/zel* MILLICENTCHAPLINSKI JFR49AILmhnO","","100","Posted","138.06"
"1/23/2025","","Withdrawal POS #000000375346/SUNOCO 8002212501 4234 SW 20TH AVEGAINESVILLE FLCard 1247","17.08","","Posted","38.06"
"1/23/2025","","Withdrawal POS #000000409491/AMAZON.COM*Z55VK0Y01 SEATTLE WACard 1247","10.19","","Posted","55.14"
"1/22/2025","","Withdrawal POS #000000268342/SUNOCO 8002212501 4234 SW 20TH AVEGAINESVILLE FLCard 1247","20.51","","Posted","65.33"
"1/21/2025","","Withdrawal Debit Card MC Debit Gator/INSTACART*159 SAN FRANCISC CADate 01/20/25 0 5020903203 0 5411Card 1247","58.79","","Posted","85.84"
"1/21/2025","","Withdrawal Debit Card MC Debit Gator/CIRCLE K # 26146 GAINESVILLE FLDate 01/19/25 0 5019898493 0 5499Card 1247","16.98","","Posted","144.63"
"1/21/2025","","Withdrawal ACH FLUENT-Gainesvil/TYPE: PAYMENT ID: 1371804719CO: FLUENT-GainesvilNAME: steven chaplinskiEntry Class Code: WEB","15","","Posted","161.61"
"1/20/2025","","Withdrawal POS #000000308001/SUNOCO 8002212501 4234 SW 20TH AVEGAINESVILLE FLCard 1247","20.51","","Posted","176.61"
"1/20/2025","","Deposit Faster Payments/zel* MILLICENTCHAPLINSKI JFRudsTpu7C4","","200","Posted","197.12"
"1/20/2025","","Withdrawal Debit Card MC Debit Gator/CIRCLE K # 06782 GAINESVILLE FLDate 01/18/25 0 5018029946 1 5499Card 1247","20.62","","Posted","-2.88"
"1/19/2025","","Withdrawal POS #000000187957/SUNOCO 8002212501 4234 SW 20TH AVEGAINESVILLE FLCard 1247","14.92","","Posted","17.74"
"1/19/2025","","Recurring Withdrawal Debit Card - MC Debit Gator/AMAZON PRIME*Z585917C0 AMZN.COM/BIL WADate 01/17/25 0 5017190493 2 5968Card 1247","15.13","","Posted","32.66"
"1/19/2025","","Withdrawal POS #000000759580/PUBLIX 3100 SW 35TH BLVD GAINESVILLE FLCard 1247","14.74","","Posted","47.79"
"1/17/2025","","Withdrawal POS #000000120665/SUNOCO 8002212501 4234 SW 20TH AVEGAINESVILLE FLCard 1247","17.08","","Posted","62.53"
"1/17/2025","","Withdrawal ACH FLUENT-Gainesvil/TYPE: PAYMENT ID: 1371804719CO: FLUENT-GainesvilNAME: steven chaplinskiEntry Class Code: WEB","27.5","","Posted","79.61"
"1/16/2025","","Withdrawal POS #000000129774/SUNOCO 8002212501 4234 SW 20TH AVEGAINESVILLE FLCard 1247","22.1","","Posted","107.11"
"1/15/2025","","Withdrawal POS #000000300162/SUNOCO 8002212501 4234 SW 20TH AVEGAINESVILLE FLCard 1247","17.08","","Posted","129.21"
"1/14/2025","","Withdrawal POS #000000194849/ETSY.COM*US WWW.ETSY.COM/ BROOKLYN NYCard 1247","11.8","","Posted","146.29"
"1/14/2025","","Withdrawal POS #000000753028/PUBLIX 3930 SW ARCHER ROAD GAINESVILLECard 1247","22.97","","Posted","158.09"
"1/14/2025","","Withdrawal POS #000096297241/FAST TRACK #200 GAINESVILLE GAINESVILLECard 1247","10","","Posted","181.06"
"1/14/2025","","Withdrawal POS #000000230647/SUNOCO 8002212501 4234 SW 20TH AVEGAINESVILLE FLCard 1247","0.17","","Posted","191.06"
"1/14/2025","","Withdrawal POS #000000223141/SUNOCO 8002212501 4234 SW 20TH AVEGAINESVILLE FLCard 1247","17.08","","Posted","191.23"
"1/13/2025","","Withdrawal ACH VENMO/TYPE: PAYMENT ID: 3264681992 CO: VENMONAME: AVATAR ARTSEntry Class Code: WEB","14.99","","Posted","208.31"
"1/13/2025","","Withdrawal POS #000000758317/PUBLIX 3100 SW 35TH BLVD GAINESVILLE FLCard 1247","37.08","","Posted","223.3"
"1/12/2025","","Recurring Withdrawal Debit Card - MC Debit Gator/APPLE.COM/BILL 866-712-7753 CADate 01/11/25 0 5011099289 2 5818Card 1247","9.99","","Posted","260.38"
"1/12/2025","","Withdrawal Debit Card MC Debit Gator/AMAZON PRIME*ZD49Q6KK0 AMZN.COM/BIL WADate 01/11/25 0 5011099282 2 5818Card 1247","3.4","","Posted","270.37"
"1/11/2025","","Withdrawal POS #000000169586/SUNOCO 8002212501 4234 SW 20TH AVEGAINESVILLE FLCard 1247","17.08","","Posted","273.77"
"1/11/2025","","Withdrawal POS #000000757925/PUBLIX 3100 SW 35TH BLVD GAINESVILLE FLCard 1247","57.86","","Posted","290.85"
"1/10/2025","","Withdrawal ACH VENMO/TYPE: PAYMENT ID: 3264681992 CO: VENMONAME: AVATAR ARTSEntry Class Code: WEB","9.99","","Posted","348.71"
"1/9/2025","","Withdrawal POS #000000944455/SUNOCO 8002212501 4234 SW 20TH AVEGAINESVILLE FLCard 1247","22.42","","Posted","358.7"
"1/7/2025","","Withdrawal Bill Payment #000000483994/GRU EZ PAY 301 SE 4TH AVE 301 SE 4TH AVCard 1247","169.56","","Posted","381.12"
"1/7/2025","","Withdrawal POS #000000000007/AMAZON.COM*ZD7CG3LN0 SEATTLE WACard 1247","18.2","","Posted","550.68"
"1/6/2025","","Recurring Withdrawal Debit Card - MC Debit Gator/NOTION LABS, INC. SAN FRANCISC CADate 01/05/25 0 5005050863 1 7372Card 1247","22","","Posted","568.88"
"1/5/2025","","Withdrawal POS #000000348915/SUNOCO 8002212501 4234 SW 20TH AVEGAINESVILLE FLCard 1247","17.08","","Posted","590.88"
"1/5/2025","","Recurring Withdrawal Debit Card - MC Debit Gator/OPENAI *CHATGPT SUBSCR SAN FRANCISC CADate 01/04/25 0 5004256434 0 5734Card 1247","20","","Posted","607.96"
"1/5/2025","","Recurring Withdrawal Debit Card - MC Debit Gator/APPLE.COM/BILL 866-712-7753 CADate 01/05/25 0 5005839186 0 5818Card 1247","10","","Posted","627.96"
"1/5/2025","","Recurring Withdrawal Debit Card - MC Debit Gator/APPLE.COM/BILL 866-712-7753 CADate 01/05/25 0 5005839185 0 5818Card 1247","2.99","","Posted","637.96"
"1/5/2025","","Recurring Withdrawal Debit Card - MC Debit Gator/APPLE.COM/BILL 866-712-7753 CADate 01/05/25 0 5005839184 0 5818Card 1247","2.99","","Posted","640.95"
"1/5/2025","","Withdrawal Bill Payment #000000192398/Adobe Park Avenue,345 San Jose CACard 1247","19.99","","Posted","643.94"
"1/3/2025","","Withdrawal POS #000000782633/SUNOCO 8002212501 4234 SW 20TH AVEGAINESVILLE FLCard 1247","18.67","","Posted","663.93"
"1/3/2025","","Withdrawal Debit Card Fee/MASTERCARD ISSUER CROSS-BORDER FEEDate 01/02/25 0 5002325431 0 8999Card 1247","0.02","","Posted","682.6"
"1/3/2025","","Withdrawal Debit Card MC Debit Gator/SOCIALWICK INNSBRUCK ATDate 01/02/25 0 5002325431 0 8999Card 1247","2.53","","Posted","682.62"
"1/3/2025","","Withdrawal Debit Card MC Debit Gator/COX GAINESVILLE COMM 800-234-3993 FLDate 01/02/25 0 5002952888 0 4899Card 1247","156.13","","Posted","685.15"
"1/3/2025","","Withdrawal POS #000000837107/AMAZON.COM*ZD3F87JM2 SEATTLE WACard 1247","28.75","","Posted","841.28"
"1/2/2025","","Withdrawal POS #000000231268/SUNOCO 8002212501 4234 SW 20TH AVEGAINESVILLE FLCard 1247","24.59","","Posted","870.03"
"1/2/2025","","Withdrawal Debit Card MC Debit Seminol/CIRCLE K # 26146 GAINESVILLE FLDate 12/31/24 0 4366909335 0 5499Card 1231","18.88","","Posted","894.62"
"1/2/2025","","Withdrawal Debit Card MC Debit Gator/OPENAI SAN FRANCISC CADate 01/02/25 0 5002915655 0 5734Card 1247","5","","Posted","913.5"
"1/2/2025","","Recurring Withdrawal Debit Card - MC Debit Gator/PARAMOUNT+ WEST HOLLYWO CADate 01/01/25 0 5001909499 0 4899Card 1247","14.96","","Posted","918.5"
"1/2/2025","","Withdrawal ACH Watson Realty Co/TYPE: WEB PMTS ID: 9000321157CO: Watson Realty CoNAME: Steven chaplinskiEntry Class Code: WEB","1179","","Posted","933.46"
"1/2/2025","","Withdrawal ACH FLUENT-Gainesvil/TYPE: PAYMENT ID: 1371804719CO: FLUENT-GainesvilNAME: steven chaplinskiEntry Class Code: WEB","54","","Posted","2112.46"
"1/2/2025","","Withdrawal ACH AppFolio, Inc. F/TYPE: WEB PMTS ID: 9001406550CO: AppFolio, Inc. FNAME: Steven chaplinskiEntry Class Code: WEB","2.49","","Posted","2166.46"
"1/2/2025","","Withdrawal POS #000000305858/AMAZON.COM*ZP8I63AL0 SEATTLE WACard 1247","23.64","","Posted","2168.95"
"1/1/2025","","Withdrawal Debit Card MC Debit Seminol/GAINESVILLE PSYCHIATRY GAINESVILLE FLDate 12/31/24 0 4366974295 0 8011Card 1231","78","","Posted","2192.59"
"1/1/2025","","Withdrawal Debit Card MC Debit Seminol/WALGREENS #5024 GAINESVILLE FLDate 12/31/24 0 4366953359 0 5912Card 1231","15","","Posted","2270.59"
"1/1/2025","","Recurring Withdrawal Debit Card - MC Debit Gator/FS *CONTEXTSFORMAC SANTA BARBAR CADate 12/31/24 0 4366973571 0 5734Card 1247","9.99","","Posted","2285.59"
"12/31/2024","","Withdrawal POS #000082182619/SMOKE CITY 2120 SW 34TH ST GAINESVILLECard 1247","11.66","","Posted","2295.58"
"12/31/2024","","Withdrawal POS #000000733350/PUBLIX 3100 SW 35TH BLVD GAINESVILLE FLCard 1247","29.57","","Posted","2307.24"
"12/31/2024","","Withdrawal ATM Fee/EFT 3401 W University Ave Gainesville FLCard 1247","2","","Posted","2336.81"
"12/31/2024","","Withdrawal at ATM #000000158366/EFT 3401 W University Ave Gainesville FLCard 1247","13","","Posted","2338.81"
"12/30/2024","","Withdrawal POS #000000188532/AMAZON.COM*ZP06Y6CW0 SEATTLE WACard 1231","18.2","","Posted","2351.81"
"12/30/2024","","Withdrawal POS #000000570772/SUNOCO 8002212501 4234 SW 20TH AVEGAINESVILLE FLCard 1231","17.08","","Posted","2370.01"
"12/30/2024","","Withdrawal Debit Card MC Debit Seminol/IONOS INC. CHESTERBROOK PADate 12/29/24 0 4364954464 0 4816Card 1231","1","","Posted","2387.09"
"12/30/2024","","Withdrawal ACH FLUENT-Gainesvil/TYPE: PAYMENT ID: 1371804719CO: FLUENT-GainesvilNAME: steven chaplinskiEntry Class Code: WEB","54","","Posted","2388.09"
"12/30/2024","","Withdrawal POS #000000522639/SUNOCO 8002212501 4234 SW 20TH AVEGAINESVILLE FLCard 1231","18.67","","Posted","2442.09"
"12/29/2024","","Withdrawal Debit Card MC Debit Seminol/SAMSUNG ELECTRONICS RIDGEFIELD P NJDate 12/27/24 0 4362999827 1 5734Card 1231","8.99","","Posted","2460.76"
"12/29/2024","","Withdrawal Debit Card MC Debit Seminol/WAWA 5325 GAINESVILLE FLDate 12/28/24 0 4363858796 0 5541Card 1231","19.72","","Posted","2469.75"
"12/29/2024","","Withdrawal Debit Card MC Debit Seminol/WALGREENS #5024 GAINESVILLE FLDate 12/27/24 0 4362000611 2 5912Card 1231","23.78","","Posted","2489.47"
"12/29/2024","","Withdrawal POS #000000504303/SUNOCO 8002212501 4234 SW 20TH AVEGAINESVILLE FLCard 1231","22.42","","Posted","2513.25"
"12/29/2024","","Deposit Home Banking Transfer/From CHAPLINSKI,LEON 3496297 Share 0090","","800","Posted","2535.67"
"12/28/2024","","Withdrawal POS #000000443910/SUNOCO 8002212501 4234 SW 20TH AVEGAINESVILLE FLCard 1231","20.83","","Posted","1735.67"
"12/27/2024","","Withdrawal POS #000000014638/SUNOCO 8002212501 4234 SW 20TH AVEGAINESVILLE FLCard 1231","20.83","","Posted","1756.5"
"12/26/2024","","Withdrawal Debit Card MC Debit Seminol/CIRCLE K # 06782 GAINESVILLE FLDate 12/24/24 0 4359511759 0 5499Card 1231","18.67","","Posted","1777.33"
"12/25/2024","","Withdrawal Debit Card MC Debit Seminol/INSTACART*159 SAN FRANCISC CADate 12/24/24 0 4359294650 0 5411Card 1231","70","","Posted","1796"
"12/25/2024","","Recurring Withdrawal Debit Card - MC Debit Seminol/FS *ADOBE SANTA BARBAR CADate 12/24/24 0 4359034647 1 5734Card 1231","0.95","","Posted","1866"
"12/24/2024","","Withdrawal POS #000013340229/WALGREENS 2415 SW 75TH 2415 SW 75TH STGAINESVILLE FLCard 1231","19.05","","Posted","1866.95"
"12/24/2024","","Withdrawal ACH FLUENT-Gainesvil/TYPE: PAYMENT ID: 1371804719CO: FLUENT-GainesvilNAME: steven chaplinskiEntry Class Code: WEB","42.5","","Posted","1886"
"12/24/2024","","Withdrawal POS #000000383621/SUNOCO 8002212501 4234 SW 20TH AVEGAINESVILLE FLCard 1231","20.51","","Posted","1928.5"
"12/23/2024","","Withdrawal Debit Card MC Debit Seminol/INSTACART*159 SAN FRANCISC CADate 12/22/24 0 4357281797 0 5411Card 1231","59","","Posted","1949.01"
"12/23/2024","","Recurring Withdrawal Bill Payment - #000000122428/NETFLIX COM LOS GATOS CACard 1231","17.84","","Posted","2008.01"
"12/22/2024","","Withdrawal POS #000000255092/SUNOCO 8002212501 4234 SW 20TH AVEGAINESVILLE FLCard 1231","10","","Posted","2025.85"
"12/22/2024","","Withdrawal POS #000000344581/SUNOCO 8002212501 4234 SW 20TH AVEGAINESVILLE FLCard 1231","14.92","","Posted","2035.85"
"12/22/2024","","Deposit Home Banking Transfer/From CHAPLINSKI,LEON 3496297 Share 0090","","2000","Posted","2050.77"
"12/22/2024","","Recurring Withdrawal Debit Card - MC Debit Seminol/CANVA* I04371-41297102 CAMDEN DEDate 12/20/24 0 4355594081 2 7333Card 1231","12.99","","Posted","50.77"
"12/22/2024","","Withdrawal Debit Card MC Debit Seminol/WAWA 5325 GAINESVILLE FLDate 12/21/24 0 4356579974 1 5541Card 1231","17.18","","Posted","63.76"
"12/22/2024","","Withdrawal Debit Card MC Debit Seminol/APPLE.COM/BILL CUPERTINO CADate 12/21/24 0 4356190590 1 5818Card 1231","9.99","","Posted","80.94"
"12/21/2024","","Withdrawal POS #000000223326/SUNOCO 8002212501 4234 SW 20TH AVEGAINESVILLE FLCard 1231","27.26","","Posted","90.93"
"12/20/2024","","Withdrawal POS #000000282496/SUNOCO 8002212501 4234 SW 20TH AVEGAINESVILLE FLCard 1231","17.08","","Posted","118.19"
"12/20/2024","","Withdrawal Debit Card MC Debit Seminol/CANNAMD 855-4209170 FLDate 12/19/24 0 4354703841 0 8011Card 1231","149","","Posted","135.27"
"12/20/2024","","Withdrawal Debit Card MC Debit Seminol/INSTACART*159 SAN FRANCISC CADate 12/19/24 0 4354168310 1 5411Card 1231","46","","Posted","284.27"
"12/20/2024","","Deposit Home Banking Transfer/From CHAPLINSKI,LEON 3496297 Share 0090","","100","Posted","330.27"
"12/19/2024","","Withdrawal POS #000000205771/SUNOCO 8002212501 4234 SW 20TH AVEGAINESVILLE FLCard 1231","20.83","","Posted","230.27"
"12/19/2024","","Recurring Withdrawal Debit Card Fee/MASTERCARD ISSUER CROSS-BORDER FEEDate 12/18/24 0 4353969048 0 5734Card 1231","0.05","","Posted","251.1"
"12/19/2024","","Recurring Withdrawal Debit Card - MC Debit Seminol/SAVE TO NOTION VAUREAL ILDate 12/18/24 0 4353969048 0 5734Card 1231","5.99","","Posted","251.15"
"12/18/2024","","Withdrawal POS #000000175132/SUNOCO 8002212501 4234 SW 20TH AVEGAINESVILLE FLCard 1231","24.26","","Posted","257.14"
"12/18/2024","","Withdrawal Debit Card MC Debit Seminol/INSTACART*159 SAN FRANCISC CADate 12/17/24 0 4352953677 0 5411Card 1231","49","","Posted","281.4"
"12/18/2024","","Recurring Withdrawal Debit Card - MC Debit Seminol/AMAZON PRIME*Z97W01ZG2 AMZN.COM/BIL WADate 12/17/24 0 4352950216 0 5968Card 1231","15.11","","Posted","330.4"
"12/17/2024","","Recurring Withdrawal Debit Card - MC Debit Seminol/SUPERPOWER CHATGPT MIDDLETOWN DEDate 12/17/24 0 4352703539 1 5734Card 1231","15","","Posted","345.51"
"12/17/2024","","Recurring Withdrawal Debit Card - MC Debit Seminol/PADDLE.NET* LEONARDOAI ASTORIA NYDate 12/16/24 0 4351323834 0 5817Card 1231","9","","Posted","360.51"
"12/17/2024","","Recurring Withdrawal Debit Card - MC Debit Seminol/PADDLE.NET* SETAPP ASTORIA NYDate 12/16/24 0 4351886849 0 5817Card 1231","12.49","","Posted","369.51"
"12/17/2024","","Recurring Withdrawal Debit Card Fee/MASTERCARD ISSUER CROSS-BORDER FEEDate 12/17/24 0 4352700468 1 5734Card 1231","0.16","","Posted","382"
"12/17/2024","","Recurring Withdrawal Debit Card - MC Debit Seminol/IDEOGRAM AI TORONTO ONDate 12/17/24 0 4352700468 1 5734Card 1231","20","","Posted","382.16"
"12/16/2024","","Withdrawal Debit Card MC Debit Seminol/INSTACART*159 SAN FRANCISC CADate 12/15/24 0 4350919827 0 5411Card 1231","50","","Posted","402.16"
"12/15/2024","","Recurring Withdrawal Debit Card - MC Debit Seminol/RUNWAY STANDARD PLAN NEWARK DEDate 12/15/24 0 4350745942 1 5734Card 1231","15","","Posted","452.16"
"12/13/2024","","Withdrawal POS #000000000027/CIRCLE K # 26146 3525 GAINESVILLE FLCard 1231","18.88","","Posted","467.16"
"12/13/2024","","Withdrawal ATM Fee/EFT 3401 W University Ave Gainesville FLCard 1231","2","","Posted","486.04"
"12/13/2024","","Withdrawal at ATM #000000472357/EFT 3401 W University Ave Gainesville FLCard 1231","23","","Posted","488.04"
"12/13/2024","","Withdrawal Debit Card MC Debit Seminol/INSTACART*159 SAN FRANCISC CADate 12/12/24 0 4347002718 1 5411Card 1231","54","","Posted","511.04"
"12/12/2024","","Withdrawal POS #000000900121/SUNOCO 8002212501 4234 SW 20TH AVEGAINESVILLE FLCard 1231","24.26","","Posted","565.04"
"12/12/2024","","Deposit Faster Payments/zel* MILLICENTCHAPLINSKI JFRFbHbabvQ2","","250","Posted","589.3"
"12/12/2024","","Withdrawal ACH VENMO/TYPE: PAYMENT ID: 3264681992 CO: VENMONAME: AVATAR ARTSEntry Class Code: WEB","14.99","","Posted","339.3"
"12/11/2024","","Withdrawal Debit Card MC Debit Seminol/AMAZON PRIME*ZR78T8681 AMZN.COM/BIL WADate 12/11/24 0 4346447241 1 5818Card 1231","3.4","","Posted","354.29"
"12/11/2024","","Withdrawal POS #000000000041/CIRCLE K # 26146 3525 GAINESVILLE FLCard 1231","26.18","","Posted","357.69"
"12/10/2024","","Recurring Withdrawal Debit Card - MC Debit Seminol/INVIDEO INC COUNTRY OF S DEDate 12/09/24 0 4344808122 0 5734Card 1231","35","","Posted","383.87"
"12/10/2024","","Withdrawal POS #000000914130/AMAZON.COM*ZR50X2ML1 SEATTLE WACard 1231","11.91","","Posted","418.87"
"12/10/2024","","Withdrawal ACH VENMO/TYPE: PAYMENT ID: 3264681992 CO: VENMONAME: AVATAR ARTSEntry Class Code: WEB","9.99","","Posted","430.78"
"12/10/2024","","Deposit ACH ETSY, INC./TYPE: PAYOUT ID: 1357612331CO: ETSY, INC.Entry Class Code: PPD","","3.91","Posted","440.77"
"12/9/2024","","Withdrawal POS #000000179448/AMAZON.COM*ZR3RB12D0 SEATTLE WACard 1231","19.12","","Posted","436.86"
"12/9/2024","","Recurring Withdrawal Debit Card - MC Debit Seminol/MYDESIGNS - PRO - MON LAS VEGAS NVDate 12/08/24 0 4343357881 0 5734Card 1231","29.99","","Posted","455.98"
"12/9/2024","","Withdrawal Debit Card MC Debit Seminol/IONOS INC. CHESTERBROOK PADate 12/08/24 0 4343153168 1 4816Card 1231","23","","Posted","485.97"
"12/9/2024","","Withdrawal ACH FLUENT-Gainesvil/TYPE: PAYMENT ID: 1371804719CO: FLUENT-GainesvilNAME: steven chaplinskiEntry Class Code: WEB","32","","Posted","508.97"
"12/9/2024","","Withdrawal POS #000020941197/GOOGLE *YouTubePremium 1600 AmphitheatreParkw Mountain View CACard 1231","9.1","","Posted","540.97"
"12/8/2024","","Recurring Withdrawal Debit Card - MC Debit Seminol/KREA.AI SAN FRANCISC CADate 12/06/24 0 4341842673 0 5734Card 1231","10","","Posted","550.07"
"12/8/2024","","Recurring Withdrawal Debit Card - MC Debit Seminol/PADDLE.NET* COPYTONOTI NEW YORK NYDate 12/07/24 0 4342788023 3 5817Card 1231","9","","Posted","560.07"
"12/8/2024","","Withdrawal Debit Card MC Debit Seminol/SAMSUNG ELECTRONICS RIDGEFIELD P NJDate 12/06/24 0 4341784790 3 5734Card 1231","16.99","","Posted","569.07"
"12/8/2024","","Recurring Withdrawal Debit Card - MC Debit Seminol/APPLE.COM/BILL 866-712-7753 CADate 12/06/24 0 4341327079 2 5818Card 1231","49.98","","Posted","586.06"
"12/6/2024","","Withdrawal POS #000000000070/CIRCLE K # 26146 3525 GAINESVILLE FLCard 1231","37.34","","Posted","636.04"
"12/6/2024","","Withdrawal Debit Card MC Debit Seminol/PP*P321458226 2033189708 NYDate 12/05/24 0 4340999603 0 4816Card 1231","1.13","","Posted","673.38"
"12/6/2024","","Recurring Withdrawal Debit Card - MC Debit Seminol/PADDLE.NET* SETAPP NEW YORK NYDate 12/05/24 0 4340998738 0 5817Card 1231","9.99","","Posted","674.51"
"12/6/2024","","Withdrawal Debit Card MC Debit Seminol/IONOS INC. CHESTERBROOK PADate 12/05/24 0 4340534140 1 4816Card 1231","16","","Posted","684.5"
"12/6/2024","","Withdrawal Debit Card MC Debit Seminol/CIRCLE K # 06782 GAINESVILLE FLDate 12/04/24 0 4339524954 1 5499Card 1231","31.57","","Posted","700.5"
"12/6/2024","","Withdrawal Debit Card MC Debit Seminol/GRU/EZ-PAY WEB PYMT 352-334-3434 FLDate 12/05/24 0 4340279271 0 4900Card 1231","171.03","","Posted","732.07"
"12/5/2024","","Recurring Withdrawal Debit Card - MC Debit Seminol/WWW.EVERBEE.IO AUSTIN TXDate 12/04/24 0 4339869891 0 5734Card 1231","29.99","","Posted","903.1"
"12/5/2024","","Recurring Withdrawal Debit Card - MC Debit Seminol/OPENAI *CHATGPT SUBSCR SAN FRANCISC CADate 12/04/24 0 4339869196 0 5734Card 1231","20","","Posted","933.09"
"12/5/2024","","Withdrawal Debit Card MC Debit Seminol/INSTACART*159 SAN FRANCISC CADate 12/04/24 0 4339868026 0 5411Card 1231","51","","Posted","953.09"
"12/5/2024","","Recurring Withdrawal Debit Card Fee/MASTERCARD ISSUER CROSS-BORDER FEEDate 12/05/24 0 4340418348 1 5734Card 1231","0.1","","Posted","1004.09"
"12/5/2024","","Recurring Withdrawal Debit Card - MC Debit Seminol/LEONARDO.AI NORTH SYDNEY NSDate 12/05/24 0 4340418348 1 5734Card 1231","12","","Posted","1004.19"
"12/5/2024","","Withdrawal Debit Card MC Debit Seminol/COX GAINESVILLE COMM 800-234-3993 FLDate 12/04/24 0 4339376311 0 4899Card 1231","156.13","","Posted","1016.19"
"12/5/2024","","Recurring Withdrawal Debit Card - MC Debit Seminol/APPLE.COM/BILL 866-712-7753 CADate 12/04/24 0 4339984092 0 5818Card 1231","2.99","","Posted","1172.32"
"12/4/2024","","Withdrawal POS #000083179688/SMOKE CITY 2120 SW 34TH ST GAINESVILLECard 1231","9.68","","Posted","1175.31"
"12/4/2024","","Recurring Withdrawal Debit Card - MC Debit Seminol/SUPERPOWER CHATGPT MIDDLETOWN DEDate 12/04/24 0 4339846699 0 5734Card 1231","15","","Posted","1184.99"
"12/4/2024","","Recurring Withdrawal Debit Card - MC Debit Seminol/TUBEBUDDYCOM* 8668823239 CADate 12/03/24 0 4338443995 0 5045Card 1231","19.79","","Posted","1199.99"
"12/4/2024","","Recurring Withdrawal Debit Card - MC Debit Seminol/APPLE.COM/BILL CUPERTINO CADate 12/03/24 0 4338442272 0 5818Card 1231","2.99","","Posted","1219.78"
"12/4/2024","","Withdrawal Bill Payment #000000196200/Adobe Park Avenue,345 San Jose CACard 1231","19.99","","Posted","1222.77"
"12/3/2024","","Withdrawal POS #000000000049/AMAZON.COM*ZL4MI32Y2 SEATTLE WACard 1231","9.13","","Posted","1242.76"
"12/3/2024","","Recurring Withdrawal Debit Card - MC Debit Seminol/NOTION LABS, INC. SAN FRANCISC CADate 12/02/24 0 4337878572 0 7372Card 1231","17.86","","Posted","1251.89"
"12/3/2024","","Withdrawal Debit Card MC Debit Seminol/VIDIQ SAN FRANCISC CADate 12/03/24 0 4338664809 1 5734Card 1231","19","","Posted","1269.75"
"12/3/2024","","Recurring Withdrawal Debit Card - MC Debit Seminol/TASKADE SAN FRANCISC CADate 12/03/24 0 4338877562 0 5734Card 1231","10","","Posted","1288.75"
"12/3/2024","","Recurring Withdrawal Debit Card Fee/MASTERCARD ISSUER CROSS-BORDER FEEDate 12/02/24 0 4337877232 0 5734Card 1231","0.05","","Posted","1298.75"
"12/3/2024","","Recurring Withdrawal Debit Card - MC Debit Seminol/IDEOGRAM AI TORONTO ONDate 12/02/24 0 4337877232 0 5734Card 1231","5.81","","Posted","1298.8"
"12/3/2024","","Withdrawal Debit Card MC Debit Seminol/WALGREENS #5024 GAINESVILLE FLDate 12/02/24 0 4337658312 1 5912Card 1231","31.74","","Posted","1304.61"
"12/3/2024","","Recurring Withdrawal POS #000006174112/PAYPAL *TUBEBUDDY TUBEBUD 2211 NorthStreet 8882211161 CACard 1231","19.79","","Posted","1336.35"
"12/2/2024","","Withdrawal POS #000000513221/SUNOCO 8002212501 4234 SW 20TH AVEGAINESVILLE FLCard 1231","20.83","","Posted","1356.14"
"12/2/2024","","Recurring Withdrawal Debit Card - MC Debit Seminol/IC* INSTACART*SUBSCRIP SAN FRANCISC CADate 11/30/24 0 4335692546 1 5411Card 1231","9.99","","Posted","1376.97"
"12/2/2024","","Withdrawal Debit Card MC Debit Seminol/SCRUBS CARWASH - GAINE GAINESVILLE FLDate 11/29/24 0 4334403825 2 7542Card 1231","6","","Posted","1386.96"
"12/2/2024","","Withdrawal ACH Watson Realty Co/TYPE: WEB PMTS ID: 9000321157CO: Watson Realty CoNAME: Steven chaplinskiEntry Class Code: WEB","1179","","Posted","1392.96"
"12/2/2024","","Withdrawal ACH FLUENT-Gainesvil/TYPE: PAYMENT ID: 1371804719CO: FLUENT-GainesvilNAME: steven chaplinskiEntry Class Code: WEB","40","","Posted","2571.96"
"12/2/2024","","Withdrawal ACH FLUENT-Gainesvil/TYPE: PAYMENT ID: 1371804719CO: FLUENT-GainesvilNAME: steven chaplinskiEntry Class Code: WEB","20","","Posted","2611.96"
"12/2/2024","","Withdrawal ACH AppFolio, Inc. F/TYPE: WEB PMTS ID: 9001406550CO: AppFolio, Inc. FNAME: Steven chaplinskiEntry Class Code: WEB","2.49","","Posted","2631.96"
"12/2/2024","","Withdrawal Bill Payment #000000352178/Disney PLUS Recurring 1375 Buena VistaDrive Lake Buena Vi FLCard 1231","18.41","","Posted","2634.45"
"12/1/2024","","Withdrawal POS #000000047747/SUNOCO 8002212501 4234 SW 20TH AVEGAINESVILLE FLCard 1231","31.05","","Posted","2652.86"
"11/30/2024","","Withdrawal Debit Card MC Debit Seminol/INSTACART*159 SAN FRANCISC CADate 11/29/24 0 4334853720 0 5411Card 1231","53","","Posted","2683.91"
"11/30/2024","","Withdrawal Debit Card MC Debit Seminol/IONOS INC. CHESTERBROOK PADate 11/29/24 0 4334602237 1 4816Card 1231","1","","Posted","2736.91"
"11/29/2024","","Withdrawal POS #000000292609/SUNOCO 8002212501 4234 SW 20TH AVEGAINESVILLE FLCard 1231","24.8","","Posted","2737.91"
"11/29/2024","","Withdrawal Debit Card MC Debit Seminol/WAWA 5325 GAINESVILLE FLDate 11/28/24 0 4333451434 0 5541Card 1231","17.82","","Posted","2762.71"
"11/28/2024","","Withdrawal POS #000000296305/SUNOCO 8002212501 4234 SW 20TH AVEGAINESVILLE FLCard 1231","20.83","","Posted","2780.53"
"11/28/2024","","Deposit Home Banking Transfer Expenses/From CHAPLINSKI,LEON 3496297 Share 0090","","2800","Posted","2801.36"
"11/28/2024","","Withdrawal Debit Card MC Debit Seminol/SAMSUNG ELECTRONICS RIDGEFIELD P NJDate 11/27/24 0 4332105121 1 5734Card 1231","8.99","","Posted","1.36"
"11/27/2024","","Withdrawal POS #000000000029/AMAZON.COM*Z38LO1T72 SEATTLE WACard 1231","14.63","","Posted","10.35"
"11/26/2024","","Withdrawal POS #000000238833/SILVER SPRINGS FOOD MART 5501 NE 35TH STSILVER SPRING FLCard 1231","10","","Posted","24.98"
"11/26/2024","","Withdrawal POS #000000201980/SUNOCO 8002212501 4234 SW 20TH AVEGAINESVILLE FLCard 1231","17.08","","Posted","34.98"
"11/26/2024","","Withdrawal Debit Card MC Debit Seminol/ARCHER ANIMAL HOSPITAL ARCHER FLDate 11/25/24 0 4330350737 0 0742Card 1231","49.24","","Posted","52.06"
"11/26/2024","","Withdrawal Debit Card MC Debit Seminol/WALGREENS #5024 GAINESVILLE FLDate 11/25/24 0 4330149353 1 5912Card 1231","10.81","","Posted","101.3"
"11/26/2024","","Deposit ACH ETSY, INC./TYPE: PAYOUT ID: 1357612331CO: ETSY, INC.Entry Class Code: PPD","","1.35","Posted","112.11"
"11/25/2024","","Withdrawal POS #000000144391/SUNOCO 8002212501 4234 SW 20TH AVEGAINESVILLE FLCard 1231","21.35","","Posted","110.76"
"11/25/2024","","Recurring Withdrawal Debit Card - MC Debit Seminol/FS *ADOBE SANTA BARBAR CADate 11/24/24 0 4329138605 1 5734Card 1231","0.95","","Posted","132.11"
"11/25/2024","","Deposit Home Banking Transfer Maverick/From CHAPLINSKI,LEON 3496297 Share 0090","","175","Posted","133.06"
"11/25/2024","","Withdrawal Courtesy Pay Fee/Entry Class Code: WEB","35","","Posted","-41.94"
"11/25/2024","","Withdrawal ACH FLUENT-Gainesvil/TYPE: PAYMENT ID: 1371804719CO: FLUENT-GainesvilNAME: steven chaplinski","18","","Posted","-6.94"
"11/25/2024","","Withdrawal POS #000000125261/SUNOCO 8002212501 4234 SW 20TH AVEGAINESVILLE FLCard 1231","14.92","","Posted","11.06"
"11/24/2024","","Withdrawal Debit Card MC Debit Seminol/INSTACART*159 SAN FRANCISC CADate 11/23/24 0 4328257179 0 5411Card 1231","41.06","","Posted","25.98"
"11/24/2024","","Withdrawal Debit Card MC Debit Seminol/WAWA 5325 GAINESVILLE FLDate 11/23/24 0 4328070994 1 5541Card 1231","20.7","","Posted","67.04"
"11/24/2024","","Withdrawal POS #000000000055/CIRCLE K # 06782 5237 GAINESVILLE FLCard 1231","16.76","","Posted","87.74"
"11/23/2024","","Withdrawal POS #000000064289/SUNOCO 8002212501 4234 SW 20TH AVEGAINESVILLE FLCard 1231","22.42","","Posted","104.5"
"11/23/2024","","Recurring Withdrawal Bill Payment - #000000145767/NETFLIX COM LOS GATOS CACard 1231","17.84","","Posted","126.92"
"11/22/2024","","Deposit Home Banking Transfer/From CHAPLINSKI,LEON 3496297 Share 0090Funds Transfer via Mobile","","125","Posted","144.76"
"11/22/2024","","Withdrawal POS #000000994295/SUNOCO 8002212501 4234 SW 20TH AVEGAINESVILLE FLCard 1231","22.1","","Posted","19.76"
"11/22/2024","","Withdrawal Debit Card MC Debit Seminol/WAWA 5325 GAINESVILLE FLDate 11/21/24 0 4326148333 1 5541Card 1231","16.66","","Posted","41.86"
"11/21/2024","","Withdrawal POS #000000998084/AMAZON.COM*9I40T2VL3 SEATTLE WACard 1231","10.73","","Posted","58.52"
"11/21/2024","","Recurring Withdrawal Debit Card - MC Debit Seminol/CANVA* I04341-45036624 CAMDEN DEDate 11/20/24 0 4325914916 0 7333Card 1231","12.99","","Posted","69.25"
"11/21/2024","","Withdrawal POS #000000951422/SUNOCO 8002212501 4234 SW 20TH AVEGAINESVILLE FLCard 1231","22.42","","Posted","82.24"
"11/20/2024","","Withdrawal POS #000000000009/CIRCLE K # 06782 5237 GAINESVILLE FLCard 1231","20.4","","Posted","104.66"
"11/19/2024","","Recurring Withdrawal Debit Card Fee/MASTERCARD ISSUER CROSS-BORDER FEEDate 11/18/24 0 4323867046 0 5734Card 1231","0.05","","Posted","125.06"
"11/19/2024","","Recurring Withdrawal Debit Card - MC Debit Seminol/SAVE TO NOTION VAUREAL ILDate 11/18/24 0 4323867046 0 5734Card 1231","5.99","","Posted","125.11"
"11/18/2024","","Withdrawal POS #000000359086/INSTACART*159 WWW.INSTACART.COM/ SANFRANCISCO CACard 1231","43","","Posted","131.1"
"11/18/2024","","Recurring Withdrawal Debit Card - MC Debit Seminol/SUPERPOWER CHATGPT MIDDLETOWN DEDate 11/17/24 0 4322285245 0 5734Card 1231","15","","Posted","174.1"
"11/18/2024","","Recurring Withdrawal Debit Card Fee/MASTERCARD ISSUER CROSS-BORDER FEEDate 11/17/24 0 4322076165 1 5734Card 1231","0.06","","Posted","189.1"
"11/18/2024","","Recurring Withdrawal Debit Card - MC Debit Seminol/IDEOGRAM AI TORONTO ONDate 11/17/24 0 4322076165 1 5734Card 1231","8","","Posted","189.16"
"11/18/2024","","Recurring Withdrawal Debit Card - MC Debit Seminol/AMAZON PRIME*LF6U08PC3 AMZN.COM/BIL WADate 11/17/24 0 4322071074 1 5968Card 1231","15.11","","Posted","197.16"
"11/17/2024","","Recurring Withdrawal Debit Card - MC Debit Seminol/PADDLE.NET* LEONARDOAI ASTORIA NYDate 11/16/24 0 4321386811 0 5817Card 1231","9","","Posted","212.27"
"11/17/2024","","Recurring Withdrawal Debit Card - MC Debit Seminol/PADDLE.NET* SETAPP ASTORIA NYDate 11/16/24 0 4321038237 1 5817Card 1231","12.49","","Posted","221.27"
"11/15/2024","","Withdrawal POS #000000000003/INSTACART*159 WWW.INSTACART.COM/ SANFRANCISCO CACard 1231","69","","Posted","233.76"
"11/15/2024","","Recurring Withdrawal Debit Card - MC Debit Seminol/NOTION LABS, INC. SAN FRANCISC CADate 11/15/24 0 4320097919 1 7372Card 1231","10","","Posted","302.76"
"11/15/2024","","Recurring Withdrawal Debit Card - MC Debit Seminol/RUNWAY STANDARD PLAN NEWARK DEDate 11/15/24 0 4320097866 1 5734Card 1231","15","","Posted","312.76"
"11/14/2024","","Withdrawal Home Banking Transfer refund/To CHAPLINSKI,LEONA 3496297 Share 0090","414","","Posted","327.76"
"11/14/2024","","Deposit Home Banking Transfer - Rascal Flats/From CHAPLINSKI,LEON 3496297 Share 0000","","414","Posted","741.76"
"11/14/2024","","Withdrawal POS #000000639340/SUNOCO 8002212501 4234 SW 20TH AVEGAINESVILLE FLCard 1231","44.56","","Posted","327.76"
"11/14/2024","","Withdrawal POS #000000353696/INSTACART*159 WWW.INSTACART.COM/ SANFRANCISCO CACard 1231","64","","Posted","372.32"
"11/12/2024","","Recurring Withdrawal Debit Card - MC Debit Seminol/CAPCUT WILMINGTON DEDate 11/11/24 0 4316889558 0 5734Card 1231","9.99","","Posted","436.32"
"11/12/2024","","Withdrawal Debit Card MC Debit Seminol/ARCHER ANIMAL HOSPITAL ARCHER FLDate 11/11/24 0 4316304922 0 0742Card 1231","82.28","","Posted","446.31"
"11/12/2024","","Recurring Withdrawal Debit Card - MC Debit Seminol/APPLE.COM/BILL 866-712-7753 CADate 11/11/24 0 4316616813 0 5818Card 1231","5.99","","Posted","528.59"
"11/12/2024","","Recurring Withdrawal Debit Card - MC Debit Seminol/APPLE.COM/BILL 866-712-7753 CADate 11/11/24 0 4316616811 0 5818Card 1231","9.99","","Posted","534.58"
"11/12/2024","","Withdrawal ACH VENMO/TYPE: PAYMENT ID: 3264681992 CO: VENMONAME: AVATAR ARTSEntry Class Code: WEB","14.99","","Posted","544.57"
"11/12/2024","","Withdrawal ACH VENMO/TYPE: PAYMENT ID: 3264681992 CO: VENMONAME: AVATAR ARTSEntry Class Code: WEB","9.99","","Posted","559.56"
"11/11/2024","","Deposit Home Banking Transfer Maverick/From CHAPLINSKI,LEON 3496297 Share 0090","","280","Posted","569.55"
"11/11/2024","","Withdrawal Debit Card MC Debit Seminol/AMAZON PRIME*2Z8Q443B3 AMZN.COM/BIL WADate 11/11/24 0 4316267232 1 5818Card 1231","3.4","","Posted","289.55"
"11/11/2024","","Withdrawal POS #000000359959/INSTACART*159 WWW.INSTACART.COM/ SANFRANCISCO CACard 1231","55","","Posted","292.95"
"11/10/2024","","Recurring Withdrawal Debit Card - MC Debit Seminol/MYDESIGNS - PRO - MON LAS VEGAS NVDate 11/08/24 0 4313744024 0 5734Card 1231","29.99","","Posted","347.95"
"11/10/2024","","Recurring Withdrawal Debit Card - MC Debit Seminol/OPENAI SAN FRANCISC CADate 11/10/24 0 4315698126 1 5734Card 1231","15.01","","Posted","377.94"
"11/10/2024","","Recurring Withdrawal Debit Card - MC Debit Seminol/INVIDEO INC COUNTRY OF S DEDate 11/09/24 0 4314032712 1 5734Card 1231","25","","Posted","392.95"
"11/10/2024","","Withdrawal Debit Card MC Debit Seminol/IONOS INC. CHESTERBROOK PADate 11/08/24 0 4313995164 0 4816Card 1231","23","","Posted","417.95"
"11/10/2024","","Withdrawal Debit Card MC Debit Seminol/COX GAINESVILLE COMM 800-234-3993 FLDate 11/08/24 0 4313741580 0 4899Card 1231","156.13","","Posted","440.95"
"11/10/2024","","Withdrawal POS #000000548638/SUNOCO 8002212501 4234 SW 20TH AVEGAINESVILLE FLCard 1231","41.74","","Posted","597.08"
"11/9/2024","","Withdrawal POS #000020542095/GOOGLE *YouTubePremium 1600 AmphitheatreParkw Mountain View CACard 1231","9.1","","Posted","638.82"
"11/8/2024","","Withdrawal Debit Card MC Debit Seminol/GRU/EZ-PAY WEB PYMT 352-334-3434 FLDate 11/07/24 0 4312396219 0 4900Card 1231","171.27","","Posted","647.92"
"11/8/2024","","Withdrawal POS #000000000016/INSTACART*159 WWW.INSTACART.COM/ SANFRANCISCO CACard 1231","55.22","","Posted","819.19"
"11/8/2024","","Withdrawal POS #000000470276/SUNOCO 8002212501 4234 SW 20TH AVEGAINESVILLE FLCard 1231","38.31","","Posted","874.41"
"11/8/2024","","Withdrawal POS #000000000002/AMAZON.COM*5A0D46X63 SEATTLE WACard 1231","17.94","","Posted","912.72"
"11/7/2024","","Recurring Withdrawal Debit Card - MC Debit Seminol/KREA.AI SAN FRANCISC CADate 11/06/24 0 4311608810 0 5734Card 1231","10","","Posted","930.66"
"11/7/2024","","Recurring Withdrawal Debit Card - MC Debit Seminol/PADDLE.NET* COPYTONOTI NEW YORK NYDate 11/07/24 0 4312608046 0 5817Card 1231","9","","Posted","940.66"
"11/7/2024","","Recurring Withdrawal Debit Card - MC Debit Seminol/TUBEBUDDYCOM* 8668823239 CADate 11/07/24 0 4312454387 1 5734Card 1231","7.5","","Posted","949.66"
"11/7/2024","","Withdrawal Debit Card MC Debit Seminol/SAMSUNG ELECTRONICS RIDGEFIELD P NJDate 11/06/24 0 4311606417 0 5734Card 1231","16.99","","Posted","957.16"
"11/7/2024","","Withdrawal POS #000000685024/AMAZON.COM*AS4EW0V93 SEATTLE WACard 1231","13.85","","Posted","974.15"
"11/6/2024","","Withdrawal Debit Card MC Debit Seminol/IONOS INC. CHESTERBROOK PADate 11/05/24 0 4310089629 1 4816Card 1231","16","","Posted","988"
"11/6/2024","","Withdrawal ACH FLUENT-Gainesvil/TYPE: PAYMENT ID: 1371804719CO: FLUENT-GainesvilNAME: steven chaplinskiEntry Class Code: WEB","52","","Posted","1004"
"11/5/2024","","Recurring Withdrawal Debit Card - MC Debit Seminol/OPENAI *CHATGPT SUBSCR SAN FRANCISC CADate 11/04/24 0 4309006198 1 5734Card 1231","20","","Posted","1056"
"11/5/2024","","Recurring Withdrawal Debit Card - MC Debit Seminol/PADDLE.NET* SETAPP NEW YORK NYDate 11/05/24 0 4310972348 0 5817Card 1231","9.99","","Posted","1076"
"11/5/2024","","Recurring Withdrawal Debit Card - MC Debit Seminol/WWW.EVERBEE.IO AUSTIN TXDate 11/05/24 0 4310004793 1 5734Card 1231","29.99","","Posted","1085.99"
"11/5/2024","","Withdrawal Debit Card MC Debit Seminol/WAWA CARD RELOAD MEDIA PADate 11/03/24 0 4308001823 1 6540Card 1231","15","","Posted","1115.98"
"11/5/2024","","Recurring Withdrawal Debit Card - MC Debit Seminol/APPLE.COM/BILL 866-712-7753 CADate 11/05/24 0 4310965680 0 5818Card 1231","2.99","","Posted","1130.98"
"11/5/2024","","Deposit ACH ETSY, INC./TYPE: PAYOUT ID: 1357612331CO: ETSY, INC.Entry Class Code: PPD","","30.29","Posted","1133.97"
"11/5/2024","","Deposit POS #000000357410/Adobe Park Avenue,345 San Jose CACard 1231","","33.75","Posted","1103.68"
"11/5/2024","","Withdrawal POS #000000794627/SUNOCO 8002212501 4234 SW 20TH AVEGAINESVILLE FLCard 1231","34.56","","Posted","1069.93"
"11/4/2024","","Withdrawal Bill Payment #000000195926/Adobe Park Avenue,345 San Jose CACard 1231","19.99","","Posted","1104.49"
"11/4/2024","","Recurring Withdrawal Debit Card - MC Debit Seminol/SUPERPOWER CHATGPT MIDDLETOWN DEDate 11/03/24 0 4308505507 0 5734Card 1231","15","","Posted","1124.48"
"11/4/2024","","Recurring Withdrawal Debit Card - MC Debit Seminol/SALESAMURAI SOFTWARE BOULDER CODate 11/04/24 0 4309610111 1 5734Card 1231","1","","Posted","1139.48"
"11/4/2024","","Withdrawal Debit Card MC Debit Seminol/WALGREENS #5024 GAINESVILLE FLDate 11/03/24 0 4308603683 1 5912Card 1231","27.97","","Posted","1140.48"
"11/4/2024","","Recurring Withdrawal Debit Card - MC Debit Seminol/APPLE.COM/BILL 866-712-7753 CADate 11/04/24 0 4309601161 1 5818Card 1231","2.99","","Posted","1168.45"
"11/4/2024","","Withdrawal ACH Watson Realty Co/TYPE: WEB PMTS ID: 9000321157CO: Watson Realty CoNAME: Steven chaplinskiEntry Class Code: WEB","1179","","Posted","1171.44"
"11/4/2024","","Withdrawal ACH AppFolio, Inc. F/TYPE: WEB PMTS ID: 9001406550CO: AppFolio, Inc. FNAME: Steven chaplinskiEntry Class Code: WEB","2.49","","Posted","2350.44"
"11/3/2024","","Withdrawal POS #000000212529/AMAZON.COM*HG16B6833 SEATTLE WACard 1231","45.43","","Posted","2352.93"
"11/3/2024","","Withdrawal Debit Card MC Debit Seminol/IONOS INC. CHESTERBROOK PADate 11/01/24 0 4306766970 1 4816Card 1231","0.68","","Posted","2398.36"
"11/3/2024","","Withdrawal Bill Payment #000000227815/Adobe Park Avenue,345 San Jose CACard 1231","34.99","","Posted","2399.04"
"11/3/2024","","Withdrawal POS #000000000013/CIRCLE K # 06782 5237 GAINESVILLE FLCard 1231","12.83","","Posted","2434.03"
"11/2/2024","","Withdrawal POS #000000000021/AMAZON.COM*TQ9TB8YN3 SEATTLE WACard 1231","30.45","","Posted","2446.86"
"11/2/2024","","Withdrawal POS #000000680703/SUNOCO 8002212501 4234 SW 20TH AVEGAINESVILLE FLCard 1231","34.88","","Posted","2477.31"
"11/2/2024","","Withdrawal Bill Payment #000000353116/Disney PLUS Recurring 1375 Buena VistaDrive Lake Buena Vi FLCard 1231","18.41","","Posted","2512.19"
"11/1/2024","","Recurring Withdrawal Debit Card - MC Debit Seminol/MYDESIGNS.IO LAS VEGAS NVDate 10/31/24 0 4305943289 0 5734Card 1231","30.57","","Posted","2530.6"
"11/1/2024","","Withdrawal ACH FLUENT-Gainesvil/TYPE: PAYMENT ID: 1371804719CO: FLUENT-GainesvilNAME: steven chaplinskiEntry Class Code: WEB","36","","Posted","2561.17"
"10/31/2024","","Withdrawal POS #000000000000/INSTACART*159 WWW.INSTACART.COM/ SANFRANCISCO CACard 1231","70.69","","Posted","2597.17"
"10/31/2024","","Withdrawal Debit Card MC Debit Seminol/WALGREENS #9304 GAINESVILLE FLDate 10/30/24 0 4304125853 1 5912Card 1231","10.81","","Posted","2667.86"
"10/30/2024","","Withdrawal POS #000000772673/INSTACART*159 WWW.INSTACART.COM/ SANFRANCISCO CACard 1231","59.1","","Posted","2678.67"
"10/30/2024","","Withdrawal Adjustment Debit Card - Credit Voucher/IONOS INC. 00580458910 CHESTERBROOK PADate 10/29/24 0 4303917306 0 4816Card 1231","","72","Posted","2737.77"
"10/30/2024","","Recurring Withdrawal Debit Card - MC Debit Seminol/IC* INSTACART*SUBSCRIP SAN FRANCISC CADate 10/29/24 0 4303918463 0 5411Card 1231","9.99","","Posted","2665.77"
"10/30/2024","","Withdrawal POS #000000563213/SUNOCO 8002212501 4234 SW 20TH AVEGAINESVILLE FLCard 1231","38.64","","Posted","2675.76"
"10/30/2024","","Deposit Home Banking Transfer Expenses/From CHAPLINSKI,LEON 3496297 Share 0090","","2800","Posted","2714.4"
"10/28/2024","","Withdrawal Debit Card MC Debit Seminol/SAMSUNG ELECTRONICS RIDGEFIELD P NJDate 10/27/24 0 4301061054 1 5734Card 1231","8.99","","Posted","-85.6"
"10/27/2024","","Withdrawal CourtesyFeeDebit","35","","Posted","-76.61"
"10/27/2024","","Withdrawal Debit Card MC Debit Seminol/IONOS INC. CHESTERBROOK PADate 10/26/24 0 4300913613 0 4816Card 1231","165","","Posted","-41.61"
"10/27/2024","","Withdrawal POS #000000929659/SUNOCO 8002212501 4234 SW 20TH AVEGAINESVILLE FLCard 1231","18.89","","Posted","123.39"
"10/26/2024","","Withdrawal POS #000000901989/SUNOCO 8002212501 4234 SW 20TH AVEGAINESVILLE FLCard 1231","22.42","","Posted","142.28"
"10/25/2024","","Withdrawal POS #000000776690/INSTACART*159 WWW.INSTACART.COM/ SANFRANCISCO CACard 1231","72","","Posted","164.7"
"10/25/2024","","Deposit Home Banking Transfer/From CHAPLINSKI,LEON 3496297 Share 0090","","200","Posted","236.7"
"10/25/2024","","Recurring Withdrawal Debit Card - MC Debit Seminol/FS *ADOBE SANTA BARBAR CADate 10/24/24 0 4298968563 0 5734Card 1231","0.95","","Posted","36.7"
"10/25/2024","","Withdrawal POS #000000850898/SUNOCO 8002212501 4234 SW 20TH AVEGAINESVILLE FLCard 1231","25.96","","Posted","37.65"
"10/24/2024","","Withdrawal POS #000000805070/SUNOCO 8002212501 4234 SW 20TH AVEGAINESVILLE FLCard 1231","22.42","","Posted","63.61"
"10/23/2024","","Recurring Withdrawal Bill Payment - #000000864701/Netflix.com NETFLIX.COM LOS GATOS CACard 1231","17.84","","Posted","86.03"
"10/23/2024","","Withdrawal POS #000000761115/PUBLIX 3100 SW 35TH BLVD GAINESVILLE FLCard 1231","10.08","","Posted","103.87"
"10/23/2024","","Withdrawal POS #000000570907/SUNOCO 8002212501 4234 SW 20TH AVEGAINESVILLE FLCard 1231","22.42","","Posted","113.95"
"10/22/2024","","Withdrawal POS #000000793069/INSTACART*159 WWW.INSTACART.COM/ SANFRANCISCO CACard 1231","55.94","","Posted","136.37"
"10/22/2024","","Deposit ACH ETSY, INC./TYPE: PAYOUT ID: 1357612331CO: ETSY, INC.Entry Class Code: PPD","","16.72","Posted","192.31"
"10/21/2024","","Recurring Withdrawal Debit Card - MC Debit Seminol/CANVA* I04310-27668476 CAMDEN DEDate 10/20/24 0 4294054048 1 7333Card 1231","12.99","","Posted","175.59"
"10/21/2024","","Withdrawal ACH FLUENT-Gainesvil/TYPE: PAYMENT ID: 1371804719CO: FLUENT-GainesvilNAME: steven chaplinskiEntry Class Code: WEB","35","","Posted","188.58"
"10/20/2024","","Recurring Withdrawal Debit Card - MC Debit Seminol/OPENAI SAN FRANCISC CADate 10/18/24 0 4292079345 2 5734Card 1231","15.03","","Posted","223.58"
"10/20/2024","","Recurring Withdrawal Debit Card Fee/MASTERCARD ISSUER CROSS-BORDER FEEDate 10/18/24 0 4292359683 2 5734Card 1231","0.05","","Posted","238.61"
"10/20/2024","","Recurring Withdrawal Debit Card - MC Debit Seminol/SAVE TO NOTION VAUREAL ILDate 10/18/24 0 4292359683 2 5734Card 1231","5.99","","Posted","238.66"
"10/20/2024","","Recurring Withdrawal Debit Card - MC Debit Seminol/MYDESIGNS.IO LAS VEGAS NVDate 10/18/24 0 4292077676 2 5734Card 1231","12.68","","Posted","244.65"
"10/20/2024","","Recurring Withdrawal Debit Card Fee/MASTERCARD ISSUER CROSS-BORDER FEEDate 10/19/24 0 4293358426 2 5817Card 1231","0.01","","Posted","257.33"
"10/20/2024","","Recurring Withdrawal Debit Card - MC Debit Seminol/CAPCUT SINGAPORE SGDate 10/19/24 0 4293358426 2 5817Card 1231","0.99","","Posted","257.34"
"10/18/2024","","Withdrawal POS #000000500838/SUNOCO 8002212501 4234 SW 20TH AVEGAINESVILLE FLCard 1231","37.78","","Posted","258.33"
"10/18/2024","","Recurring Withdrawal Debit Card - MC Debit Seminol/AMAZON PRIME*ZZ8XZ1T22 AMZN.COM/BIL WADate 10/17/24 0 4291354760 0 5968Card 1231","15.11","","Posted","296.11"
"10/17/2024","","Deposit ACH STEVEN CHAPLINSK/TYPE: MOBILE DEP CO: STEVEN CHAPLINSKACH Trace Number: 263178470000008","","240","Posted","311.22"
"10/17/2024","","Withdrawal POS #000000514838/SUNOCO 8002212501 4234 SW 20TH AVEGAINESVILLE FLCard 1231","22.42","","Posted","71.22"
"10/17/2024","","Recurring Withdrawal Debit Card - MC Debit Seminol/SUPERPOWER CHATGPT MIDDLETOWN DEDate 10/17/24 0 4291148991 1 5734Card 1231","15","","Posted","93.64"
"10/17/2024","","Recurring Withdrawal Debit Card - MC Debit Seminol/PADDLE.NET* LEONARDOAI ASTORIA NYDate 10/16/24 0 4290347897 0 5817Card 1231","9","","Posted","108.64"
"10/17/2024","","Recurring Withdrawal Debit Card - MC Debit Seminol/PADDLE.NET* SETAPP ASTORIA NYDate 10/16/24 0 4290896850 0 5817Card 1231","12.49","","Posted","117.64"
"10/17/2024","","Recurring Withdrawal Debit Card Fee/MASTERCARD ISSUER CROSS-BORDER FEEDate 10/17/24 0 4291146721 1 5734Card 1231","0.06","","Posted","130.13"
"10/17/2024","","Recurring Withdrawal Debit Card - MC Debit Seminol/IDEOGRAM AI TORONTO ONDate 10/17/24 0 4291146721 1 5734Card 1231","8","","Posted","130.19"
"10/16/2024","","Recurring Withdrawal Debit Card - MC Debit Seminol/NOTION LABS, INC. SAN FRANCISC CADate 10/15/24 0 4289885767 0 7372Card 1231","10","","Posted","138.19"
"10/16/2024","","Recurring Withdrawal Debit Card - MC Debit Seminol/RUNWAY STANDARD PLAN NEWARK DEDate 10/15/24 0 4289885711 0 5734Card 1231","15","","Posted","148.19"
"10/16/2024","","Withdrawal POS #000000796464/INSTACART*159 WWW.INSTACART.COM/ SANFRANCISCO CACard 1231","60","","Posted","163.19"
"10/16/2024","","Withdrawal POS #000000388399/SUNOCO 8002212501 4234 SW 20TH AVEGAINESVILLE FLCard 1231","32.42","","Posted","223.19"
"10/16/2024","","Deposit ACH ETSY, INC./TYPE: PAYOUT ID: 1357612331CO: ETSY, INC.Entry Class Code: PPD","","1.22","Posted","255.61"
"10/15/2024","","Recurring Withdrawal Debit Card - MC Debit Seminol/PADDLE.NET* SETAPP NEW YORK NYDate 10/14/24 0 4288882561 0 5817Card 1231","9.99","","Posted","254.39"
"10/14/2024","","Recurring Withdrawal Debit Card - MC Debit Seminol/D-ID STUDIO WILMINGTON DEDate 10/13/24 0 4287011811 1 7399Card 1231","5.9","","Posted","264.38"
"10/11/2024","","Withdrawal POS #000000219736/SUNOCO 8002212501 4234 SW 20TH AVEGAINESVILLE FLCard 1231","34.24","","Posted","270.28"
"10/11/2024","","Recurring Withdrawal Debit Card Fee/MASTERCARD ISSUER CROSS-BORDER FEEDate 10/11/24 0 4285915368 0 5817Card 1231","0.08","","Posted","304.52"
"10/11/2024","","Recurring Withdrawal Debit Card - MC Debit Seminol/CAPCUT SINGAPORE SGDate 10/11/24 0 4285915368 0 5817Card 1231","9.99","","Posted","304.6"
"10/11/2024","","Withdrawal Debit Card MC Debit Seminol/AMAZON PRIME*NL5H74FI3 AMZN.COM/BIL WADate 10/11/24 0 4285071195 1 5818Card 1231","3.4","","Posted","314.59"
"10/11/2024","","Withdrawal ACH VENMO/TYPE: PAYMENT ID: 3264681992 CO: VENMONAME: AVATAR ARTSEntry Class Code: WEB","14.99","","Posted","317.99"
"10/10/2024","","Withdrawal ACH VENMO/TYPE: PAYMENT ID: 3264681992 CO: VENMONAME: AVATAR ARTSEntry Class Code: WEB","9.99","","Posted","332.98"
"10/9/2024","","Withdrawal POS #000000110496/SUNOCO 8002212501 4234 SW 20TH AVEGAINESVILLE FLCard 1231","37.78","","Posted","342.97"
"10/9/2024","","Recurring Withdrawal Debit Card - MC Debit Seminol/INVIDEO INC COUNTRY OF S DEDate 10/09/24 0 4283111145 1 5734Card 1231","60","","Posted","380.75"
"10/9/2024","","Recurring Withdrawal Debit Card - MC Debit Seminol/MYDESIGNS - PRO - MON LAS VEGAS NVDate 10/09/24 0 4283929863 0 5734Card 1231","29.99","","Posted","440.75"
"10/9/2024","","Withdrawal Debit Card MC Debit Seminol/CIRCLE K # 06782 GAINESVILLE FLDate 10/07/24 0 4281924124 0 5499Card 1231","33.08","","Posted","470.74"
"10/9/2024","","Recurring Withdrawal Debit Card - MC Debit Seminol/APPLE.COM/BILL 866-712-7753 CADate 10/08/24 0 4282739947 0 5818Card 1231","2.99","","Posted","503.82"
"10/9/2024","","Withdrawal ACH FLUENT-Gainesvil/TYPE: PAYMENT ID: 1371804719CO: FLUENT-GainesvilNAME: steven chaplinskiEntry Class Code: WEB","33","","Posted","506.81"
"10/9/2024","","Withdrawal POS #000020628140/GOOGLE *YouTubePremium 1600 AmphitheatreParkw Mountain View CACard 1231","9.1","","Posted","539.81"
"10/7/2024","","Recurring Withdrawal Debit Card - MC Debit Seminol/TUBEBUDDYCOM* 8668823239 CADate 10/07/24 0 4281084817 2 5734Card 1231","7.5","","Posted","548.91"
"10/7/2024","","Withdrawal Debit Card MC Debit Seminol/SAMSUNG ELECTRONICS RIDGEFIELD P NJDate 10/06/24 0 4280082073 2 5734Card 1231","16.99","","Posted","556.41"
"10/7/2024","","Withdrawal Debit Card MC Debit Seminol/CIRCLE K # 06782 GAINESVILLE FLDate 10/05/24 0 4279070275 2 5499Card 1231","33.08","","Posted","573.4"
"10/7/2024","","Withdrawal Debit Card MC Debit Seminol/GRU/EZ-PAY WEB PYMT 352-334-3434 FLDate 10/06/24 0 4280069927 2 4900Card 1231","179.69","","Posted","606.48"
"10/6/2024","","Recurring Withdrawal Debit Card - MC Debit Seminol/OPENAI *CHATGPT SUBSCR SAN FRANCISC CADate 10/05/24 0 4279609183 4 5734Card 1231","20","","Posted","786.17"
"10/6/2024","","Withdrawal Debit Card MC Debit Seminol/IONOS INC. CHESTERBROOK PADate 10/05/24 0 4279888536 2 4816Card 1231","16","","Posted","806.17"
"10/6/2024","","Withdrawal Debit Card MC Debit Seminol/WALGREENS #5024 GAINESVILLE FLDate 10/05/24 0 4279879417 2 5912Card 1231","15","","Posted","822.17"
"10/6/2024","","Withdrawal Debit Card MC Debit Seminol/COX GAINESVILLE COMM 800-234-3993 FLDate 10/05/24 0 4279871365 2 4899Card 1231","156.13","","Posted","837.17"
"10/6/2024","","Withdrawal POS #000000592618/AMAZON.COM*PF74M5SG3 SEATTLE WACard 1231","10.74","","Posted","993.3"
"10/4/2024","","Recurring Withdrawal Debit Card Fee/MASTERCARD ISSUER CROSS-BORDER FEEDate 10/03/24 0 4277044624 1 7399Card 1231","0.47","","Posted","1004.04"
"10/4/2024","","Recurring Withdrawal Debit Card - MC Debit Seminol/CREATIVE FABRICA AMSTERDAM NHDate 10/03/24 0 4277044624 1 7399Card 1231","59.16","","Posted","1004.51"
"10/4/2024","","Recurring Withdrawal Debit Card - MC Debit Seminol/APPLE.COM/BILL 866-712-7753 CADate 10/03/24 0 4277938820 0 5818Card 1231","2.99","","Posted","1063.67"
"10/4/2024","","Withdrawal POS #000000784928/AMAZON.COM*NG4MN0L33 SEATTLE WACard 1231","32.84","","Posted","1066.66"
"10/3/2024","","Withdrawal POS #000000757832/SUNOCO 8002212501 4234 SW 20TH AVEGAINESVILLE FLCard 1231","46.35","","Posted","1099.5"
"10/3/2024","","Withdrawal Debit Card MC Debit Seminol/IONOS INC. CHESTERBROOK PADate 10/02/24 0 4276189742 1 4816Card 1231","1","","Posted","1145.85"
"10/3/2024","","Withdrawal Bill Payment #000000776300/Adobe Park Avenue,345 San Jose CACard 1231","19.99","","Posted","1146.85"
"10/3/2024","","Withdrawal POS #000000772291/INSTACART*159 WWW.INSTACART.COM/ SANFRANCISCO CACard 1231","97.44","","Posted","1166.84"
"10/2/2024","","Recurring Withdrawal Debit Card - MC Debit Seminol/DISNEY PLUS 8889057888 CADate 10/02/24 0 4276239357 1 4899Card 1231","16.11","","Posted","1264.28"
"10/2/2024","","Withdrawal ACH Watson Realty Co/TYPE: WEB PMTS ID: 9000321157CO: Watson Realty CoNAME: Steven chaplinskiEntry Class Code: WEB","1179","","Posted","1280.39"
"10/2/2024","","Withdrawal ACH AppFolio, Inc. F/TYPE: WEB PMTS ID: 9001406550CO: AppFolio, Inc. FNAME: Steven chaplinskiEntry Class Code: WEB","2.49","","Posted","2459.39"
"10/1/2024","","Withdrawal POS #000000680755/SUNOCO 8002212501 4234 SW 20TH AVEGAINESVILLE FLCard 1231","34.24","","Posted","2461.88"
"10/1/2024","","Withdrawal Debit Card MC Debit Seminol/WALGREENS #9304 GAINESVILLE FLDate 09/30/24 0 4274152821 1 5912Card 1231","10.81","","Posted","2496.12"
"9/30/2024","","Withdrawal POS #000000000001/INSTACART*159 WWW.INSTACART.COM/ SANFRANCISCO CACard 1231","67","","Posted","2506.93"
"9/30/2024","","Withdrawal POS #000000604407/SUNOCO 8002212501 4234 SW 20TH AVEGAINESVILLE FLCard 1231","34.24","","Posted","2573.93"
"9/30/2024","","Withdrawal POS #000000741900/PUBLIX 3100 SW 35TH BLVD GAINESVILLE FLCard 1231","32.09","","Posted","2608.17"
"9/30/2024","","Withdrawal ACH FLUENT-Gainesvil/TYPE: PAYMENT ID: 1371804719CO: FLUENT-GainesvilNAME: steven chaplinskiEntry Class Code: WEB","56.39","","Posted","2640.26"
"9/29/2024","","Recurring Withdrawal Debit Card - MC Debit Seminol/IC* INSTACART*SUBSCRIP SAN FRANCISC CADate 09/28/24 0 4272959868 0 5411Card 1231","9.99","","Posted","2696.65"
"9/29/2024","","Withdrawal Debit Card MC Debit Seminol/INSTACART*159 SAN FRANCISC CADate 09/28/24 0 4272170453 2 5411Card 1231","75.38","","Posted","2706.64"
"9/29/2024","","Withdrawal Debit Card MC Debit Seminol/SAMSUNG ELECTRONICS RIDGEFIELD P NJDate 09/27/24 0 4271170159 2 5734Card 1231","8.99","","Posted","2782.02"
"9/28/2024","","Withdrawal POS #000000527167/SUNOCO 8002212501 4234 SW 20TH AVEGAINESVILLE FLCard 1231","30.7","","Posted","2791.01"
"9/27/2024","","Deposit Home Banking Transfer/From CHAPLINSKI,LEON 3496297 Share 0090","","2800","Posted","2821.71"
"9/26/2024","","Withdrawal Debit Card MC Debit Seminol/CIRCLE K # 06782 GAINESVILLE FLDate 09/24/24 0 4268492649 1 5499Card 1231","18.34","","Posted","21.71"
"9/26/2024","","Withdrawal POS #000000408760/SUNOCO 8002212501 4234 SW 20TH AVEGAINESVILLE FLCard 1231","18.89","","Posted","40.05"
"9/25/2024","","Recurring Withdrawal Debit Card - MC Debit Seminol/FS *ADOBE SANTA BARBAR CADate 09/24/24 0 4268906697 0 5734Card 1231","0.95","","Posted","58.94"
"9/25/2024","","Withdrawal POS #000000395026/SUNOCO 8002212501 4234 SW 20TH AVEGAINESVILLE FLCard 1231","22.42","","Posted","59.89"
"9/24/2024","","Deposit ACH ETSY, INC./TYPE: PAYOUT ID: 1357612331CO: ETSY, INC.Entry Class Code: PPD","","4.87","Posted","82.31"
"9/23/2024","","Withdrawal POS #000000786299/INSTACART*159 WWW.INSTACART.COM/ SANFRANCISCO CACard 1231","84","","Posted","77.44"
"9/23/2024","","Deposit Home Banking Transfer/From CHAPLINSKI,LEON 3496297 Share 0090","","150","Posted","161.44"
"9/23/2024","","Recurring Withdrawal Bill Payment - #000000980999/Netflix.com NETFLIX.COM LOS GATOS CACard 1231","17.84","","Posted","11.44"
"9/22/2024","","Recurring Withdrawal Debit Card - MC Debit Seminol/CANVA* I04280-41401823 CAMDEN DEDate 09/20/24 0 4264118913 2 7333Card 1231","12.99","","Posted","29.28"
"9/22/2024","","Withdrawal POS #000000764249/PUBLIX 3100 SW 35TH BLVD GAINESVILLE FLCard 1231","10.08","","Posted","42.27"
"9/22/2024","","Withdrawal POS #000000745864/PUBLIX 3930 SW ARCHER ROAD GAINESVILLECard 1231","26.02","","Posted","52.35"
"9/20/2024","","Withdrawal POS #000000161599/SUNOCO 8002212501 4234 SW 20TH AVEGAINESVILLE FLCard 1231","34.24","","Posted","78.37"
"9/19/2024","","Withdrawal POS #000000794971/INSTACART*159 WWW.INSTACART.COM/ SANFRANCISCO CACard 1231","41.52","","Posted","112.61"
"9/19/2024","","Recurring Withdrawal Debit Card Fee/MASTERCARD ISSUER CROSS-BORDER FEEDate 09/18/24 0 4262900658 0 5734Card 1231","0.05","","Posted","154.13"
"9/19/2024","","Recurring Withdrawal Debit Card - MC Debit Seminol/SAVE TO NOTION VAUREAL ILDate 09/18/24 0 4262900658 0 5734Card 1231","5.99","","Posted","154.18"
"9/18/2024","","Recurring Withdrawal Debit Card - MC Debit Seminol/AMAZON PRIME*DG9S32713 AMZN.COM/BIL WADate 09/17/24 0 4261881793 0 5968Card 1231","15.11","","Posted","160.17"
"9/17/2024","","Withdrawal POS #000000794677/INSTACART*159 WWW.INSTACART.COM/ SANFRANCISCO CACard 1231","50","","Posted","175.28"
"9/17/2024","","Withdrawal POS #000000607925/AMAZON.COM*796MW6TO3 SEATTLE WACard 1231","12.85","","Posted","225.28"
"9/17/2024","","Recurring Withdrawal Debit Card - MC Debit Seminol/SUPERPOWER CHATGPT MIDDLETOWN DEDate 09/17/24 0 4261105994 1 5734Card 1231","15","","Posted","238.13"
"9/17/2024","","Recurring Withdrawal Debit Card - MC Debit Seminol/PADDLE.NET* LEONARDOAI ASTORIA NYDate 09/16/24 0 4260359414 0 5817Card 1231","9","","Posted","253.13"
"9/17/2024","","Recurring Withdrawal Debit Card - MC Debit Seminol/PADDLE.NET* SETAPP ASTORIA NYDate 09/16/24 0 4260853114 0 5817Card 1231","12.49","","Posted","262.13"
"9/17/2024","","Recurring Withdrawal Debit Card Fee/MASTERCARD ISSUER CROSS-BORDER FEEDate 09/17/24 0 4261103470 1 5734Card 1231","0.06","","Posted","274.62"
"9/17/2024","","Recurring Withdrawal Debit Card - MC Debit Seminol/IDEOGRAM AI TORONTO ONDate 09/17/24 0 4261103470 1 5734Card 1231","8","","Posted","274.68"
"9/17/2024","","Withdrawal POS #000000029377/SUNOCO 8002212501 4234 SW 20TH AVEGAINESVILLE FLCard 1231","34.24","","Posted","282.68"
"9/17/2024","","Deposit ACH ETSY, INC./TYPE: PAYOUT ID: 1357612331CO: ETSY, INC.Entry Class Code: PPD","","77.28","Posted","316.92"
"9/16/2024","","Recurring Withdrawal Debit Card - MC Debit Seminol/NOTION LABS, INC. SAN FRANCISC CADate 09/15/24 0 4259305128 0 7372Card 1231","10","","Posted","239.64"
"9/16/2024","","Recurring Withdrawal Debit Card - MC Debit Seminol/RUNWAY STANDARD PLAN NEWARK DEDate 09/15/24 0 4259010239 1 5734Card 1231","15","","Posted","249.64"
"9/16/2024","","Withdrawal ACH FLUENT-Gainesvil/TYPE: PAYMENT ID: 1371804719CO: FLUENT-GainesvilNAME: steven chaplinskiEntry Class Code: WEB","30","","Posted","264.64"
"9/15/2024","","Recurring Withdrawal Debit Card - MC Debit Seminol/PADDLE.NET* SETAPP NEW YORK NYDate 09/14/24 0 4258038199 1 5817Card 1231","9.99","","Posted","294.64"
"9/15/2024","","Recurring Withdrawal Debit Card - MC Debit Seminol/D-ID STUDIO WILMINGTON DEDate 09/13/24 0 4257121975 2 7399Card 1231","2.95","","Posted","304.63"
"9/15/2024","","Withdrawal Debit Card MC Debit Seminol/CIRCLE K # 26146 GAINESVILLE FLDate 09/12/24 0 4256143852 2 5499Card 1231","29.33","","Posted","307.58"
"9/13/2024","","Withdrawal Debit Card MC Debit Seminol/WAWA 5325 GAINESVILLE FLDate 09/12/24 0 4256163151 1 5541Card 1231","20.87","","Posted","336.91"
"9/12/2024","","Withdrawal POS #000000745537/PUBLIX 3100 SW 35TH BLVD GAINESVILLE FLCard 1231","23.93","","Posted","357.78"
"9/12/2024","","Withdrawal POS #000000000009/AMAZON.COM*139PT8J63 SEATTLE WACard 1231","14.91","","Posted","381.71"
"9/12/2024","","Withdrawal Debit Card MC Debit Seminol/CAPCUT WILMINGTON DEDate 09/11/24 0 4255891362 0 5734Card 1231","0.99","","Posted","396.62"
"9/12/2024","","Recurring Withdrawal Debit Card - MC Debit Seminol/MYDESIGNS.IO LAS VEGAS NVDate 09/12/24 0 4256961595 0 5734Card 1231","57.29","","Posted","397.61"
"9/12/2024","","Recurring Withdrawal Debit Card Fee/MASTERCARD ISSUER CROSS-BORDER FEEDate 09/12/24 0 4256890128 0 5817Card 1231","0.08","","Posted","454.9"
"9/12/2024","","Recurring Withdrawal Debit Card - MC Debit Seminol/CAPCUT SINGAPORE SGDate 09/12/24 0 4256890128 0 5817Card 1231","9.99","","Posted","454.98"
"9/12/2024","","Withdrawal POS #000000651483/AMAZON.COM*I55DY6IV3 SEATTLE WACard 1231","19.12","","Posted","464.97"
"9/11/2024","","Recurring Withdrawal Debit Card - MC Debit Seminol/AIRTABLE.COM/BILL SAN FRANCISC CADate 09/11/24 0 4255913774 0 7372Card 1231","31","","Posted","484.09"
"9/11/2024","","Withdrawal Debit Card MC Debit Seminol/INSTACART*159 SAN FRANCISC CADate 09/10/24 0 4254818709 0 5411Card 1231","43.63","","Posted","515.09"
"9/11/2024","","Withdrawal Debit Card MC Debit Seminol/AMAZON PRIME*XS2HD1WH3 AMZN.COM/BIL WADate 09/11/24 0 4255908162 0 5818Card 1231","3.4","","Posted","558.72"
"9/11/2024","","Recurring Withdrawal Debit Card - MC Debit Seminol/AMAZON PRIME*Z81YY4CB1 AMZN.COM/BIL WADate 09/10/24 0 4254816559 0 5968Card 1231","2.01","","Posted","562.12"
"9/10/2024","","Withdrawal POS #000000049785/AMAZON.COM*AV5RE3583 SEATTLE WACard 1231","9.13","","Posted","564.13"
"9/10/2024","","Withdrawal POS #000000010894/AMAZON.COM*Z82Y13CR1 SEATTLE WACard 1231","5.36","","Posted","573.26"
"9/10/2024","","Recurring Withdrawal Debit Card - MC Debit Seminol/OPENAI SAN FRANCISC CADate 09/09/24 0 4253896772 0 5734Card 1231","15.02","","Posted","578.62"
"9/10/2024","","Withdrawal Debit Card MC Debit Seminol/CIRCLE K # 06782 GAINESVILLE FLDate 09/08/24 0 4252889868 0 5499Card 1231","42.82","","Posted","593.64"
"9/10/2024","","Withdrawal ACH VENMO/TYPE: PAYMENT ID: 3264681992 CO: VENMONAME: AVATAR ARTSEntry Class Code: WEB","14.99","","Posted","636.46"
"9/10/2024","","Withdrawal ACH VENMO/TYPE: PAYMENT ID: 3264681992 CO: VENMONAME: AVATAR ARTSEntry Class Code: WEB","9.99","","Posted","651.45"
"9/10/2024","","Withdrawal POS #000000000046/CIRCLE K # 06782 5237 GAINESVILLE FLCard 1231","29.18","","Posted","661.44"
"9/9/2024","","Withdrawal Adjustment Debit Card - Credit Voucher/AMAZON PRIME PMTS AMZN.COM/BIL WADate 09/08/24 0 4252395606 0 5818Card 1231","","2.33","Posted","690.62"
"9/9/2024","","Recurring Withdrawal Debit Card - MC Debit Seminol/INVIDEO INC COUNTRY OF S DEDate 09/09/24 0 4253873198 0 5734Card 1231","60","","Posted","688.29"
"9/9/2024","","Recurring Withdrawal Debit Card - MC Debit Seminol/MYDESIGNS - PRO - MON LAS VEGAS NVDate 09/08/24 0 4252079101 1 5734Card 1231","29.99","","Posted","748.29"
"9/9/2024","","Withdrawal POS #000020599152/GOOGLE *YouTubePremium 1600 AmphitheatreParkw Mountain View CACard 1231","9.1","","Posted","778.28"
"9/8/2024","","Recurring Withdrawal Debit Card - MC Debit Seminol/TUBEBUDDYCOM* 8668823239 CADate 09/07/24 0 4251439681 2 5045Card 1231","7.5","","Posted","787.38"
"9/8/2024","","Withdrawal Debit Card MC Debit Seminol/SAMSUNG ELECTRONICS RIDGEFIELD P NJDate 09/06/24 0 4250130158 2 5734Card 1231","16.99","","Posted","794.88"
"9/8/2024","","Withdrawal Debit Card MC Debit Seminol/WAWA CARD RELOAD MEDIA PADate 09/07/24 0 4251918366 0 6540Card 1231","15","","Posted","811.87"
"9/8/2024","","Withdrawal Debit Card MC Debit Seminol/WALGREENS #5024 GAINESVILLE FLDate 09/06/24 0 4250431555 2 5912Card 1231","33.35","","Posted","826.87"
"9/8/2024","","Recurring Withdrawal Debit Card - MC Debit Seminol/APPLE.COM/BILL 866-712-7753 CADate 09/07/24 0 4251430319 2 5818Card 1231","2.99","","Posted","860.22"
"9/8/2024","","Withdrawal POS #000000215944/AMAZON.COM*Z85JQ4LM2 SEATTLE WACard 1231","29.12","","Posted","863.21"
"9/6/2024","","Withdrawal POS #000000000001/AMAZON.COM*ZT6072MV1 SEATTLE WACard 1231","16.11","","Posted","892.33"
"9/6/2024","","Withdrawal Debit Card MC Debit Seminol/IONOS INC. CHESTERBROOK PADate 09/05/24 0 4249995627 0 4816Card 1231","16","","Posted","908.44"
"9/6/2024","","Recurring Withdrawal Bill Payment - #000000026814/Netflix.com NETFLIX.COM LOS GATOS CACard 1231","8.05","","Posted","924.44"
"9/5/2024","","Recurring Withdrawal Debit Card - MC Debit Seminol/OPENAI *CHATGPT SUBSCR SAN FRANCISC CADate 09/04/24 0 4248036028 1 5734Card 1231","20","","Posted","932.49"
"9/5/2024","","Withdrawal POS #000000438983/SUNOCO 8002212501 4234 SW 20TH AVEGAINESVILLE FLCard 1231","34.24","","Posted","952.49"
"9/4/2024","","Withdrawal Debit Card MC Debit Seminol/WALGREENS #5024 GAINESVILLE FLDate 09/03/24 0 4247223801 1 5912Card 1231","10.81","","Posted","986.73"
"9/4/2024","","Withdrawal Debit Card MC Debit Seminol/CIRCLE K # 06782 GAINESVILLE FLDate 09/02/24 0 4246221313 1 5499Card 1231","29.18","","Posted","997.54"
"9/4/2024","","Recurring Withdrawal Debit Card - MC Debit Seminol/APPLE.COM/BILL 866-712-7753 CADate 09/03/24 0 4247844436 0 5818Card 1231","2.99","","Posted","1026.72"
"9/4/2024","","Deposit ACH ETSY, INC./TYPE: PAYOUT ID: 1357612331CO: ETSY, INC.Entry Class Code: PPD","","106.21","Posted","1029.71"
"9/3/2024","","Withdrawal POS #000000749495/PUBLIX 3315 W. UNIVERSITY AVE.FLCard 1231","33.1","","Posted","923.5"
"9/3/2024","","Recurring Withdrawal Debit Card - MC Debit Seminol/MYDESIGNS.IO LAS VEGAS NVDate 09/02/24 0 4246904059 0 5734Card 1231","27.26","","Posted","956.6"
"9/3/2024","","Withdrawal Debit Card MC Debit Seminol/INSTACART*159 SAN FRANCISC CADate 09/02/24 0 4246902876 0 5411Card 1231","61.13","","Posted","983.86"
"9/3/2024","","Withdrawal ACH Watson Realty Co/TYPE: WEB PMTS ID: 9000321157CO: Watson Realty CoNAME: Steven chaplinskiEntry Class Code: WEB","1179","","Posted","1044.99"
"9/3/2024","","Withdrawal ACH FLUENT-Gainesvil/TYPE: PAYMENT ID: 1371804719CO: FLUENT-GainesvilNAME: steven chaplinskiEntry Class Code: WEB","45","","Posted","2223.99"
"9/3/2024","","Withdrawal ACH AppFolio, Inc. F/TYPE: WEB PMTS ID: 9001406550CO: AppFolio, Inc. FNAME: Steven chaplinskiEntry Class Code: WEB","2.49","","Posted","2268.99"
"9/3/2024","","Withdrawal Bill Payment #000000786503/Adobe Park Avenue,345 San Jose CACard 1231","19.99","","Posted","2271.48"
"9/2/2024","","Withdrawal Debit Card MC Debit Seminol/GRU/EZ-PAY WEB PYMT 352-334-3434 FLDate 09/01/24 0 4245989258 0 4900Card 1231","189.27","","Posted","2291.47"
"9/2/2024","","Withdrawal Debit Card MC Debit Seminol/COX GAINESVILLE COMM 800-234-3993 FLDate 08/31/24 0 4244993156 1 4899Card 1231","156.13","","Posted","2480.74"
"8/31/2024","","Withdrawal POS #000000736143/PUBLIX 3100 SW 35TH BLVD GAINESVILLE FLCard 1231","18.46","","Posted","2636.87"
"8/31/2024","","Withdrawal POS #000000004805/AMAZON.COM*RK4ZA05U1 SEATTLE WACard 1231","25.94","","Posted","2655.33"
"8/31/2024","","Withdrawal POS #000000000085/CIRCLE K # 06782 5237 GAINESVILLE FLCard 1231","29.18","","Posted","2681.27"
"8/30/2024","","Recurring Withdrawal Debit Card - MC Debit Seminol/MYDESIGNS.IO LAS VEGAS NVDate 08/29/24 0 4242999544 0 5734Card 1231","64.44","","Posted","2710.45"
"8/30/2024","","Withdrawal Debit Card MC Debit Seminol/AMAZON PRIME*RK8MN8K72 AMZN.COM/BIL WADate 08/30/24 0 4243993934 0 5818Card 1231","3.44","","Posted","2774.89"
"8/29/2024","","Withdrawal POS #000000775931/INSTACART*159 WWW.INSTACART.COM/ SANFRANCISCO CACard 1231","68.63","","Posted","2778.33"
"8/29/2024","","Deposit Home Banking Transfer/From CHAPLINSKI,LEON 3496297 Share 0090","","2800","Posted","2846.96"
"8/28/2024","","Withdrawal POS #000000073608/SUNOCO 8002212501 4234 SW 20TH AVEGAINESVILLE FLCard 1231","34.24","","Posted","46.96"
"8/28/2024","","Withdrawal Debit Card MC Debit Seminol/SAMSUNG ELECTRONICS RIDGEFIELD P NJDate 08/27/24 0 4240911144 0 5734Card 1231","8.99","","Posted","81.2"
"8/27/2024","","Recurring Withdrawal Debit Card - MC Debit Seminol/MYDESIGNS.IO LAS VEGAS NVDate 08/27/24 0 4240080985 1 5734Card 1231","17.03","","Posted","90.19"
"8/27/2024","","Withdrawal Debit Card MC Debit Seminol/IONOS INC. CHESTERBROOK PADate 08/26/24 0 4239887355 0 4816Card 1231","2","","Posted","107.22"
"8/27/2024","","Deposit ACH ETSY, INC./TYPE: PAYOUT ID: 1357612331CO: ETSY, INC.Entry Class Code: PPD","","12.77","Posted","109.22"
"8/26/2024","","Withdrawal POS #000000963385/SUNOCO 8002212501 4234 SW 20TH AVEGAINESVILLE FLCard 1231","34.24","","Posted","96.45"
"8/25/2024","","Withdrawal POS #000000784235/INSTACART*159 WWW.INSTACART.COM/ SANFRANCISCO CACard 1231","58.42","","Posted","130.69"
"8/25/2024","","Recurring Withdrawal Debit Card - MC Debit Seminol/FS *ADOBE SANTA BARBAR CADate 08/24/24 0 4237923935 0 5734Card 1231","0.95","","Posted","189.11"
"8/25/2024","","Recurring Withdrawal Debit Card - MC Debit Seminol/APPLE.COM/BILL 866-712-7753 CADate 08/25/24 0 4238111248 1 5818Card 1231","15.99","","Posted","190.06"
"8/22/2024","","Withdrawal POS #000000773230/INSTACART*159 WWW.INSTACART.COM/ SANFRANCISCO CACard 1231","85.99","","Posted","206.05"
"8/22/2024","","Withdrawal POS #000000170815/AMAZON.COM*R456X2LE0 SEATTLE WACard 1231","25.76","","Posted","292.04"
"8/22/2024","","Withdrawal POS #000000902881/SUNOCO 8002212501 4234 SW 20TH AVEGAINESVILLE FLCard 1231","30.7","","Posted","317.8"
"8/22/2024","","Deposit Home Banking Transfer food/From CHAPLINSKI,LEON 3496297 Share 0090","","200","Posted","348.5"
"8/22/2024","","Withdrawal POS #000000777262/SUNOCO 8002212501 4234 SW 20TH AVEGAINESVILLE FLCard 1231","18.89","","Posted","148.5"
"8/21/2024","","Recurring Withdrawal Debit Card - MC Debit Seminol/CANVA* I04249-43399962 CAMDEN DEDate 08/20/24 0 4233594945 0 7221Card 1231","12.99","","Posted","167.39"
"8/20/2024","","Deposit ACH ETSY, INC./TYPE: PAYOUT ID: 1357612331CO: ETSY, INC.Entry Class Code: PPD","","19.92","Posted","180.38"
"8/19/2024","","Withdrawal POS #000000670233/SUNOCO 8002212501 4234 SW 20TH AVEGAINESVILLE FLCard 1231","7.02","","Posted","160.46"
"8/19/2024","","Withdrawal POS #000000732534/SUNOCO 8002212501 4234 SW 20TH AVEGAINESVILLE FLCard 1231","34.24","","Posted","167.48"
"8/19/2024","","Recurring Withdrawal Debit Card Fee/MASTERCARD ISSUER CROSS-BORDER FEEDate 08/18/24 0 4231951752 0 5734Card 1231","0.05","","Posted","201.72"
"8/19/2024","","Recurring Withdrawal Debit Card - MC Debit Seminol/SAVE TO NOTION VAUREAL ILDate 08/18/24 0 4231951752 0 5734Card 1231","5.99","","Posted","201.77"
"8/19/2024","","Withdrawal ACH FLUENT-Gainesvil/TYPE: PAYMENT ID: 1371804719CO: FLUENT-GainesvilNAME: steven chaplinskiEntry Class Code: WEB","30","","Posted","207.76"
"8/18/2024","","Recurring Withdrawal Debit Card - MC Debit Seminol/SUPERPOWER CHATGPT MIDDLETOWN DEDate 08/17/24 0 4230474948 0 5734Card 1231","15","","Posted","237.76"
"8/18/2024","","Recurring Withdrawal Debit Card - MC Debit Seminol/PADDLE.NET* LEONARDOAI ASTORIA NYDate 08/16/24 0 4229015017 1 5817Card 1231","9","","Posted","252.76"
"8/18/2024","","Recurring Withdrawal Debit Card - MC Debit Seminol/PADDLE.NET* SETAPP ASTORIA NYDate 08/16/24 0 4229819554 1 5817Card 1231","12.49","","Posted","261.76"
"8/18/2024","","Recurring Withdrawal Debit Card Fee/MASTERCARD ISSUER CROSS-BORDER FEEDate 08/17/24 0 4230854170 0 5734Card 1231","0.06","","Posted","274.25"
"8/18/2024","","Recurring Withdrawal Debit Card - MC Debit Seminol/IDEOGRAM AI TORONTO ONDate 08/17/24 0 4230854170 0 5734Card 1231","8","","Posted","274.31"
"8/17/2024","","Withdrawal POS #000000000048/CIRCLE K # 26146 3525 GAINESVILLE FLCard 1231","26","","Posted","282.31"
"8/16/2024","","Recurring Withdrawal Debit Card - MC Debit Seminol/INVIDEO INC COUNTRY OF S DEDate 08/15/24 0 4228943735 0 5734Card 1231","27.67","","Posted","308.31"
"8/15/2024","","Withdrawal POS #000000773008/Instacart 50 Beal St Suite 600 SanFrancisco CACard 1231","69.88","","Posted","335.98"
"8/15/2024","","Withdrawal Debit Card MC Debit Seminol/NOTION LABS, INC. SAN FRANCISC CADate 08/15/24 0 4228171261 1 7372Card 1231","10","","Posted","405.86"
"8/15/2024","","Recurring Withdrawal Debit Card - MC Debit Seminol/RUNWAY STANDARD PLAN NEWARK DEDate 08/15/24 0 4228171210 1 5734Card 1231","15","","Posted","415.86"
"8/14/2024","","Withdrawal POS #000000623894/SUNOCO 8002212501 4234 SW 20TH AVEGAINESVILLE FLCard 1231","41.2","","Posted","430.86"
"8/14/2024","","Recurring Withdrawal Debit Card - MC Debit Seminol/D-ID STUDIO WILMINGTON DEDate 08/13/24 0 4226859392 0 7399Card 1231","2.95","","Posted","472.06"
"8/14/2024","","Recurring Withdrawal Debit Card - MC Debit Seminol/SUNO INC. CAMBRIDGE MADate 08/13/24 0 4226902139 0 5734Card 1231","10","","Posted","475.01"
"8/13/2024","","Deposit ACH ETSY, INC./TYPE: PAYOUT ID: 1357612331CO: ETSY, INC.Entry Class Code: PPD","","9.84","Posted","485.01"
"8/12/2024","","Recurring Withdrawal Debit Card - MC Debit Seminol/OPENAI SAN FRANCISC CADate 08/12/24 0 4225899261 0 5734Card 1231","15.03","","Posted","475.17"
"8/12/2024","","Recurring Withdrawal Debit Card - MC Debit Seminol/PAYPAL *PLAYSTATION 4029357733 CADate 08/09/24 0 4222963102 0 7994Card 1231","14.99","","Posted","490.2"
"8/12/2024","","Recurring Withdrawal Debit Card - MC Debit Seminol/PAYPAL *PLAYSTATION 4029357733 CADate 08/09/24 0 4222963101 0 7994Card 1231","9.99","","Posted","505.19"
"8/12/2024","","Withdrawal POS #000000427484/SUNOCO 8002212501 4234 SW 20TH AVEGAINESVILLE FLCard 1231","37.78","","Posted","515.18"
"8/11/2024","","Recurring Withdrawal Debit Card - MC Debit Seminol/AIRTABLE.COM/BILL SAN FRANCISC CADate 08/11/24 0 4224906504 2 7372Card 1231","31","","Posted","552.96"
"8/11/2024","","Withdrawal Debit Card MC Debit Seminol/IONOS INC. CHESTERBROOK PADate 08/09/24 0 4222244271 1 4816Card 1231","16","","Posted","583.96"
"8/10/2024","","Withdrawal POS #000000334497/SUNOCO 8002212501 4234 SW 20TH AVEGAINESVILLE FLCard 1231","42.78","","Posted","599.96"
"8/9/2024","","Recurring Withdrawal Debit Card - MC Debit Seminol/INVIDEO INC COUNTRY OF S DEDate 08/09/24 0 4222136862 1 5734Card 1231","25","","Posted","642.74"
"8/9/2024","","Recurring Withdrawal Debit Card - MC Debit Seminol/MYDESIGNS - PRO - MON LAS VEGAS NVDate 08/09/24 0 4222882568 0 5734Card 1231","29.99","","Posted","667.74"
"8/9/2024","","Recurring Withdrawal Debit Card Fee/MASTERCARD ISSUER CROSS-BORDER FEEDate 08/09/24 0 4222405366 0 5817Card 1231","0.08","","Posted","697.73"
"8/9/2024","","Recurring Withdrawal Debit Card - MC Debit Seminol/CAPCUT SINGAPORE SGDate 08/09/24 0 4222405366 0 5817Card 1231","9.99","","Posted","697.81"
"8/9/2024","","Withdrawal Debit Card MC Debit Seminol/WALGREENS #5024 GAINESVILLE FLDate 08/08/24 0 4221131985 1 5912Card 1231","28.95","","Posted","707.8"
"8/9/2024","","Recurring Withdrawal Debit Card - MC Debit Seminol/AMAZON PRIME*RM70P9F91 AMZN.COM/BIL WADate 08/08/24 0 4221404019 0 5968Card 1231","15.13","","Posted","736.75"
"8/9/2024","","Withdrawal POS #000020303936/GOOGLE *YouTubePremium 1600 AmphitheatreParkw Mountain View CACard 1231","9.1","","Posted","751.88"
"8/9/2024","","Withdrawal POS #000000792124/INSTACART*159 WWW.INSTACART.COM/ SANFRANCISCO CACard 1231","72.01","","Posted","760.98"
"8/8/2024","","Deposit Home Banking Transfer/From CHAPLINSKI,LEON 3496297 Share 0090","","150","Posted","832.99"
"8/7/2024","","Withdrawal POS #000000212396/SUNOCO 8002212501 4234 SW 20TH AVEGAINESVILLE FLCard 1231","37.67","","Posted","682.99"
"8/7/2024","","Withdrawal Debit Card MC Debit Seminol/SAMSUNG ELECTRONICS RIDGEFIELD P NJDate 08/06/24 0 4219920231 0 5734Card 1231","16.99","","Posted","720.66"
"8/7/2024","","Withdrawal Debit Card MC Debit Seminol/GRU/EZ-PAY WEB PYMT 352-334-3434 FLDate 08/06/24 0 4219448708 0 4900Card 1231","220.95","","Posted","737.65"
"8/7/2024","","Withdrawal Debit Card MC Debit Seminol/COX GAINESVILLE COMM 800-234-3993 FLDate 08/06/24 0 4219854218 0 4899Card 1231","156.13","","Posted","958.6"
"8/6/2024","","Deposit ACH ETSY, INC./TYPE: PAYOUT ID: 1357612331CO: ETSY, INC.Entry Class Code: PPD","","8.04","Posted","1114.73"
"8/6/2024","","Recurring Withdrawal Bill Payment - #000000350295/Netflix.com NETFLIX.COM LOS GATOS CACard 1231","13.81","","Posted","1106.69"
"8/6/2024","","Withdrawal POS #000000239287/SUNOCO 8002212501 4234 SW 20TH AVEGAINESVILLE FLCard 1231","33.06","","Posted","1120.5"
"8/5/2024","","Recurring Withdrawal Debit Card - MC Debit Seminol/OPENAI *CHATGPT SUBSCR SAN FRANCISC CADate 08/04/24 0 4217020552 1 5734Card 1231","20","","Posted","1153.56"
"8/5/2024","","Withdrawal ACH FLUENT-Gainesvil/TYPE: PAYMENT ID: 1371804719CO: FLUENT-GainesvilNAME: steven chaplinskiEntry Class Code: WEB","42.5","","Posted","1173.56"
"8/4/2024","","Withdrawal POS #000000786208/INSTACART*159 WWW.INSTACART.COM/ SANFRANCISCO CACard 1231","80.6","","Posted","1216.06"
"8/4/2024","","Withdrawal Debit Card MC Debit Seminol/IONOS INC. CHESTERBROOK PADate 08/03/24 0 4216015505 2 4816Card 1231","17.74","","Posted","1296.66"
"8/4/2024","","Withdrawal Debit Card MC Debit Seminol/WALGREENS #5024 GAINESVILLE FLDate 08/02/24 0 4215626223 4 5912Card 1231","10.81","","Posted","1314.4"
"8/4/2024","","Recurring Withdrawal Debit Card - MC Debit Seminol/APPLE.COM/BILL 866-712-7753 CADate 08/03/24 0 4216623643 4 5818Card 1231","2.99","","Posted","1325.21"
"8/3/2024","","Withdrawal POS #000000156204/SUNOCO 8002212501 4234 SW 20TH AVEGAINESVILLE FLCard 1231","30.7","","Posted","1328.2"
"8/3/2024","","Withdrawal Bill Payment #000000783713/Adobe Park Avenue,345 San Jose CACard 1231","19.99","","Posted","1358.9"
"8/3/2024","","Withdrawal POS #000000775244/Instacart 50 Beal St Suite 600 SanFrancisco CACard 1231","66.13","","Posted","1378.89"
"8/2/2024","","Deposit Home Banking Transfer/From CHAPLINSKI,LEON 3496297 Share 0090hair cur black seed oil","","45","Posted","1445.02"
"8/2/2024","","Withdrawal Debit Card MC Debit Seminol/RANDY'S HAIRCUTS FOR M GAINESVILLE FLDate 08/01/24 0 4214894751 0 7230Card 1231","30","","Posted","1400.02"
"8/2/2024","","Withdrawal ACH Watson Realty Co/TYPE: WEB PMTS ID: 9000321157CO: Watson Realty CoNAME: Steven chaplinskiEntry Class Code: WEB","1179","","Posted","1430.02"
"8/2/2024","","Withdrawal ACH AppFolio, Inc. F/TYPE: WEB PMTS ID: 9001406550CO: AppFolio, Inc. FNAME: Steven chaplinskiEntry Class Code: WEB","2.49","","Posted","2609.02"
"8/1/2024","","Withdrawal POS #000000000002/AMAZON.COM*RV6JQ8U41 SEATTLE WACard 1231","28.95","","Posted","2611.51"
"8/1/2024","","Withdrawal POS #000000983835/SUNOCO 8002212501 4234 SW 20TH AVEGAINESVILLE FLCard 1231","30.7","","Posted","2640.46"
"8/1/2024","","Withdrawal POS #000000735887/PUBLIX 3315 W. UNIVERSITY AVE.FLCard 1231","70.24","","Posted","2671.16"
"7/31/2024","","Withdrawal POS #000000922607/SUNOCO 8002212501 4234 SW 20TH AVEGAINESVILLE FLCard 1231","34.24","","Posted","2741.4"
"7/30/2024","","Withdrawal Debit Card MC Debit Seminol/AMAZON DIGIT*RV2ZN2GA1 AMZN.COM/BIL WADate 07/30/24 0 4212878109 0 5818Card 1231","3.44","","Posted","2775.64"
"7/30/2024","","Recurring Withdrawal Debit Card - MC Debit Seminol/APPLE.COM/BILL 866-712-7753 CADate 07/29/24 0 4211570450 0 5818Card 1231","7.98","","Posted","2779.08"
"7/30/2024","","Deposit ACH ETSY, INC./TYPE: PAYOUT ID: 1357612331CO: ETSY, INC.Entry Class Code: PPD","","1.36","Posted","2787.06"
"7/29/2024","","Withdrawal POS #000000782390/INSTACART*159 WWW.INSTACART.COM/ SANFRANCISCO CACard 1231","60","","Posted","2785.7"
"7/29/2024","","Withdrawal Debit Card MC Debit Seminol/WAWA CARD RELOAD MEDIA PADate 07/28/24 0 4210031062 1 6540Card 1231","15","","Posted","2845.7"
"7/29/2024","","Deposit Home Banking Transfer/From CHAPLINSKI,LEON 3496297 Share 0000","","800","Posted","2860.7"
"7/29/2024","","Deposit Home Banking Transfer/From CHAPLINSKI,LEON 3496297 Share 0090","","2000","Posted","2060.7"
"7/28/2024","","Withdrawal POS #000000575942/SUNOCO 8002212501 4234 SW 20TH AVEGAINESVILLE FLCard 1231","22.42","","Posted","60.7"
"7/26/2024","","Withdrawal POS #000000665239/SUNOCO 8002212501 4234 SW 20TH AVEGAINESVILLE FLCard 1231","37.67","","Posted","83.12"
"7/25/2024","","Withdrawal Adjustment Debit Card - Credit Voucher/TUBEBUDDYCOM 8668823239 CADate 07/24/24 0 4206883904 0 5734Card 1231","","7.5","Posted","120.79"
"7/25/2024","","Recurring Withdrawal Debit Card - MC Debit Seminol/YVETTE GODET, DMD GAINESVILLE FLDate 07/24/24 0 4206848776 0 8021Card 1231","20","","Posted","113.29"
"7/25/2024","","Recurring Withdrawal Debit Card - MC Debit Seminol/FS *ADOBE SANTA BARBAR CADate 07/24/24 0 4206889164 0 5734Card 1231","0.95","","Posted","133.29"
"7/25/2024","","Recurring Withdrawal Debit Card - MC Debit Seminol/APPLE.COM/BILL 866-712-7753 CADate 07/25/24 0 4207172375 1 5818Card 1231","0.29","","Posted","134.24"
"7/25/2024","","Withdrawal POS #000000000006/AMAZON.COM*RJ6HJ7RA2 SEATTLE WACard 1231","8.59","","Posted","134.53"
"7/24/2024","","Withdrawal POS #000000616677/SUNOCO 8002212501 4234 SW 20TH AVEGAINESVILLE FLCard 1231","21.56","","Posted","143.12"
"7/24/2024","","Withdrawal POS #000000803033/IC* INSTACART*159 WWW.INSTACART.COM/ SANFRANCISCO CACard 1231","76","","Posted","164.68"
"7/23/2024","","Deposit Home Banking Transfer/From CHAPLINSKI,LEON 3496297 Share 0090","","200","Posted","240.68"
"7/23/2024","","Withdrawal POS #000000524840/SUNOCO 8002212501 4234 SW 20TH AVEGAINESVILLE FLCard 1231","37.78","","Posted","40.68"
"7/23/2024","","Deposit ACH ETSY, INC./TYPE: PAYOUT ID: 1357612331CO: ETSY, INC.Entry Class Code: PPD","","2.53","Posted","78.46"
"7/21/2024","","Recurring Withdrawal Adjustment - Debit Card Credit Voucher/WORDPRESS YLZK812XJ6 SAN FRANCISC CADate 07/18/24 0 4200026617 1 5734Card 1231","","9","Posted","75.93"
"7/21/2024","","Recurring Withdrawal Debit Card - MC Debit Seminol/CANVA* I04218-28500872 CAMDEN DEDate 07/20/24 0 4202716426 0 7221Card 1231","12.99","","Posted","66.93"
"7/21/2024","","Recurring Withdrawal Debit Card - MC Debit Seminol/TUBEBUDDYCOM 8668823239 CADate 07/20/24 0 4202875818 0 5734Card 1231","7.5","","Posted","79.92"
"7/21/2024","","Withdrawal POS #000000000124/CIRCLE K # 06782 5237 GAINESVILLE FLCard 1231","26.83","","Posted","87.42"
"7/19/2024","","Recurring Withdrawal Adjustment - Debit Card Credit Voucher/PADDLE.NET* SETAPP NEW YORK NYDate 07/18/24 0 4200710352 0 5817Card 1231","","9.99","Posted","114.25"
"7/19/2024","","Recurring Withdrawal Debit Card Fee/MASTERCARD ISSUER CROSS-BORDER FEEDate 07/18/24 0 4200710264 0 5734Card 1231","0.05","","Posted","104.26"
"7/19/2024","","Recurring Withdrawal Debit Card - MC Debit Seminol/SAVE TO NOTION VAUREAL ILDate 07/18/24 0 4200710264 0 5734Card 1231","5.99","","Posted","104.31"
"7/19/2024","","Recurring Withdrawal Debit Card - MC Debit Seminol/WORDPRESS YLZK812XJ6 SAN FRANCISC CADate 07/18/24 0 4200709907 0 5734Card 1231","9","","Posted","110.3"
"7/18/2024","","Withdrawal POS #000000357918/SUNOCO 8002212501 4234 SW 20TH AVEGAINESVILLE FLCard 1231","34.24","","Posted","119.3"
"7/18/2024","","Recurring Withdrawal Debit Card - MC Debit Seminol/SUPERPOWER CHATGPT MIDDLETOWN DEDate 07/17/24 0 4199660339 0 5734Card 1231","15","","Posted","153.54"
"7/18/2024","","Withdrawal ACH FLUENT-Gainesvil/TYPE: PAYMENT ID: 1371804719CO: FLUENT-GainesvilNAME: steven chaplinskiEntry Class Code: WEB","36","","Posted","168.54"
"7/18/2024","","Deposit ACH ETSY, INC./TYPE: PAYOUT ID: 1357612331CO: ETSY, INC.Entry Class Code: PPD","","29.2","Posted","204.54"
"7/17/2024","","Withdrawal POS #000000976832/AMAZON.COM*RS88T71I1 SEATTLE WACard 1231","16.43","","Posted","175.34"
"7/17/2024","","Recurring Withdrawal Debit Card - MC Debit Seminol/PADDLE.NET* LEONARDOAI ASTORIA NYDate 07/16/24 0 4198745563 0 5817Card 1231","9","","Posted","191.77"
"7/17/2024","","Recurring Withdrawal Debit Card - MC Debit Seminol/PADDLE.NET* SETAPP ASTORIA NYDate 07/16/24 0 4198606327 0 5817Card 1231","12.49","","Posted","200.77"
"7/17/2024","","Recurring Withdrawal Debit Card Fee/MASTERCARD ISSUER CROSS-BORDER FEEDate 07/17/24 0 4199108326 1 5734Card 1231","0.06","","Posted","213.26"
"7/17/2024","","Recurring Withdrawal Debit Card - MC Debit Seminol/IDEOGRAM AI TORONTO ONDate 07/17/24 0 4199108326 1 5734Card 1231","8","","Posted","213.32"
"7/16/2024","","Withdrawal POS #000000795251/INSTACART*159 WWW.INSTACART.COM/ SANFRANCISCO CACard 1231","42.92","","Posted","221.32"
"7/16/2024","","Deposit Faster Payments/RTP deposit from VENMO","","29.48","Posted","264.24"
"7/16/2024","","Withdrawal POS #000000271518/SUNOCO 8002212501 4234 SW 20TH AVEGAINESVILLE FLCard 1231","37.78","","Posted","234.76"
"7/15/2024","","Recurring Withdrawal Debit Card - MC Debit Seminol/RUNWAY STANDARD PLAN NEWARK DEDate 07/15/24 0 4197591427 1 5734Card 1231","15","","Posted","272.54"
"7/15/2024","","Withdrawal POS #000000211548/SUNOCO 8002212501 4234 SW 20TH AVEGAINESVILLE FLCard 1231","37.78","","Posted","287.54"
"7/14/2024","","Recurring Withdrawal Debit Card - MC Debit Seminol/OPENAI SAN FRANCISC CADate 07/14/24 0 4196394793 1 5734Card 1231","15.01","","Posted","325.32"
"7/14/2024","","Recurring Withdrawal Debit Card - MC Debit Seminol/SUPERPOWER CHATGPT MIDDLETOWN DEDate 07/13/24 0 4195402190 0 5734Card 1231","15","","Posted","340.33"
"7/14/2024","","Recurring Withdrawal Debit Card - MC Debit Seminol/D-ID STUDIO WILMINGTON DEDate 07/13/24 0 4195852605 0 7399Card 1231","2.95","","Posted","355.33"
"7/14/2024","","Recurring Withdrawal Debit Card - MC Debit Seminol/SUNO INC. CAMBRIDGE MADate 07/13/24 0 4195401634 0 5734Card 1231","10","","Posted","358.28"
"7/14/2024","","Recurring Withdrawal Debit Card - MC Debit Seminol/APPLE.COM/BILL 866-712-7753 CADate 07/13/24 0 4195115185 3 5818Card 1231","18.98","","Posted","368.28"
"7/13/2024","","Withdrawal POS #000000165380/SUNOCO 8002212501 4234 SW 20TH AVEGAINESVILLE FLCard 1231","36.81","","Posted","387.26"
"7/12/2024","","Withdrawal Debit Card MC Debit Seminol/WAWA CARD RELOAD MEDIA PADate 07/11/24 0 4193151203 1 6540Card 1231","15","","Posted","424.07"
"7/12/2024","","Withdrawal Debit Card MC Debit Seminol/WAWA CARD RELOAD MEDIA PADate 07/11/24 0 4193151202 1 6540Card 1231","20","","Posted","439.07"
"7/12/2024","","Withdrawal Debit Card MC Debit Seminol/CIRCLE K # 06782 GAINESVILLE FLDate 07/10/24 0 4192897494 0 5499Card 1231","21.77","","Posted","459.07"
"7/12/2024","","Withdrawal POS #000000037228/WAWA 5325 2373 SW ARCHER ROADFLCard 1231","18.03","","Posted","480.84"
"7/11/2024","","Recurring Withdrawal Adjustment - Debit Card Credit Voucher/INVIDEO INC COUNTRY OF S DEDate 07/09/24 0 4191984130 0 5734Card 1231","","50","Posted","498.87"
"7/11/2024","","Recurring Withdrawal Debit Card - MC Debit Seminol/AIRTABLE.COM/BILL SAN FRANCISC CADate 07/10/24 0 4192868077 0 7372Card 1231","31","","Posted","448.87"
"7/11/2024","","Withdrawal Debit Card MC Debit Seminol/WALGREENS #5024 GAINESVILLE FLDate 07/10/24 0 4192117338 1 5912Card 1231","36.44","","Posted","479.87"
"7/11/2024","","Withdrawal Debit Card MC Debit Seminol/B2P* FL OMMU MJ MED CA JACKSONVILLE FLDate 07/10/24 0 4192863496 0 9399Card 1231","77.75","","Posted","516.31"
"7/11/2024","","Withdrawal ACH FLUENT-Gainesvil/TYPE: PAYMENT ID: 1371804719CO: FLUENT-GainesvilNAME: steven chaplinskiEntry Class Code: WEB","48","","Posted","594.06"
"7/9/2024","","Withdrawal POS #000000041458/SUNOCO 8002212501 4234 SW 20TH AVEGAINESVILLE FLCard 1231","37.78","","Posted","642.06"
"7/8/2024","","Recurring Withdrawal Debit Card - MC Debit Seminol/APPLE.COM/BILL 866-712-7753 CADate 07/08/24 0 4190849912 0 5818Card 1231","2.99","","Posted","679.84"
"7/7/2024","","Withdrawal Debit Card MC Debit Seminol/SAMSUNG ELECTRONICS RIDGEFIELD P NJDate 07/06/24 0 4188926193 0 5734Card 1231","16.99","","Posted","682.83"
"7/7/2024","","Withdrawal Debit Card MC Debit Seminol/WALGREENS #5024 GAINESVILLE FLDate 07/05/24 0 4187128964 2 5912Card 1231","24.75","","Posted","699.82"
"7/7/2024","","Withdrawal Debit Card MC Debit Seminol/GRU/EZ-PAY WEB PYMT 352-334-3434 FLDate 07/05/24 0 4187656509 0 4900Card 1231","200","","Posted","724.57"
"7/7/2024","","Withdrawal Debit Card MC Debit Seminol/COX GAINESVILLE COMM 800-234-3993 FLDate 07/05/24 0 4187656473 0 4899Card 1231","156.13","","Posted","924.57"
"7/7/2024","","Withdrawal POS #000000792733/INSTACART*159 WWW.INSTACART.COM/ SANFRANCISCO CACard 1231","59.07","","Posted","1080.7"
"7/6/2024","","Recurring Withdrawal Bill Payment - #000000404960/NETFLIX COM LOS GATOS CACard 1231","13.81","","Posted","1139.77"
"7/5/2024","","Withdrawal POS #000000828132/SUNOCO 8002212501 4234 SW 20TH AVEGAINESVILLE FLCard 1231","30.7","","Posted","1153.58"
"7/5/2024","","Recurring Withdrawal Debit Card - MC Debit Seminol/OPENAI *CHATGPT SUBSCR SAN FRANCISC CADate 07/04/24 0 4186555750 0 5734Card 1231","20","","Posted","1184.28"
"7/4/2024","","Withdrawal POS #000000601921/SUNOCO 8002212501 4234 SW 20TH AVEGAINESVILLE FLCard 1231","37.78","","Posted","1204.28"
"7/4/2024","","Withdrawal POS #000000000004/INSTACART*159 WWW.INSTACART.COM/ SANFRANCISCO CACard 1231","95","","Posted","1242.06"
"7/3/2024","","Withdrawal POS #000000784963/ETSY, INC. ADAMS STREET BROOKLYN NYCard 1231","31.06","","Posted","1337.06"
"7/3/2024","","Recurring Withdrawal Debit Card - MC Debit Seminol/DOCSIUM.COM SANTA CLARA CADate 07/02/24 0 4184077595 1 5734Card 1231","10","","Posted","1368.12"
"7/3/2024","","Recurring Withdrawal Debit Card - MC Debit Seminol/INVIDEO INC COUNTRY OF S DEDate 07/02/24 0 4184336533 0 5734Card 1231","50","","Posted","1378.12"
"7/3/2024","","Recurring Withdrawal Debit Card - MC Debit Seminol/APPLE.COM/BILL 866-712-7753 CADate 07/03/24 0 4185191278 1 5818Card 1231","2.99","","Posted","1428.12"
"7/3/2024","","Withdrawal Bill Payment #000000776267/Adobe Park Avenue,345 San Jose CACard 1231","19.99","","Posted","1431.11"
"7/2/2024","","Withdrawal POS #000000636425/WAWA 5325 2373 SW ARCHER ROADFLCard 1231","25.64","","Posted","1451.1"
"7/2/2024","","Withdrawal ACH Watson Realty Co/TYPE: WEB PMTS ID: 9000321157CO: Watson Realty CoNAME: Steven chaplinskiEntry Class Code: WEB","1079","","Posted","1476.74"
"7/2/2024","","Withdrawal ACH AppFolio, Inc. F/TYPE: WEB PMTS ID: 9001406550CO: AppFolio, Inc. FNAME: Steven chaplinskiEntry Class Code: WEB","2.49","","Posted","2555.74"
"7/1/2024","","Withdrawal POS #000000794215/Etsy.com*US ADAMS STREET BROOKLYN NYCard 1231","19.38","","Posted","2558.23"
"6/30/2024","","Withdrawal Debit Card MC Debit Seminol/CIRCLE K # 06782 GAINESVILLE FLDate 06/27/24 0 4179059238 2 5499Card 1231","10.93","","Posted","2577.61"
"6/30/2024","","Withdrawal POS #000000585907/SUNOCO 8002212501 4234 SW 20TH AVEGAINESVILLE FLCard 1231","30.7","","Posted","2588.54"
"6/30/2024","","Withdrawal POS #000000000002/INSTACART*159 WWW.INSTACART.COM/ SANFRANCISCO CACard 1231","3","","Posted","2619.24"
"6/29/2024","","Withdrawal POS #000000794238/INSTACART*159 WWW.INSTACART.COM/ SANFRANCISCO CACard 1231","102","","Posted","2622.24"
"6/28/2024","","Withdrawal ATM Fee/EFT 6419 W Newberry Rd Gainesville FLCard 1231","2","","Posted","2724.24"
"6/28/2024","","Withdrawal at ATM #000000187788/EFT 6419 W Newberry Rd Gainesville FLCard 1231","58","","Posted","2726.24"
"6/27/2024","","Withdrawal POS #000000000163/CIRCLE K # 06782 5237 GAINESVILLE FLCard 1231","10.83","","Posted","2784.24"
"6/26/2024","","Deposit Home Banking Transfer 0090/From CHAPLINSKI,LEON 3496297 Share 0000","","2800","Posted","2795.07"
"6/25/2024","","Recurring Withdrawal Debit Card - MC Debit Seminol/NOTION LABS, INC. SAN FRANCISC CADate 06/24/24 0 4176845324 0 7372Card 1231","28","","Posted","-4.93"
"6/25/2024","","Recurring Withdrawal Debit Card - MC Debit Seminol/FS *ADOBE SANTA BARBAR CADate 06/24/24 0 4176843252 0 5734Card 1231","0.95","","Posted","23.07"
"6/24/2024","","Recurring Withdrawal Debit Card - MC Debit Seminol/VIDIQ SAN FRANCISC CADate 06/23/24 0 4175962388 0 5734Card 1231","10","","Posted","24.02"
"6/22/2024","","Withdrawal POS #000000222542/WAWA 5325 2373 SW ARCHER ROADFLCard 1231","21.03","","Posted","34.02"
"6/22/2024","","Withdrawal POS #000000736979/PUBLIX 3100 SW 35TH BLVD GAINESVILLE FLCard 1231","3.57","","Posted","55.05"
"6/21/2024","","Recurring Withdrawal Debit Card - MC Debit Seminol/CANVA* I04188-40633252 CAMDEN DEDate 06/20/24 0 4172950372 0 7221Card 1231","12.99","","Posted","58.62"
"6/21/2024","","Recurring Withdrawal Debit Card - MC Debit Seminol/TUBEBUDDYCOM 8668823239 CADate 06/20/24 0 4172966177 0 5734Card 1231","7.5","","Posted","71.61"
"6/20/2024","","Withdrawal POS #000000062103/SUNOCO 8002212501 4234 SW 20TH AVEGAINESVILLE FLCard 1231","27.17","","Posted","79.11"
"6/20/2024","","Deposit Home Banking Transfer/From CHAPLINSKI,LEON 3496297 Share 0090","","100","Posted","106.28"
"6/20/2024","","Withdrawal POS #000075513000/WAWA 5325 2373 SW ARCHER ROADFLCard 1231","7.91","","Posted","6.28"
"6/20/2024","","Withdrawal POS #000003380654/GOOGLE *YouTubePremium 1600 AmphitheatreParkw Mountain View CACard 1231","15.92","","Posted","14.19"
"6/19/2024","","Recurring Withdrawal Debit Card - MC Debit Seminol/OPENAI SAN FRANCISC CADate 06/19/24 0 4171146931 1 5734Card 1231","15.07","","Posted","30.11"
"6/19/2024","","Recurring Withdrawal Debit Card Fee/MASTERCARD ISSUER CROSS-BORDER FEEDate 06/18/24 0 4170210550 0 5734Card 1231","0.05","","Posted","45.18"
"6/19/2024","","Recurring Withdrawal Debit Card - MC Debit Seminol/SAVE TO NOTION VAUREAL ILDate 06/18/24 0 4170210550 0 5734Card 1231","5.99","","Posted","45.23"
"6/19/2024","","Recurring Withdrawal Debit Card - MC Debit Seminol/WORDPRESS JTXC3339UX SAN FRANCISC CADate 06/18/24 0 4170210352 0 5734Card 1231","9","","Posted","51.22"
"6/19/2024","","Withdrawal Debit Card MC Debit Seminol/MYDESIGNS.IO LAS VEGAS NVDate 06/18/24 0 4170210349 0 5734Card 1231","24.26","","Posted","60.22"
"6/19/2024","","Withdrawal Debit Card MC Debit Seminol/MYDESIGNS.IO LAS VEGAS NVDate 06/18/24 0 4170210348 0 5734Card 1231","22.77","","Posted","84.48"
"6/18/2024","","Recurring Withdrawal Debit Card - MC Debit Seminol/SUPERPOWER CHATGPT MIDDLETOWN DEDate 06/17/24 0 4169773640 0 5734Card 1231","15","","Posted","107.25"
"6/18/2024","","Withdrawal POS #000010941641/CIRCLE K # 26146 3525 GAINESVILLE FLCard 1231","32.54","","Posted","122.25"
"6/18/2024","","Deposit Home Banking Transfer/From CHAPLINSKI,LEON 3496297 Share 0090","","200","Posted","154.79"
"6/17/2024","","Recurring Withdrawal Debit Card - MC Debit Seminol/LINKTREE* LINKTREE VENICE CADate 06/16/24 0 4168933314 0 7399Card 1231","9","","Posted","-45.21"
"6/17/2024","","Recurring Withdrawal Debit Card - MC Debit Seminol/MYDESIGNS - PRO - MON LAS VEGAS NVDate 06/16/24 0 4168024493 1 5734Card 1231","29.99","","Posted","-36.21"
"6/17/2024","","Recurring Withdrawal Debit Card - MC Debit Seminol/PADDLE.NET* LEONARDOAI ASTORIA NYDate 06/16/24 0 4168303365 0 5817Card 1231","9","","Posted","-6.22"
"6/17/2024","","Recurring Withdrawal Debit Card - MC Debit Seminol/PADDLE.NET* SETAPP ASTORIA NYDate 06/16/24 0 4168931750 0 5817Card 1231","12.49","","Posted","2.78"
"6/17/2024","","Recurring Withdrawal Debit Card - MC Debit Seminol/WWW.EVERBEE.IO AUSTIN TXDate 06/16/24 0 4168931700 0 5734Card 1231","29.99","","Posted","15.27"
"6/17/2024","","Recurring Withdrawal Debit Card Fee/MASTERCARD ISSUER CROSS-BORDER FEEDate 06/17/24 0 4169858722 0 5734Card 1231","0.06","","Posted","45.26"
"6/17/2024","","Recurring Withdrawal Debit Card - MC Debit Seminol/IDEOGRAM AI TORONTO ONDate 06/17/24 0 4169858722 0 5734Card 1231","8","","Posted","45.32"
"6/17/2024","","Withdrawal ACH FLUENT-Gainesvil/TYPE: PAYMENT ID: 1371804719CO: FLUENT-GainesvilNAME: steven chaplinskiEntry Class Code: WEB","42.9","","Posted","53.32"
"6/16/2024","","Withdrawal POS #000000909995/SUNOCO 8002212501 4234 SW 20TH AVEGAINESVILLE FLCard 1231","26.42","","Posted","96.22"
"6/16/2024","","Recurring Withdrawal Debit Card - MC Debit Seminol/PP*DOORDASH BURGERKIN 4029357733 CADate 06/13/24 0 4165038114 2 5812Card 1231","23.7","","Posted","122.64"
"6/16/2024","","Recurring Withdrawal Debit Card Fee/MASTERCARD ISSUER CROSS-BORDER FEEDate 06/15/24 0 4167922806 1 5734Card 1231","0.13","","Posted","146.34"
"6/16/2024","","Recurring Withdrawal Debit Card - MC Debit Seminol/VANCEAI CENTRAL HODate 06/15/24 0 4167922806 1 5734Card 1231","15.9","","Posted","146.47"
"6/16/2024","","Recurring Withdrawal Debit Card - MC Debit Seminol/APPLE.COM/BILL 866-712-7753 CADate 06/15/24 0 4167495198 2 5818Card 1231","9.99","","Posted","162.37"
"6/14/2024","","Withdrawal Debit Card MC Debit Seminol/PIKA.ART PALO ALTO CADate 06/13/24 0 4165935401 0 5734Card 1231","10","","Posted","172.36"
"6/14/2024","","Recurring Withdrawal Debit Card - MC Debit Seminol/SUPERPOWER CHATGPT MIDDLETOWN DEDate 06/13/24 0 4165297516 0 5734Card 1231","15","","Posted","182.36"
"6/14/2024","","Recurring Withdrawal Debit Card - MC Debit Seminol/D-ID STUDIO WILMINGTON DEDate 06/13/24 0 4165935259 0 7399Card 1231","5.9","","Posted","197.36"
"6/14/2024","","Recurring Withdrawal Debit Card - MC Debit Seminol/SUNO INC. CAMBRIDGE MADate 06/13/24 0 4165296878 0 5734Card 1231","10","","Posted","203.26"
"6/14/2024","","Recurring Withdrawal Debit Card Fee/MASTERCARD ISSUER CROSS-BORDER FEEDate 06/14/24 0 4166958438 0 5734Card 1231","0.03","","Posted","213.26"
"6/14/2024","","Recurring Withdrawal Debit Card - MC Debit Seminol/ETSYHUNT TECH SINGAPORE SGDate 06/14/24 0 4166958438 0 5734Card 1231","3.99","","Posted","213.29"
"6/14/2024","","Withdrawal Debit Card MC Debit Seminol/WAWA CARD RELOAD MEDIA PADate 06/12/24 0 4164067788 1 6540Card 1231","20","","Posted","217.28"
"6/14/2024","","Withdrawal POS #000000000069/CIRCLE K # 26146 3525 GAINESVILLE FLCard 1231","28.89","","Posted","237.28"
"6/13/2024","","Withdrawal Debit Card MC Debit Seminol/CANNAMD 855-4209170 FLDate 06/12/24 0 4164913043 0 8011Card 1231","50","","Posted","266.17"
"6/13/2024","","Recurring Withdrawal Debit Card - MC Debit Seminol/APPLE.COM/BILL 866-712-7753 CADate 06/13/24 0 4165138639 1 5818Card 1231","15.99","","Posted","316.17"
"6/13/2024","","Recurring Withdrawal Debit Card - MC Debit Seminol/APPLE.COM/BILL 866-712-7753 CADate 06/13/24 0 4165138632 1 5818Card 1231","2.99","","Posted","332.16"
"6/13/2024","","Withdrawal ACH Watson Realty Co/TYPE: WEB PMTS ID: 9000321157CO: Watson Realty CoNAME: Steven chaplinskiEntry Class Code: WEB","75","","Posted","335.15"
"6/13/2024","","Withdrawal ACH AppFolio, Inc. F/TYPE: WEB PMTS ID: 9001406550CO: AppFolio, Inc. FNAME: Steven chaplinskiEntry Class Code: WEB","2.49","","Posted","410.15"
"6/12/2024","","Withdrawal POS #000000728249/SUNOCO 8002212501 4234 SW 20TH AVEGAINESVILLE FLCard 1231","38.24","","Posted","412.64"
"6/12/2024","","Recurring Withdrawal Debit Card - MC Debit Seminol/OPENAI SAN FRANCISC CADate 06/12/24 0 4164955921 0 5734Card 1231","15.01","","Posted","450.88"
"6/12/2024","","Recurring Withdrawal Debit Card - MC Debit Seminol/PADDLE.NET* SETAPP NEW YORK NYDate 06/12/24 0 4164955257 0 5817Card 1231","9.99","","Posted","465.89"
"6/11/2024","","Withdrawal POS #000009220158/WALGREENS 2415 SW 75TH 2415 SW 75TH STGAINESVILLE FLCard 1231","4.3","","Posted","475.88"
"6/11/2024","","Withdrawal POS #000009214940/WALGREENS 2415 SW 75TH 2415 SW 75TH STGAINESVILLE FLCard 1231","29.58","","Posted","480.18"
"6/11/2024","","Deposit ACH ETSY, INC./TYPE: PAYOUT ID: 1357612331CO: ETSY, INC.Entry Class Code: PPD","","23.2","Posted","509.76"
"6/10/2024","","Recurring Withdrawal Adjustment - Debit Card Credit Voucher/GOOGLE ADS7127436844 MOUNTAIN VIE CADate 06/09/24 0 4161975802 0 7311Card 2801","","0.06","Posted","486.56"
"6/9/2024","","Withdrawal POS #000000794668/INSTACART*159 WWW.INSTACART.COM/ SANFRANCISCO CACard 1231","3","","Posted","486.5"
"6/9/2024","","Withdrawal POS #000000000005/INSTACART*159 WWW.INSTACART.COM/ SANFRANCISCO CACard 1231","90.66","","Posted","489.5"
"6/9/2024","","Withdrawal Debit Card MC Debit Seminol/WALGREENS #5024 GAINESVILLE FLDate 06/07/24 0 4159311957 2 5912Card 1231","10.81","","Posted","580.16"
"6/9/2024","","Recurring Withdrawal Debit Card - MC Debit Seminol/APPLE.COM/BILL 866-712-7753 CADate 06/07/24 0 4159617075 1 5818Card 1231","2.99","","Posted","590.97"
"6/9/2024","","Withdrawal POS #000000596566/SUNOCO 8002212501 4234 SW 20TH AVEGAINESVILLE FLCard 1231","34.24","","Posted","593.96"
"6/7/2024","","Withdrawal Debit Card MC Debit Seminol/COX GAINESVILLE COMM 800-234-3993 FLDate 06/06/24 0 4158037132 1 4899Card 1231","142.13","","Posted","628.2"
"6/6/2024","","Withdrawal POS #000000792685/INSTACART*159 WWW.INSTACART.COM/ SANFRANCISCO CACard 1231","3","","Posted","770.33"
"6/6/2024","","Withdrawal POS #000000793127/INSTACART*159 WWW.INSTACART.COM/ SANFRANCISCO CACard 1231","81","","Posted","773.33"
"6/6/2024","","Withdrawal Bill Payment #000000144331/GRU EZ PAY 301 SE 4TH AVE 301 SE 4TH AVCard 1231","161.55","","Posted","854.33"
"6/6/2024","","Withdrawal Debit Card MC Debit Seminol/SAMSUNG ELECTRONICS RIDGEFIELD P NJDate 06/06/24 0 4158976711 0 5734Card 1231","16.99","","Posted","1015.88"
"6/6/2024","","Withdrawal POS #000000431904/SUNOCO 8002212501 4234 SW 20TH AVEGAINESVILLE FLCard 1231","28.64","","Posted","1032.87"
"6/6/2024","","Recurring Withdrawal Bill Payment - #000000178852/NETFLIX COM LOS GATOS CACard 1231","13.81","","Posted","1061.51"
"6/5/2024","","Recurring Withdrawal Debit Card - MC Debit Seminol/OPENAI *CHATGPT SUBSCR SAN FRANCISC CADate 06/04/24 0 4156605279 0 5734Card 1231","20","","Posted","1075.32"
"6/5/2024","","Withdrawal Debit Card MC Debit Seminol/1473 - QUINN EYE CENTE GAINESVILLE FLDate 06/04/24 0 4156985542 0 8042Card 1231","54","","Posted","1095.32"
"6/5/2024","","Withdrawal Bill Payment #000009216703/PAYPAL *PARAMNTPLUS 2211 North FirstStreet 8882211161 CACard 1231","13.81","","Posted","1149.32"
"6/4/2024","","Withdrawal POS #000000775534/INSTACART*159 WWW.INSTACART.COM/ SANFRANCISCO CACard 1231","111.29","","Posted","1163.13"
"6/4/2024","","Withdrawal POS #000000367990/SUNOCO 8002212501 4234 SW 20TH AVEGAINESVILLE FLCard 1231","25.96","","Posted","1274.42"
"6/4/2024","","Withdrawal Debit Card MC Debit Seminol/CIRCLE K # 06782 GAINESVILLE FLDate 06/02/24 0 4154170879 1 5499Card 1231","28.74","","Posted","1300.38"
"6/4/2024","","Withdrawal ACH FLUENT-Gainesvil/TYPE: PAYMENT ID: 1371804719CO: FLUENT-GainesvilNAME: steven chaplinskiEntry Class Code: WEB","82.6","","Posted","1329.12"
"6/4/2024","","Deposit ACH ETSY, INC./TYPE: PAYOUT ID: 1357612331CO: ETSY, INC.Entry Class Code: PPD","","26.04","Posted","1411.72"
"6/3/2024","","Recurring Withdrawal Debit Card - MC Debit Seminol/DOCSIUM.COM SANTA CLARA CADate 06/02/24 0 4154586018 1 5734Card 1231","10","","Posted","1385.68"
"6/3/2024","","Recurring Withdrawal Debit Card - MC Debit Seminol/INVIDEO INC COUNTRY OF S DEDate 06/02/24 0 4154049359 0 5734Card 1231","50","","Posted","1395.68"
"6/3/2024","","Withdrawal Debit Card MC Debit Seminol/WAWA CARD RELOAD MEDIA PADate 06/02/24 0 4154531671 1 6540Card 1231","25","","Posted","1445.68"
"6/3/2024","","Recurring Withdrawal Debit Card - MC Debit Seminol/APPLE.COM/BILL 866-712-7753 CADate 06/03/24 0 4155527708 1 5818Card 1231","2.99","","Posted","1470.68"
"6/3/2024","","Withdrawal Bill Payment #000000786071/Adobe Park Avenue,345 San Jose CACard 1231","19.99","","Posted","1473.67"
"6/3/2024","","Withdrawal ACH Watson Realty Co/TYPE: WEB PMTS ID: 9000321157CO: Watson Realty CoNAME: Steven chaplinskiEntry Class Code: WEB","1079","","Posted","1493.66"
"6/3/2024","","Withdrawal ACH AppFolio, Inc. F/TYPE: WEB PMTS ID: 9001406550CO: AppFolio, Inc. FNAME: Steven chaplinskiEntry Class Code: WEB","2.49","","Posted","2572.66"
"6/2/2024","","Withdrawal POS #000000278995/SUNOCO 8002212501 4234 SW 20TH AVEGAINESVILLE FLCard 1231","22.42","","Posted","2575.15"
"6/2/2024","","Withdrawal Bill Payment #000011385521/PAYPAL *SPOTIFYUSAI 2211 North FirstStreet 8882211161 CACard 1231","6.82","","Posted","2597.57"
"6/1/2024","","Withdrawal POS #000000774843/ETSY.COM*US WWW.ETSY.COM/ BROOKLYN NYCard 1231","28.29","","Posted","2604.39"
"5/31/2024","","Withdrawal POS #000000786599/INSTACART*159 WWW.INSTACART.COM/ SANFRANCISCO CACard 1231","5","","Posted","2632.68"
"5/31/2024","","Withdrawal POS #000000000006/INSTACART*159 WWW.INSTACART.COM/ SANFRANCISCO CACard 1231","75","","Posted","2637.68"
"5/30/2024","","Withdrawal Debit Card MC Debit Seminol/WALGREENS #5024 GAINESVILLE FLDate 05/29/24 0 4150067031 1 5912Card 1231","22.65","","Posted","2712.68"
"5/29/2024","","Withdrawal POS #000000803191/INSTACART*159 WWW.INSTACART.COM/ SANFRANCISCO CACard 1231","5","","Posted","2735.33"
"5/29/2024","","Withdrawal POS #000000795511/INSTACART*159 WWW.INSTACART.COM/ SANFRANCISCO CACard 1231","60","","Posted","2740.33"
"5/29/2024","","Withdrawal POS #000000131389/SUNOCO 8002212501 4234 SW 20TH AVEGAINESVILLE FLCard 1231","37.78","","Posted","2800.33"
"5/29/2024","","Deposit Home Banking Transfer/From CHAPLINSKI,LEON 3496297 Share 0000","","2800","Posted","2838.11"
"5/28/2024","","Withdrawal POS #000000102672/SUNOCO 8002212501 4234 SW 20TH AVEGAINESVILLE FLCard 1231","10.61","","Posted","38.11"
"5/28/2024","","Recurring Withdrawal Debit Card - MC Debit Seminol/APPLE.COM/BILL 866-712-7753 CADate 05/27/24 0 4148755967 0 5818Card 1231","9.99","","Posted","48.72"
"5/27/2024","","Recurring Withdrawal Debit Card - MC Debit Seminol/BLAZE TODAY SUNNYVALE CADate 05/26/24 0 4147283808 0 5734Card 1231","8.39","","Posted","58.71"
"5/27/2024","","Withdrawal POS #000000000000/IC* INSTACART*159 WWW.INSTACART.COM/ SANFRANCISCO CACard 1231","3","","Posted","67.1"
"5/27/2024","","Withdrawal POS #000000794186/IC* INSTACART*159 WWW.INSTACART.COM/ SANFRANCISCO CACard 1231","37.72","","Posted","70.1"
"5/27/2024","","Withdrawal Bill Payment #000007088724/PAYPAL *IONOS INC 2211 North First8882211161 CACard 1231","17","","Posted","107.82"
"5/26/2024","","Recurring Withdrawal Debit Card - MC Debit Seminol/NOTION LABS, INC. SAN FRANCISC CADate 05/24/24 0 4145017161 2 7372Card 1231","28","","Posted","124.82"
"5/26/2024","","Recurring Withdrawal Debit Card - MC Debit Seminol/FS *ADOBE SANTA BARBAR CADate 05/24/24 0 4145014325 2 5734Card 1231","0.95","","Posted","152.82"
"5/26/2024","","Withdrawal POS #000000000001/INSTACART*159 WWW.INSTACART.COM/ SANFRANCISCO CACard 1231","3","","Posted","153.77"
"5/26/2024","","Withdrawal POS #000000782598/INSTACART*159 WWW.INSTACART.COM/ SANFRANCISCO CACard 1231","60","","Posted","156.77"
"5/25/2024","","Deposit Home Banking Transfer/From CHAPLINSKI,LEON 3496297 Share 0090","","200","Posted","216.77"
"5/25/2024","","Withdrawal Bill Payment #000006272109/PAYPAL *IONOS INC 2211 North First8882211161 CACard 1231","7","","Posted","16.77"
"5/24/2024","","Recurring Withdrawal Debit Card - MC Debit Seminol/AIRTABLE.COM/BILL SAN FRANCISC CADate 05/24/24 0 4145150548 1 7372Card 1231","32.8","","Posted","23.77"
"5/24/2024","","Recurring Withdrawal Debit Card - MC Debit Seminol/VIDIQ SAN FRANCISC CADate 05/23/24 0 4144928316 0 5734Card 1231","10","","Posted","56.57"
"5/21/2024","","Withdrawal POS #000000797901/SUNOCO 8002212501 4234 SW 20TH AVEGAINESVILLE FLCard 1231","25.96","","Posted","66.57"
"5/21/2024","","Withdrawal Bill Payment #000007101908/PAYPAL *IONOS INC 2211 North First8882211161 CACard 1231","7","","Posted","92.53"
"5/21/2024","","Recurring Withdrawal Debit Card - MC Debit Seminol/CANVA* I04157-41978019 CAMDEN DEDate 05/20/24 0 4141808212 0 7221Card 1231","12.99","","Posted","99.53"
"5/21/2024","","Recurring Withdrawal Debit Card - MC Debit Seminol/TUBEBUDDYCOM 8668823239 CADate 05/20/24 0 4141845145 0 5734Card 1231","7.5","","Posted","112.52"
"5/20/2024","","Recurring Withdrawal Debit Card Fee/MASTERCARD ISSUER CROSS-BORDER FEEDate 05/19/24 0 4140937257 0 5734Card 1231","0.07","","Posted","120.02"
"5/20/2024","","Recurring Withdrawal Debit Card - MC Debit Seminol/PAYPAL *PADDLE.NET 35314369001 GBDate 05/19/24 0 4140937257 0 5734Card 1231","9","","Posted","120.09"
"5/20/2024","","Withdrawal POS #000003232252/GOOGLE *YouTubePremium 1600 AmphitheatreParkw Mountain View CACard 1231","15.92","","Posted","129.09"
"5/19/2024","","Withdrawal POS #000000680126/WAWA 5325 2373 SW ARCHER ROADFLCard 1231","18.03","","Posted","145.01"
"5/19/2024","","Recurring Withdrawal Debit Card - MC Debit Seminol/SUPERPOWER CHATGPT MIDDLETOWN DEDate 05/17/24 0 4138018304 2 5734Card 1231","15","","Posted","163.04"
"5/19/2024","","Recurring Withdrawal Debit Card Fee/MASTERCARD ISSUER CROSS-BORDER FEEDate 05/18/24 0 4139958413 0 5734Card 1231","0.05","","Posted","178.04"
"5/19/2024","","Recurring Withdrawal Debit Card - MC Debit Seminol/SAVE TO NOTION VAUREAL ILDate 05/18/24 0 4139958413 0 5734Card 1231","5.99","","Posted","178.09"
"5/19/2024","","Recurring Withdrawal Debit Card - MC Debit Seminol/WORDPRESS ZMTWVYVHAL SAN FRANCISC CADate 05/18/24 0 4139958144 0 7372Card 1231","9","","Posted","184.08"
"5/19/2024","","Withdrawal Debit Card Fee/MASTERCARD ISSUER CROSS-BORDER FEEDate 05/16/24 0 4137015306 2 4816Card 1231","0.12","","Posted","193.08"
"5/19/2024","","Withdrawal Debit Card MC Debit Seminol/PAYPAL *2CO.COM 35314369001 NLDate 05/16/24 0 4137015306 2 4816Card 1231","14.99","","Posted","193.2"
"5/19/2024","","Withdrawal POS #000000795687/IC* INSTACART*159 WWW.INSTACART.COM/ SANFRANCISCO CACard 1231","3","","Posted","208.19"
"5/19/2024","","Withdrawal POS #000000784752/IC* INSTACART*159 WWW.INSTACART.COM/ SANFRANCISCO CACard 1231","46","","Posted","211.19"
"5/17/2024","","Recurring Withdrawal Debit Card - MC Debit Seminol/LINKTREE* LINKTREE DOVER DEDate 05/16/24 0 4137933466 0 7399Card 1231","9","","Posted","257.19"
"5/17/2024","","Recurring Withdrawal Debit Card - MC Debit Seminol/MYDESIGNS - PRO - MON LAS VEGAS NVDate 05/16/24 0 4137953308 0 5734Card 1231","29.99","","Posted","266.19"
"5/17/2024","","Recurring Withdrawal Debit Card - MC Debit Seminol/PADDLE.NET* LEONARDOAI ASTORIA NYDate 05/16/24 0 4137285984 0 5817Card 1231","9","","Posted","296.18"
"5/17/2024","","Recurring Withdrawal Debit Card - MC Debit Seminol/PADDLE.NET* SETAPP ASTORIA NYDate 05/16/24 0 4137932128 0 5817Card 1231","12.49","","Posted","305.18"
"5/17/2024","","Recurring Withdrawal Debit Card - MC Debit Seminol/WWW.EVERBEE.IO AUSTIN TXDate 05/16/24 0 4137932088 0 5734Card 1231","29.99","","Posted","317.67"
"5/17/2024","","Recurring Withdrawal Debit Card Fee/MASTERCARD ISSUER CROSS-BORDER FEEDate 05/17/24 0 4138070362 1 5734Card 1231","0.06","","Posted","347.66"
"5/17/2024","","Recurring Withdrawal Debit Card - MC Debit Seminol/IDEOGRAM.AI TORONTO ONDate 05/17/24 0 4138070362 1 5734Card 1231","8","","Posted","347.72"
"5/17/2024","","Withdrawal POS #000000585746/SUNOCO 8002212501 4234 SW 20TH AVEGAINESVILLE FLCard 1231","37.78","","Posted","355.72"
"5/16/2024","","Withdrawal Debit Card Fee/MASTERCARD ISSUER CROSS-BORDER FEEDate 05/13/24 0 4134864561 0 5734Card 1231","0.62","","Posted","393.5"
"5/16/2024","","Withdrawal Debit Card MC Debit Seminol/PAYPAL *PADDLE.NET 07790810231 GBDate 05/13/24 0 4134864561 0 5734Card 1231","77.07","","Posted","394.12"
"5/16/2024","","Deposit Home Banking Transfer battery/From CHAPLINSKI,LEON 3496297 Share 0090","","85","Posted","471.19"
"5/15/2024","","Withdrawal POS #000000534382/SUNOCO 8002212501 4234 SW 20TH AVEGAINESVILLE FLCard 1231","37.78","","Posted","386.19"
"5/15/2024","","Recurring Withdrawal Debit Card - MC Debit Seminol/MIDJOURNEY INC. SOUTH SAN FR CADate 05/14/24 0 4135994595 0 5734Card 1231","10","","Posted","423.97"
"5/15/2024","","Recurring Withdrawal Debit Card Fee/MASTERCARD ISSUER CROSS-BORDER FEEDate 05/15/24 0 4136993433 0 5734Card 1231","0.13","","Posted","433.97"
"5/15/2024","","Recurring Withdrawal Debit Card - MC Debit Seminol/VANCEAI CENTRAL HODate 05/15/24 0 4136993433 0 5734Card 1231","15.9","","Posted","434.1"
"5/15/2024","","Withdrawal Debit Card MC Debit Seminol/CHIPOTLE ONLINE CHIPOTLE.COM CADate 05/14/24 0 4135921741 0 5814Card 1231","41","","Posted","450"
"5/15/2024","","Withdrawal POS #000004117844/PAYPAL *PLAYSTATION 2211 North FirstStreet 8882211161 CACard 1231","9.99","","Posted","491"
"5/14/2024","","Recurring Withdrawal Debit Card - MC Debit Seminol/OPENAI SAN FRANCISC CADate 05/14/24 0 4135914307 0 5734Card 1231","15.02","","Posted","500.99"
"5/14/2024","","Recurring Withdrawal Debit Card - MC Debit Seminol/SUPERPOWER CHATGPT MIDDLETOWN DEDate 05/13/24 0 4134368690 0 5734Card 1231","15","","Posted","516.01"
"5/14/2024","","Recurring Withdrawal Debit Card Fee/MASTERCARD ISSUER CROSS-BORDER FEEDate 05/14/24 0 4135869366 0 5734Card 1231","0.03","","Posted","531.01"
"5/14/2024","","Recurring Withdrawal Debit Card - MC Debit Seminol/ETSYHUNT TECH SINGAPORE SGDate 05/14/24 0 4135869366 0 5734Card 1231","3.99","","Posted","531.04"
"5/14/2024","","Withdrawal Debit Card MC Debit Seminol/WALGREENS #5024 GAINESVILLE FLDate 05/13/24 0 4134909562 0 5912Card 1231","15","","Posted","535.03"
"5/13/2024","","Withdrawal POS #000014536880/WALGREENS 2415 SW 75TH 2415 SW 75TH STGAINESVILLE FLCard 1231","27.24","","Posted","550.03"
"5/13/2024","","Withdrawal POS #000000293405/WAL-MART #1081 Wal-Mart Super CenterGAINESVILLE FLCard 1231","74.97","","Posted","577.27"
"5/13/2024","","Withdrawal POS #000000450318/SUNOCO 8002212501 4234 SW 20TH AVEGAINESVILLE FLCard 1231","37.78","","Posted","652.24"
"5/13/2024","","Recurring Withdrawal Debit Card - MC Debit Seminol/APPLE.COM/BILL 866-712-7753 CADate 05/13/24 0 4134846731 0 5818Card 1231","23.98","","Posted","690.02"
"5/12/2024","","Withdrawal Debit Card MC Debit Seminol/CHIPOTLE ONLINE CHIPOTLE.COM CADate 05/11/24 0 4132095312 1 5814Card 1231","17.14","","Posted","714"
"5/12/2024","","Recurring Withdrawal Debit Card - MC Debit Seminol/APPLE.COM/BILL 866-712-7753 CADate 05/10/24 0 4131679078 1 5818Card 1231","7.99","","Posted","731.14"
"5/12/2024","","Recurring Withdrawal Debit Card - MC Debit Seminol/APPLE.COM/BILL 866-712-7753 CADate 05/10/24 0 4131679029 1 5818Card 1231","18.97","","Posted","739.13"
"5/10/2024","","Withdrawal POS #000000000004/INSTACART*159 WWW.INSTACART.COM/ SANFRANCISCO CACard 1231","5","","Posted","758.1"
"5/10/2024","","Withdrawal POS #000000805593/INSTACART*159 WWW.INSTACART.COM/ SANFRANCISCO CACard 1231","92.46","","Posted","763.1"
"5/10/2024","","Withdrawal ACH FLUENT-Gainesvil/TYPE: PAYMENT ID: 1371804719CO: FLUENT-GainesvilNAME: steven chaplinskiEntry Class Code: WEB","68","","Posted","855.56"
"5/9/2024","","Withdrawal Debit Card MC Debit Seminol/WALGREENS #5024 GAINESVILLE FLDate 05/08/24 0 4129217598 1 5912Card 1231","10.81","","Posted","923.56"
"5/8/2024","","Withdrawal POS #000000246839/SUNOCO 8002212501 4234 SW 20TH AVEGAINESVILLE FLCard 1231","34.24","","Posted","934.37"
"5/8/2024","","Withdrawal POS #000011384494/PAYPAL *PLAYSTATION 2211 North FirstStreet 8882211161 CACard 1231","14.99","","Posted","968.61"
"5/7/2024","","Withdrawal POS #000000786829/INSTACART*159 WWW.INSTACART.COM/ SANFRANCISCO CACard 1231","5","","Posted","983.6"
"5/7/2024","","Withdrawal POS #000000792260/INSTACART*159 WWW.INSTACART.COM/ SANFRANCISCO CACard 1231","86","","Posted","988.6"
"5/6/2024","","Recurring Withdrawal Bill Payment - #000000343444/NETFLIX COM LOS GATOS CACard 1231","13.81","","Posted","1074.6"
"5/6/2024","","Withdrawal POS #000000171901/SUNOCO 8002212501 4234 SW 20TH AVEGAINESVILLE FLCard 1231","37.78","","Posted","1088.41"
"5/5/2024","","Recurring Withdrawal Debit Card - MC Debit Seminol/CHATGPT SUBSCRIPTION SAN FRANCISC CADate 05/04/24 0 4125659188 0 5734Card 1231","20","","Posted","1126.19"
"5/5/2024","","Withdrawal Debit Card MC Debit Seminol/CANNAMD 855-4209170 FLDate 05/03/24 0 4124568142 1 8011Card 1231","195","","Posted","1146.19"
"5/5/2024","","Recurring Withdrawal Debit Card - MC Debit Seminol/APPLE.COM/BILL CUPERTINO CADate 05/03/24 0 4124646881 1 5735Card 1231","2.99","","Posted","1341.19"
"5/5/2024","","Recurring Withdrawal Debit Card - MC Debit Seminol/APPLE.COM/BILL 866-712-7753 CADate 05/04/24 0 4125577568 0 5818Card 1231","2.99","","Posted","1344.18"
"5/5/2024","","Withdrawal Bill Payment #000009057953/PAYPAL *PARAMNTPLUS 2211 North FirstStreet 8882211161 CACard 1231","13.81","","Posted","1347.17"
"5/3/2024","","Recurring Withdrawal Debit Card - MC Debit Seminol/DOCSIUM.COM SANTA CLARA CADate 05/02/24 0 4123905624 0 5734Card 1231","10","","Posted","1360.98"
"5/3/2024","","Recurring Withdrawal Debit Card - MC Debit Seminol/INVIDEO INC COUNTRY OF S DEDate 05/02/24 0 4123988858 0 5734Card 1231","50","","Posted","1370.98"
"5/3/2024","","Withdrawal Debit Card MC Debit Seminol/COX GAINESVILLE COMM 800-234-3993 FLDate 05/02/24 0 4123982882 0 4899Card 1231","126.13","","Posted","1420.98"
"5/3/2024","","Withdrawal Bill Payment #000000774654/Adobe Park Avenue,345 San Jose CACard 1231","19.99","","Posted","1547.11"
"5/3/2024","","Withdrawal ACH Watson Realty Co/TYPE: WEB PMTS ID: 9000321157CO: Watson Realty CoNAME: Steven chaplinskiEntry Class Code: WEB","1079","","Posted","1567.1"
"5/3/2024","","Withdrawal ACH AppFolio, Inc. F/TYPE: WEB PMTS ID: 9001406550CO: AppFolio, Inc. FNAME: Steven chaplinskiEntry Class Code: WEB","2.49","","Posted","2646.1"
"5/2/2024","","Withdrawal Bill Payment #000000284847/GRU EZ PAY 301 SE 4TH AVE 301 SE 4TH AVCard 1231","132.23","","Posted","2648.59"
"5/2/2024","","Withdrawal Bill Payment #050211031354/PAYPAL *SPOTIFYUSAI 2211 North FirstStreet San Jose CACard 1231","6.82","","Posted","2780.82"
"5/2/2024","","Withdrawal POS #000000804821/INSTACART*159 WWW.INSTACART.COM/ SANFRANCISCO CACard 1231","3","","Posted","2787.64"
"5/2/2024","","Withdrawal POS #000000793624/INSTACART*159 WWW.INSTACART.COM/ SANFRANCISCO CACard 1231","94.95","","Posted","2790.64"
"5/1/2024","","Withdrawal POS #000000217221/SUNOCO 8002212501 4234 SW 20TH AVEGAINESVILLE FLCard 1231","37.78","","Posted","2885.59"
"4/30/2024","","Deposit Home Banking Transfer expenses/From CHAPLINSKI,LEON 3496297 Share 0090","","2800","Posted","2923.37"
"4/28/2024","","Recurring Withdrawal Debit Card - MC Debit Seminol/BLAZE TODAY SUNNYVALE CADate 04/26/24 0 4117285439 0 5734Card 1231","8.39","","Posted","123.37"
"4/27/2024","","Withdrawal Bill Payment #000008086025/PAYPAL *IONOS INC 2211 North FirstSan Jose CACard 1231","17","","Posted","131.76"
"4/26/2024","","Withdrawal POS #000000031004/SUNOCO 8002212501 4234 SW 20TH AVEGAINESVILLE FLCard 1231","37.78","","Posted","148.76"
"4/26/2024","","Recurring Withdrawal Debit Card - MC Debit Seminol/FS *RAINDROP.IO SANTA BARBAR CADate 04/25/24 0 4116899101 0 5734Card 1231","3","","Posted","186.54"
"4/26/2024","","Withdrawal Debit Card MC Debit Seminol/CIRCLE K # 06782 GAINESVILLE FLDate 04/24/24 0 4115893649 0 5499Card 1231","21.04","","Posted","189.54"
"4/26/2024","","Recurring Withdrawal Debit Card - MC Debit Seminol/APPLE.COM/BILL 866-712-7753 CADate 04/25/24 0 4116886532 0 5818Card 1231","5.99","","Posted","210.58"
"4/25/2024","","Withdrawal POS #000000772089/INSTACART*159 WWW.INSTACART.COM/ SANFRANCISCO CACard 1231","1","","Posted","216.57"
"4/25/2024","","Withdrawal POS #000000000765/INSTACART*159 WWW.INSTACART.COM/ SANFRANCISCO CACard 1231","65.4","","Posted","217.57"
"4/25/2024","","Recurring Withdrawal Debit Card - MC Debit Seminol/NOTION LABS, INC. SAN FRANCISC CADate 04/24/24 0 4115372320 0 7372Card 1231","27.04","","Posted","282.97"
"4/25/2024","","Recurring Withdrawal Debit Card - MC Debit Seminol/FS *ADOBE SANTA BARBAR CADate 04/24/24 0 4115901267 0 5734Card 1231","0.95","","Posted","310.01"
"4/25/2024","","Withdrawal Debit Card MC Debit Seminol/CHIPOTLE ONLINE CHIPOTLE.COM CADate 04/24/24 0 4115958339 0 5814Card 1231","18","","Posted","310.96"
"4/24/2024","","Withdrawal POS #000002059014/PAYPAL *ETSY INC 2211 North First StreetSan Jose CACard 1231","19.76","","Posted","328.96"
"4/24/2024","","Recurring Withdrawal Debit Card - MC Debit Seminol/GUMROAD.COM/C* AUCTOR SAN FRANCISC CADate 04/24/24 0 4115942524 0 5192Card 1231","5.35","","Posted","348.72"
"4/24/2024","","Recurring Withdrawal Debit Card - MC Debit Seminol/GUMROAD.COM/C* AUCTOR SAN FRANCISC CADate 04/24/24 0 4115942523 0 5192Card 1231","5.35","","Posted","354.07"
"4/24/2024","","Recurring Withdrawal Debit Card - MC Debit Seminol/VIDIQ SAN FRANCISC CADate 04/23/24 0 4114819971 0 5734Card 1231","10","","Posted","359.42"
"4/24/2024","","Withdrawal Debit Card Fee/MASTERCARD ISSUER CROSS-BORDER FEEDate 04/23/24 0 4114819674 0 7392Card 1231","0.08","","Posted","369.42"
"4/24/2024","","Withdrawal Debit Card MC Debit Seminol/WWW.GLH-GR* BUSINESS A LONDON LNDate 04/23/24 0 4114819674 0 7392Card 1231","10","","Posted","369.5"
"4/24/2024","","Withdrawal Debit Card Fee/MASTERCARD ISSUER CROSS-BORDER FEEDate 04/23/24 0 4114819673 0 7392Card 1231","0.04","","Posted","379.5"
"4/24/2024","","Withdrawal Debit Card MC Debit Seminol/WWW.GLH-GR* BUSINESS A LONDON LNDate 04/23/24 0 4114819673 0 7392Card 1231","5","","Posted","379.54"
"4/23/2024","","Withdrawal Debit Card MC Debit Seminol/AIRTABLE.COM/BILL SAN FRANCISC CADate 04/23/24 0 4114941463 0 7372Card 1231","24","","Posted","384.54"
"4/23/2024","","Recurring Withdrawal Debit Card - MC Debit Seminol/OPENAI SAN FRANCISC CADate 04/23/24 0 4114941406 0 5734Card 1231","15.03","","Posted","408.54"
"4/23/2024","","Recurring Withdrawal Debit Card - MC Debit Seminol/RUNWAY STANDARD PLAN NEWARK DEDate 04/22/24 0 4113848879 0 5734Card 1231","15","","Posted","423.57"
"4/23/2024","","Withdrawal POS #000000851229/SUNOCO 8002212501 4234 SW 20TH AVEGAINESVILLE FLCard 1231","27.17","","Posted","438.57"
"4/22/2024","","Withdrawal ACH FLUENT-Gainesvil/TYPE: PAYMENT ID: 1371804719CO: FLUENT-GainesvilNAME: steven chaplinskiEntry Class Code: WEB","65","","Posted","465.74"
"4/22/2024","","Withdrawal Bill Payment #000007322712/PAYPAL *IONOS INC 2211 North FirstSan Jose CACard 1231","7","","Posted","530.74"
"4/21/2024","","Recurring Withdrawal Debit Card - MC Debit Seminol/CANVA* I04127-28722894 CAMDEN DEDate 04/20/24 0 4111985987 0 7221Card 1231","12.99","","Posted","537.74"
"4/21/2024","","Withdrawal Debit Card MC Debit Seminol/CIRCLE K # 26146 GAINESVILLE FLDate 04/18/24 0 4109064505 2 5499Card 1231","9.02","","Posted","550.73"
"4/21/2024","","Recurring Withdrawal Debit Card - MC Debit Seminol/TUBEBUDDYCOM 8668823239 CADate 04/20/24 0 4111932836 0 5734Card 1231","7.5","","Posted","559.75"
"4/20/2024","","Withdrawal POS #000003089132/GOOGLE *YouTubePremium 1600 AmphitheatreParkw Mountain View CACard 1231","15.92","","Posted","567.25"
"4/19/2024","","Recurring Withdrawal Debit Card - MC Debit Seminol/WORDPRESS 6ZJ0S7Z01P SAN FRANCISC CADate 04/18/24 0 4109333578 0 7372Card 1231","9","","Posted","583.17"
"4/19/2024","","Withdrawal Bill Payment #000003047046/PAYPAL *HOSTGATOR 2211 North FirstSan Jose CACard 1231","15.99","","Posted","592.17"
"4/18/2024","","Withdrawal POS #000000051270/SUNOCO 8002212501 4234 SW 20TH AVEGAINESVILLE FLCard 1231","34.24","","Posted","608.16"
"4/18/2024","","Recurring Withdrawal Debit Card - MC Debit Seminol/PROMPT HUNT, INC. LOS ANGELES CADate 04/18/24 0 4109016478 1 5734Card 1231","1.99","","Posted","642.4"
"4/18/2024","","Recurring Withdrawal Debit Card - MC Debit Seminol/ELEVENLABS.IO NEW YORK NYDate 04/17/24 0 4108862142 0 5734Card 1231","22","","Posted","644.39"
"4/18/2024","","Withdrawal Debit Card MC Debit Seminol/CHIPOTLE ONLINE CHIPOTLE.COM CADate 04/17/24 0 4108013128 1 5814Card 1231","18","","Posted","666.39"
"4/18/2024","","Withdrawal POS #000000805331/IC* INSTACART*159 WWW.INSTACART.COM/ SANFRANCISCO CACard 1231","77.14","","Posted","684.39"
"4/17/2024","","Recurring Withdrawal Adjustment - Debit Card Credit Voucher/APPLE.COM/BILL 866-712-7753 CADate 04/17/24 0 4108973748 0 5818Card 1231","","2.21","Posted","761.53"
"4/17/2024","","Recurring Withdrawal Debit Card - MC Debit Seminol/LINKTREE* LINKTREE DOVER DEDate 04/16/24 0 4107289275 0 7399Card 1231","9","","Posted","759.32"
"4/17/2024","","Recurring Withdrawal Debit Card - MC Debit Seminol/SUPERPOWER CHATGPT MIDDLETOWN DEDate 04/17/24 0 4108980411 0 5734Card 1231","15","","Posted","768.32"
"4/17/2024","","Recurring Withdrawal Debit Card - MC Debit Seminol/OPENAI SAN FRANCISC CADate 04/16/24 0 4107145993 0 5734Card 1231","10","","Posted","783.32"
"4/17/2024","","Withdrawal Debit Card Fee/MASTERCARD ISSUER CROSS-BORDER FEEDate 04/16/24 0 4107738492 1 5815Card 1231","0.06","","Posted","793.32"
"4/17/2024","","Withdrawal Debit Card MC Debit Seminol/PHOTOPEA.COM KOSTELEC NAD CZDate 04/16/24 0 4107738492 1 5815Card 1231","7.68","","Posted","793.38"
"4/17/2024","","Recurring Withdrawal Debit Card - MC Debit Seminol/MYDESIGNS - PRO - MON LAS VEGAS NVDate 04/16/24 0 4107736414 1 5734Card 1231","29.99","","Posted","801.06"
"4/17/2024","","Recurring Withdrawal Debit Card - MC Debit Seminol/PADDLE.NET* LEONARDOAI ASTORIA NYDate 04/16/24 0 4107288953 0 5817Card 1231","9","","Posted","831.05"
"4/17/2024","","Recurring Withdrawal Debit Card Fee/MASTERCARD ISSUER CROSS-BORDER FEEDate 04/17/24 0 4108978436 0 5734Card 1231","0.16","","Posted","840.05"
"4/17/2024","","Recurring Withdrawal Debit Card - MC Debit Seminol/IDEOGRAM.AI TORONTO ONDate 04/17/24 0 4108978436 0 5734Card 1231","20","","Posted","840.21"
"4/17/2024","","Recurring Withdrawal Debit Card Fee/MASTERCARD ISSUER CROSS-BORDER FEEDate 04/17/24 0 4108978435 0 5734Card 1231","0.39","","Posted","860.21"
"4/17/2024","","Recurring Withdrawal Debit Card - MC Debit Seminol/BROWSE.AI PLAN BURNABY BCDate 04/17/24 0 4108978435 0 5734Card 1231","48.75","","Posted","860.6"
"4/17/2024","","Recurring Withdrawal Debit Card - MC Debit Seminol/APPLE.COM/BILL 866-712-7753 CADate 04/17/24 0 4108973709 0 5818Card 1231","6.99","","Posted","909.35"
"4/17/2024","","Recurring Withdrawal Debit Card - MC Debit Seminol/APPLE.COM/BILL 866-712-7753 CADate 04/17/24 0 4108973707 0 5818Card 1231","10.99","","Posted","916.34"
"4/17/2024","","Withdrawal POS #041705070341/PAYPAL *FASTSPRING 2211 North FirstSan Jose CACard 1231","15","","Posted","927.33"
"4/17/2024","","Withdrawal POS #000000796638/SUNOCO 8002212501 4234 SW 20TH AVEGAINESVILLE FLCard 1231","41.1","","Posted","942.33"
"4/16/2024","","Recurring Withdrawal Debit Card - MC Debit Seminol/PADDLE.NET* SETAPP ASTORIA NYDate 04/15/24 0 4106277865 0 5817Card 1231","12.49","","Posted","983.43"
"4/16/2024","","Withdrawal Debit Card MC Debit Seminol/LYFT *2 RIDES 04-14 SAN FRANCISC CADate 04/15/24 0 4106835374 0 4121Card 1231","31.52","","Posted","995.92"
"4/16/2024","","Withdrawal Debit Card MC Debit Seminol/IDEOGRAM.AI TORONTO ONDate 04/15/24 0 4106835174 0 5734Card 1231","0.58","","Posted","1027.44"
"4/16/2024","","Withdrawal POS #000006227588/PAYPAL *SOCIALBLADE 2211 North FirstStreet San Jose CACard 1231","3.99","","Posted","1028.02"
"4/16/2024","","Withdrawal POS #000000665593/SUNOCO 8002212501 4234 SW 20TH AVEGAINESVILLE FLCard 1231","37.42","","Posted","1032.01"
"4/15/2024","","Recurring Withdrawal Debit Card - MC Debit Seminol/MIDJOURNEY INC. SOUTH SAN FR CADate 04/14/24 0 4105078963 1 5734Card 1231","10","","Posted","1069.43"
"4/15/2024","","Recurring Withdrawal Debit Card Fee/MASTERCARD ISSUER CROSS-BORDER FEEDate 04/15/24 0 4106077756 1 5734Card 1231","0.13","","Posted","1079.43"
"4/15/2024","","Recurring Withdrawal Debit Card - MC Debit Seminol/VANCEAI CENTRAL HODate 04/15/24 0 4106077756 1 5734Card 1231","15.9","","Posted","1079.56"
"4/15/2024","","Withdrawal Debit Card MC Debit Seminol/WALGREENS #5024 GAINESVILLE FLDate 04/14/24 0 4105827629 0 5912Card 1231","16.39","","Posted","1095.46"
"4/15/2024","","Withdrawal POS #000001042040/PAYPAL *PLAYSTATION 2211 North FirstStreet San Jose CACard 1231","14.99","","Posted","1111.85"
"4/15/2024","","Withdrawal POS #000012007844/PAYPAL *PLAYSTATION 2211 North FirstStreet San Jose CACard 1231","24.99","","Posted","1126.84"
"4/14/2024","","Withdrawal POS #000000590860/SUNOCO 8002212501 4234 SW 20TH AVEGAINESVILLE FLCard 1231","25.96","","Posted","1151.83"
"4/14/2024","","Withdrawal Debit Card MC Debit Seminol/LYFT *2 RIDES 04-11 SAN FRANCISC CADate 04/12/24 0 4103370191 0 4121Card 1231","38.92","","Posted","1177.79"
"4/14/2024","","Recurring Withdrawal Debit Card - MC Debit Seminol/APPLE.COM/BILL 866-712-7753 CADate 04/13/24 0 4104933092 1 5818Card 1231","22.47","","Posted","1216.71"
"4/12/2024","","Withdrawal POS #000000773144/INSTACART*159 WWW.INSTACART.COM/ SANFRANCISCO CACard 1231","5","","Posted","1239.18"
"4/12/2024","","Withdrawal POS #000000772370/INSTACART*159 WWW.INSTACART.COM/ SANFRANCISCO CACard 1231","90","","Posted","1244.18"
"4/12/2024","","Withdrawal POS #000000518066/SUNOCO 8002212501 4234 SW 20TH AVEGAINESVILLE FLCard 1231","30.7","","Posted","1334.18"
"4/10/2024","","Withdrawal POS #000000618024/SUNOCO 8002212501 4234 SW 20TH AVEGAINESVILLE FLCard 1231","37.78","","Posted","1364.88"
"4/10/2024","","Deposit Home Banking Transfer/From CHAPLINSKI,LEON 3496297 Share 0000Funds Transfer via Mobile","","500","Posted","1402.66"
"4/10/2024","","Withdrawal Debit Card MC Debit Seminol/LYFT *1 RIDE 04-08 SAN FRANCISC CADate 04/09/24 0 4100802332 0 4121Card 1231","8.67","","Posted","902.66"
"4/10/2024","","Withdrawal ACH FLUENT-Gainesvil/TYPE: PAYMENT ID: 1371804719CO: FLUENT-GainesvilNAME: steven chaplinskiEntry Class Code: WEB","49","","Posted","911.33"
"4/9/2024","","Withdrawal POS #000000000009/INSTACART*159 WWW.INSTACART.COM/ SANFRANCISCO CACard 1231","3","","Posted","960.33"
"4/9/2024","","Withdrawal POS #000000804440/INSTACART*159 WWW.INSTACART.COM/ SANFRANCISCO CACard 1231","89.91","","Posted","963.33"
"4/8/2024","","Withdrawal ATM Fee/FLUENT DISPE-375207 3400 SW 34TH STREETGAINESVILLE FLCard 1231","2","","Posted","1053.24"
"4/8/2024","","Withdrawal at ATM #000000001720/FLUENT DISPE-375207 3400 SW 34TH STREETGAINESVILLE FLCard 1231","23","","Posted","1055.24"
"4/8/2024","","Withdrawal ATM Fee/INQ FLUENT DISPE-375207 3400 SW 34THSTREET GAINESVILLE FLCard 1231","1","","Posted","1078.24"
"4/8/2024","","Withdrawal Debit Card MC Debit Seminol/WALGREENS #5024 GAINESVILLE FLDate 04/07/24 0 4098790166 0 5912Card 1231","23.78","","Posted","1079.24"
"4/7/2024","","Withdrawal POS #000000000072/IC* INSTACART*159 WWW.INSTACART.COM/ SANFRANCISCO CACard 1231","5","","Posted","1103.02"
"4/7/2024","","Withdrawal POS #000000000004/IC* INSTACART*159 WWW.INSTACART.COM/ SANFRANCISCO CACard 1231","56.68","","Posted","1108.02"
"4/7/2024","","Withdrawal POS #000000372860/SUNOCO 8002212501 4234 SW 20TH AVEGAINESVILLE FLCard 1231","37.78","","Posted","1164.7"
"4/6/2024","","Recurring Withdrawal Bill Payment - #000000078357/NETFLIX COM LOS GATOS CACard 1231","13.81","","Posted","1202.48"
"4/5/2024","","Recurring Withdrawal Debit Card - MC Debit Seminol/CHATGPT SUBSCRIPTION SAN FRANCISC CADate 04/04/24 0 4095278410 0 5734Card 1231","20","","Posted","1216.29"
"4/5/2024","","Withdrawal Debit Card MC Debit Seminol/COX GAINESVILLE COMM 800-234-3993 FLDate 04/04/24 0 4095901317 0 4899Card 1231","126.13","","Posted","1236.29"
"4/5/2024","","Withdrawal Bill Payment #000009078159/PAYPAL *PARAMNTPLUS 2211 North FirstStreet San Jose CACard 1231","13.81","","Posted","1362.42"
"4/4/2024","","Recurring Withdrawal Debit Card - MC Debit Seminol/APPLE.COM/BILL CUPERTINO CADate 04/03/24 0 4094830660 0 5735Card 1231","2.99","","Posted","1376.23"
"4/4/2024","","Withdrawal Bill Payment #000000253521/GRU EZ PAY 301 SE 4TH AVE US GAINESVILLEFLCard 1231","137.08","","Posted","1379.22"
"4/3/2024","","Recurring Withdrawal Debit Card - MC Debit Seminol/DOCSIUM.COM SANTA CLARA CADate 04/02/24 0 4093105111 1 5734Card 1231","10","","Posted","1516.3"
"4/3/2024","","Recurring Withdrawal Debit Card - MC Debit Seminol/INVIDEO INC COUNTRY OF S DEDate 04/02/24 0 4093284762 0 5734Card 1231","50","","Posted","1526.3"
"4/3/2024","","Recurring Withdrawal Bill Payment - #000000782876/ADOBE PARK AVENUE,345 SAN JOSE CACard 1231","19.99","","Posted","1576.3"
"4/3/2024","","Withdrawal ACH Watson Realty Co/TYPE: WEB PMTS ID: 9000321157CO: Watson Realty CoNAME: Steven chaplinskiEntry Class Code: WEB","1079","","Posted","1596.29"
"4/3/2024","","Withdrawal ACH AppFolio, Inc. F/TYPE: WEB PMTS ID: 9001406550CO: AppFolio, Inc. FNAME: Steven chaplinskiEntry Class Code: WEB","2.49","","Posted","2675.29"
"4/2/2024","","Withdrawal Bill Payment #000011239590/PAYPAL *SPOTIFYUSAI 2211 North FirstStreet San Jose CACard 1231","6.82","","Posted","2677.78"
"4/1/2024","","Withdrawal POS #000000776580/IC* INSTACART*159 WWW.INSTACART.COM/ SANFRANCISCO CACard 1231","5","","Posted","2684.6"
"4/1/2024","","Withdrawal POS #000000000006/IC* INSTACART*159 WWW.INSTACART.COM/ SANFRANCISCO CACard 1231","103","","Posted","2689.6"
"4/1/2024","","Withdrawal POS #000000804240/ETSY, INC. WWW.ETSY.COM/ BROOKLYN NYCard 1231","24.62","","Posted","2792.6"
"3/31/2024","","Withdrawal POS #000000313260/SUNOCO 8002212501 4234 SW 20TH AVEGAINESVILLE FLCard 1231","37.78","","Posted","2817.22"
"3/31/2024","","Deposit Home Banking Transfer expenses/From CHAPLINSKI,LEON 3496297 Share 0090","","2800","Posted","2855"
"3/29/2024","","Withdrawal POS #000000210024/SUNOCO 8002212501 4234 SW 20TH AVEGAINESVILLE FLCard 1231","29.39","","Posted","55"
"3/29/2024","","Recurring Withdrawal Debit Card - MC Debit Seminol/APPLE.COM/BILL 866-712-7753 CADate 03/28/24 0 4088852714 0 5818Card 1231","2.99","","Posted","84.39"
"3/28/2024","","Withdrawal Debit Card MC Debit Seminol/ZAPIER.COM/CHARGE SAN FRANCISC CADate 03/28/24 0 4088973131 0 5734Card 1231","59.87","","Posted","87.38"
"3/28/2024","","Recurring Withdrawal Debit Card - MC Debit Seminol/NOTION LABS, INC. SAN FRANCISC CADate 03/27/24 0 4087303943 0 7372Card 1231","10","","Posted","147.25"
"3/28/2024","","Recurring Withdrawal Debit Card - MC Debit Seminol/APPLE.COM/BILL 866-712-7753 CADate 03/27/24 0 4087824766 0 5818Card 1231","7.99","","Posted","157.25"
"3/27/2024","","Withdrawal POS #000000030230/SUNOCO 8002212501 4234 SW 20TH AVEGAINESVILLE FLCard 1231","34.24","","Posted","165.24"
"3/27/2024","","Deposit Home Banking Transfer expenses/From CHAPLINSKI,LEON 3496297 Share 0090","","200","Posted","199.48"
"3/27/2024","","Withdrawal Bill Payment #000010368568/PAYPAL *IONOS INC 2211 North FirstSan Jose CACard 1231","17","","Posted","-0.52"
"3/26/2024","","Recurring Withdrawal Debit Card - MC Debit Seminol/OPENAI SAN FRANCISC CADate 03/25/24 0 4085797776 0 5734Card 1231","7","","Posted","16.48"
"3/25/2024","","Withdrawal POS #000000050354/SUNOCO 8002212501 4234 SW 20TH AVEGAINESVILLE FLCard 1231","7.07","","Posted","23.48"
"3/25/2024","","Recurring Withdrawal Debit Card - MC Debit Seminol/FS *ADOBE SANTA BARBAR CADate 03/24/24 0 4084969709 0 5734Card 1231","0.95","","Posted","30.55"
"3/24/2024","","Withdrawal POS #000000933167/SUNOCO 8002212501 4234 SW 20TH AVEGAINESVILLE FLCard 1231","11.81","","Posted","31.5"
"3/24/2024","","Recurring Withdrawal Debit Card - MC Debit Seminol/RUNWAY STANDARD PLAN NEWARK DEDate 03/22/24 0 4082877888 1 5734Card 1231","15","","Posted","43.31"
"3/24/2024","","Recurring Withdrawal Debit Card - MC Debit Seminol/VIDIQ SAN FRANCISC CADate 03/23/24 0 4083879208 0 5734Card 1231","10","","Posted","58.31"
"3/24/2024","","Withdrawal POS #000000892167/SUNOCO 8002212501 4234 SW 20TH AVEGAINESVILLE FLCard 1231","12.07","","Posted","68.31"
"3/22/2024","","Recurring Withdrawal Debit Card - MC Debit Seminol/AIPRM, CORP. WILMINGTON DEDate 03/21/24 0 4081866631 0 5734Card 1231","9.71","","Posted","80.38"
"3/22/2024","","Withdrawal Bill Payment #000009082470/PAYPAL *IONOS INC 2211 North FirstSan Jose CACard 1231","7","","Posted","90.09"
"3/21/2024","","Withdrawal ATM Fee/EFT 3401 W University Ave Gainesville FLCard 1231","2","","Posted","97.09"
"3/21/2024","","Withdrawal at ATM #000000029376/EFT 3401 W University Ave Gainesville FLCard 1231","8","","Posted","99.09"
"3/21/2024","","Withdrawal POS #000000731021/SUNOCO 8002212501 4234 SW 20TH AVEGAINESVILLE FLCard 1231","37.78","","Posted","107.09"
"3/21/2024","","Recurring Withdrawal Debit Card - MC Debit Seminol/CANVA* I04096-42257036 CAMDEN DEDate 03/20/24 0 4080874207 0 7221Card 1231","12.99","","Posted","144.87"
"3/21/2024","","Recurring Withdrawal Debit Card - MC Debit Seminol/TUBEBUDDYCOM 8668823239 CADate 03/20/24 0 4080896528 0 5045Card 1231","7.5","","Posted","157.86"
"3/21/2024","","Deposit Home Banking Transfer cbd/From CHAPLINSKI,LEON 3496297 Share 0090","","100","Posted","165.36"
"3/20/2024","","Withdrawal Debit Card MC Debit Seminol/PRINTIFY.COM WILMINGTON DEDate 03/19/24 0 4079795188 0 7333Card 1231","12.74","","Posted","65.36"
"3/20/2024","","Withdrawal POS #000003210549/GOOGLE *YouTubePremium 1600 AmphitheatreParkw Mountain View CACard 1231","15.92","","Posted","78.1"
"3/19/2024","","Withdrawal POS #000000736878/SUNOCO 8002212501 4234 SW 20TH AVEGAINESVILLE FLCard 1231","37.78","","Posted","94.02"
"3/19/2024","","Withdrawal Debit Card MC Debit Seminol/CHIPOTLE ONLINE CHIPOTLE.COM CADate 03/18/24 0 4078974465 0 5814Card 1231","17.84","","Posted","131.8"
"3/19/2024","","Withdrawal ACH FLUENT-Gainesvil/TYPE: PAYMENT ID: 1371804719CO: FLUENT-GainesvilNAME: steven chaplinskiEntry Class Code: WEB","34","","Posted","149.64"
"3/19/2024","","Withdrawal Bill Payment #000003021539/PAYPAL *HOSTGATOR 2211 North FirstSan Jose CACard 1231","15.99","","Posted","183.64"
"3/18/2024","","Withdrawal Debit Card Fee/MASTERCARD ISSUER CROSS-BORDER FEEDate 03/17/24 0 4077994868 0 5815Card 1231","0.06","","Posted","199.63"
"3/18/2024","","Withdrawal Debit Card MC Debit Seminol/PHOTOPEA.COM KOSTELEC NAD CZDate 03/17/24 0 4077994868 0 5815Card 1231","7.85","","Posted","199.69"
"3/18/2024","","Withdrawal Debit Card MC Debit Seminol/ELEVENLABS.IO NEW YORK NYDate 03/17/24 0 4077908969 0 5734Card 1231","11","","Posted","207.54"
"3/17/2024","","Withdrawal POS #000000000082/CIRCLE K # 26146 3525 GAINESVILLE FLCard 1231","26.57","","Posted","218.54"
"3/17/2024","","Withdrawal Debit Card MC Debit Seminol/LINKTREE* LINKTREE DOVER DEDate 03/17/24 0 4077836772 0 7399Card 1231","9","","Posted","245.11"
"3/17/2024","","Recurring Withdrawal Debit Card - MC Debit Seminol/MYDESIGNS - PRO - MON LAS VEGAS NVDate 03/16/24 0 4076835673 0 5734Card 1231","29.99","","Posted","254.11"
"3/17/2024","","Recurring Withdrawal Debit Card - MC Debit Seminol/PADDLE.NET* LEONARDOAI ASTORIA NYDate 03/16/24 0 4076599401 0 5817Card 1231","9","","Posted","284.1"
"3/17/2024","","Recurring Withdrawal Debit Card Fee/MASTERCARD ISSUER CROSS-BORDER FEEDate 03/17/24 0 4077006794 1 5734Card 1231","0.06","","Posted","293.1"
"3/17/2024","","Recurring Withdrawal Debit Card - MC Debit Seminol/IDEOGRAM.AI TORONTO ONDate 03/17/24 0 4077006794 1 5734Card 1231","8","","Posted","293.16"
"3/17/2024","","Withdrawal Debit Card Fee/MASTERCARD ISSUER CROSS-BORDER FEEDate 03/17/24 0 4077006793 1 5734Card 1231","0.39","","Posted","301.16"
"3/17/2024","","Withdrawal Debit Card MC Debit Seminol/BROWSE.AI PLAN BURNABY BCDate 03/17/24 0 4077006793 1 5734Card 1231","48.75","","Posted","301.55"
"3/17/2024","","Withdrawal Debit Card MC Debit Seminol/WALGREENS #5024 GAINESVILLE FLDate 03/16/24 0 4076002444 1 5912Card 1231","19.99","","Posted","350.3"
"3/17/2024","","Withdrawal POS #031705851390/PAYPAL *FASTSPRING 2211 North FirstSan Jose CACard 1231","15","","Posted","370.29"
"3/17/2024","","Withdrawal POS #000006228614/PAYPAL *HAVOCMARKET HAVOC 2211 NorthStreet San Jose CACard 1231","1.49","","Posted","385.29"
"3/17/2024","","Withdrawal POS #000001014760/PAYPAL *PLAYSTATION 2211 North FirstStreet San Jose CACard 1231","14.99","","Posted","386.78"
"3/17/2024","","Withdrawal POS #000009276996/PAYPAL *PLAYSTATION 2211 North FirstStreet San Jose CACard 1231","39.99","","Posted","401.77"
"3/16/2024","","Withdrawal POS #000000697185/SUNOCO 8002212501 4234 SW 20TH AVEGAINESVILLE FLCard 1231","14.15","","Posted","441.76"
"3/16/2024","","Withdrawal POS #000006245883/PAYPAL *SOCIALBLADE 2211 North FirstStreet San Jose CACard 1231","3.99","","Posted","455.91"
"3/16/2024","","Deposit Home Banking Transfer Maverick/From CHAPLINSKI,LEON 3496297 Share 0000","","150","Posted","459.9"
"3/16/2024","","Withdrawal POS #000065583144/URGENT VET- GAINESVILL 2680 CLARK BUTLERBLVD. GAINESVILLE FLCard 1231","154","","Posted","309.9"
"3/14/2024","","Withdrawal POS #000015057686/WALGREENS 2415 SW 75TH GAINESVILLE FLCard 1231","9.66","","Posted","463.9"
"3/14/2024","","Withdrawal POS #000000555763/SUNOCO 8002212501 4234 SW 20TH AVEGAINESVILLE FLCard 1231","37.78","","Posted","473.56"
"3/13/2024","","Withdrawal POS #000000803119/IC* INSTACART*159 WWW.INSTACART.COM/ SANFRANCISCO CACard 1231","3","","Posted","511.34"
"3/13/2024","","Withdrawal POS #000000782038/Instacart 50 Beal St Suite 600 SanFrancisco CACard 1231","24.94","","Posted","514.34"
"3/13/2024","","Withdrawal POS #000000782026/IC* INSTACART*159 WWW.INSTACART.COM/ SANFRANCISCO CACard 1231","125","","Posted","539.28"
"3/13/2024","","Withdrawal POS #000000488663/SUNOCO 8002212501 4234 SW 20TH AVEGAINESVILLE FLCard 1231","29.5","","Posted","664.28"
"3/13/2024","","Recurring Withdrawal Debit Card - MC Debit Seminol/APPLE.COM/BILL 866-712-7753 CADate 03/13/24 0 4073882836 0 5818Card 1231","18.98","","Posted","693.78"
"3/12/2024","","Recurring Withdrawal Debit Card - MC Debit Seminol/MIDJOURNEY INC. SOUTH SAN FR CADate 03/11/24 0 4071281515 0 5734Card 1231","30","","Posted","712.76"
"3/12/2024","","Withdrawal Debit Card MC Debit Seminol/SCRUBS CARWASH - GAINE GAINESVILLE FLDate 03/11/24 0 4071879202 0 7542Card 1231","3.5","","Posted","742.76"
"3/11/2024","","Withdrawal POS #000000514197/SUNOCO 8002212501 4234 SW 20TH AVEGAINESVILLE FLCard 1231","37.78","","Posted","746.26"
"3/10/2024","","Withdrawal Debit Card MC Debit Seminol/CHIPOTLE ONLINE CHIPOTLE.COM CADate 03/08/24 0 4068694631 2 5814Card 1231","34.68","","Posted","784.04"
"3/10/2024","","Withdrawal Debit Card MC Debit Seminol/WALGREENS #5024 GAINESVILLE FLDate 03/08/24 0 4068690235 2 5912Card 1231","10.81","","Posted","818.72"
"3/9/2024","","Withdrawal POS #000000000008/IC* INSTACART*159 WWW.INSTACART.COM/ SANFRANCISCO CACard 1231","5","","Posted","829.53"
"3/9/2024","","Withdrawal POS #000000000065/IC* INSTACART*159 WWW.INSTACART.COM/ SANFRANCISCO CACard 1231","163.69","","Posted","834.53"
"3/8/2024","","Withdrawal POS #000000221295/SUNOCO 8002212501 4234 SW 20TH AVEGAINESVILLE FLCard 1231","40.7","","Posted","998.22"
"3/8/2024","","Recurring Withdrawal Debit Card - MC Debit Seminol/APPLE.COM/BILL 866-712-7753 CADate 03/08/24 0 4068976803 0 5818Card 1231","2.99","","Posted","1038.92"
"3/7/2024","","Recurring Withdrawal Debit Card - MC Debit Seminol/OPENAI SAN FRANCISC CADate 03/07/24 0 4067912809 0 5734Card 1231","7.74","","Posted","1041.91"
"3/6/2024","","Recurring Withdrawal Debit Card - MC Debit Seminol/PIKA.ART MOUNTAIN VIE CADate 03/05/24 0 4065950684 0 5734Card 1231","10","","Posted","1049.65"
"3/6/2024","","Withdrawal ACH FLUENT-Gainesvil/TYPE: PAYMENT ID: 1371804719CO: FLUENT-GainesvilNAME: steven chaplinskiEntry Class Code: WEB","51.5","","Posted","1059.65"
"3/6/2024","","Recurring Withdrawal Bill Payment - #000000134816/NETFLIX COM LOS GATOS CACard 1231","13.81","","Posted","1111.15"
"3/5/2024","","Withdrawal POS #000000783607/IC* INSTACART*159 WWW.INSTACART.COM/ SANFRANCISCO CACard 1231","5","","Posted","1124.96"
"3/5/2024","","Withdrawal POS #000000000040/IC* INSTACART*159 WWW.INSTACART.COM/ SANFRANCISCO CACard 1231","136.27","","Posted","1129.96"
"3/5/2024","","Recurring Withdrawal Debit Card - MC Debit Seminol/CHATGPT SUBSCRIPTION SAN FRANCISC CADate 03/04/24 0 4064324144 0 5734Card 1231","20","","Posted","1266.23"
"3/5/2024","","Withdrawal Debit Card MC Debit Seminol/COX GAINESVILLE COMM 800-234-3993 FLDate 03/04/24 0 4064754380 0 4899Card 1231","142.8","","Posted","1286.23"
"3/4/2024","","Withdrawal Bill Payment #000000378137/GRU EZ PAY 301 SE 4TH AVE US GAINESVILLEFLCard 1231","165.01","","Posted","1429.03"
"3/4/2024","","Withdrawal POS #000000246748/SUNOCO 8002212501 4234 SW 20TH AVEGAINESVILLE FLCard 1231","34.24","","Posted","1594.04"
"3/4/2024","","Recurring Withdrawal Debit Card - MC Debit Seminol/APPLE.COM/BILL 866-712-7753 CADate 03/03/24 0 4063943695 0 5818Card 1231","2.99","","Posted","1628.28"
"3/4/2024","","Withdrawal ACH Watson Realty Co/TYPE: WEB PMTS ID: 9000321157CO: Watson Realty CoNAME: Steven chaplinskiEntry Class Code: WEB","1079","","Posted","1631.27"
"3/4/2024","","Withdrawal ACH AppFolio, Inc. F/TYPE: WEB PMTS ID: 9001406550CO: AppFolio, Inc. FNAME: Steven chaplinskiEntry Class Code: WEB","2.49","","Posted","2710.27"
"3/3/2024","","Recurring Withdrawal Debit Card - MC Debit Seminol/INVIDEO INC COUNTRY OF S DEDate 03/02/24 0 4062554503 0 5734Card 1231","50","","Posted","2712.76"
"3/3/2024","","Recurring Withdrawal Debit Card - MC Debit Seminol/DOCSIUM.COM SANTA CLARA CADate 03/02/24 0 4062554502 0 5734Card 1231","10","","Posted","2762.76"
"3/3/2024","","Withdrawal Bill Payment #000000795978/Adobe Park Avenue,345 San Jose CACard 1231","19.99","","Posted","2772.76"
"3/2/2024","","Withdrawal Bill Payment #030210607517/PAYPAL *SPOTIFYUSAI 2211 North FirstStreet San Jose CACard 1231","6.82","","Posted","2792.75"
"3/1/2024","","Withdrawal POS #000000784744/ETSY, INC. WWW.ETSY.COM/ BROOKLYN NYCard 1231","17.44","","Posted","2799.57"
"2/29/2024","","Withdrawal POS #000000785940/IC* INSTACART*159 WWW.INSTACART.COM/ SANFRANCISCO CACard 1231","3","","Posted","2817.01"
"2/29/2024","","Withdrawal POS #000000804013/IC* INSTACART*159 WWW.INSTACART.COM/ SANFRANCISCO CACard 1231","122.37","","Posted","2820.01"
"2/28/2024","","Withdrawal Debit Card MC Debit Seminol/ZAPIER.COM/CHARGE SAN FRANCISC CADate 02/27/24 0 4058887137 0 5734Card 1231","29.99","","Posted","2942.38"
"2/28/2024","","Recurring Withdrawal Debit Card Fee/MASTERCARD ISSUER CROSS-BORDER FEEDate 02/25/24 0 4056812425 0 4816Card 1231","0.12","","Posted","2972.37"
"2/28/2024","","Recurring Withdrawal Debit Card - MC Debit Seminol/PAYPAL *HOSTINGER 35314369001 CYDate 02/25/24 0 4056812425 0 4816Card 1231","14.98","","Posted","2972.49"
"2/28/2024","","Recurring Withdrawal Debit Card Fee/MASTERCARD ISSUER CROSS-BORDER FEEDate 02/25/24 0 4056812424 0 4816Card 1231","0.02","","Posted","2987.47"
"2/28/2024","","Recurring Withdrawal Debit Card - MC Debit Seminol/PAYPAL *HOSTINGER 35314369001 CYDate 02/25/24 0 4056812424 0 4816Card 1231","2.17","","Posted","2987.49"
"2/28/2024","","Withdrawal Debit Card MC Debit Seminol/CHIPOTLE ONLINE CHIPOTLE.COM CADate 02/27/24 0 4058906372 0 5814Card 1231","32.37","","Posted","2989.66"
"2/28/2024","","Recurring Withdrawal Debit Card - MC Debit Seminol/APPLE.COM/BILL 866-712-7753 CADate 02/28/24 0 4059902873 0 5818Card 1231","14.98","","Posted","3022.03"
"2/28/2024","","Deposit Home Banking Transfer expenses/From CHAPLINSKI,LEON 3496297 Share 0090","","2800","Posted","3037.01"
"2/27/2024","","Withdrawal POS #000000965925/SUNOCO 8002212501 4234 SW 20TH AVEGAINESVILLE FLCard 1231","22.42","","Posted","237.01"
"2/27/2024","","Withdrawal Bill Payment #000009017556/PAYPAL *IONOS INC 2211 North FirstSan Jose CACard 1231","17","","Posted","259.43"
"2/25/2024","","Recurring Withdrawal Debit Card - MC Debit Seminol/SHOPIFY* 218664050 ELK GROVE VI ILDate 02/24/24 0 4055933818 1 5734Card 1231","1","","Posted","276.43"
"2/25/2024","","Recurring Withdrawal Debit Card - MC Debit Seminol/VIDIQ SAN FRANCISC CADate 02/23/24 0 4054865006 1 5734Card 1231","10","","Posted","277.43"
"2/25/2024","","Recurring Withdrawal Debit Card - MC Debit Seminol/FS *ADOBE SANTA BARBAR CADate 02/24/24 0 4055835597 0 5734Card 1231","0.95","","Posted","287.43"
"2/23/2024","","Recurring Withdrawal Debit Card - MC Debit Seminol/RUNWAY STANDARD PLAN NEWARK DEDate 02/22/24 0 4053857135 0 5734Card 1231","15","","Posted","288.38"
"2/23/2024","","Withdrawal Debit Card MC Debit Seminol/IC* INSTACART*159 SAN FRANCISC CADate 02/23/24 0 4054872144 0 5411Card 1231","108.76","","Posted","303.38"
"2/23/2024","","Withdrawal Debit Card MC Debit Seminol/APPLE.COM/BILL CUPERTINO CADate 02/22/24 0 4053853179 0 5735Card 1231","6.99","","Posted","412.14"
"2/23/2024","","Withdrawal POS #000000000006/IC* INSTACART*159 WWW.INSTACART.COM/ SANFRANCISCO CACard 1231","5","","Posted","419.13"
"2/23/2024","","Withdrawal POS #000000768640/SUNOCO 8002212501 4234 SW 20TH AVEGAINESVILLE FLCard 1231","34.24","","Posted","424.13"
"2/22/2024","","Deposit Home Banking Transfer food/From CHAPLINSKI,LEON 3496297 Share 0090","","200","Posted","458.37"
"2/22/2024","","Recurring Withdrawal Debit Card - MC Debit Seminol/AIPRM, CORP. WILMINGTON DEDate 02/21/24 0 4052801927 0 5734Card 1231","9.71","","Posted","258.37"
"2/21/2024","","Recurring Withdrawal Debit Card - MC Debit Seminol/OPENAI SAN FRANCISC CADate 02/21/24 0 4052816296 0 5734Card 1231","15","","Posted","268.08"
"2/21/2024","","Recurring Withdrawal Debit Card - MC Debit Seminol/CANVA* I04067-39730644 CAMDEN DEDate 02/20/24 0 4051830672 0 7221Card 1231","12.99","","Posted","283.08"
"2/21/2024","","Withdrawal Debit Card MC Debit Seminol/CHIPOTLE ONLINE CHIPOTLE.COM CADate 02/20/24 0 4051813723 0 5814Card 1231","17.14","","Posted","296.07"
"2/21/2024","","Withdrawal POS #000000710759/SUNOCO 8002212501 4234 SW 20TH AVEGAINESVILLE FLCard 1231","41.31","","Posted","313.21"
"2/20/2024","","Withdrawal POS #000003336793/GOOGLE *YouTubePremium 1600 AmphitheatreParkw Mountain View CACard 1231","15.92","","Posted","354.52"
"2/19/2024","","Withdrawal Debit Card MC Debit Seminol/IC* INSTACART*159 SAN FRANCISC CADate 02/18/24 0 4049816277 0 5411Card 1231","80","","Posted","370.44"
"2/19/2024","","Withdrawal Adjustment Debit Card - Credit Voucher/ADOBE *PS CREATIVE CL 4085366000 CADate 02/18/24 0 4049811917 0 5734Card 2801","","22.99","Posted","450.44"
"2/19/2024","","Withdrawal Adjustment Debit Card - Credit Voucher/ADOBE *PS CREATIVE CL 4085366000 CADate 02/18/24 0 4049811916 0 5734Card 2801","","22.99","Posted","427.45"
"2/19/2024","","Withdrawal Bill Payment #000003063817/PAYPAL *HOSTGATOR 2211 North FirstSan Jose CACard 1231","15.99","","Posted","404.46"
"2/18/2024","","Withdrawal POS #000005360799/PAYPAL *ETSY INC 2211 North First StreetSan Jose CACard 1231","15","","Posted","420.45"
"2/18/2024","","Withdrawal POS #000000564527/SUNOCO 8002212501 4234 SW 20TH AVEGAINESVILLE FLCard 1231","37.78","","Posted","435.45"
"2/18/2024","","Withdrawal POS #000000793050/IC* INSTACART*159 WWW.INSTACART.COM/ SANFRANCISCO CACard 1231","5","","Posted","473.23"
"2/18/2024","","Withdrawal Debit Card MC Debit Seminol/OPENAI SAN FRANCISC CADate 02/16/24 0 4047896474 1 5734Card 1231","35.09","","Posted","478.23"
"2/18/2024","","Withdrawal Debit Card MC Debit Seminol/INVIDEO INC COUNTRY OF S DEDate 02/16/24 0 4047895344 1 5734Card 1231","20.38","","Posted","513.32"
"2/18/2024","","Withdrawal Debit Card Fee/MASTERCARD ISSUER CROSS-BORDER FEEDate 02/17/24 0 4048895127 1 5734Card 1231","0.06","","Posted","533.7"
"2/18/2024","","Withdrawal Debit Card MC Debit Seminol/IDEOGRAM.AI TORONTO ONDate 02/17/24 0 4048895127 1 5734Card 1231","8","","Posted","533.76"
"2/18/2024","","Recurring Withdrawal Debit Card - MC Debit Seminol/FS *CONTEXTSFORMAC SANTA BARBAR CADate 02/16/24 0 4047893711 1 5734Card 1231","9.99","","Posted","541.76"
"2/18/2024","","Withdrawal Debit Card MC Debit Seminol/WALGREENS #5024 GAINESVILLE FLDate 02/16/24 0 4047928029 1 5912Card 1231","27.97","","Posted","551.75"
"2/18/2024","","Deposit POS #000000785049/Adobe Park Avenue,345 San Jose CACard 1231","","22.99","Posted","579.72"
"2/18/2024","","Withdrawal Bill Payment #000000783899/Adobe Park Avenue,345 San Jose CACard 1231","19.99","","Posted","556.73"
"2/18/2024","","Withdrawal Bill Payment #000000795070/Adobe Park Avenue,345 San Jose CACard 1231","22.99","","Posted","576.72"
"2/17/2024","","Withdrawal POS #021701718368/PAYPAL *FASTSPRING 2211 North FirstSan Jose CACard 1231","15","","Posted","599.71"
"2/17/2024","","Withdrawal Bill Payment #021702810023/PAYPAL *HOSTGATOR 2211 North FirstSan Jose CACard 1231","15.99","","Posted","614.71"
"2/17/2024","","Withdrawal POS #000009211307/PAYPAL *SOCIALBLADE 2211 North FirstStreet San Jose CACard 1231","3.99","","Posted","630.7"
"2/17/2024","","Withdrawal Bill Payment #000008014696/PAYPAL *IONOS INC 2211 North FirstSan Jose CACard 1231","16","","Posted","634.69"
"2/16/2024","","Withdrawal POS #000000570329/SUNOCO 8002212501 4234 SW 20TH AVEGAINESVILLE FLCard 1231","41.31","","Posted","650.69"
"2/16/2024","","Withdrawal Bill Payment #000008363326/PAYPAL *MEDIUM.COM 2211 North FirstSan Jose CACard 1231","50","","Posted","692"
"2/15/2024","","Withdrawal Debit Card MC Debit Seminol/IC* INSTACART*159 SAN FRANCISC CADate 02/14/24 0 4045833788 0 5411Card 1231","97.56","","Posted","742"
"2/15/2024","","Withdrawal Debit Card MC Debit Seminol/LYFT 2 RIDES 02-13 8558659553 CADate 02/14/24 0 4045828699 0 4121Card 1231","31.88","","Posted","839.56"
"2/14/2024","","Withdrawal POS #000000000001/IC* INSTACART*159 WWW.INSTACART.COM/ SANFRANCISCO CACard 1231","3","","Posted","871.44"
"2/14/2024","","Recurring Withdrawal Debit Card - MC Debit Seminol/APPLE.COM/BILL CUPERTINO CADate 02/13/24 0 4044890161 0 5735Card 1231","15.99","","Posted","874.44"
"2/13/2024","","Withdrawal Debit Card MC Debit Seminol/LYFT 2 RIDES 02-11 8558659553 CADate 02/12/24 0 4043681210 0 4121Card 1231","26.29","","Posted","890.43"
"2/13/2024","","Withdrawal ACH FLUENT-Gainesvil/TYPE: PAYMENT ID: 1371804719CO: FLUENT-GainesvilNAME: steven chaplinskiEntry Class Code: WEB","73","","Posted","916.72"
"2/12/2024","","Withdrawal POS #000000325837/SUNOCO 8002212501 4234 SW 20TH AVEGAINESVILLE FLCard 1231","37.78","","Posted","989.72"
"2/12/2024","","Recurring Withdrawal Debit Card - MC Debit Seminol/MIDJOURNEY INC. SOUTH SAN FR CADate 02/11/24 0 4042266296 0 5734Card 1231","30","","Posted","1027.5"
"2/11/2024","","Withdrawal Debit Card MC Debit Seminol/IC* INSTACART*159 SAN FRANCISC CADate 02/09/24 0 4040832330 0 5411Card 1231","130.36","","Posted","1057.5"
"2/11/2024","","Withdrawal Debit Card MC Debit Seminol/LYFT 1 RIDE 02-08 8558659553 CADate 02/09/24 0 4040200188 1 4121Card 1231","14.99","","Posted","1187.86"
"2/9/2024","","Withdrawal POS #000000341143/SUNOCO 8002212501 4234 SW 20TH AVEGAINESVILLE FLCard 1231","36.53","","Posted","1202.85"
"2/9/2024","","Recurring Withdrawal Debit Card - MC Debit Seminol/APPLE.COM/BILL CUPERTINO CADate 02/08/24 0 4039766268 0 5735Card 1231","2.99","","Posted","1239.38"
"2/9/2024","","Withdrawal Debit Card MC Debit Seminol/WALGREENS #5024 GAINESVILLE FLDate 02/08/24 0 4039910522 0 5912Card 1231","10.81","","Posted","1242.37"
"2/9/2024","","Recurring Withdrawal Debit Card - MC Debit Seminol/NETFLIX.COM CADate 02/09/24 0 4040905249 0 4899Card 1231","13.2","","Posted","1253.18"
"2/9/2024","","Withdrawal POS #000000804934/IC* INSTACART*159 WWW.INSTACART.COM/ SANFRANCISCO CACard 1231","5","","Posted","1266.38"
"2/8/2024","","Deposit/Prov Credit MERCADOPAGO*SUPERBUPERCAP.FEDERAL AV Card #2801 Disp ID 30679","","71.46","Posted","1271.38"
"2/8/2024","","Deposit/Prov Credit HAULMER*VENTA DE MALLCL Card #2801 Disp ID 30679","","50.21","Posted","1199.92"
"2/6/2024","","Withdrawal Debit Card MC Debit Seminol/PIKA.ART MOUNTAIN VIE CADate 02/05/24 0 4036916837 0 5734Card 1231","10","","Posted","1149.71"
"2/6/2024","","Withdrawal Debit Card MC Debit Seminol/IC* INSTACART*159 SAN FRANCISC CADate 02/05/24 0 4036668571 0 5411Card 1231","76.44","","Posted","1159.71"
"2/5/2024","","Withdrawal POS #000000235720/SUNOCO 8002212501 4234 SW 20TH AVEGAINESVILLE FLCard 1231","36.53","","Posted","1236.15"
"2/5/2024","","Recurring Withdrawal Debit Card - MC Debit Seminol/CHATGPT SUBSCRIPTION SAN FRANCISC CADate 02/04/24 0 4035267699 0 5734Card 1231","20","","Posted","1272.68"
"2/5/2024","","Withdrawal POS #000000795274/IC* INSTACART*159 WWW.INSTACART.COM/ SANFRANCISCO CACard 1231","3","","Posted","1292.68"
"2/5/2024","","Withdrawal ACH Watson Realty Co/TYPE: WEB PMTS ID: 9000321157CO: Watson Realty CoNAME: Steven chaplinskiEntry Class Code: WEB","1079","","Posted","1295.68"
"2/5/2024","","Withdrawal ACH AppFolio, Inc. F/TYPE: WEB PMTS ID: 9001406550CO: AppFolio, Inc. FNAME: Steven chaplinskiEntry Class Code: WEB","2.49","","Posted","2374.68"
"2/4/2024","","Recurring Withdrawal Debit Card - MC Debit Seminol/INVIDEO INC COUNTRY OF S DEDate 02/02/24 0 4033532725 0 5734Card 1231","10","","Posted","2377.17"
"2/4/2024","","Withdrawal Debit Card MC Debit Seminol/DOCSIUM.COM SANTA CLARA CADate 02/02/24 0 4033532724 0 5734Card 1231","10","","Posted","2387.17"
"2/4/2024","","Withdrawal Debit Card MC Debit Seminol/CHIPOTLE ONLINE CHIPOTLE.COM CADate 02/04/24 0 4035900306 0 5814Card 1231","32.75","","Posted","2397.17"
"2/4/2024","","Recurring Withdrawal Debit Card - MC Debit Seminol/APPLE.COM/BILL 866-712-7753 CADate 02/03/24 0 4034901682 1 5818Card 1231","2.99","","Posted","2429.92"
"2/4/2024","","Withdrawal Debit Card MC Debit Seminol/COX GAINESVILLE COMM 800-234-3993 FLDate 02/03/24 0 4034928536 0 4899Card 1231","76.13","","Posted","2432.91"
"2/4/2024","","Withdrawal Bill Payment #000000776451/Adobe Park Avenue,345 San Jose CACard 1231","29.99","","Posted","2509.04"
"2/3/2024","","Withdrawal Bill Payment #000000317514/GRU EZ PAY 301 SE 4TH AVE US GAINESVILLEFLCard 1231","211.5","","Posted","2539.03"
"2/2/2024","","Withdrawal POS #000000028242/SUNOCO 8002212501 4234 SW 20TH AVEGAINESVILLE FLCard 1231","36.53","","Posted","2750.53"
"2/2/2024","","Withdrawal Bill Payment #000010087462/PAYPAL *SPOTIFYUSAI 2211 North FirstStreet San Jose CACard 1231","6.82","","Posted","2787.06"
"2/1/2024","","Withdrawal Debit Card MC Debit Seminol/IC* INSTACART*159 SAN FRANCISC CADate 02/01/24 0 4032880893 0 5411Card 1231","54.75","","Posted","2793.88"
"2/1/2024","","Withdrawal POS #000000795959/IC* INSTACART*159 WWW.INSTACART.COM/ SANFRANCISCO CACard 1231","5","","Posted","2848.63"
"1/30/2024","","Deposit Home Banking Transfer expenses/From CHAPLINSKI,LEON 3496297 Share 0000","","2800","Posted","2853.63"
"1/29/2024","","Recurring Withdrawal Debit Card - MC Debit Seminol/APPLE.COM/BILL 866-712-7753 CADate 01/29/24 0 4029763045 0 5818Card 1231","2.99","","Posted","53.63"
"1/28/2024","","Withdrawal Debit Card MC Debit Seminol/RUNWAY NEWARK DEDate 01/26/24 0 4026573341 0 5734Card 1231","10","","Posted","56.62"
"1/28/2024","","Withdrawal Debit Card MC Debit Seminol/AIPRM, CORP. WILMINGTON DEDate 01/26/24 0 4026718596 1 5734Card 1231","9.71","","Posted","66.62"
"1/28/2024","","Recurring Withdrawal Debit Card - MC Debit Seminol/SHOPIFY* 214299651 ELK GROVE VI ILDate 01/26/24 0 4026855967 1 5734Card 1231","1","","Posted","76.33"
"1/28/2024","","Withdrawal Debit Card MC Debit Seminol/VIDIQ SAN FRANCISC CADate 01/26/24 0 4026717498 1 5734Card 1231","10","","Posted","77.33"
"1/28/2024","","Recurring Withdrawal Debit Card - MC Debit Seminol/FS *ADOBE SANTA BARBAR CADate 01/27/24 0 4027835930 0 5734Card 1231","0.95","","Posted","87.33"
"1/28/2024","","Recurring Withdrawal Debit Card - MC Debit Seminol/APPLE.COM/BILL 866-712-7753 CADate 01/28/24 0 4028896141 0 5818Card 1231","4.99","","Posted","88.28"
"1/27/2024","","Withdrawal POS #000000330624/SUNOCO 8002212501 4234 SW 20TH AVEGAINESVILLE FLCard 1231","39.21","","Posted","93.27"
"1/26/2024","","Withdrawal Bill Payment #000000737187/EIG*HOSTGATOR.COM WEB*HOSTGATOR.COMBURLINGTON MACard 1231","15.99","","Posted","132.48"
"1/26/2024","","Withdrawal POS #000000000001/IC* INSTACART*159 WWW.INSTACART.COM/ SANFRANCISCO CACard 1231","5","","Posted","148.47"
"1/26/2024","","Withdrawal POS #000000772467/IC* INSTACART*159 WWW.INSTACART.COM/ SANFRANCISCO CACard 1231","83.79","","Posted","153.47"
"1/25/2024","","Withdrawal POS #000000778591/SUNOCO 8002212501 4234 SW 20TH AVEGAINESVILLE FLCard 1231","30.08","","Posted","237.26"
"1/25/2024","","Deposit Home Banking Transfer food/From CHAPLINSKI,LEON 3496297 Share 0090","","200","Posted","267.34"
"1/23/2024","","Withdrawal POS #000000735703/SUNOCO 8002212501 4234 SW 20TH AVEGAINESVILLE FLCard 1231","15.35","","Posted","67.34"
"1/22/2024","","Recurring Withdrawal Debit Card - MC Debit Seminol/RUNWAYML PRO PLAN NEWARK DEDate 01/22/24 0 4022751687 0 5734Card 1231","15","","Posted","82.69"
"1/22/2024","","Recurring Withdrawal Debit Card - MC Debit Seminol/APPLE.COM/BILL 866-712-7753 CADate 01/21/24 0 4021893834 0 5818Card 1231","42.98","","Posted","97.69"
"1/22/2024","","Withdrawal Debit Card MC Debit Seminol/LYFT 2 RIDES 01-20 8558659553 CADate 01/21/24 0 4021891955 0 4121Card 1231","21.14","","Posted","140.67"
"1/21/2024","","Withdrawal Debit Card MC Debit Seminol/CANVA* I04036-26173350 CAMDEN DEDate 01/20/24 0 4020778238 0 7221Card 1231","12.99","","Posted","161.81"
"1/21/2024","","Withdrawal POS #000000806756/IC* INSTACART*159 WWW.INSTACART.COM/ SANFRANCISCO CACard 1231","3","","Posted","174.8"
"1/21/2024","","Withdrawal POS #000000782726/IC* INSTACART*159 WWW.INSTACART.COM/ SANFRANCISCO CACard 1231","65.09","","Posted","177.8"
"1/21/2024","","Withdrawal POS #000000000119/CIRCLE K # 26146 3525 GAINESVILLE FLCard 1231","32.07","","Posted","242.89"
"1/20/2024","","Deposit Home Banking Transfer food/From CHAPLINSKI,LEON 3496297 Share 0090","","200","Posted","274.96"
"1/20/2024","","Withdrawal POS #000006039863/GOOGLE *YouTubePremium 1600 AmphitheatreParkw Mountain View CACard 1231","15.92","","Posted","74.96"
"1/19/2024","","Withdrawal Debit Card MC Debit Seminol/WALGREENS #5024 GAINESVILLE FLDate 01/18/24 0 4018883934 0 5912Card 1231","15","","Posted","90.88"
"1/18/2024","","Withdrawal POS #000020839973/SUNOCO 80022125 GAINESVILLE GAINESVILLECard 1231","36.53","","Posted","105.88"
"1/17/2024","","Deposit ACH ETSY INC/TYPE: PAYOUT ID: 4263863381 CO: ETSY INCEntry Class Code: CCD","","6.3","Posted","142.41"
"1/16/2024","","Withdrawal POS #000000000000/IC* INSTACART*159 WWW.INSTACART.COM/ SANFRANCISCO CACard 1231","3","","Posted","136.11"
"1/16/2024","","Withdrawal POS #000000000071/IC* INSTACART*159 WWW.INSTACART.COM/ SANFRANCISCO CACard 1231","59.11","","Posted","139.11"
"1/16/2024","","Withdrawal POS #000020836462/SUNOCO 80022125 GAINESVILLE GAINESVILLECard 1231","10","","Posted","198.22"
"1/15/2024","","Withdrawal POS #000020834526/SUNOCO 80022125 GAINESVILLE GAINESVILLECard 1231","36.53","","Posted","208.22"
"1/14/2024","","Withdrawal POS #000000792113/IC* INSTACART*159 WWW.INSTACART.COM/ SANFRANCISCO CACard 1231","3","","Posted","244.75"
"1/14/2024","","Withdrawal POS #000000783971/IC* INSTACART*159 WWW.INSTACART.COM/ SANFRANCISCO CACard 1231","62","","Posted","247.75"
"1/14/2024","","Withdrawal POS #000000000017/CIRCLE K # 06782 5237 GAINESVILLE FLCard 1231","31.96","","Posted","309.75"
"1/12/2024","","Withdrawal Debit Card MC Debit Seminol/MIDJOURNEY INC. SOUTH SAN FR CADate 01/11/24 0 4011746894 0 5734Card 1231","30","","Posted","341.71"
"1/11/2024","","Withdrawal POS #000000000113/CIRCLE K # 26162 7302 GAINESVILLE FLCard 1231","28.32","","Posted","371.71"
"1/11/2024","","Withdrawal Debit Card Fee/MASTERCARD ISSUER CROSS-BORDER FEEDate 01/10/24 0 4010873277 0 8999Card 2801","0.57","","Posted","400.03"
"1/11/2024","","Withdrawal Debit Card MC Debit Seminol/MERCADOPAGO*SUPERBUPER CAP.FEDERAL AVDate 01/10/24 0 4010873277 0 8999Card 2801","71.46","","Posted","400.6"
"1/11/2024","","Withdrawal Debit Card Fee/MASTERCARD ISSUER CROSS-BORDER FEEDate 01/10/24 0 4010868194 0 5571Card 2801","0.4","","Posted","472.06"
"1/11/2024","","Withdrawal Debit Card MC Debit Seminol/HAULMER*VENTA DE MALL SANTIAGO CLDate 01/10/24 0 4010868194 0 5571Card 2801","50.21","","Posted","472.46"
"1/11/2024","","Withdrawal ACH KLARNA/TYPE: E4F7Z8C ID: 0514670203 CO: KLARNANAME: steven chaplinskiEntry Class Code: WEB","66.92","","Posted","522.67"
"1/9/2024","","Withdrawal Adjustment Debit Card - Credit Voucher/ETSY.COM*AIAVATAR BROOKLYN NYDate 01/08/24 0 4008758896 0 5699Card 2801","","19.55","Posted","589.59"
"1/9/2024","","Recurring Withdrawal Debit Card - MC Debit Seminol/KDP AUTOMATION LAS VEGAS NVDate 01/09/24 0 4009846213 0 7392Card 2801","14.99","","Posted","570.04"
"1/9/2024","","Recurring Withdrawal Debit Card - MC Debit Seminol/OPENAI SAN FRANCISC CADate 01/08/24 0 4008760800 0 5734Card 2801","5.83","","Posted","585.03"
"1/9/2024","","Withdrawal Debit Card MC Debit Seminol/PAYPAL *PHOTOPEA 4029357733 CADate 01/08/24 0 4008760242 0 5734Card 2801","8.8","","Posted","590.86"
"1/9/2024","","Recurring Withdrawal Debit Card - MC Debit Seminol/MYDESIGNS.IO LAS VEGAS NVDate 01/08/24 0 4008793270 0 5734Card 2801","16.76","","Posted","599.66"
"1/9/2024","","Withdrawal Debit Card MC Debit Seminol/ETSY.COM*AIAVATAR BROOKLYN NYDate 01/08/24 0 4008758895 0 5699Card 2801","11.55","","Posted","616.42"
"1/9/2024","","Recurring Withdrawal Debit Card - MC Debit Seminol/ETSY.COM*AIAVATAR BROOKLYN NYDate 01/08/24 0 4008758894 0 5699Card 2801","14.97","","Posted","627.97"
"1/9/2024","","Recurring Withdrawal Debit Card - MC Debit Seminol/AMAZON PRIME*RT0NZ30U0 AMZN.COM/BIL WADate 01/08/24 0 4008298648 0 5968Card 2801","15.13","","Posted","642.94"
"1/9/2024","","Recurring Withdrawal Debit Card - MC Debit Seminol/APPLE.COM/BILL 866-712-7753 CADate 01/08/24 0 4008756344 0 5818Card 2801","2.99","","Posted","658.07"
"1/9/2024","","Withdrawal POS #000000000001/AMAZON.COM*TK5HF56S1 SEATTLE WACard 2801","36.99","","Posted","661.06"
"1/8/2024","","Recurring Withdrawal Debit Card Fee/MASTERCARD ISSUER CROSS-BORDER FEEDate 01/08/24 0 4008859029 0 5734Card 2801","0.24","","Posted","698.05"
"1/8/2024","","Recurring Withdrawal Debit Card - MC Debit Seminol/ALURA SUBSCRIPTION OSLO DUDate 01/08/24 0 4008859029 0 5734Card 2801","29.99","","Posted","698.29"
"1/8/2024","","Withdrawal Debit Card MC Debit Seminol/PRINTIFY.COM WILMINGTON DEDate 01/07/24 0 4007751687 0 7333Card 2801","26.85","","Posted","728.28"
"1/8/2024","","Withdrawal Debit Card MC Debit Seminol/MYDESIGNS.IO LAS VEGAS NVDate 01/07/24 0 4007751481 0 5734Card 2801","50","","Posted","755.13"
"1/8/2024","","Withdrawal Debit Card Fee/MASTERCARD ISSUER CROSS-BORDER FEEDate 01/07/24 0 4007255515 0 5734Card 2801","0.07","","Posted","805.13"
"1/8/2024","","Withdrawal Debit Card MC Debit Seminol/IDEOGRAM.AI TORONTO ONDate 01/07/24 0 4007255515 0 5734Card 2801","8.38","","Posted","805.2"
"1/8/2024","","Withdrawal Debit Card MC Debit Seminol/ETSY.COM*AIAVATAR BROOKLYN NYDate 01/07/24 0 4007750413 0 5699Card 2801","19.55","","Posted","813.58"
"1/8/2024","","Withdrawal POS #000000000026/INSTACART*159 WWW.INSTACART.COM/ SANFRANCISCO CACard 2801","81.9","","Posted","833.13"
"1/7/2024","","Withdrawal POS #000020838579/SUNOCO 80022125 GAINESVILLE GAINESVILLECard 2801","36.53","","Posted","915.03"
"1/7/2024","","Recurring Withdrawal Debit Card - MC Debit Seminol/D-ID STUDIO WILMINGTON DEDate 01/06/24 0 4006082355 1 7399Card 2801","49","","Posted","951.56"
"1/7/2024","","Recurring Withdrawal Debit Card - MC Debit Seminol/LINKTREE* LINKTREE DOVER DEDate 01/05/24 0 4005830282 1 5734Card 2801","14.99","","Posted","1000.56"
"1/7/2024","","Recurring Withdrawal Debit Card Fee/MASTERCARD ISSUER CROSS-BORDER FEEDate 01/06/24 0 4006875269 0 5815Card 2801","0.31","","Posted","1015.55"
"1/7/2024","","Recurring Withdrawal Debit Card - MC Debit Seminol/PLAY.HT BANGALORE BEDate 01/06/24 0 4006875269 0 5815Card 2801","39","","Posted","1015.86"
"1/7/2024","","Recurring Withdrawal Debit Card - MC Debit Seminol/ELEVENLABS.IO NEW YORK NYDate 01/07/24 0 4007080576 1 5734Card 2801","5","","Posted","1054.86"
"1/7/2024","","Recurring Withdrawal Debit Card - MC Debit Seminol/MARMALEAD, LLC 4079065736 FLDate 01/05/24 0 4005822541 1 5045Card 2801","19","","Posted","1059.86"
"1/6/2024","","Recurring Withdrawal Bill Payment - #000000166582/NETFLIX COM LOS GATOS CACard 2801","13.2","","Posted","1078.86"
"1/5/2024","","Recurring Withdrawal Debit Card - MC Debit Seminol/CHATGPT SUBSCRIPTION SAN FRANCISC CADate 01/04/24 0 4004307990 0 5734Card 2801","20","","Posted","1092.06"
"1/5/2024","","Recurring Withdrawal Debit Card - MC Debit Seminol/WWW.EVERBEE.IO SANTEE CADate 01/05/24 0 4005834841 0 5734Card 2801","29.99","","Posted","1112.06"
"1/5/2024","","Recurring Withdrawal Debit Card - MC Debit Seminol/DISNEY PLUS 8889057888 CADate 01/04/24 0 4004768661 0 4899Card 2801","16.11","","Posted","1142.05"
"1/5/2024","","Withdrawal Debit Card MC Debit Seminol/MAIL.COM 005802235076- PHILADELPHIA PADate 01/04/24 0 4004909282 0 4816Card 2801","14.95","","Posted","1158.16"
"1/5/2024","","Recurring Withdrawal Debit Card - MC Debit Seminol/ADOBE *STOCK 4085366000 CADate 01/04/24 0 4004903002 0 5734Card 2801","29.99","","Posted","1173.11"
"1/4/2024","","Recurring Withdrawal Debit Card - MC Debit Seminol/MINDRENDERS.COM LAPEER MIDate 01/04/24 0 4004883312 0 5734Card 2801","5","","Posted","1203.1"
"1/4/2024","","Withdrawal Debit Card MC Debit Seminol/IONOS INC. CHESTERBROOK PADate 01/03/24 0 4003951251 0 4816Card 2801","1","","Posted","1208.1"
"1/4/2024","","Recurring Withdrawal Debit Card - MC Debit Seminol/APPLE.COM/BILL CUPERTINO CADate 01/03/24 0 4003843327 0 5735Card 2801","2.99","","Posted","1209.1"
"1/4/2024","","Recurring Withdrawal Debit Card - MC Debit Seminol/ADOBE *CREATIVE CLOUD 4085366000 CADate 01/03/24 0 4003945121 0 5734Card 2801","19.99","","Posted","1212.09"
"1/4/2024","","Withdrawal ACH FLUENT-Gainesvil/TYPE: PAYMENT ID: 1371804719CO: FLUENT-GainesvilNAME: steven chaplinskiEntry Class Code: WEB","52","","Posted","1232.08"
"1/3/2024","","Recurring Withdrawal Debit Card - MC Debit Seminol/PARAMOUNT+ SAN FRANCISC CADate 01/02/24 0 4002821550 0 4899Card 2801","13.81","","Posted","1284.08"
"1/3/2024","","Recurring Withdrawal Debit Card Fee/MASTERCARD ISSUER CROSS-BORDER FEEDate 01/02/24 0 4002821343 0 7399Card 2801","0.07","","Posted","1297.89"
"1/3/2024","","Recurring Withdrawal Debit Card - MC Debit Seminol/CREATIVE FABRICA AMSTERDAM NHDate 01/02/24 0 4002821343 0 7399Card 2801","9","","Posted","1297.96"
"1/3/2024","","Deposit ACH ETSY INC/TYPE: PAYOUT ID: 4263863381 CO: ETSY INCEntry Class Code: CCD","","5.34","Posted","1306.96"
"1/2/2024","","Withdrawal POS #010210787460/PAYPAL *SPOTIFYUSAI 2211 North FirstStreet San Jose CACard 2801","6.82","","Posted","1301.62"
"1/2/2024","","Withdrawal POS #000000966158/SUNOCO 8002212501 4234 SW 20TH AVEGAINESVILLE FLCard 2801","34.56","","Posted","1308.44"
"1/2/2024","","Withdrawal POS #000012002801/WALGREENS 3455 SW ARCH GAINESVILLE FLCard 2801","20.38","","Posted","1343"
"1/2/2024","","Recurring Withdrawal Debit Card - MC Debit Seminol/NAME-CHEAP.COM* NNMBEK PHOENIX AZDate 01/01/24 0 4001676508 0 7372Card 2801","10.46","","Posted","1363.38"
"1/2/2024","","Recurring Withdrawal Debit Card - MC Debit Seminol/WPDEVELOPER MILTON DEDate 01/02/24 0 4002616374 0 7372Card 2801","39","","Posted","1373.84"
"1/2/2024","","Recurring Withdrawal Debit Card - MC Debit Seminol/PADDLE.NET* KAIBER AI ASTORIA NYDate 01/01/24 0 4001675678 0 5817Card 2801","15","","Posted","1412.84"
"1/2/2024","","Withdrawal Debit Card MC Debit Seminol/PRINTIFY.COM WILMINGTON DEDate 01/01/24 0 4001649319 0 7333Card 2801","11.21","","Posted","1427.84"
"1/2/2024","","Recurring Withdrawal Debit Card - MC Debit Seminol/FS *ADOBE SANTA BARBAR CADate 01/01/24 0 4001674859 0 5734Card 2801","9.99","","Posted","1439.05"
"1/2/2024","","Withdrawal Debit Card MC Debit Seminol/CHIPOTLE ONLINE CHIPOTLE.COM CADate 01/02/24 0 4002615532 0 5814Card 2801","45","","Posted","1449.04"
"1/2/2024","","Recurring Withdrawal Debit Card - MC Debit Seminol/ADOBE *PS CREATIVE CL 4085366000 CADate 01/01/24 0 4001644620 0 5734Card 2801","22.99","","Posted","1494.04"
"1/2/2024","","Withdrawal ACH Watson Realty Co/TYPE: WEB PMTS ID: 9000321157CO: Watson Realty CoNAME: Steven chaplinskiEntry Class Code: WEB","1079","","Posted","1517.03"
"1/2/2024","","Withdrawal ACH AppFolio, Inc. F/TYPE: WEB PMTS ID: 9001406550CO: AppFolio, Inc. FNAME: Steven chaplinskiEntry Class Code: WEB","2.49","","Posted","2596.03"
"1/1/2024","","Withdrawal Debit Card MC Debit Seminol/INTERNET MARKETING SOL PARKERSBURG WVDate 12/31/23 0 3365856927 0 7392Card 2801","37","","Posted","2598.52"
"1/1/2024","","Recurring Withdrawal Debit Card - MC Debit Seminol/LEMSQZY* KWESTIFY SALT LAKE CI UTDate 12/31/23 0 3365856866 0 5734Card 2801","12","","Posted","2635.52"
"1/1/2024","","Withdrawal Debit Card MC Debit Seminol/INTERNET MARKETING SOL PARKERSBURG WVDate 12/31/23 0 3365227002 0 7392Card 2801","12","","Posted","2647.52"
"1/1/2024","","Withdrawal Debit Card MC Debit Seminol/PIXEL ML, INC. LAS VEGAS NVDate 12/31/23 0 3365226971 0 5734Card 2801","9","","Posted","2659.52"
"1/1/2024","","Withdrawal Debit Card Fee/MASTERCARD ISSUER CROSS-BORDER FEEDate 01/01/24 0 4001856471 0 5734Card 2801","0.12","","Posted","2668.52"
"1/1/2024","","Withdrawal Debit Card MC Debit Seminol/HOSTINGER.COM LARNAKA CYDate 01/01/24 0 4001856471 0 5734Card 2801","14.98","","Posted","2668.64"
"1/1/2024","","Recurring Withdrawal Debit Card - MC Debit Seminol/MYDESIGNS - PRO - MON LAS VEGAS NVDate 01/01/24 0 4001780983 0 5734Card 2801","29.99","","Posted","2683.62"
"1/1/2024","","Recurring Withdrawal Debit Card Fee/MASTERCARD ISSUER CROSS-BORDER FEEDate 12/31/23 0 3365740203 0 5734Card 2801","0.2","","Posted","2713.61"
"1/1/2024","","Recurring Withdrawal Debit Card - MC Debit Seminol/MERCHDOMINATOR.COM LONDON LNDate 12/31/23 0 3365740203 0 5734Card 2801","24.5","","Posted","2713.81"
"1/1/2024","","Recurring Withdrawal Debit Card - MC Debit Seminol/ETSY.COM*AIAVATAR BROOKLYN NYDate 01/01/24 0 4001780812 0 5970Card 2801","21.2","","Posted","2738.31"
"1/1/2024","","Withdrawal Debit Card MC Debit Seminol/ETSY.COM*AIAVATAR BROOKLYN NYDate 01/01/24 0 4001780748 0 5699Card 2801","14.07","","Posted","2759.51"
"1/1/2024","","Withdrawal Debit Card MC Debit Seminol/GRU/EZ-PAY WEB PYMT 352-334-3434 FLDate 12/31/23 0 3365848981 0 4900Card 2801","149.11","","Posted","2773.58"
"1/1/2024","","Withdrawal POS #000000890165/SUNOCO 8002212501 4234 SW 20TH AVEGAINESVILLE FLCard 2801","29.5","","Posted","2922.69"
"1/1/2024","","Deposit ACH STEVEN CHAPLINSK/TYPE: MOBILE DEP CO: STEVEN CHAPLINSKACH Trace Number: 263178470000002","","90","Posted","2952.19"
"12/31/2023","","Recurring Withdrawal Debit Card Fee/MASTERCARD ISSUER CROSS-BORDER FEEDate 12/29/23 0 3363663127 1 5734Card 2801","0.24","","Posted","2862.19"
"12/31/2023","","Recurring Withdrawal Debit Card - MC Debit Seminol/KITTL.COM BERLIN BEDate 12/29/23 0 3363663127 1 5734Card 2801","30","","Posted","2862.43"
"12/31/2023","","Recurring Withdrawal Debit Card Fee/MASTERCARD ISSUER CROSS-BORDER FEEDate 12/29/23 0 3363662310 1 5734Card 2801","0.06","","Posted","2892.43"
"12/31/2023","","Recurring Withdrawal Debit Card - MC Debit Seminol/IDEOGRAM.AI TORONTO ONDate 12/29/23 0 3363662310 1 5734Card 2801","8","","Posted","2892.49"
"12/31/2023","","Withdrawal Debit Card MC Debit Seminol/PLAYSTATIONNETWORK SAN MATEO CADate 12/31/23 0 3365872496 0 5816Card 2801","89.99","","Posted","2900.49"
"12/31/2023","","Withdrawal Debit Card MC Debit Seminol/ETSY.COM*AIAVATAR BROOKLYN NYDate 12/31/23 0 3365776697 0 5699Card 2801","2.5","","Posted","2990.48"
"12/31/2023","","Withdrawal Debit Card MC Debit Seminol/COX GAINESVILLE COMM 800-234-3993 FLDate 12/30/23 0 3364773034 0 4899Card 2801","81.13","","Posted","2992.98"
"12/30/2023","","Withdrawal POS #000000000004/INSTACART*159 WWW.INSTACART.COM/ SANFRANCISCO CACard 2801","134.45","","Posted","3074.11"
"12/30/2023","","Deposit Home Banking Transfer expenses/From CHAPLINSKI,LEON 3496297 Share 0090","","2800","Posted","3208.56"
"12/29/2023","","Recurring Withdrawal Debit Card Fee/MASTERCARD ISSUER CROSS-BORDER FEEDate 12/28/23 0 3362846037 0 5734Card 2801","0.08","","Posted","408.56"
"12/29/2023","","Recurring Withdrawal Debit Card - MC Debit Seminol/TRACEJOURNEY DARMSTADT BEDate 12/28/23 0 3362846037 0 5734Card 2801","10","","Posted","408.64"
"12/29/2023","","Recurring Withdrawal Debit Card Fee/MASTERCARD ISSUER CROSS-BORDER FEEDate 12/29/23 0 3363914191 0 5734Card 2801","0.13","","Posted","418.64"
"12/29/2023","","Recurring Withdrawal Debit Card - MC Debit Seminol/VANCEAI CENTRAL HODate 12/29/23 0 3363914191 0 5734Card 2801","15.9","","Posted","418.77"
"12/28/2023","","Recurring Withdrawal Debit Card Fee/MASTERCARD ISSUER CROSS-BORDER FEEDate 12/28/23 0 3362741008 0 5734Card 2801","0.16","","Posted","434.67"
"12/28/2023","","Recurring Withdrawal Debit Card - MC Debit Seminol/ETSYHUNT TECH SINGAPORE SGDate 12/28/23 0 3362741008 0 5734Card 2801","19.99","","Posted","434.83"
"12/27/2023","","Withdrawal Debit Card MC Debit Seminol/IONOS INC. CHESTERBROOK PADate 12/26/23 0 3360761872 0 4816Card 2801","16","","Posted","454.82"
"12/27/2023","","Withdrawal ACH KLARNA/TYPE: E4F7Z8C ID: 0514670203 CO: KLARNANAME: steven chaplinskiEntry Class Code: WEB","66.92","","Posted","470.82"
"12/26/2023","","Withdrawal Debit Card MC Debit Seminol/WWW.DARBEE.IO MOUNT PROSPE ILDate 12/25/23 0 3359421946 0 5734Card 2801","8","","Posted","537.74"
"12/26/2023","","Recurring Withdrawal Debit Card - MC Debit Seminol/SHOPIFY* 209984801 ELK GROVE VI ILDate 12/26/23 0 3360264224 0 5734Card 2801","1","","Posted","545.74"
"12/26/2023","","Withdrawal Debit Card MC Debit Seminol/PADDLE.NET* REBRANDY ASTORIA NYDate 12/25/23 0 3359421538 0 5817Card 2801","10.99","","Posted","546.74"
"12/25/2023","","Withdrawal POS #000000677826/WAWA 5323 4322 SW ARCHER RD GAINESVILLECard 2801","30.52","","Posted","557.73"
"12/25/2023","","Recurring Withdrawal Debit Card - MC Debit Seminol/QUILLBOT OAK BROOK ILDate 12/25/23 0 3359752154 0 5734Card 2801","19.95","","Posted","588.25"
"12/25/2023","","Withdrawal Debit Card MC Debit Seminol/CHIPOTLE ONLINE CHIPOTLE.COM CADate 12/25/23 0 3359751543 0 5814Card 2801","13.19","","Posted","608.2"
"12/24/2023","","Recurring Withdrawal Debit Card Fee/MASTERCARD ISSUER CROSS-BORDER FEEDate 12/24/23 0 3358055608 1 5734Card 2801","0.07","","Posted","621.39"
"12/24/2023","","Recurring Withdrawal Debit Card - MC Debit Seminol/DRIVE EXPLORER ADDON MADURAI TNDate 12/24/23 0 3358055608 1 5734Card 2801","9","","Posted","621.46"
"12/24/2023","","Withdrawal Debit Card MC Debit Seminol/MYDESIGNS.IO LAS VEGAS NVDate 12/23/23 0 3357067234 2 5734Card 2801","16","","Posted","630.46"
"12/24/2023","","Recurring Withdrawal Debit Card - MC Debit Seminol/PADDLE.NET* BAVARIA2TM ASTORIA NYDate 12/22/23 0 3356595223 0 5817Card 2801","39.95","","Posted","646.46"
"12/24/2023","","Withdrawal Debit Card MC Debit Seminol/MYDESIGNS.IO LAS VEGAS NVDate 12/22/23 0 3356016708 2 5734Card 2801","16","","Posted","686.41"
"12/24/2023","","Recurring Withdrawal Debit Card - MC Debit Seminol/VIDIQ SAN FRANCISC CADate 12/23/23 0 3357950683 0 5734Card 2801","10","","Posted","702.41"
"12/24/2023","","Recurring Withdrawal Debit Card Fee/MASTERCARD ISSUER CROSS-BORDER FEEDate 12/23/23 0 3357950389 0 5734Card 2801","0.04","","Posted","712.41"
"12/24/2023","","Recurring Withdrawal Debit Card - MC Debit Seminol/IMAGINEAPI.DEV EDMONTON ABDate 12/23/23 0 3357950389 0 5734Card 2801","5","","Posted","712.45"
"12/24/2023","","Recurring Withdrawal Debit Card Fee/MASTERCARD ISSUER CROSS-BORDER FEEDate 12/22/23 0 3356066505 2 5734Card 2801","0.15","","Posted","717.45"
"12/24/2023","","Recurring Withdrawal Debit Card - MC Debit Seminol/AU UP ADACHIKU TODate 12/22/23 0 3356066505 2 5734Card 2801","19","","Posted","717.6"
"12/24/2023","","Withdrawal Debit Card MC Debit Seminol/SAMSUNG ELECTRONICS RIDGEFIELD P NJDate 12/22/23 0 3356065481 2 5734Card 2801","15.99","","Posted","736.6"
"12/24/2023","","Withdrawal POS #000000000015/CIRCLE K # 06782 5237 GAINESVILLE FLCard 2801","24.33","","Posted","752.59"
"12/23/2023","","Withdrawal POS #000002040482/GOOGLE *Google Storage 1600 AmphitheatreParkw Mountain View CACard 2801","1.99","","Posted","776.92"
"12/22/2023","","Withdrawal POS #000000512490/SUNOCO 8002212501 4234 SW 20TH AVEGAINESVILLE FLCard 2801","38.1","","Posted","778.91"
"12/22/2023","","Recurring Withdrawal Debit Card - MC Debit Seminol/SOCIETY6.COM SANTA MONICA CADate 12/22/23 0 3356093278 1 7333Card 2801","4.99","","Posted","817.01"
"12/22/2023","","Recurring Withdrawal Debit Card - MC Debit Seminol/AIPRM, CORP. WILMINGTON DEDate 12/21/23 0 3355965402 0 5734Card 2801","9","","Posted","822"
"12/22/2023","","Recurring Withdrawal Debit Card - MC Debit Seminol/PADDLE.NET* BAVARIA2TM ASTORIA NYDate 12/22/23 0 3356092061 1 5817Card 2801","19.95","","Posted","831"
"12/22/2023","","Recurring Withdrawal Debit Card - MC Debit Seminol/PADDLE.NET* BAVARIA2TM ASTORIA NYDate 12/21/23 0 3355092060 1 5817Card 2801","49.95","","Posted","850.95"
"12/22/2023","","Recurring Withdrawal Debit Card - MC Debit Seminol/WWW.MAKE.COM NEW YORK NYDate 12/21/23 0 3355964412 0 5734Card 2801","10.59","","Posted","900.9"
"12/22/2023","","Withdrawal Debit Card MC Debit Seminol/ETSY.COM*AIAVATAR BROOKLYN NYDate 12/22/23 0 3356021599 1 5970Card 2801","17.03","","Posted","911.49"
"12/22/2023","","Withdrawal ACH FLUENT-Gainesvil/TYPE: PAYMENT ID: 1371804719CO: FLUENT-GainesvilNAME: steven chaplinskiEntry Class Code: WEB","140.4","","Posted","928.52"
"12/21/2023","","Recurring Withdrawal Debit Card - MC Debit Seminol/SUPERPOWER CHATGPT MIDDLETOWN DEDate 12/20/23 0 3354887306 0 5734Card 2801","15.19","","Posted","1068.92"
"12/21/2023","","Withdrawal Debit Card MC Debit Seminol/YVETTE GODET DMD PA GAINESVILLE FLDate 12/20/23 0 3354886410 0 8021Card 2801","90","","Posted","1084.11"
"12/21/2023","","Recurring Withdrawal Debit Card - MC Debit Seminol/CANVA* I04005-37462786 CAMDEN DEDate 12/20/23 0 3354886372 0 7221Card 2801","12.99","","Posted","1174.11"
"12/21/2023","","Withdrawal Debit Card MC Debit Seminol/WALGREENS #9304 GAINESVILLE FLDate 12/20/23 0 3354958966 0 5912Card 2801","12.97","","Posted","1187.1"
"12/21/2023","","Withdrawal Debit Card MC Debit Seminol/WALGREENS #5024 GAINESVILLE FLDate 12/20/23 0 3354958934 0 5912Card 2801","15","","Posted","1200.07"
"12/21/2023","","Deposit Home Banking Transfer dentist/From CHAPLINSKI,LEON 3496297 Share 0090","","90","Posted","1215.07"
"12/20/2023","","Withdrawal POS #000000030009/PUBLIX 3930 SW ARCHER ROAD GAINESVILLECard 2801","179.55","","Posted","1125.07"
"12/20/2023","","Withdrawal POS #000000546857/SUNOCO 8002212501 4234 SW 20TH AVEGAINESVILLE FLCard 2801","22.53","","Posted","1304.62"
"12/20/2023","","Withdrawal POS #000003048219/GOOGLE *YouTubePremium 1600 AmphitheatreParkw Mountain View CACard 2801","15.92","","Posted","1327.15"
"12/19/2023","","Withdrawal POS #000019162189/WALGREENS 2415 SW 75TH GAINESVILLE FLCard 2801","11.81","","Posted","1343.07"
"12/19/2023","","Withdrawal POS #000000501588/SUNOCO 8002212501 4234 SW 20TH AVEGAINESVILLE FLCard 2801","20.68","","Posted","1354.88"
"12/19/2023","","Recurring Withdrawal Debit Card - MC Debit Seminol/MYDESIGNS.IO LAS VEGAS NVDate 12/18/23 0 3352803630 0 5734Card 2801","26.04","","Posted","1375.56"
"12/19/2023","","Withdrawal POS #000000494960/SUNOCO 8002212501 4234 SW 20TH AVEGAINESVILLE FLCard 2801","30.81","","Posted","1401.6"
"12/19/2023","","Withdrawal Bill Payment #000000478995/EIG*HOSTGATOR.COM WEB*HOSTGATOR.COMBURLINGTON MACard 2801","31.98","","Posted","1432.41"
"12/18/2023","","Recurring Withdrawal Debit Card - MC Debit Seminol/TUBEBUDDYCOM 8668823239 CADate 12/17/23 0 3351973822 0 5734Card 2801","7.5","","Posted","1464.39"
"12/17/2023","","Recurring Withdrawal Debit Card - MC Debit Seminol/HELLOCUSTOM REDDING CADate 12/16/23 0 3350121941 2 5734Card 2801","29.99","","Posted","1471.89"
"12/17/2023","","Withdrawal Debit Card MC Debit Seminol/WWW.VIVOPRINT.COM FREMONT CADate 12/15/23 0 3349081630 2 5399Card 2801","22.26","","Posted","1501.88"
"12/16/2023","","Withdrawal POS #000000795671/IC* INSTACART*159 WWW.INSTACART.COM/ SANFRANCISCO CACard 2801","75.79","","Posted","1524.14"
"12/16/2023","","Withdrawal POS #000000776371/IC* INSTACART*159 WWW.INSTACART.COM/ SANFRANCISCO CACard 2801","5","","Posted","1599.93"
"12/16/2023","","Withdrawal POS #000000296387/SUNOCO 8002212501 4234 SW 20TH AVEGAINESVILLE FLCard 2801","21.91","","Posted","1604.93"
"12/15/2023","","Deposit Home Banking Transfer xmas/From CHAPLINSKI,LEON 3496297 Share 0090","","100","Posted","1626.84"
"12/15/2023","","Withdrawal POS #000000291004/SUNOCO 8002212501 4234 SW 20TH AVEGAINESVILLE FLCard 2801","33.72","","Posted","1526.84"
"12/14/2023","","Recurring Withdrawal Debit Card - MC Debit Seminol/APPLE.COM/BILL 866-712-7753 CADate 12/13/23 0 3347838871 0 5818Card 2801","39.99","","Posted","1560.56"
"12/14/2023","","Withdrawal ACH KLARNA/TYPE: E4F7Z8C ID: 0514670203 CO: KLARNANAME: steven chaplinskiEntry Class Code: WEB","66.92","","Posted","1600.55"
"12/13/2023","","Withdrawal Debit Card MC Debit Seminol/PLAYSTATIONNETWORK SAN MATEO CADate 12/12/23 0 3346849436 0 5816Card 2801","39.99","","Posted","1667.47"
"12/13/2023","","Recurring Withdrawal Debit Card - MC Debit Seminol/APPLE.COM/BILL 866-712-7753 CADate 12/13/23 0 3347983231 0 5818Card 2801","2.99","","Posted","1707.46"
"12/13/2023","","Withdrawal ACH FLUENT-Gainesvil/TYPE: PAYMENT ID: 1371804719CO: FLUENT-GainesvilNAME: steven chaplinskiEntry Class Code: WEB","53.5","","Posted","1710.45"
"12/12/2023","","Recurring Withdrawal Debit Card - MC Debit Seminol/OPUS CLIP REDWOOD CITY CADate 12/11/23 0 3345860166 0 7372Card 2801","19","","Posted","1763.95"
"12/12/2023","","Withdrawal Debit Card Fee/MASTERCARD ISSUER CROSS-BORDER FEEDate 12/12/23 0 3346905405 0 5734Card 2801","0.08","","Posted","1782.95"
"12/12/2023","","Withdrawal Debit Card MC Debit Seminol/WWW.STABILITY.AI LONDON LNDate 12/12/23 0 3346905405 0 5734Card 2801","10","","Posted","1783.03"
"12/12/2023","","Withdrawal Debit Card MC Debit Seminol/SCRUBS CARWASH - GAINE GAINESVILLE FLDate 12/11/23 0 3345931229 0 7542Card 2801","5.75","","Posted","1793.03"
"12/11/2023","","Withdrawal POS #000000067493/PUBLIX 3930 SW ARCHER ROAD GAINESVILLECard 2801","108.61","","Posted","1798.78"
"12/11/2023","","Recurring Withdrawal Debit Card - MC Debit Seminol/MIDJOURNEY INC. SOUTH SAN FR CADate 12/10/23 0 3344002786 1 5734Card 2801","30","","Posted","1907.39"
"12/11/2023","","Withdrawal POS #000000074576/SUNOCO 8002212501 4234 SW 20TH AVEGAINESVILLE FLCard 2801","33.62","","Posted","1937.39"
"12/10/2023","","Withdrawal Debit Card MC Debit Seminol/WALGREENS #9304 GAINESVILLE FLDate 12/08/23 0 3342073508 2 5912Card 2801","26.79","","Posted","1971.01"
"12/10/2023","","Withdrawal Debit Card MC Debit Seminol/AMAZON PRIME*PE3IN5Y03 AMZN.COM/BIL WADate 12/08/23 0 3342550116 0 5968Card 2801","15.15","","Posted","1997.8"
"12/8/2023","","Withdrawal POS #000000788111/PUBLIX 3100 SW 35TH BLVD GAINESVILLE FLCard 2801","58.29","","Posted","2012.95"
"12/8/2023","","Recurring Withdrawal Debit Card Fee/MASTERCARD ISSUER CROSS-BORDER FEEDate 12/08/23 0 3342028707 1 5734Card 2801","0.24","","Posted","2071.24"
"12/8/2023","","Recurring Withdrawal Debit Card - MC Debit Seminol/ALURA SUBSCRIPTION OSLO DUDate 12/08/23 0 3342028707 1 5734Card 2801","29.99","","Posted","2071.48"
"12/8/2023","","Recurring Withdrawal Debit Card - MC Debit Seminol/LASTPASS.COM MADate 12/07/23 0 3341331845 0 5968Card 2801","36","","Posted","2101.47"
"12/7/2023","","Recurring Withdrawal Debit Card - MC Debit Seminol/D-ID STUDIO WILMINGTON DEDate 12/06/23 0 3340019761 1 7399Card 2801","49","","Posted","2137.47"
"12/7/2023","","Recurring Withdrawal Debit Card - MC Debit Seminol/OPENAI SAN FRANCISC CADate 12/06/23 0 3340019724 1 5734Card 2801","0.63","","Posted","2186.47"
"12/7/2023","","Recurring Withdrawal Debit Card Fee/MASTERCARD ISSUER CROSS-BORDER FEEDate 12/06/23 0 3340942652 0 5815Card 2801","0.31","","Posted","2187.1"
"12/7/2023","","Recurring Withdrawal Debit Card - MC Debit Seminol/PLAY.HT BANGALORE BEDate 12/06/23 0 3340942652 0 5815Card 2801","39","","Posted","2187.41"
"12/7/2023","","Recurring Withdrawal Debit Card - MC Debit Seminol/ELEVENLABS.IO NEW YORK NYDate 12/07/23 0 3341924592 0 5734Card 2801","5","","Posted","2226.41"
"12/7/2023","","Recurring Withdrawal Debit Card - MC Debit Seminol/NETFLIX.COM CADate 12/06/23 0 3340936032 0 4899Card 2801","13.2","","Posted","2231.41"
"12/6/2023","","Withdrawal Debit Card MC Debit Seminol/WWW.VIVOPRINT.COM FREMONT CADate 12/05/23 0 3339923190 0 5399Card 2801","18.97","","Posted","2244.61"
"12/6/2023","","Recurring Withdrawal Debit Card Fee/MASTERCARD ISSUER CROSS-BORDER FEEDate 12/06/23 0 3340923092 0 5734Card 2801","0.12","","Posted","2263.58"
"12/6/2023","","Recurring Withdrawal Debit Card - MC Debit Seminol/LINKTREE* LINKTREE COLLINGWOOD VIDate 12/06/23 0 3340923092 0 5734Card 2801","14.99","","Posted","2263.7"
"12/6/2023","","Recurring Withdrawal Debit Card - MC Debit Seminol/APPLE.COM/BILL 866-712-7753 CADate 12/06/23 0 3340922343 0 5818Card 2801","5.98","","Posted","2278.69"
"12/6/2023","","Recurring Withdrawal Debit Card - MC Debit Seminol/APPLE.COM/BILL 866-712-7753 CADate 12/06/23 0 3340921934 0 5818Card 2801","2.99","","Posted","2284.67"
"12/6/2023","","Withdrawal Debit Card MC Debit Seminol/GRU/EZ-PAY WEB PYMT 352-334-3434 FLDate 12/05/23 0 3339324917 0 4900Card 2801","136.45","","Posted","2287.66"
"12/6/2023","","Withdrawal Debit Card MC Debit Seminol/COX GAINESVILLE COMM 800-234-3993 FLDate 12/05/23 0 3339324895 0 4899Card 2801","159.46","","Posted","2424.11"
"12/6/2023","","Recurring Withdrawal Debit Card - MC Debit Seminol/MARMALEAD, LLC 4079065736 FLDate 12/05/23 0 3339916108 0 5045Card 2801","19","","Posted","2583.57"
"12/5/2023","","Withdrawal POS #000000914637/SUNOCO 8002212501 4234 SW 20TH AVEGAINESVILLE FLCard 2801","27.27","","Posted","2602.57"
"12/5/2023","","Withdrawal POS #000000735733/PUBLIX 3315 W. UNIVERSITY AVE.FLCard 2801","51.71","","Posted","2629.84"
"12/5/2023","","Recurring Withdrawal Debit Card - MC Debit Seminol/CHATGPT SUBSCRIPTION SAN FRANCISC CADate 12/04/23 0 3338320191 0 5734Card 2801","20","","Posted","2681.55"
"12/5/2023","","Recurring Withdrawal Debit Card - MC Debit Seminol/WWW.EVERBEE.IO SANTEE CADate 12/05/23 0 3339857361 0 5734Card 2801","29.99","","Posted","2701.55"
"12/5/2023","","Recurring Withdrawal Debit Card - MC Debit Seminol/DISNEY PLUS 8889057888 CADate 12/04/23 0 3338792430 0 4899Card 2801","16.11","","Posted","2731.54"
"12/5/2023","","Recurring Withdrawal Debit Card - MC Debit Seminol/ADOBE *STOCK 4085366000 CADate 12/04/23 0 3338964178 0 5734Card 2801","29.99","","Posted","2747.65"
"12/4/2023","","Recurring Withdrawal Debit Card - MC Debit Seminol/ENVATO 61383766284 UTDate 12/03/23 0 3337000060 1 5815Card 2801","23","","Posted","2777.64"
"12/4/2023","","Recurring Withdrawal Debit Card - MC Debit Seminol/ADOBE *CREATIVE CLOUD 4085366000 CADate 12/03/23 0 3337999974 0 5734Card 2801","19.99","","Posted","2800.64"
"12/4/2023","","Withdrawal ACH Watson Realty Co/TYPE: WEB PMTS ID: 9000321157CO: Watson Realty CoNAME: Steven chaplinskiEntry Class Code: WEB","1079","","Posted","2820.63"
"12/4/2023","","Withdrawal ACH AppFolio, Inc. F/TYPE: WEB PMTS ID: 9001406550CO: AppFolio, Inc. FNAME: Steven chaplinskiEntry Class Code: WEB","2.49","","Posted","3899.63"
"12/4/2023","","Deposit ACH AMAZON.COM, INC./TYPE: ACCTVERIFY ID: 9000027358CO: AMAZON.COM, INC.Entry Class Code: CTX","","0.01","Posted","3902.12"
"12/3/2023","","Recurring Withdrawal Debit Card - MC Debit Seminol/PARAMOUNT+ SAN FRANCISC CADate 12/02/23 0 3336902908 0 4899Card 2801","13.81","","Posted","3902.11"
"12/3/2023","","Recurring Withdrawal Debit Card Fee/MASTERCARD ISSUER CROSS-BORDER FEEDate 12/02/23 0 3336902692 0 7399Card 2801","0.07","","Posted","3915.92"
"12/3/2023","","Recurring Withdrawal Debit Card - MC Debit Seminol/CREATIVE FABRICA AMSTERDAM NHDate 12/02/23 0 3336902692 0 7399Card 2801","9","","Posted","3915.99"
"12/3/2023","","Recurring Withdrawal Debit Card - MC Debit Seminol/KAIBER AI WILMINGTON DEDate 12/01/23 0 3335109742 2 5815Card 2801","15","","Posted","3924.99"
"12/3/2023","","Recurring Withdrawal Debit Card - MC Debit Seminol/ETSY.COM*THEKREATUREFE BROOKLYN NYDate 12/02/23 0 3336050320 2 5970Card 2801","0.2","","Posted","3939.99"
"12/3/2023","","Recurring Withdrawal Debit Card - MC Debit Seminol/ETSY.COM*FEATUREDKREAT BROOKLYN NYDate 12/02/23 0 3336050313 2 5970Card 2801","0.2","","Posted","3940.19"
"12/3/2023","","Recurring Withdrawal Debit Card - MC Debit Seminol/FS *ADOBE SANTA BARBAR CADate 12/01/23 0 3335107710 2 5734Card 2801","9.99","","Posted","3940.39"
"12/3/2023","","Recurring Withdrawal Debit Card - MC Debit Seminol/ADOBE *PS CREATIVE CL 4085366000 CADate 12/01/23 0 3335099237 2 5734Card 2801","22.99","","Posted","3950.38"
"12/3/2023","","Withdrawal POS #000000000004/CIRCLE K # 06782 5237 GAINESVILLE FLCard 2801","27.97","","Posted","3973.37"
"12/1/2023","","Recurring Withdrawal Debit Card - MC Debit Seminol/SALESAMURAI SOFTWARE BOULDER CODate 12/01/23 0 3335918185 0 5734Card 2801","39.99","","Posted","4001.34"
"12/1/2023","","Recurring Withdrawal Debit Card - MC Debit Seminol/MYDESIGNS - PRO - MON LAS VEGAS NVDate 12/01/23 0 3335916562 0 5734Card 2801","29.99","","Posted","4041.33"
"12/1/2023","","Recurring Withdrawal Debit Card - MC Debit Seminol/ETSY.COM*AIAVATAR BROOKLYN NYDate 12/01/23 0 3335916254 0 5970Card 2801","37.84","","Posted","4071.32"
"11/30/2023","","Withdrawal POS #000000673237/SUNOCO 8002212501 4234 SW 20TH AVEGAINESVILLE FLCard 2801","33.62","","Posted","4109.16"
"11/30/2023","","Recurring Withdrawal Debit Card Fee/MASTERCARD ISSUER CROSS-BORDER FEEDate 11/29/23 0 3333836208 0 5734Card 2801","0.24","","Posted","4142.78"
"11/30/2023","","Recurring Withdrawal Debit Card - MC Debit Seminol/KITTL.COM BERLIN BEDate 11/29/23 0 3333836208 0 5734Card 2801","30","","Posted","4143.02"
"11/30/2023","","Withdrawal Debit Card MC Debit Seminol/AUTOMATEPOD CENTENNIAL CODate 11/30/23 0 3334861916 0 5815Card 2801","14.99","","Posted","4173.02"
"11/30/2023","","Withdrawal Debit Card Fee/MASTERCARD ISSUER CROSS-BORDER FEEDate 11/29/23 0 3333835711 0 5734Card 2801","0.06","","Posted","4188.01"
"11/30/2023","","Withdrawal Debit Card MC Debit Seminol/IDEOGRAM.AI TORONTO ONDate 11/29/23 0 3333835711 0 5734Card 2801","8","","Posted","4188.07"
"11/29/2023","","Withdrawal POS #000000805513/Instacart 50 Beal St Suite 600 SanFrancisco CACard 2801","5","","Posted","4196.07"
"11/29/2023","","Withdrawal POS #000000802668/Instacart 50 Beal St Suite 600 SanFrancisco CACard 2801","101.07","","Posted","4201.07"
"11/29/2023","","Withdrawal Debit Card MC Debit Seminol/KLARNA COLUMBUS OHDate 11/29/23 0 3333041255 1 5999Card 2801","66.92","","Posted","4302.14"
"11/29/2023","","Recurring Withdrawal Debit Card Fee/MASTERCARD ISSUER CROSS-BORDER FEEDate 11/28/23 0 3332825932 0 5734Card 2801","0.08","","Posted","4369.06"
"11/29/2023","","Recurring Withdrawal Debit Card - MC Debit Seminol/TRACEJOURNEY DARMSTADT BEDate 11/28/23 0 3332825932 0 5734Card 2801","10","","Posted","4369.14"
"11/29/2023","","Withdrawal Debit Card MC Debit Seminol/PAYPAL *PHOTOPEA 4029357733 CADate 11/28/23 0 3332041156 1 5734Card 2801","8.8","","Posted","4379.14"
"11/29/2023","","Recurring Withdrawal Debit Card Fee/MASTERCARD ISSUER CROSS-BORDER FEEDate 11/29/23 0 3333040670 1 5734Card 2801","0.13","","Posted","4387.94"
"11/29/2023","","Recurring Withdrawal Debit Card - MC Debit Seminol/VANCEAI CENTRAL HODate 11/29/23 0 3333040670 1 5734Card 2801","15.9","","Posted","4388.07"
"11/29/2023","","Withdrawal POS #000000002769/AMAZON.COM*XR9VQ0EW3 SEATTLE WACard 2801","42.99","","Posted","4403.97"
"11/29/2023","","Withdrawal POS #000000353089/AMAZON.COM*D84KU4CA3 SEATTLE WACard 2801","47.26","","Posted","4446.96"
"11/28/2023","","Deposit Home Banking Transfer expenses/From CHAPLINSKI,LEON 3496297 Share 0000","","2800","Posted","4494.22"
"11/28/2023","","Recurring Withdrawal Debit Card Fee/MASTERCARD ISSUER CROSS-BORDER FEEDate 11/28/23 0 3332875963 0 5734Card 2801","0.16","","Posted","1694.22"
"11/28/2023","","Recurring Withdrawal Debit Card - MC Debit Seminol/ETSYHUNT TECH SINGAPORE SGDate 11/28/23 0 3332875963 0 5734Card 2801","19.99","","Posted","1694.38"
"11/28/2023","","Withdrawal POS #000007355341/PAYPAL *MYDESIGNS 2211 North FirstSan Jose CACard 2801","10","","Posted","1714.37"
"11/27/2023","","Withdrawal POS #000000573781/SUNOCO 8002212501 4234 SW 20TH AVEGAINESVILLE FLCard 2801","30.81","","Posted","1724.37"
"11/27/2023","","Withdrawal Debit Card MC Debit Seminol/IONOS INC. CHESTERBROOK PADate 11/26/23 0 3330927871 0 4816Card 2801","16","","Posted","1755.18"
"11/26/2023","","Recurring Withdrawal Debit Card - MC Debit Seminol/QUILLBOT OAK BROOK ILDate 11/25/23 0 3329941398 1 5734Card 2801","19.95","","Posted","1771.18"
"11/24/2023","","Recurring Withdrawal Debit Card Fee/MASTERCARD ISSUER CROSS-BORDER FEEDate 11/24/23 0 3328385142 0 5734Card 2801","0.07","","Posted","1791.13"
"11/24/2023","","Recurring Withdrawal Debit Card - MC Debit Seminol/DRIVE EXPLORER ADDON MADURAI TNDate 11/24/23 0 3328385142 0 5734Card 2801","9","","Posted","1791.2"
"11/24/2023","","Recurring Withdrawal Debit Card - MC Debit Seminol/VIDIQ SAN FRANCISC CADate 11/23/23 0 3327711049 0 5734Card 2801","10","","Posted","1800.2"
"11/24/2023","","Withdrawal ACH FLUENT-Gainesvil/TYPE: PAYMENT ID: 1371804719CO: FLUENT-GainesvilNAME: steven chaplinskiEntry Class Code: WEB","72.5","","Posted","1810.2"
"11/24/2023","","Withdrawal ACH FLUENT-Gainesvil/TYPE: PAYMENT ID: 1371804719CO: FLUENT-GainesvilNAME: steven chaplinskiEntry Class Code: WEB","21.5","","Posted","1882.7"
"11/23/2023","","Withdrawal Debit Card MC Debit Seminol/SAMSUNG ELECTRONICS RIDGEFIELD P NJDate 11/22/23 0 3326003035 1 5734Card 2801","15.99","","Posted","1904.2"
"11/23/2023","","Withdrawal POS #000002209394/GOOGLE *Google Storage 1600 AmphitheatreParkw Mountain View CACard 2801","1.99","","Posted","1920.19"
"11/22/2023","","Withdrawal POS #000000000107/CIRCLE K # 26146 3525 GAINESVILLE FLCard 2801","24.43","","Posted","1922.18"
"11/22/2023","","Withdrawal Debit Card MC Debit Seminol/PLAYSTATIONNETWORK SAN MATEO CADate 11/21/23 0 3325828415 0 5816Card 2801","89.98","","Posted","1946.61"
"11/22/2023","","Withdrawal Debit Card MC Debit Seminol/WALGREENS #5024 GAINESVILLE FLDate 11/21/23 0 3325008637 1 5912Card 2801","15","","Posted","2036.59"
"11/22/2023","","Withdrawal POS #000000804692/Instacart 50 Beal St Suite 600 SanFrancisco CACard 2801","5","","Posted","2051.59"
"11/22/2023","","Withdrawal POS #000000774433/Instacart 50 Beal St Suite 600 SanFrancisco CACard 2801","105","","Posted","2056.59"
"11/22/2023","","Withdrawal POS #000000806691/Instacart 50 Beal St Suite 600 SanFrancisco CACard 2801","1.39","","Posted","2161.59"
"11/21/2023","","Recurring Withdrawal Debit Card - MC Debit Seminol/CANVA* I03975-36248096 CAMDEN DEDate 11/20/23 0 3324792194 0 7221Card 2801","12.99","","Posted","2162.98"
"11/20/2023","","Withdrawal POS #000000773136/Instacart 50 Beal St Suite 600 SanFrancisco CACard 2801","3","","Posted","2175.97"
"11/20/2023","","Withdrawal POS #000000782796/Instacart 50 Beal St Suite 600 SanFrancisco CACard 2801","121.64","","Posted","2178.97"
"11/20/2023","","Withdrawal POS #000000238444/SUNOCO 8002212501 4234 SW 20TH AVEGAINESVILLE FLCard 2801","37.26","","Posted","2300.61"
"11/20/2023","","Recurring Withdrawal Debit Card - MC Debit Seminol/WEB*HOSTGATOR.COM BURLINGTON MADate 11/18/23 0 3322020816 1 4816Card 2801","31.98","","Posted","2337.87"
"11/20/2023","","Withdrawal POS #000003240708/GOOGLE *YouTubePremium 1600 AmphitheatreParkw Mountain View CACard 2801","15.92","","Posted","2369.85"
"11/19/2023","","Recurring Withdrawal Debit Card - MC Debit Seminol/TUBEBUDDYCOM 8668823239 CADate 11/17/23 0 3321078733 2 5734Card 2801","7.5","","Posted","2385.77"
"11/19/2023","","Withdrawal POS #000000177815/SUNOCO 8002212501 4234 SW 20TH AVEGAINESVILLE FLCard 2801","37.26","","Posted","2393.27"
"11/17/2023","","Withdrawal POS #000000802383/Instacart 50 Beal St Suite 600 SanFrancisco CACard 2801","5","","Posted","2430.53"
"11/17/2023","","Withdrawal POS #000000783938/Instacart 50 Beal St Suite 600 SanFrancisco CACard 2801","82.44","","Posted","2435.53"
"11/17/2023","","Recurring Withdrawal Debit Card - MC Debit Seminol/MIDJOURNEY INC. SOUTH SAN FR CADate 11/16/23 0 3320923293 0 5734Card 2801","10","","Posted","2517.97"
"11/15/2023","","Withdrawal POS #000000068021/SUNOCO 8002212501 4234 SW 20TH AVEGAINESVILLE FLCard 2801","35.75","","Posted","2527.97"
"11/15/2023","","Withdrawal POS #000000742821/PUBLIX 4115 NW 16TH BLVD GAINESVILLE FLCard 2801","77.12","","Posted","2563.72"
"11/14/2023","","Withdrawal POS #000000772752/Instacart 50 Beal St Suite 600 SanFrancisco CACard 2801","5","","Posted","2640.84"
"11/14/2023","","Withdrawal POS #000000773467/Instacart 50 Beal St Suite 600 SanFrancisco CACard 2801","119.32","","Posted","2645.84"
"11/14/2023","","Withdrawal Adjustment Debit Card - Credit Voucher/APPLE.COM/BILL 866-712-7753 CADate 11/13/23 0 3317730556 0 5818Card 2801","","7.21","Posted","2765.16"
"11/14/2023","","Withdrawal Debit Card MC Debit Seminol/COX GAINESVILLE COMM 800-234-3993 FLDate 11/13/23 0 3317253019 0 4899Card 2801","75.04","","Posted","2757.95"
"11/14/2023","","Recurring Withdrawal Debit Card - MC Debit Seminol/APPLE.COM/BILL 866-712-7753 CADate 11/13/23 0 3317730551 0 5818Card 2801","42.98","","Posted","2832.99"
"11/14/2023","","Withdrawal Debit Card MC Debit Seminol/MIRACLE MADE 2015640522 NYDate 11/13/23 0 3317729103 0 5719Card 2801","161.48","","Posted","2875.97"
"11/14/2023","","Withdrawal ACH FLUENT-Gainesvil/TYPE: PAYMENT ID: 1371804719CO: FLUENT-GainesvilNAME: stevenchaplinskiEntry Class Code: WEB","71","","Posted","3037.45"
"11/13/2023","","Withdrawal Debit Card MC Debit Seminol/SALESAMURAI.IO SFTWARE BOULDER CODate 11/13/23 0 3317927273 0 5734Card 2801","9.99","","Posted","3108.45"
"11/13/2023","","Withdrawal Debit Card MC Debit Seminol/CANNAMD 855-4209170 FLDate 11/12/23 0 3316926888 0 8011Card 2801","195","","Posted","3118.44"
"11/12/2023","","Withdrawal POS #000000000106/CIRCLE K # 26146 3525 GAINESVILLE FLCard 2801","27.9","","Posted","3313.44"
"11/12/2023","","Recurring Withdrawal Debit Card - MC Debit Seminol/MIDJOURNEY INC. SOUTH SAN FR CADate 11/10/23 0 3314793421 1 5734Card 2801","30","","Posted","3341.34"
"11/12/2023","","Recurring Withdrawal Debit Card - MC Debit Seminol/OPUS CLIP REDWOOD CITY CADate 11/11/23 0 3315019448 1 7372Card 2801","19","","Posted","3371.34"
"11/12/2023","","Withdrawal Debit Card MC Debit Seminol/WALGREENS #9304 GAINESVILLE FLDate 11/11/23 0 3315920550 0 5912Card 2801","8.16","","Posted","3390.34"
"11/11/2023","","Withdrawal POS #000000047875/PUBLIX 3930 SW ARCHER ROAD GAINESVILLECard 2801","52.21","","Posted","3398.5"
"11/11/2023","","Withdrawal POS #000000741171/PUBLIX 3100 SW 35TH BLVD GAINESVILLE FLCard 2801","27.88","","Posted","3450.71"
"11/10/2023","","Withdrawal Debit Card MC Debit Seminol/WALGREENS #5024 GAINESVILLE FLDate 11/09/23 0 3313912372 0 5912Card 2801","3.38","","Posted","3478.59"
"11/10/2023","","Withdrawal POS #000000796988/Instacart 50 Beal St Suite 600 SanFrancisco CACard 2801","5","","Posted","3481.97"
"11/10/2023","","Withdrawal POS #000000795742/Instacart 50 Beal St Suite 600 SanFrancisco CACard 2801","65.49","","Posted","3486.97"
"11/9/2023","","Withdrawal Debit Card MC Debit Seminol/AMAZON PRIME*VI6QQ5093 AMZN.COM/BIL WADate 11/08/23 0 3312939290 0 5968Card 2801","15.15","","Posted","3552.46"
"11/8/2023","","Recurring Withdrawal Debit Card - MC Debit Seminol/OPENAI SAN FRANCISC CADate 11/07/23 0 3311590641 0 5734Card 2801","1.57","","Posted","3567.61"
"11/8/2023","","Withdrawal Debit Card MC Debit Seminol/MOVAVI.COM WILDWOOD MODate 11/07/23 0 3311216937 0 5734Card 2801","69.95","","Posted","3569.18"
"11/7/2023","","Withdrawal POS #000000804016/Instacart 50 Beal St Suite 600 SanFrancisco CACard 2801","10","","Posted","3639.13"
"11/7/2023","","Withdrawal POS #000000784007/Instacart 50 Beal St Suite 600 SanFrancisco CACard 2801","87.37","","Posted","3649.13"
"11/7/2023","","Withdrawal POS #000000738427/WAWA 5325 2373 SW ARCHER ROADFLCard 2801","27.09","","Posted","3736.5"
"11/7/2023","","Recurring Withdrawal Debit Card - MC Debit Seminol/D-ID STUDIO WILMINGTON DEDate 11/06/23 0 3310886691 0 7399Card 2801","49","","Posted","3763.59"
"11/7/2023","","Recurring Withdrawal Debit Card Fee/MASTERCARD ISSUER CROSS-BORDER FEEDate 11/06/23 0 3310695225 0 5815Card 2801","0.31","","Posted","3812.59"
"11/7/2023","","Recurring Withdrawal Debit Card - MC Debit Seminol/PLAY.HT BANGALORE BEDate 11/06/23 0 3310695225 0 5815Card 2801","39","","Posted","3812.9"
"11/7/2023","","Recurring Withdrawal Debit Card - MC Debit Seminol/ELEVENLABS.IO NEW YORK NYDate 11/07/23 0 3311836280 0 5734Card 2801","5","","Posted","3851.9"
"11/6/2023","","Recurring Withdrawal Debit Card Fee/MASTERCARD ISSUER CROSS-BORDER FEEDate 11/06/23 0 3310145828 0 5734Card 2801","0.12","","Posted","3856.9"
"11/6/2023","","Recurring Withdrawal Debit Card - MC Debit Seminol/LINKTREE* LINKTREE COLLINGWOOD VIDate 11/06/23 0 3310145828 0 5734Card 2801","14.99","","Posted","3857.02"
"11/6/2023","","Recurring Withdrawal Debit Card - MC Debit Seminol/MARMALEAD, LLC 4079065736 FLDate 11/05/23 0 3309540300 1 5045Card 2801","19","","Posted","3872.01"
"11/6/2023","","Recurring Withdrawal Bill Payment - #000000177618/NETFLIX COM LOS GATOS CACard 2801","11","","Posted","3891.01"
"11/5/2023","","Withdrawal POS #000000805076/Instacart 50 Beal St Suite 600 SanFrancisco CACard 2801","3","","Posted","3902.01"
"11/5/2023","","Withdrawal POS #000000782111/Instacart 50 Beal St Suite 600 SanFrancisco CACard 2801","103.52","","Posted","3905.01"
"11/5/2023","","Recurring Withdrawal Debit Card - MC Debit Seminol/CHATGPT SUBSCRIPTION SAN FRANCISC CADate 11/04/23 0 3308519868 0 5734Card 2801","20","","Posted","4008.53"
"11/5/2023","","Recurring Withdrawal Debit Card - MC Debit Seminol/WWW.EVERBEE.IO SANTEE CADate 11/05/23 0 3309519436 0 5734Card 2801","29.99","","Posted","4028.53"
"11/5/2023","","Recurring Withdrawal Debit Card - MC Debit Seminol/DISNEY PLUS 8889057888 CADate 11/04/23 0 3308886681 0 4899Card 2801","16.11","","Posted","4058.52"
"11/5/2023","","Recurring Withdrawal Debit Card - MC Debit Seminol/APPLE.COM/BILL 866-712-7753 CADate 11/03/23 0 3307866987 1 5818Card 2801","2.99","","Posted","4074.63"
"11/5/2023","","Recurring Withdrawal Debit Card - MC Debit Seminol/APPLE.COM/BILL 866-712-7753 CADate 11/03/23 0 3307866985 1 5818Card 2801","2.99","","Posted","4077.62"
"11/5/2023","","Recurring Withdrawal Debit Card - MC Debit Seminol/ADOBE INC. 4085366000 CADate 11/03/23 0 3307864674 1 5734Card 2801","19.99","","Posted","4080.61"
"11/5/2023","","Recurring Withdrawal Debit Card - MC Debit Seminol/ADOBE INC. 4085366000 CADate 11/04/23 0 3308880510 0 5734Card 2801","29.99","","Posted","4100.6"
"11/3/2023","","Recurring Withdrawal Debit Card - MC Debit Seminol/PARAMOUNT+ SAN FRANCISC CADate 11/02/23 0 3306889322 0 4899Card 2801","13.81","","Posted","4130.59"
"11/3/2023","","Recurring Withdrawal Debit Card Fee/MASTERCARD ISSUER CROSS-BORDER FEEDate 11/02/23 0 3306889171 0 7399Card 2801","0.07","","Posted","4144.4"
"11/3/2023","","Recurring Withdrawal Debit Card - MC Debit Seminol/CREATIVE FABRICA AMSTERDAM NHDate 11/02/23 0 3306889171 0 7399Card 2801","9","","Posted","4144.47"
"11/3/2023","","Deposit Home Banking Transfer/From CHAPLINSKI,LEON 3496297 Share 0090Funds Transfer via Online","","2800","Posted","4153.47"
"11/2/2023","","Withdrawal POS #000000793257/Instacart 50 Beal St Suite 600 SanFrancisco CACard 2801","2","","Posted","1353.47"
"11/2/2023","","Withdrawal POS #000000804519/Instacart 50 Beal St Suite 600 SanFrancisco CACard 2801","71.83","","Posted","1355.47"
"11/2/2023","","Withdrawal Adjustment Debit Card - Credit Voucher/ADOBE INC. 4085366000 CADate 11/02/23 0 3306885794 0 5734Card 2801","","24.99","Posted","1427.3"
"11/2/2023","","Recurring Withdrawal Debit Card - MC Debit Seminol/KAIBER AI WILMINGTON DEDate 11/02/23 0 3306046960 1 5815Card 2801","15","","Posted","1402.31"
"11/2/2023","","Withdrawal Debit Card MC Debit Seminol/GRU/EZ-PAY WEB PYMT 352-334-3434 FLDate 11/01/23 0 3305328053 0 4900Card 2801","164.04","","Posted","1417.31"
"11/2/2023","","Recurring Withdrawal Debit Card - MC Debit Seminol/ADOBE INC. 4085366000 CADate 11/02/23 0 3306885795 0 5734Card 2801","22.99","","Posted","1581.35"
"11/1/2023","","Withdrawal POS #000000592623/AMAZON.COM*SX78M3I43 SEATTLE WACard 2801","23.17","","Posted","1604.34"
"11/1/2023","","Recurring Withdrawal Debit Card - MC Debit Seminol/D-ID STUDIO WILMINGTON DEDate 10/31/23 0 3304270877 0 7399Card 2801","20","","Posted","1627.51"
"11/1/2023","","Recurring Withdrawal Debit Card - MC Debit Seminol/D-ID STUDIO WILMINGTON DEDate 10/31/23 0 3304692631 0 7399Card 2801","19.6","","Posted","1647.51"
"11/1/2023","","Recurring Withdrawal Debit Card - MC Debit Seminol/D-ID STUDIO WILMINGTON DEDate 10/31/23 0 3304692630 0 7399Card 2801","1.7","","Posted","1667.11"
"11/1/2023","","Recurring Withdrawal Debit Card - MC Debit Seminol/MYDESIGNS - PRO - MON LAS VEGAS NVDate 11/01/23 0 3305923961 0 5734Card 2801","29.99","","Posted","1668.81"
"11/1/2023","","Recurring Withdrawal Debit Card - MC Debit Seminol/ETSY.COM*AIAVATAR BROOKLYN NYDate 11/01/23 0 3305923691 0 5970Card 2801","3.22","","Posted","1698.8"
"11/1/2023","","Withdrawal ACH Watson Realty Co/TYPE: WEB PMTS ID: 9000321157CO: Watson Realty CoNAME: Steven chaplinskiEntry Class Code: WEB","1079","","Posted","1702.02"
"11/1/2023","","Withdrawal ACH AppFolio, Inc. F/TYPE: WEB PMTS ID: 9001406550CO: AppFolio, Inc. FNAME: Steven chaplinskiEntry Class Code: WEB","2.49","","Posted","2781.02"
"10/31/2023","","Withdrawal POS #000000437179/SUNOCO 8002212501 4234 SW 20TH AVEGAINESVILLE FLCard 2801","35","","Posted","2783.51"
"10/31/2023","","Withdrawal Debit Card MC Debit Seminol/MOVAVI.COM WILDWOOD MODate 10/31/23 0 3304893922 0 5734Card 2801","59.95","","Posted","2818.51"
"10/31/2023","","Deposit Home Banking Transfer expenses/From CHAPLINSKI,LEON 3496297 Share 0000","","2800","Posted","2878.46"
"10/31/2023","","Withdrawal POS #000000792483/Instacart 50 Beal St Suite 600 SanFrancisco CACard 2801","2","","Posted","78.46"
"10/31/2023","","Withdrawal POS #000000806130/Instacart 50 Beal St Suite 600 SanFrancisco CACard 2801","49.92","","Posted","80.46"
"10/30/2023","","Withdrawal ACH FLUENT-Gainesvil/TYPE: PAYMENT ID: 1371804719CO: FLUENT-GainesvilNAME: steven chaplinskiEntry Class Code: WEB","32","","Posted","130.38"
"10/29/2023","","Recurring Withdrawal Debit Card Fee/MASTERCARD ISSUER CROSS-BORDER FEEDate 10/27/23 0 3300915753 1 5734Card 2801","0.16","","Posted","162.38"
"10/29/2023","","Recurring Withdrawal Debit Card - MC Debit Seminol/ETSYHUNT* TRIAL OVER SINGAPORE SGDate 10/27/23 0 3300915753 1 5734Card 2801","19.99","","Posted","162.54"
"10/29/2023","","Withdrawal Debit Card MC Debit Seminol/CIRCLE K # 06782 GAINESVILLE FLDate 10/26/23 0 3299850285 1 5499Card 2801","30.29","","Posted","182.53"
"10/29/2023","","Recurring Withdrawal Debit Card - MC Debit Seminol/APPLE.COM/BILL 866-712-7753 CADate 10/27/23 0 3300913011 1 5818Card 2801","15.99","","Posted","212.82"
"10/29/2023","","Recurring Withdrawal Debit Card - MC Debit Seminol/ADOBE INC. 4085366000 CADate 10/27/23 0 3300910616 1 5734Card 2801","29.99","","Posted","228.81"
"10/28/2023","","Deposit Home Banking Transfer food/From CHAPLINSKI,LEON 3496297 Share 0090","","200","Posted","258.8"
"10/28/2023","","Withdrawal POS #000000784940/Instacart 50 Beal St Suite 600 SanFrancisco CACard 2801","3","","Posted","58.8"
"10/28/2023","","Withdrawal POS #000000785372/Instacart 50 Beal St Suite 600 SanFrancisco CACard 2801","57.06","","Posted","61.8"
"10/27/2023","","Withdrawal Debit Card MC Debit Seminol/PADDLE.NET* LEONARDOAI ASTORIA NYDate 10/26/23 0 3299263117 0 5817Card 2801","9","","Posted","118.86"
"10/27/2023","","Withdrawal Debit Card MC Debit Seminol/IONOS INC. CHESTERBROOK PADate 10/26/23 0 3299971722 0 4816Card 2801","12","","Posted","127.86"
"10/27/2023","","Withdrawal POS #000000295264/SUNOCO 8002212501 4234 SW 20TH AVEGAINESVILLE FLCard 2801","17.92","","Posted","139.86"
"10/26/2023","","Withdrawal Debit Card Fee/MASTERCARD ISSUER CROSS-BORDER FEEDate 10/26/23 0 3299890944 0 5815Card 2801","0.07","","Posted","157.78"
"10/26/2023","","Withdrawal Debit Card MC Debit Seminol/VOICESTARS PARIS ILDate 10/26/23 0 3299890944 0 5815Card 2801","8.99","","Posted","157.85"
"10/25/2023","","Recurring Withdrawal Debit Card - MC Debit Seminol/QUILLBOT OAK BROOK ILDate 10/25/23 0 3298900132 0 5734Card 2801","19.95","","Posted","166.84"
"10/25/2023","","Recurring Withdrawal Debit Card - MC Debit Seminol/WEB*HOSTGATOR.COM BURLINGTON MADate 10/24/23 0 3297898879 0 4816Card 2801","15.99","","Posted","186.79"
"10/25/2023","","Recurring Withdrawal Debit Card Fee/MASTERCARD ISSUER CROSS-BORDER FEEDate 10/25/23 0 3298820645 0 5734Card 2801","0.01","","Posted","202.78"
"10/25/2023","","Recurring Withdrawal Debit Card - MC Debit Seminol/ETSYHUNT TECH SINGAPORE SGDate 10/25/23 0 3298820645 0 5734Card 2801","1","","Posted","202.79"
"10/24/2023","","Recurring Withdrawal Debit Card Fee/MASTERCARD ISSUER CROSS-BORDER FEEDate 10/24/23 0 3297846350 0 5734Card 2801","0.07","","Posted","203.79"
"10/24/2023","","Recurring Withdrawal Debit Card - MC Debit Seminol/DRIVE EXPLORER ADDON MADURAI TNDate 10/24/23 0 3297846350 0 5734Card 2801","9","","Posted","203.86"
"10/24/2023","","Recurring Withdrawal Debit Card - MC Debit Seminol/VIDIQ SAN FRANCISC CADate 10/23/23 0 3296829691 0 5734Card 2801","10","","Posted","212.86"
"10/24/2023","","Withdrawal Debit Card MC Debit Seminol/ARCHER ANIMAL HOSPITAL ARCHER FLDate 10/23/23 0 3296327463 0 0742Card 2801","351.13","","Posted","222.86"
"10/24/2023","","Recurring Withdrawal Debit Card - MC Debit Seminol/WEB*HOSTGATOR.COM BURLINGTON MADate 10/23/23 0 3296829048 0 4816Card 2801","15.99","","Posted","573.99"
"10/24/2023","","Withdrawal Debit Card MC Debit Seminol/WALGREENS #5024 GAINESVILLE FLDate 10/23/23 0 3296842064 0 5912Card 2801","15","","Posted","589.98"
"10/24/2023","","Deposit Home Banking Transfer expenses/From CHAPLINSKI,LEON 3496297 Share 0000","","225","Posted","604.98"
"10/23/2023","","Deposit Home Banking Transfer vet/From CHAPLINSKI,LEON 3496297 Share 0000","","300","Posted","379.98"
"10/23/2023","","Withdrawal POS #000000802327/Instacart 50 Beal St Suite 600 SanFrancisco CACard 2801","3","","Posted","79.98"
"10/23/2023","","Withdrawal POS #000000772536/Instacart 50 Beal St Suite 600 SanFrancisco CACard 2801","73.34","","Posted","82.98"
"10/23/2023","","Withdrawal POS #000003091116/GOOGLE *Google Storage 1600 AmphitheatreParkw Mountain View CACard 2801","1.99","","Posted","156.32"
"10/22/2023","","Recurring Withdrawal Debit Card - MC Debit Seminol/CANVA* I03944-36326674 CAMDEN DEDate 10/20/23 0 3293031248 1 7221Card 2801","12.99","","Posted","158.31"
"10/20/2023","","Recurring Withdrawal Debit Card Fee/MASTERCARD ISSUER CROSS-BORDER FEEDate 10/20/23 0 3293815850 0 5734Card 2801","0.1","","Posted","171.3"
"10/20/2023","","Recurring Withdrawal Debit Card - MC Debit Seminol/SHINYWHITEBOX.COM WELLINGTON NZDate 10/20/23 0 3293815850 0 5734Card 2801","12","","Posted","171.4"
"10/20/2023","","Withdrawal POS #000003087192/GOOGLE *YouTubePremium 1600 AmphitheatreParkw Mountain View CACard 2801","15.92","","Posted","183.4"
"10/19/2023","","Withdrawal ACH FLUENT-Gainesvil/TYPE: PAYMENT ID: 1371804719CO: FLUENT-GainesvilNAME: steven chaplinskiEntry Class Code: WEB","164.64","","Posted","199.32"
"10/18/2023","","Recurring Withdrawal Adjustment - Debit Card Credit Voucher/WEB*HOSTGATOR.COM BURLINGTON MADate 10/17/23 0 3290976506 0 4816Card 2801","","12.95","Posted","363.96"
"10/18/2023","","Recurring Withdrawal Debit Card - MC Debit Seminol/D-ID STUDIO WILMINGTON DEDate 10/17/23 0 3290979156 0 7399Card 2801","1.8","","Posted","351.01"
"10/18/2023","","Recurring Withdrawal Debit Card - MC Debit Seminol/WEB*HOSTGATOR.COM BURLINGTON MADate 10/17/23 0 3290976504 0 4816Card 2801","12.95","","Posted","352.81"
"10/17/2023","","Withdrawal POS #000000058955/PUBLIX 3100 SW 35TH BLVD GAINESVILLE FLCard 2801","61.04","","Posted","365.76"
"10/17/2023","","Withdrawal POS #000000000073/CIRCLE K # 26146 3525 GAINESVILLE FLCard 2801","30.3","","Posted","426.8"
"10/17/2023","","Withdrawal POS #000000829953/AMAZON.COM*TP0VL4K22 SEATTLE WACard 2801","25.04","","Posted","457.1"
"10/17/2023","","Deposit Home Banking Transfer expenses/From CHAPLINSKI,LEON 3496297 Share 0000","","200","Posted","482.14"
"10/17/2023","","Deposit Home Banking Transfer help/From CHAPLINSKI,LEON 3496297 Share 0090","","100","Posted","282.14"
"10/17/2023","","Withdrawal Debit Card MC Debit Seminol/MIDJOURNEY INC. SOUTH SAN FR CADate 10/16/23 0 3289666656 0 5734Card 2801","10","","Posted","182.14"
"10/17/2023","","Recurring Withdrawal Debit Card - MC Debit Seminol/TUBEBUDDYCOM 8668823239 CADate 10/17/23 0 3290995005 1 5045Card 2801","7.5","","Posted","192.14"
"10/17/2023","","Recurring Withdrawal Debit Card - MC Debit Seminol/TUBEBUDDYCOM 8668823239 CADate 10/17/23 0 3290995004 1 5045Card 2801","7.5","","Posted","199.64"
"10/13/2023","","Withdrawal POS #000000688068/SUNOCO 8002212501 4234 SW 20TH AVEGAINESVILLE FLCard 2801","31.79","","Posted","207.14"
"10/12/2023","","Withdrawal Debit Card MC Debit Seminol/OPUS CLIP REDWOOD CITY CADate 10/11/23 0 3284328119 0 7372Card 2801","19","","Posted","238.93"
"10/11/2023","","Recurring Withdrawal Debit Card - MC Debit Seminol/MIDJOURNEY INC. SOUTH SAN FR CADate 10/10/23 0 3283868204 0 5734Card 2801","30","","Posted","257.93"
"10/11/2023","","Withdrawal Debit Card MC Debit Seminol/PUBLIX #1784 GAINESVILLE FLDate 10/10/23 0 3283933280 0 5411Card 2801","100.9","","Posted","287.93"
"10/11/2023","","Withdrawal Debit Card MC Debit Seminol/WALGREENS #9304 GAINESVILLE FLDate 10/10/23 0 3283862910 0 5912Card 2801","6.96","","Posted","388.83"
"10/11/2023","","Recurring Withdrawal Debit Card - MC Debit Seminol/APPLE.COM/BILL 866-712-7753 CADate 10/11/23 0 3284928845 0 5818Card 2801","18.98","","Posted","395.79"
"10/10/2023","","Withdrawal POS #000011460214/WALGREENS 3455 SW ARCH GAINESVILLE FLCard 2801","21.13","","Posted","414.77"
"10/10/2023","","Withdrawal POS #000000792062/Instacart 50 Beal St Suite 600 SanFrancisco CACard 2801","3","","Posted","435.9"
"10/10/2023","","Withdrawal POS #000000792297/Instacart 50 Beal St Suite 600 SanFrancisco CACard 2801","60.92","","Posted","438.9"
"10/9/2023","","Withdrawal Debit Card MC Debit Seminol/AMAZON PRIME*TE7E41GQ0 AMZN.COM/BIL WADate 10/08/23 0 3281257359 0 5968Card 2801","15.13","","Posted","499.82"
"10/9/2023","","Withdrawal POS #000000000009/AMAZON.COM*TE99A7580 SEATTLE WACard 2801","24.21","","Posted","514.95"
"10/8/2023","","Recurring Withdrawal Debit Card - MC Debit Seminol/D-ID STUDIO WILMINGTON DEDate 10/06/23 0 3279683480 1 7399Card 2801","5.9","","Posted","539.16"
"10/8/2023","","Withdrawal Debit Card Fee/MASTERCARD ISSUER CROSS-BORDER FEEDate 10/06/23 0 3279122045 2 5815Card 2801","0.31","","Posted","545.06"
"10/8/2023","","Withdrawal Debit Card MC Debit Seminol/PLAY.HT BANGALORE BEDate 10/06/23 0 3279122045 2 5815Card 2801","39","","Posted","545.37"
"10/8/2023","","Withdrawal Debit Card MC Debit Seminol/ELEVENLABS.IO NEW YORK NYDate 10/07/23 0 3280076314 2 5734Card 2801","1","","Posted","584.37"
"10/8/2023","","Withdrawal Debit Card MC Debit Seminol/SAMSUNG ELECTRONICS RIDGEFIELD P NJDate 10/06/23 0 3279680685 1 5734Card 2801","15.99","","Posted","585.37"
"10/6/2023","","Withdrawal POS #000000000000/AMAZON.COM*TE9JX40H2 SEATTLE WACard 2801","119.97","","Posted","601.36"
"10/6/2023","","Recurring Withdrawal Debit Card Fee/MASTERCARD ISSUER CROSS-BORDER FEEDate 10/06/23 0 3279875670 0 5734Card 2801","0.12","","Posted","721.33"
"10/6/2023","","Recurring Withdrawal Debit Card - MC Debit Seminol/LINKTREE* LINKTREE COLLINGWOOD VIDate 10/06/23 0 3279875670 0 5734Card 2801","14.99","","Posted","721.45"
"10/6/2023","","Recurring Withdrawal Debit Card - MC Debit Seminol/MARMALEAD, LLC 4079065736 FLDate 10/05/23 0 3278869693 0 5045Card 2801","19","","Posted","736.44"
"10/6/2023","","Recurring Withdrawal Bill Payment - #000000033416/NETFLIX COM LOS GATOS CACard 2801","11","","Posted","755.44"
"10/6/2023","","Deposit Home Banking Transfer food/From CHAPLINSKI,LEON 3496297 Share 0090","","120","Posted","766.44"
"10/5/2023","","Recurring Withdrawal Debit Card - MC Debit Seminol/CHATGPT SUBSCRIPTION SAN FRANCISC CADate 10/04/23 0 3277321921 0 5734Card 2801","20","","Posted","646.44"
"10/5/2023","","Recurring Withdrawal Debit Card - MC Debit Seminol/WWW.EVERBEE.IO SANTEE CADate 10/05/23 0 3278907060 0 5734Card 2801","29.99","","Posted","666.44"
"10/5/2023","","Recurring Withdrawal Debit Card - MC Debit Seminol/DISNEY PLUS 8889057888 CADate 10/04/23 0 3277775987 0 4899Card 2801","12.66","","Posted","696.43"
"10/5/2023","","Recurring Withdrawal Debit Card - MC Debit Seminol/ADOBE *STOCK 4085366000 CADate 10/04/23 0 3277900612 0 5734Card 2801","29.99","","Posted","709.09"
"10/5/2023","","Withdrawal POS #000000802629/Instacart 50 Beal St Suite 600 SanFrancisco CACard 2801","54.44","","Posted","739.08"
"10/4/2023","","Withdrawal POS #000000338994/SUNOCO 8002212501 4234 SW 20TH AVEGAINESVILLE FLCard 2801","34.36","","Posted","793.52"
"10/4/2023","","Recurring Withdrawal Debit Card - MC Debit Seminol/APPLE.COM/BILL 866-712-7753 CADate 10/03/23 0 3276827222 0 5818Card 2801","2.99","","Posted","827.88"
"10/4/2023","","Recurring Withdrawal Debit Card - MC Debit Seminol/APPLE.COM/BILL 866-712-7753 CADate 10/03/23 0 3276827221 0 5818Card 2801","2.99","","Posted","830.87"
"10/3/2023","","Recurring Withdrawal Debit Card - MC Debit Seminol/PARAMOUNT+ SAN FRANCISC CADate 10/02/23 0 3275860755 0 4899Card 2801","13.81","","Posted","833.86"
"10/3/2023","","Recurring Withdrawal Debit Card Fee/MASTERCARD ISSUER CROSS-BORDER FEEDate 10/02/23 0 3275860604 0 7399Card 2801","0.47","","Posted","847.67"
"10/3/2023","","Recurring Withdrawal Debit Card - MC Debit Seminol/CREATIVE FABRICA AMSTERDAM NHDate 10/02/23 0 3275860604 0 7399Card 2801","59.16","","Posted","848.14"
"10/3/2023","","Withdrawal Debit Card Fee/MASTERCARD ISSUER CROSS-BORDER FEEDate 10/02/23 0 3275860600 0 5815Card 2801","0.31","","Posted","907.3"
"10/3/2023","","Withdrawal Debit Card MC Debit Seminol/PLAY.HT BANGALORE BEDate 10/02/23 0 3275860600 0 5815Card 2801","39","","Posted","907.61"
"10/3/2023","","Withdrawal Debit Card MC Debit Seminol/GRU/EZ-PAY WEB PYMT 352-334-3434 FLDate 10/02/23 0 3275297532 0 4900Card 2801","175.52","","Posted","946.61"
"10/3/2023","","Withdrawal Debit Card MC Debit Seminol/COX GAINESVILLE COMM 800-234-3993 FLDate 10/02/23 0 3275855008 0 4899Card 2801","111.39","","Posted","1122.13"
"10/2/2023","","Withdrawal POS #000000782690/Instacart 50 Beal St Suite 600 SanFrancisco CACard 2801","2","","Posted","1233.52"
"10/2/2023","","Withdrawal POS #000000802532/Instacart 50 Beal St Suite 600 SanFrancisco CACard 2801","72.59","","Posted","1235.52"
"10/2/2023","","Recurring Withdrawal Debit Card - MC Debit Seminol/MYDESIGNS - PRO - MON LAS VEGAS NVDate 10/01/23 0 3274789338 1 5734Card 2801","29.99","","Posted","1308.11"
"10/2/2023","","Recurring Withdrawal Debit Card - MC Debit Seminol/KAIBER AI WILMINGTON DEDate 10/01/23 0 3274908200 0 5815Card 2801","15","","Posted","1338.1"
"10/2/2023","","Recurring Withdrawal Debit Card - MC Debit Seminol/ETSY.COM*AIAVATAR BROOKLYN NYDate 10/01/23 0 3274789186 1 5970Card 2801","16.95","","Posted","1353.1"
"10/2/2023","","Withdrawal ACH Watson Realty Co/TYPE: WEB PMTS ID: 9000321157CO: Watson Realty CoNAME: Steven chaplinskiEntry Class Code: WEB","1079","","Posted","1370.05"
"10/2/2023","","Withdrawal ACH AppFolio, Inc. F/TYPE: WEB PMTS ID: 9001406550CO: AppFolio, Inc. FNAME: Steven chaplinskiEntry Class Code: WEB","2.49","","Posted","2449.05"
"9/30/2023","","Withdrawal Debit Card MC Debit Seminol/PHR*SIMEDHEALTHLLC GAINESVILLE FLDate 09/29/23 0 3272984653 0 8011Card 2801","45","","Posted","2451.54"
"9/29/2023","","Withdrawal POS #000000126446/SUNOCO 8002212501 4234 SW 20TH AVEGAINESVILLE FLCard 2801","35","","Posted","2496.54"
"9/29/2023","","Recurring Withdrawal Debit Card - MC Debit Seminol/IC* INSTACART*SUBSCRIP SAN FRANCISC CADate 09/28/23 0 3271996294 0 5411Card 2801","49","","Posted","2531.54"
"9/29/2023","","Withdrawal Debit Card MC Debit Seminol/PHR*SIMEDHEALTHLLC GAINESVILLE FLDate 09/28/23 0 3271994911 0 8011Card 2801","45","","Posted","2580.54"
"9/29/2023","","Withdrawal Debit Card MC Debit Seminol/WALGREENS #9304 GAINESVILLE FLDate 09/28/23 0 3271906334 0 5912Card 2801","5.07","","Posted","2625.54"
"9/29/2023","","Withdrawal Debit Card MC Debit Seminol/WALGREENS #9304 GAINESVILLE FLDate 09/28/23 0 3271906333 0 5912Card 2801","19.93","","Posted","2630.61"
"9/29/2023","","Withdrawal ACH FLUENT-Gainesvil/TYPE: PAYMENT ID: 1371804719CO: FLUENT-GainesvilEntry Class Code: PPD","5","","Posted","2650.54"
"9/29/2023","","Withdrawal POS #000000792104/Instacart 50 Beal St Suite 600 SanFrancisco CACard 2801","2","","Posted","2655.54"
"9/29/2023","","Withdrawal POS #000000802523/Instacart 50 Beal St Suite 600 SanFrancisco CACard 2801","50.73","","Posted","2657.54"
"9/28/2023","","Withdrawal POS #000013684735/CIRCLE K # 26146 3525 GAINESVILLE FLCard 2801","20","","Posted","2708.27"
"9/28/2023","","Withdrawal POS #000000759224/AMAZON.COM*T10N02X21 SEATTLE WACard 2801","31.82","","Posted","2728.27"
"9/28/2023","","Withdrawal POS #000000076873/SUNOCO 8002212501 4234 SW 20TH AVEGAINESVILLE FLCard 2801","28.55","","Posted","2760.09"
"9/28/2023","","Recurring Withdrawal Debit Card - MC Debit Seminol/ADOBE *CREATIVE CLOUD 4085366000 CADate 09/27/23 0 3270848511 0 5734Card 2801","29.99","","Posted","2788.64"
"9/28/2023","","Deposit Home Banking Transfer expenses/From CHAPLINSKI,LEON 3496297 Share 0090","","2800","Posted","2818.63"
"9/27/2023","","Withdrawal POS #000000046634/SUNOCO 8002212501 4234 SW 20TH AVEGAINESVILLE FLCard 2801","17.49","","Posted","18.63"
"9/26/2023","","Withdrawal POS #000000078132/SUNOCO 8002212501 4234 SW 20TH AVEGAINESVILLE FLCard 2801","17.49","","Posted","36.12"
"9/25/2023","","Withdrawal POS #000000792501/Instacart 50 Beal St Suite 600 SanFrancisco CACard 2801","3","","Posted","53.61"
"9/25/2023","","Withdrawal POS #000000782865/Instacart 50 Beal St Suite 600 SanFrancisco CACard 2801","61.03","","Posted","56.61"
"9/24/2023","","Deposit Home Banking Transfer food/From CHAPLINSKI,LEON 3496297 Share 0090","","100","Posted","117.64"
"9/24/2023","","Deposit Home Banking Transfer food/From CHAPLINSKI,LEON 3496297 Share 0090","","75","Posted","17.64"
"9/24/2023","","Withdrawal Courtesy Pay Fee","35","","Posted","-57.36"
"9/24/2023","","Withdrawal POS #000000938024/SUNOCO 8002212501 4234 SW 20TH AVEGAINESVILLE FLCard 2801","17.49","","Posted","-22.36"
"9/24/2023","","Withdrawal POS #000014322053/WALGREENS 2415 SW 75TH GAINESVILLE FLCard 2801","15","","Posted","-4.87"
"9/24/2023","","Recurring Withdrawal Debit Card - MC Debit Seminol/CANVA* I03914-38299904 CAMDEN DEDate 09/23/23 0 3266003765 1 7221Card 2801","12.99","","Posted","10.13"
"9/24/2023","","Recurring Withdrawal Debit Card - MC Debit Seminol/VIDIQ SAN FRANCISC CADate 09/23/23 0 3266003554 1 5734Card 2801","10","","Posted","23.12"
"9/24/2023","","Recurring Withdrawal Debit Card - MC Debit Seminol/ETSY.COM - AIAVATAR BROOKLYN NYDate 09/24/23 0 3267006030 1 5699Card 2801","33.29","","Posted","33.12"
"9/23/2023","","Withdrawal POS #000000920351/AMAZON.COM*T18RP5V32 SEATTLE WACard 2801","22.88","","Posted","66.41"
"9/23/2023","","Withdrawal POS #000000895586/SUNOCO 8002212501 4234 SW 20TH AVEGAINESVILLE FLCard 2801","17.49","","Posted","89.29"
"9/23/2023","","Withdrawal POS #000003340288/GOOGLE *Google Storage 1600 AmphitheatreParkw Mountain View CACard 2801","1.99","","Posted","106.78"
"9/22/2023","","Withdrawal POS #000000772390/Instacart 50 Beal St Suite 600 SanFrancisco CACard 2801","3","","Posted","108.77"
"9/22/2023","","Withdrawal POS #000000792964/Instacart 50 Beal St Suite 600 SanFrancisco CACard 2801","62.38","","Posted","111.77"
"9/21/2023","","Withdrawal POS #000000772238/Instacart 50 Beal St Suite 600 SanFrancisco CACard 2801","57.89","","Posted","174.15"
"9/20/2023","","Withdrawal POS #000000765409/SUNOCO 8002212501 4234 SW 20TH AVEGAINESVILLE FLCard 2801","28.55","","Posted","232.04"
"9/20/2023","","Deposit Home Banking Transfer food/From CHAPLINSKI,LEON 3496297 Share 0090","","250","Posted","260.59"
"9/20/2023","","Withdrawal POS #000003320828/GOOGLE *YouTubePremium 1600 AmphitheatreParkw Mountain View CACard 2801","15.92","","Posted","10.59"
"9/19/2023","","Withdrawal POS #000000689838/SUNOCO 8002212501 4234 SW 20TH AVEGAINESVILLE FLCard 2801","17.49","","Posted","26.51"
"9/18/2023","","Withdrawal POS #000000655618/SUNOCO 8002212501 4234 SW 20TH AVEGAINESVILLE FLCard 2801","17.49","","Posted","44"
"9/18/2023","","Withdrawal Debit Card MC Debit Seminol/PRINTIFY.COM WILMINGTON DEDate 09/17/23 0 3260843086 0 7333Card 2801","23.04","","Posted","61.49"
"9/18/2023","","Withdrawal Debit Card MC Debit Seminol/PRINTIFY.COM WILMINGTON DEDate 09/17/23 0 3260843085 0 7333Card 2801","33.04","","Posted","84.53"
"9/17/2023","","Withdrawal POS #000000792176/Instacart 50 Beal St Suite 600 SanFrancisco CACard 2801","49.13","","Posted","117.57"
"9/17/2023","","Recurring Withdrawal Debit Card - MC Debit Seminol/PLAYERAUCTIONS 800-342-0768 DEDate 09/17/23 0 3260060094 1 5816Card 2801","38.6","","Posted","166.7"
"9/17/2023","","Withdrawal Debit Card MC Debit Seminol/WALGREENS #5024 GAINESVILLE FLDate 09/16/23 0 3259059724 1 5912Card 2801","8.16","","Posted","205.3"
"9/17/2023","","Recurring Withdrawal Debit Card - MC Debit Seminol/APPLE.COM/BILL 866-712-7753 CADate 09/16/23 0 3259205559 2 5818Card 2801","18.98","","Posted","213.46"
"9/15/2023","","Recurring Withdrawal Adjustment - Debit Card Credit Voucher/WEB*BLUEHOST.COM PROVO UTDate 09/14/23 0 3257921186 0 5968Card 2801","","20.99","Posted","232.44"
"9/15/2023","","Recurring Withdrawal Adjustment - Debit Card Credit Voucher/WEB*BLUEHOST.COM PROVO UTDate 09/14/23 0 3257921185 0 5968Card 2801","","143.88","Posted","211.45"
"9/15/2023","","Recurring Withdrawal Debit Card - MC Debit Seminol/WEB*BLUEHOST.COM PROVO UTDate 09/14/23 0 3257921184 0 5968Card 2801","20.99","","Posted","67.57"
"9/15/2023","","Withdrawal POS #000000802091/Instacart 50 Beal St Suite 600 SanFrancisco CACard 2801","3","","Posted","88.56"
"9/15/2023","","Withdrawal POS #000000802049/Instacart 50 Beal St Suite 600 SanFrancisco CACard 2801","63.95","","Posted","91.56"
"9/14/2023","","Recurring Withdrawal Debit Card - MC Debit Seminol/WEB*BLUEHOST.COM PROVO UTDate 09/13/23 0 3256906037 0 5968Card 2801","143.88","","Posted","155.51"
"9/14/2023","","Withdrawal Debit Card MC Debit Seminol/CIRCLE K # 06782 GAINESVILLE FLDate 09/12/23 0 3255899974 0 5499Card 2801","26.23","","Posted","299.39"
"9/13/2023","","Withdrawal POS #000000023432/AMAZON.COM*TR0QF4EI1 SEATTLE WACard 2801","18.12","","Posted","325.62"
"9/12/2023","","Withdrawal POS #000000792554/Instacart 50 Beal St Suite 600 SanFrancisco CACard 2801","74.1","","Posted","343.74"
"9/12/2023","","Recurring Withdrawal Debit Card - MC Debit Seminol/QUILLBOT OAK BROOK ILDate 09/11/23 0 3254733194 0 5734Card 2801","19.95","","Posted","417.84"
"9/12/2023","","Withdrawal POS #000005013671/PAYPAL *PRINTIFY 2211 North First StreetSan Jose CACard 2801","10","","Posted","437.79"
"9/12/2023","","Deposit ACH ETSY INC/TYPE: PAYOUT ID: 4263863381 CO: ETSY INCEntry Class Code: CCD","","16.84","Posted","447.79"
"9/11/2023","","Withdrawal ACH CAPITAL ONE/TYPE: ONLINE PMT ID: 9279744391CO: CAPITAL ONE NAME: STEVEN CHAPLINSKIEntry Class Code: WEB","26","","Posted","430.95"
"9/11/2023","","Recurring Withdrawal Debit Card - MC Debit Seminol/MIDJOURNEY INC. SOUTH SAN FR CADate 09/10/23 0 3253006510 1 5734Card 2801","30","","Posted","456.95"
"9/10/2023","","Recurring Withdrawal Debit Card - MC Debit Seminol/MIDJOURNEY INC. SOUTH SAN FR CADate 09/08/23 0 3251850724 1 5734Card 2801","30","","Posted","486.95"
"9/10/2023","","Recurring Withdrawal Debit Card - MC Debit Seminol/WEB*HOSTGATOR.COM BURLINGTON MADate 09/08/23 0 3251838693 1 4816Card 2801","21.99","","Posted","516.95"
"9/10/2023","","Withdrawal Debit Card MC Debit Seminol/AMAZON PRIME*TR9UL8ZP0 AMZN.COM/BIL WADate 09/08/23 0 3251834805 1 5968Card 2801","15.13","","Posted","538.94"
"9/8/2023","","Recurring Withdrawal Debit Card Fee/MASTERCARD ISSUER CROSS-BORDER FEEDate 09/07/23 0 3250971158 0 5734Card 2801","0.24","","Posted","554.07"
"9/8/2023","","Recurring Withdrawal Debit Card - MC Debit Seminol/ALURA SUBSCRIPTION OSLO DUDate 09/07/23 0 3250971158 0 5734Card 2801","29.99","","Posted","554.31"
"9/8/2023","","Withdrawal POS #000096296533/FAST TRACK #200 GAINESVILLE FLCard 2801","27.56","","Posted","584.3"
"9/7/2023","","Withdrawal POS #000000772425/Instacart 50 Beal St Suite 600 SanFrancisco CACard 2801","5","","Posted","611.86"
"9/7/2023","","Withdrawal POS #000000772319/Instacart 50 Beal St Suite 600 SanFrancisco CACard 2801","78.72","","Posted","616.86"
"9/7/2023","","Recurring Withdrawal Debit Card - MC Debit Seminol/SALESAMURAI.IO SFTWARE BOULDER CODate 09/07/23 0 3250945464 0 5734Card 2801","9.99","","Posted","695.58"
"9/6/2023","","Recurring Withdrawal Debit Card Fee/MASTERCARD ISSUER CROSS-BORDER FEEDate 09/06/23 0 3249708425 0 5734Card 2801","0.12","","Posted","705.57"
"9/6/2023","","Recurring Withdrawal Debit Card - MC Debit Seminol/LINKTREE* LINKTREE COLLINGWOOD VIDate 09/06/23 0 3249708425 0 5734Card 2801","14.99","","Posted","705.69"
"9/6/2023","","Recurring Withdrawal Debit Card - MC Debit Seminol/MARMALEAD, LLC 4079065736 FLDate 09/05/23 0 3248703827 0 5045Card 2801","19","","Posted","720.68"
"9/6/2023","","Recurring Withdrawal Bill Payment - #000000330342/Netflix.com NETFLIX.COM LOS GATOS CACard 2801","11","","Posted","739.68"
"9/5/2023","","Recurring Withdrawal Debit Card - MC Debit Seminol/WWW.EVERBEE.IO SANTEE CADate 09/05/23 0 3248777430 0 5734Card 2801","6","","Posted","750.68"
"9/5/2023","","Recurring Withdrawal Debit Card - MC Debit Seminol/DISNEY PLUS 8889057888 CADate 09/04/23 0 3247706318 0 4899Card 2801","12.66","","Posted","756.68"
"9/5/2023","","Recurring Withdrawal Debit Card - MC Debit Seminol/ADOBE *STOCK 4085366000 CADate 09/04/23 0 3247815159 0 5734Card 2801","29.99","","Posted","769.34"
"9/5/2023","","Withdrawal ACH Watson Realty Co/TYPE: WEB PMTS ID: 9000321157CO: Watson Realty CoNAME: Steven chaplinskiEntry Class Code: WEB","1079","","Posted","799.33"
"9/5/2023","","Withdrawal ACH FLUENT-Gainesvil/TYPE: PAYMENT ID: 1371804719CO: FLUENT-GainesvilEntry Class Code: PPD","83","","Posted","1878.33"
"9/5/2023","","Withdrawal ACH AppFolio, Inc. F/TYPE: WEB PMTS ID: 9001406550CO: AppFolio, Inc. FNAME: Steven chaplinskiEntry Class Code: WEB","2.49","","Posted","1961.33"
"9/4/2023","","Recurring Withdrawal Debit Card - MC Debit Seminol/CHATGPT SUBSCRIPTION SAN FRANCISC CADate 09/03/23 0 3246038633 1 5734Card 2801","20","","Posted","1963.82"
"9/4/2023","","Recurring Withdrawal Debit Card - MC Debit Seminol/APPLE.COM/BILL 866-712-7753 CADate 09/03/23 0 3246843033 0 5818Card 2801","2.99","","Posted","1983.82"
"9/4/2023","","Recurring Withdrawal Debit Card - MC Debit Seminol/APPLE.COM/BILL 866-712-7753 CADate 09/03/23 0 3246843032 0 5818Card 2801","2.99","","Posted","1986.81"
"9/3/2023","","Withdrawal POS #000000010502/CIRCLE K # 26146 3525 GAINESVILLE FLCard 2801","27.72","","Posted","1989.8"
"9/3/2023","","Withdrawal POS #000000777017/PUBLIX 3100 SW 35TH BLVD GAINESVILLE FLCard 2801","52.69","","Posted","2017.52"
"9/3/2023","","Withdrawal Debit Card MC Debit Seminol/SESAME CARE - HEALTH MIAMI FLDate 09/01/23 0 3244024909 2 8099Card 2801","40","","Posted","2070.21"
"9/3/2023","","Recurring Withdrawal Debit Card - MC Debit Seminol/PARAMOUNT+ SAN FRANCISC CADate 09/02/23 0 3245001222 1 4899Card 2801","13.81","","Posted","2110.21"
"9/3/2023","","Withdrawal Debit Card MC Debit Seminol/WALGREENS #5024 GAINESVILLE FLDate 09/02/23 0 3245975396 0 5912Card 2801","11.74","","Posted","2124.02"
"9/3/2023","","Withdrawal Debit Card MC Debit Seminol/GRU/EZ-PAY WEB PYMT 352-334-3434 FLDate 09/01/23 0 3244541676 0 4900Card 2801","168.55","","Posted","2135.76"
"9/3/2023","","Withdrawal Debit Card MC Debit Seminol/COX GAINESVILLE COMM 800-234-3993 FLDate 09/01/23 0 3244017480 2 4899Card 2801","125.03","","Posted","2304.31"
"9/2/2023","","Withdrawal POS #000000935000/AMAZON.COM*TL49B6PZ2 SEATTLE WACard 2801","19.96","","Posted","2429.34"
"9/2/2023","","Withdrawal POS #000000890020/SUNOCO 8002212501 4234 SW 20TH AVEGAINESVILLE FLCard 2801","35.41","","Posted","2449.3"
"9/2/2023","","Withdrawal POS #000000005018/AMAZON.COM*TL5XF0NC0 SEATTLE WACard 2801","14.31","","Posted","2484.71"
"9/1/2023","","Withdrawal POS #000000772372/Instacart 50 Beal St Suite 600 SanFrancisco CACard 2801","5","","Posted","2499.02"
"9/1/2023","","Withdrawal POS #000000792009/Instacart 50 Beal St Suite 600 SanFrancisco CACard 2801","56.97","","Posted","2504.02"
"9/1/2023","","Withdrawal Debit Card MC Debit Seminol/MYDESIGNS - PRO - MON LAS VEGAS NVDate 09/01/23 0 3244164229 1 5734Card 2801","29.99","","Posted","2560.99"
"9/1/2023","","Recurring Withdrawal Debit Card - MC Debit Seminol/AIAVATAR BROOKLYN NYDate 09/01/23 0 3244163906 1 5970Card 2801","1.2","","Posted","2590.98"
"9/1/2023","","Withdrawal POS #000096296875/FAST TRACK #200 GAINESVILLE FLCard 2801","45.61","","Posted","2592.18"
"9/1/2023","","Deposit Home Banking Transfer - monthly expenses/From CHAPLINSKI,LEON 3496297 Share 0090","","2600","Posted","2637.79"
"8/31/2023","","Recurring Withdrawal Debit Card - MC Debit Seminol/KAIBER AI WILMINGTON DEDate 08/30/23 0 3242340816 0 5815Card 2801","5","","Posted","37.79"
"8/29/2023","","Recurring Withdrawal Debit Card Fee/MASTERCARD ISSUER CROSS-BORDER FEEDate 08/29/23 0 3241987657 0 5734Card 2801","0.13","","Posted","42.79"
"8/29/2023","","Recurring Withdrawal Debit Card - MC Debit Seminol/VANCEAI CENTRAL HODate 08/29/23 0 3241987657 0 5734Card 2801","15.9","","Posted","42.92"
"8/28/2023","","Recurring Withdrawal Debit Card - MC Debit Seminol/ADOBE *CREATIVE CLOUD 4085366000 CADate 08/27/23 0 3239947934 0 5734Card 2801","29.99","","Posted","58.82"
"8/28/2023","","Deposit Home Banking Transfer expenses/From CHAPLINSKI,LEON 3496297 Share 0090","","100","Posted","88.81"
"8/27/2023","","Recurring Withdrawal Debit Card - MC Debit Seminol/MIDJOURNEY INC. SOUTH SAN FR CADate 08/26/23 0 3238302720 1 5734Card 2801","4","","Posted","-11.19"
"8/27/2023","","Recurring Withdrawal Debit Card - MC Debit Seminol/YVETTE GODET DMD PA GAINESVILLE FLDate 08/25/23 0 3237032877 1 8021Card 2801","46","","Posted","-7.19"
"8/27/2023","","Withdrawal Transfer fee","8","","Posted","38.81"
"8/27/2023","","Deposit Transfer From Share 0000","","5","Posted","46.81"
"8/27/2023","","Withdrawal Debit Card MC Debit Seminol/WALGREENS #5024 GAINESVILLE FLDate 08/26/23 0 3238251787 1 5912Card 2801","15","","Posted","41.81"
"8/27/2023","","Withdrawal POS #000000782382/Instacart 50 Beal St Suite 600 SanFrancisco CACard 2801","5","","Posted","56.81"
"8/27/2023","","Withdrawal POS #000000792497/Instacart 50 Beal St Suite 600 SanFrancisco CACard 2801","71.52","","Posted","61.81"
"8/26/2023","","Withdrawal POS #000000513073/SUNOCO 8002212501 4234 SW 20TH AVEGAINESVILLE FLCard 2801","37.86","","Posted","133.33"
"8/26/2023","","Withdrawal Home Banking Transfer - To Share 0000/Funds Transfer via Online","5","","Posted","171.19"
"8/25/2023","","Deposit Home Banking Transfer 3658366/From CHAPLINSKI,LEON 3496297 Share 0090","","100","Posted","176.19"
"8/25/2023","","Deposit Home Banking Transfer dr godet/From CHAPLINSKI,LEON 3496297 Share 0090","","50","Posted","76.19"
"8/25/2023","","Withdrawal POS #000000452996/SUNOCO 8002212501 4234 SW 20TH AVEGAINESVILLE FLCard 2801","33.98","","Posted","26.19"
"8/24/2023","","Withdrawal POS #000000782733/Instacart 50 Beal St Suite 600 SanFrancisco CACard 2801","5","","Posted","60.17"
"8/24/2023","","Withdrawal POS #000000782712/Instacart 50 Beal St Suite 600 SanFrancisco CACard 2801","70.85","","Posted","65.17"
"8/24/2023","","Recurring Withdrawal Debit Card - MC Debit Seminol/VIDIQ PRO SAN FRANCISC CADate 08/23/23 0 3235876504 0 5734Card 2801","10","","Posted","136.02"
"8/23/2023","","Deposit Home Banking Transfer expenses/From CHAPLINSKI,LEON 3496297 Share 0090","","150","Posted","146.02"
"8/23/2023","","Withdrawal ACH FLUENT-Gainesvil/TYPE: PAYMENT ID: 1371804719CO: FLUENT-GainesvilEntry Class Code: PPD","45","","Posted","-3.98"
"8/23/2023","","Withdrawal Transfer fee","8","","Posted","41.02"
"8/23/2023","","Deposit Transfer From Share 0000","","5.85","Posted","49.02"
"8/23/2023","","Withdrawal POS #000003099853/GOOGLE *Google Storage 1600 AmphitheatreParkw Mountain View CACard 2801","1.99","","Posted","43.17"
"8/23/2023","","Withdrawal POS #000000772787/Instacart 50 Beal St Suite 600 SanFrancisco CACard 2801","5","","Posted","45.16"
"8/23/2023","","Withdrawal POS #000000792009/Instacart 50 Beal St Suite 600 SanFrancisco CACard 2801","55.19","","Posted","50.16"
"8/22/2023","","Withdrawal Debit Card MC Debit Seminol/WALGREENS #5024 GAINESVILLE FLDate 08/21/23 0 3233007786 1 5912Card 2801","8.16","","Posted","105.35"
"8/21/2023","","Withdrawal Bill Payment #000002088135/PAYPAL *PYPL Payin4 2211 North FirstStreet San Jose CACard 2801","13.75","","Posted","113.51"
"8/21/2023","","Withdrawal POS #000000782601/Instacart 50 Beal St Suite 600 SanFrancisco CACard 2801","5","","Posted","127.26"
"8/21/2023","","Withdrawal POS #000000772667/Instacart 50 Beal St Suite 600 SanFrancisco CACard 2801","72.54","","Posted","132.26"
"8/21/2023","","Withdrawal POS #000000265255/SUNOCO 8002212501 4234 SW 20TH AVEGAINESVILLE FLCard 2801","32.22","","Posted","204.8"
"8/21/2023","","Recurring Withdrawal Debit Card - MC Debit Seminol/CANVA* I03883-21590389 CAMDEN DEDate 08/20/23 0 3232977264 0 7221Card 2801","12.99","","Posted","237.02"
"8/21/2023","","Deposit Home Banking Transfer food/From CHAPLINSKI,LEON 3496297 Share 0090","","200","Posted","250.01"
"8/20/2023","","Withdrawal POS #000000782885/Instacart 50 Beal St Suite 600 SanFrancisco CACard 2801","44.75","","Posted","50.01"
"8/20/2023","","Withdrawal Debit Card MC Debit Seminol/APPLE.COM/BILL CUPERTINO CADate 08/18/23 0 3230028421 2 5735Card 2801","2.99","","Posted","94.76"
"8/20/2023","","Withdrawal POS #000003285955/GOOGLE *YouTubePremium 1600 AmphitheatreParkw Mountain View CACard 2801","13.64","","Posted","97.75"
"8/19/2023","","Withdrawal POS #000000772216/Instacart 50 Beal St Suite 600 SanFrancisco CACard 2801","5","","Posted","111.39"
"8/19/2023","","Withdrawal POS #000000772311/Instacart 50 Beal St Suite 600 SanFrancisco CACard 2801","44.94","","Posted","116.39"
"8/18/2023","","Withdrawal POS #000000782947/Instacart 50 Beal St Suite 600 SanFrancisco CACard 2801","5","","Posted","161.33"
"8/18/2023","","Withdrawal POS #000000782232/Instacart 50 Beal St Suite 600 SanFrancisco CACard 2801","47.92","","Posted","166.33"
"8/18/2023","","Withdrawal POS #000000104876/SUNOCO 8002212501 4234 SW 20TH AVEGAINESVILLE FLCard 2801","21.16","","Posted","214.25"
"8/17/2023","","Withdrawal POS #000000772845/Instacart 50 Beal St Suite 600 SanFrancisco CACard 2801","5","","Posted","235.41"
"8/17/2023","","Withdrawal POS #000000802826/Instacart 50 Beal St Suite 600 SanFrancisco CACard 2801","70.11","","Posted","240.41"
"8/17/2023","","Withdrawal POS #000000083324/SUNOCO 8002212501 4234 SW 20TH AVEGAINESVILLE FLCard 2801","31.79","","Posted","310.52"
"8/17/2023","","Deposit Home Banking Transfer food/From CHAPLINSKI,LEON 3496297 Share 0090","","250","Posted","342.31"
"8/16/2023","","Withdrawal POS #000000782893/Instacart 50 Beal St Suite 600 SanFrancisco CACard 2801","5","","Posted","92.31"
"8/16/2023","","Withdrawal POS #000000792627/Instacart 50 Beal St Suite 600 SanFrancisco CACard 2801","56.89","","Posted","97.31"
"8/16/2023","","Withdrawal POS #000000028432/SUNOCO 8002212501 4234 SW 20TH AVEGAINESVILLE FLCard 2801","17.51","","Posted","154.2"
"8/14/2023","","Withdrawal POS #000000018892/PUBLIX 3315 W. UNIVERSITY AVE.FLCard 2801","86.46","","Posted","171.71"
"8/13/2023","","Withdrawal POS #000000851822/SUNOCO 8002212501 4234 SW 20TH AVEGAINESVILLE FLCard 2801","31.79","","Posted","258.17"
"8/12/2023","","Withdrawal POS #000000772900/Instacart 50 Beal St Suite 600 SanFrancisco CACard 2801","5","","Posted","289.96"
"8/12/2023","","Withdrawal POS #000000802571/Instacart 50 Beal St Suite 600 SanFrancisco CACard 2801","61.27","","Posted","294.96"
"8/11/2023","","Recurring Withdrawal Debit Card - MC Debit Seminol/MIDJOURNEY INC. SOUTH SAN FR CADate 08/10/23 0 3222981879 0 5734Card 2801","30","","Posted","356.23"
"8/10/2023","","Withdrawal POS #000000751774/SUNOCO 8002212501 4234 SW 20TH AVEGAINESVILLE FLCard 2801","42.87","","Posted","386.23"
"8/9/2023","","Recurring Withdrawal Debit Card - MC Debit Seminol/MIDJOURNEY INC. SOUTH SAN FR CADate 08/08/23 0 3220859759 0 5734Card 2801","30","","Posted","429.1"
"8/9/2023","","Recurring Withdrawal Debit Card Fee/MASTERCARD ISSUER CROSS-BORDER FEEDate 08/08/23 0 3220043177 1 7399Card 2801","0.23","","Posted","459.1"
"8/9/2023","","Recurring Withdrawal Debit Card - MC Debit Seminol/CREATIVE FABRICA AMSTERDAM NHDate 08/08/23 0 3220043177 1 7399Card 2801","29","","Posted","459.33"
"8/9/2023","","Recurring Withdrawal Debit Card - MC Debit Seminol/WEB*HOSTGATOR.COM BURLINGTON MADate 08/08/23 0 3220041608 1 4816Card 2801","12.95","","Posted","488.33"
"8/9/2023","","Withdrawal Debit Card MC Debit Seminol/AMAZON PRIME*TA0BI59I2 AMZN.COM/BIL WADate 08/08/23 0 3220037222 1 5968Card 2801","15.13","","Posted","501.28"
"8/9/2023","","Withdrawal ACH CAPITAL ONE/TYPE: ONLINE PMT ID: 9279744391CO: CAPITAL ONE NAME: STEVEN CHAPLINSKIEntry Class Code: WEB","26","","Posted","516.41"
"8/8/2023","","Withdrawal POS #000000792946/Instacart 50 Beal St Suite 600 SanFrancisco CACard 2801","5","","Posted","542.41"
"8/8/2023","","Withdrawal POS #000000802557/Instacart 50 Beal St Suite 600 SanFrancisco CACard 2801","56","","Posted","547.41"
"8/8/2023","","Recurring Withdrawal Debit Card Fee/MASTERCARD ISSUER CROSS-BORDER FEEDate 08/07/23 0 3219017867 1 5734Card 2801","0.24","","Posted","603.41"
"8/8/2023","","Recurring Withdrawal Debit Card - MC Debit Seminol/ALURA SUBSCRIPTION OSLO DUDate 08/07/23 0 3219017867 1 5734Card 2801","29.99","","Posted","603.65"
"8/8/2023","","Withdrawal Debit Card MC Debit Seminol/B2P* FL OMMU MJ MED CA JACKSONVILLE FLDate 08/07/23 0 3219013208 1 9399Card 2801","77.75","","Posted","633.64"
"8/8/2023","","Withdrawal Debit Card MC Debit Seminol/UBER TRIP 8005928996 CADate 08/07/23 0 3219009537 1 4121Card 2801","26.94","","Posted","711.39"
"8/8/2023","","Withdrawal Debit Card MC Debit Seminol/UBER TRIP 8005928996 CADate 08/07/23 0 3219009531 1 4121Card 2801","16.97","","Posted","738.33"
"8/8/2023","","Deposit Home Banking Transfer medical/From CHAPLINSKI,LEON 3496297 Share 0090","","270","Posted","755.3"
"8/7/2023","","Withdrawal POS #000000772209/Instacart 50 Beal St Suite 600 SanFrancisco CACard 2801","101.21","","Posted","485.3"
"8/7/2023","","Recurring Withdrawal Debit Card - MC Debit Seminol/SALESAMURAI.IO SFTWARE BOULDER CODate 08/07/23 0 3219924706 0 5734Card 2801","9.99","","Posted","586.51"
"8/6/2023","","Withdrawal Bill Payment #000001089739/PAYPAL *PYPL Payin4 2211 North FirstStreet San Jose CACard 2801","13.75","","Posted","596.5"
"8/6/2023","","Recurring Withdrawal Debit Card - MC Debit Seminol/WWW.EVERBEE.IO SANTEE CADate 08/05/23 0 3217038747 3 5734Card 2801","29.99","","Posted","610.25"
"8/6/2023","","Recurring Withdrawal Debit Card - MC Debit Seminol/DISNEY PLUS 8889057888 CADate 08/04/23 0 3216012011 2 4899Card 2801","12.66","","Posted","640.24"
"8/6/2023","","Withdrawal Debit Card MC Debit Seminol/WALGREENS #5024 GAINESVILLE FLDate 08/04/23 0 3216030661 3 5912Card 2801","29.78","","Posted","652.9"
"8/6/2023","","Recurring Withdrawal Debit Card - MC Debit Seminol/APPLE.COM/BILL 866-712-7753 CADate 08/06/23 0 3218094412 1 5818Card 2801","15.99","","Posted","682.68"
"8/6/2023","","Recurring Withdrawal Debit Card - MC Debit Seminol/ADOBE *STOCK 4085366000 CADate 08/04/23 0 3216007220 2 5734Card 2801","29.99","","Posted","698.67"
"8/6/2023","","Recurring Withdrawal Debit Card - MC Debit Seminol/MARMALEAD, LLC 4079065736 FLDate 08/05/23 0 3217970394 0 5045Card 2801","19","","Posted","728.66"
"8/6/2023","","Recurring Withdrawal Bill Payment - #000000410382/NETFLIX COM LOS GATOS CACard 2801","11","","Posted","747.66"
"8/4/2023","","Recurring Withdrawal Debit Card - MC Debit Seminol/MIDJOURNEY INC. SOUTH SAN FR CADate 08/04/23 0 3216198985 1 5734Card 2801","4","","Posted","758.66"
"8/4/2023","","Recurring Withdrawal Debit Card - MC Debit Seminol/CHATGPT SUBSCRIPTION SAN FRANCISC CADate 08/04/23 0 3216122516 1 5734Card 2801","20","","Posted","762.66"
"8/4/2023","","Withdrawal Debit Card MC Debit Seminol/PHR*SIMEDHEALTHLLC GAINESVILLE FLDate 08/03/23 0 3215120036 1 8011Card 2801","45","","Posted","782.66"
"8/4/2023","","Withdrawal Debit Card MC Debit Seminol/WALGREENS #9304 GAINESVILLE FLDate 08/03/23 0 3215192531 1 5912Card 2801","32.91","","Posted","827.66"
"8/4/2023","","Recurring Withdrawal Debit Card - MC Debit Seminol/APPLE.COM/BILL 866-712-7753 CADate 08/03/23 0 3215905953 0 5818Card 2801","2.99","","Posted","860.57"
"8/4/2023","","Recurring Withdrawal Debit Card - MC Debit Seminol/APPLE.COM/BILL 866-712-7753 CADate 08/03/23 0 3215905952 0 5818Card 2801","2.99","","Posted","863.56"
"8/3/2023","","Withdrawal POS #000017155615/WALGREENS 3455 SW ARCH GAINESVILLE FLCard 2801","5.99","","Posted","866.55"
"8/3/2023","","Recurring Withdrawal Debit Card - MC Debit Seminol/MIDJOURNEY INC. SOUTH SAN FR CADate 08/02/23 0 3214189525 1 5734Card 2801","8","","Posted","872.54"
"8/3/2023","","Recurring Withdrawal Debit Card - MC Debit Seminol/PARAMOUNT+ SAN FRANCISC CADate 08/02/23 0 3214930352 0 4899Card 2801","13.81","","Posted","880.54"
"8/3/2023","","Withdrawal Debit Card MC Debit Seminol/UBER TRIP 8005928996 CADate 08/02/23 0 3214923759 0 4121Card 2801","23.9","","Posted","894.35"
"8/2/2023","","Recurring Withdrawal Debit Card - MC Debit Seminol/ETSY INC SELLER FEES BROOKLYN NYDate 08/02/23 0 3214235855 1 7311Card 2801","0.2","","Posted","918.25"
"8/2/2023","","Recurring Withdrawal Debit Card - MC Debit Seminol/ETSY INC SELLER FEES BROOKLYN NYDate 08/02/23 0 3214235853 1 7311Card 2801","0.2","","Posted","918.45"
"8/2/2023","","Withdrawal Debit Card MC Debit Seminol/BOCA GAS STATION GAINESVILLE FLDate 08/01/23 0 3213233381 1 5541Card 2801","28.38","","Posted","918.65"
"8/2/2023","","Withdrawal POS #000000747649/PUBLIX 3315 W. UNIVERSITY AVE.FLCard 2801","137.28","","Posted","947.03"
"8/2/2023","","Withdrawal POS #000000001537/CIRCLE K # 21303 2320 GAINESVILLE FLCard 2801","27.39","","Posted","1084.31"
"8/1/2023","","Recurring Withdrawal Debit Card - MC Debit Seminol/MIDJOURNEY INC. SOUTH SAN FR CADate 07/31/23 0 3212947111 0 5734Card 2801","8","","Posted","1111.7"
"8/1/2023","","Recurring Withdrawal Debit Card - MC Debit Seminol/MIDJOURNEY INC. SOUTH SAN FR CADate 07/31/23 0 3212357840 0 5734Card 2801","4","","Posted","1119.7"
"8/1/2023","","Recurring Withdrawal Debit Card - MC Debit Seminol/ETSY INC SELLER FEES BROOKLYN NYDate 08/01/23 0 3213088061 1 7311Card 2801","3","","Posted","1123.7"
"8/1/2023","","Withdrawal Debit Card MC Debit Seminol/CIRCLE K # 06782 GAINESVILLE FLDate 07/31/23 0 3212940436 0 5541Card 2801","25.82","","Posted","1126.7"
"8/1/2023","","Withdrawal Debit Card MC Debit Seminol/GRU/EZ-PAY WEB PYMT 352-334-3434 FLDate 07/31/23 0 3212355876 0 4900Card 2801","225.05","","Posted","1152.52"
"8/1/2023","","Withdrawal Debit Card MC Debit Seminol/COX GAINESVILLE COMM 800-234-3993 FLDate 07/31/23 0 3212823057 0 4899Card 2801","125.03","","Posted","1377.57"
"8/1/2023","","Withdrawal ACH Watson Realty Co/TYPE: WEB PMTS ID: 9000321157CO: Watson Realty CoNAME: Steven chaplinskiEntry Class Code: WEB","1079","","Posted","1502.6"
"8/1/2023","","Withdrawal ACH FLUENT-Gainesvil/TYPE: PAYMENT ID: 1371804719CO: FLUENT-GainesvilEntry Class Code: PPD","49","","Posted","2581.6"
"7/31/2023","","Recurring Withdrawal Debit Card - MC Debit Seminol/MIDJOURNEY INC. SOUTH SAN FR CADate 07/30/23 0 3211945515 0 5734Card 2801","8","","Posted","2630.6"
"7/31/2023","","Recurring Withdrawal Debit Card - MC Debit Seminol/KAIBER AI WILMINGTON DEDate 07/30/23 0 3211262093 0 5815Card 2801","5","","Posted","2638.6"
"7/31/2023","","Deposit Home Banking Transfer expenses/From CHAPLINSKI,LEON 3496297 Share 0090","","2600","Posted","2643.6"
"7/30/2023","","Recurring Withdrawal Debit Card Fee/MASTERCARD ISSUER CROSS-BORDER FEEDate 07/29/23 0 3210810050 1 5734Card 2801","0.13","","Posted","43.6"
"7/30/2023","","Recurring Withdrawal Debit Card - MC Debit Seminol/VANCEAI CENTRAL HODate 07/29/23 0 3210810050 1 5734Card 2801","15.9","","Posted","43.73"
"7/30/2023","","Withdrawal Debit Card MC Debit Seminol/CIRCLE K # 26146 GAINESVILLE FLDate 07/28/23 0 3209802364 1 5541Card 2801","19.43","","Posted","59.63"
"7/30/2023","","Withdrawal POS #000000792783/Instacart 50 Beal St Suite 600 SanFrancisco CACard 2801","4.15","","Posted","79.06"
"7/30/2023","","Withdrawal POS #000000792995/Instacart 50 Beal St Suite 600 SanFrancisco CACard 2801","50","","Posted","83.21"
"7/28/2023","","Withdrawal Debit Card MC Debit Seminol/DISTANT FUTURE CORP SAN FRANCISC CADate 07/27/23 0 3208120284 1 5817Card 2801","29.95","","Posted","133.21"
"7/28/2023","","Withdrawal Debit Card MC Debit Seminol/WALGREENS #5024 GAINESVILLE FLDate 07/27/23 0 3208143995 1 5912Card 2801","18.91","","Posted","163.16"
"7/28/2023","","Withdrawal Debit Card MC Debit Seminol/CIRCLE K # 06782 GAINESVILLE FLDate 07/26/23 0 3207111703 1 5499Card 2801","17.46","","Posted","182.07"
"7/28/2023","","Recurring Withdrawal Debit Card - MC Debit Seminol/ADOBE *CREATIVE CLOUD 4085366000 CADate 07/27/23 0 3208894437 0 5734Card 2801","29.99","","Posted","199.53"
"7/27/2023","","Deposit Home Banking Transfer food/From CHAPLINSKI,LEON 3496297 Share 0090","","200","Posted","229.52"
"7/27/2023","","Withdrawal POS #000000937357/SUNOCO 8002212501 4234 SW 20TH AVEGAINESVILLE FLCard 2801","32.87","","Posted","29.52"
"7/26/2023","","Withdrawal POS #000000772808/Instacart 50 Beal St Suite 600 SanFrancisco CACard 2801","5","","Posted","62.39"
"7/26/2023","","Withdrawal POS #000000782782/Instacart 50 Beal St Suite 600 SanFrancisco CACard 2801","49.28","","Posted","67.39"
"7/26/2023","","Withdrawal Debit Card MC Debit Seminol/EXXON FAST TRACK #200 GAINESVILLE FLDate 07/25/23 0 3206136870 1 5541Card 2801","16.23","","Posted","116.67"
"7/26/2023","","Withdrawal POS #000000634941/SUNOCO 8002212501 4234 SW 20TH AVEGAINESVILLE FLCard 2801","16.44","","Posted","132.9"
"7/25/2023","","Withdrawal POS #000000792604/Instacart 50 Beal St Suite 600 SanFrancisco CACard 2801","5.83","","Posted","149.34"
"7/25/2023","","Withdrawal POS #000000772122/Instacart 50 Beal St Suite 600 SanFrancisco CACard 2801","71.56","","Posted","155.17"
"7/25/2023","","Deposit Home Banking Transfer food/From CHAPLINSKI,LEON 3496297 Share 0090","","200","Posted","226.73"
"7/24/2023","","Withdrawal POS #000000814434/SUNOCO 8002212501 4234 SW 20TH AVEGAINESVILLE FLCard 2801","16.44","","Posted","26.73"
"7/24/2023","","Recurring Withdrawal Debit Card - MC Debit Seminol/VIDIQ PRO SAN FRANCISC CADate 07/23/23 0 3204956369 0 5734Card 2801","10","","Posted","43.17"
"7/23/2023","","Withdrawal POS #000003245378/GOOGLE *Google Storage 1600 AmphitheatreParkw Mountain View CACard 2801","1.99","","Posted","53.17"
"7/22/2023","","Withdrawal POS #000000000008/AMAZON.COM*NT3PE5TH3 SEATTLE WACard 2801","12.69","","Posted","55.16"
"7/22/2023","","Withdrawal Bill Payment #000001057749/PAYPAL *PYPL Payin4 2211 North FirstStreet San Jose CACard 2801","13.75","","Posted","67.85"
"7/21/2023","","Recurring Withdrawal Debit Card - MC Debit Seminol/CANVA* I03852-21436246 CAMDEN DEDate 07/20/23 0 3201948972 0 7221Card 2801","12.99","","Posted","81.6"
"7/20/2023","","Withdrawal POS #000003365470/GOOGLE *YouTubePremium 1600 AmphitheatreParkw Mountain View CACard 2801","13.64","","Posted","94.59"
"7/18/2023","","Recurring Withdrawal Debit Card - MC Debit Seminol/APPLE.COM/BILL 866-712-7753 CADate 07/18/23 0 3199086849 1 5818Card 2801","2.99","","Posted","108.23"
"7/17/2023","","Withdrawal POS #000000008772/CIRCLE K # 26146 3525 GAINESVILLE FLCard 2801","27.47","","Posted","111.22"
"7/17/2023","","Withdrawal ATM Fee/EFT 3401 W University Ave Gainesville FLCard 2801","2","","Posted","138.69"
"7/17/2023","","Withdrawal at ATM #000000977234/EFT 3401 W University Ave Gainesville FLCard 2801","83","","Posted","140.69"
"7/15/2023","","Withdrawal POS #000000363695/SUNOCO 8002212501 4234 SW 20TH AVEGAINESVILLE FLCard 2801","32.87","","Posted","223.69"
"7/12/2023","","Withdrawal POS #000000802635/Instacart 50 Beal St Suite 600 SanFrancisco CACard 2801","5","","Posted","256.56"
"7/12/2023","","Withdrawal POS #000000782504/Instacart 50 Beal St Suite 600 SanFrancisco CACard 2801","56.51","","Posted","261.56"
"7/12/2023","","Deposit Home Banking Transfer food/From CHAPLINSKI,LEON 3496297 Share 0090","","200","Posted","318.07"
"7/11/2023","","Withdrawal POS #000000215946/SUNOCO 8002212501 4234 SW 20TH AVEGAINESVILLE FLCard 2801","32.87","","Posted","118.07"
"7/10/2023","","Withdrawal ACH CAPITAL ONE/TYPE: ONLINE PMT ID: 9279744391CO: CAPITAL ONE NAME: STEVEN CHAPLINSKIEntry Class Code: WEB","26","","Posted","150.94"
"7/9/2023","","Recurring Withdrawal Debit Card - MC Debit Seminol/MIDJOURNEY INC. SOUTH SAN FR CADate 07/08/23 0 3189263519 0 5734Card 2801","30","","Posted","176.94"
"7/9/2023","","Recurring Withdrawal Debit Card - MC Debit Seminol/WEB*HOSTGATOR.COM BURLINGTON MADate 07/08/23 0 3189966288 0 4816Card 2801","12.95","","Posted","206.94"
"7/9/2023","","Withdrawal Debit Card MC Debit Seminol/GOOGLE *COLAB CC GOOGLE.CO CADate 07/08/23 0 3189962202 0 7399Card 2801","9.99","","Posted","219.89"
"7/9/2023","","Withdrawal Debit Card MC Debit Seminol/AMAZON PRIME*EI0RV58V3 AMZN.COM/BIL WADate 07/08/23 0 3189961984 0 5968Card 2801","15.13","","Posted","229.88"
"7/8/2023","","Withdrawal POS #000016231692/CASH APP*MIDJOURNEY INC SQUAREUP.COMSAN FRA CACard 2801","30","","Posted","245.01"
"7/8/2023","","Withdrawal Adjustment POS #070803436311/PAYPAL *TARGETCORPO 2211 North FirstStreet San Jose CACard 2801","","12.9","Posted","275.01"
"7/7/2023","","Withdrawal POS #000000971405/SUNOCO 8002212501 4234 SW 20TH AVEGAINESVILLE FLCard 2801","32.87","","Posted","262.11"
"7/7/2023","","Withdrawal Debit Card MC Debit Seminol/SALESAMURAI.IO SFTWARE BOULDER CODate 07/06/23 0 3187119829 1 5734Card 2801","9.99","","Posted","294.98"
"7/7/2023","","Recurring Withdrawal Debit Card - MC Debit Seminol/APPLE.COM/BILL 866-712-7753 CADate 07/06/23 0 3187931286 0 5818Card 2801","15.99","","Posted","304.97"
"7/7/2023","","Withdrawal POS #070708407232/PAYPAL *PYPL Payin4 2211 North FirstStreet San Jose CACard 2801","13.75","","Posted","320.96"
"7/7/2023","","Withdrawal POS #000000772328/Instacart 50 Beal St Suite 600 SanFrancisco CACard 2801","5","","Posted","334.71"
"7/7/2023","","Withdrawal POS #000000802034/Instacart 50 Beal St Suite 600 SanFrancisco CACard 2801","80.19","","Posted","339.71"
"7/6/2023","","Withdrawal POS #000000002415/CIRCLE K # 26162 7302 GAINESVILLE FLCard 2801","17.47","","Posted","419.9"
"7/6/2023","","Withdrawal ATM Transaction","40","","Posted","437.37"
"7/6/2023","","Withdrawal Debit Card MC Debit Seminol/DRI*ID.MYCOMMERCE.COM MINNETONKA MNDate 07/05/23 0 3186032383 1 5734Card 2801","22.8","","Posted","477.37"
"7/6/2023","","Recurring Withdrawal Debit Card - MC Debit Seminol/MARMALEAD, LLC 4079065736 FLDate 07/05/23 0 3186769564 0 5045Card 2801","19","","Posted","500.17"
"7/6/2023","","Recurring Withdrawal Bill Payment - #000000406426/NETFLIX COM LOS GATOS CACard 2801","11","","Posted","519.17"
"7/5/2023","","Recurring Withdrawal Debit Card - MC Debit Seminol/WWW.EVERBEE.IO SANTEE CADate 07/05/23 0 3186811005 0 5734Card 2801","29.99","","Posted","530.17"
"7/5/2023","","Withdrawal Debit Card MC Debit Seminol/PLAYSTATIONNETWORK SAN MATEO CADate 07/05/23 0 3186810835 0 5816Card 2801","29.99","","Posted","560.16"
"7/5/2023","","Recurring Withdrawal Debit Card - MC Debit Seminol/DISNEY PLUS 8889057888 CADate 07/04/23 0 3185801884 0 4899Card 2801","12.66","","Posted","590.15"
"7/5/2023","","Recurring Withdrawal Debit Card - MC Debit Seminol/PLAYERAUCTIONS 800-342-0768 DEDate 07/04/23 0 3185800329 0 5816Card 2801","57.46","","Posted","602.81"
"7/5/2023","","Recurring Withdrawal Debit Card - MC Debit Seminol/AMAZON PRIME*QP8EE86P3 AMZN.COM/BIL WADate 07/04/23 0 3185799509 0 5968Card 2801","15.15","","Posted","660.27"
"7/5/2023","","Recurring Withdrawal Debit Card - MC Debit Seminol/ADOBE *STOCK 4085366000 CADate 07/04/23 0 3185798080 0 5734Card 2801","29.99","","Posted","675.42"
"7/5/2023","","Withdrawal ACH FLUENT-Gainesvil/TYPE: PAYMENT ID: 1371804719CO: FLUENT-GainesvilEntry Class Code: PPD","81.8","","Posted","705.41"
"7/5/2023","","Withdrawal ACH FLUENT-Gainesvil/TYPE: PAYMENT ID: 1371804719CO: FLUENT-GainesvilEntry Class Code: PPD","15","","Posted","787.21"
"7/4/2023","","Withdrawal POS #070409334948/PAYPAL *TARGETCORPO 2211 North FirstStreet San Jose CACard 2801","12.9","","Posted","802.21"
"7/4/2023","","Recurring Withdrawal Debit Card - MC Debit Seminol/CHATGPT SUBSCRIPTION SAN FRANCISC CADate 07/03/23 0 3184072640 1 5734Card 2801","20","","Posted","815.11"
"7/4/2023","","Recurring Withdrawal Debit Card - MC Debit Seminol/APPLE.COM/BILL CUPERTINO CADate 07/03/23 0 3184067429 1 5735Card 2801","2.99","","Posted","835.11"
"7/4/2023","","Recurring Withdrawal Debit Card - MC Debit Seminol/APPLE.COM/BILL 866-712-7753 CADate 07/04/23 0 3185066017 1 5818Card 2801","2.99","","Posted","838.1"
"7/4/2023","","Withdrawal POS #000000802896/Instacart 50 Beal St Suite 600 SanFrancisco CACard 2801","5","","Posted","841.09"
"7/4/2023","","Withdrawal POS #000000782097/Instacart 50 Beal St Suite 600 SanFrancisco CACard 2801","94.94","","Posted","846.09"
"7/4/2023","","Withdrawal POS #000008031049/PAYPAL *HAVOCMARKET HAVOC 2211 NorthStreet San Jose CACard 2801","2.99","","Posted","941.03"
"7/3/2023","","Withdrawal POS #000000626872/SUNOCO 8002212501 4234 SW 20TH AVEGAINESVILLE FLCard 2801","32.87","","Posted","944.02"
"7/3/2023","","Recurring Withdrawal Debit Card - MC Debit Seminol/PARAMOUNT+ SAN FRANCISC CADate 07/02/23 0 3183995126 0 4899Card 2801","13.81","","Posted","976.89"
"7/2/2023","","Recurring Withdrawal Debit Card - MC Debit Seminol/KAIBER AI WILMINGTON DEDate 06/30/23 0 3181776203 0 5815Card 2801","5","","Posted","990.7"
"6/30/2023","","Withdrawal Debit Card Fee/MASTERCARD ISSUER CROSS-BORDER FEEDate 06/29/23 0 3180883261 0 5999Card 2801","0.04","","Posted","995.7"
"6/30/2023","","Withdrawal Debit Card MC Debit Seminol/PAYPAL *PADDLE.NET 35314369001 GBDate 06/29/23 0 3180883261 0 5999Card 2801","4.99","","Posted","995.74"
"6/30/2023","","Withdrawal Debit Card MC Debit Seminol/GRU/EZ-PAY WEB PYMT 352-334-3434 FLDate 06/29/23 0 3180354940 0 4900Card 2801","186.42","","Posted","1000.73"
"6/29/2023","","Withdrawal Bill Payment #000003355888/PAYPAL *MAX 2211 North First Street SanJose CACard 2801","18.41","","Posted","1187.15"
"6/29/2023","","Withdrawal Debit Card Fee/MASTERCARD ISSUER CROSS-BORDER FEEDate 06/29/23 0 3180070895 1 5734Card 2801","0.13","","Posted","1205.56"
"6/29/2023","","Withdrawal Debit Card MC Debit Seminol/VANCEAI CENTRAL HODate 06/29/23 0 3180070895 1 5734Card 2801","15.9","","Posted","1205.69"
"6/29/2023","","Recurring Withdrawal Debit Card - MC Debit Seminol/PLAYERAUCTIONS 800-342-0768 DEDate 06/29/23 0 3180080494 1 5816Card 2801","38.6","","Posted","1221.59"
"6/29/2023","","Withdrawal Debit Card MC Debit Seminol/COX GAINESVILLE COMM 800-234-3993 FLDate 06/28/23 0 3179357082 0 4899Card 2801","125.03","","Posted","1260.19"
"6/29/2023","","Withdrawal ACH Watson Realty Co/TYPE: WEB PMTS ID: 9000321157CO: Watson Realty CoNAME: Steven chaplinskiEntry Class Code: WEB","995","","Posted","1385.22"
"6/29/2023","","Withdrawal POS #000000792028/Instacart 50 Beal St Suite 600 SanFrancisco CACard 2801","5","","Posted","2380.22"
"6/29/2023","","Withdrawal POS #000000772324/Instacart 50 Beal St Suite 600 SanFrancisco CACard 2801","81.48","","Posted","2385.22"
"6/29/2023","","Withdrawal POS #000000362128/PLAYSTATION.COM US FOSTER CITY CACard 2801","99.99","","Posted","2466.7"
"6/28/2023","","Withdrawal POS #000000488417/SUNOCO 8002212501 4234 SW 20TH AVEGAINESVILLE FLCard 2801","34.98","","Posted","2566.69"
"6/28/2023","","Deposit Home Banking Transfer trf/From CHAPLINSKI,LEON 3496297 Share 0000","","2600","Posted","2601.67"
"6/28/2023","","Recurring Withdrawal Debit Card - MC Debit Seminol/ADOBE *CREATIVE CLOUD 4085366000 CADate 06/27/23 0 3178852802 0 5734Card 2801","29.99","","Posted","1.67"
"6/27/2023","","Withdrawal Debit Card MC Debit Seminol/WALGREENS #5024 GAINESVILLE FLDate 06/26/23 0 3177001861 1 5912Card 2801","15","","Posted","31.66"
"6/26/2023","","Withdrawal POS #000000409276/SUNOCO 8002212501 4234 SW 20TH AVEGAINESVILLE FLCard 2801","28.55","","Posted","46.66"
"6/26/2023","","Withdrawal POS #000011251276/WALGREENS 2415 SW 75TH GAINESVILLE FLCard 2801","5.28","","Posted","75.21"
"6/25/2023","","Withdrawal POS #000000347643/SUNOCO 8002212501 4234 SW 20TH AVEGAINESVILLE FLCard 2801","35.2","","Posted","80.49"
"6/25/2023","","Recurring Withdrawal Debit Card MC Debit/VIDIQ PRO SAN FRANCISC CADate 06/23/23 0 3174219633 1 5734Card 2801","10","","Posted","115.69"
"6/25/2023","","Withdrawal Debit Card MC Debit/WALGREENS #5024 GAINESVILLE FLDate 06/23/23 0 3174465834 2 5912Card 2801","18.49","","Posted","125.69"
"6/24/2023","","Withdrawal POS #000000153618/PLAYSTATION.COM US FOSTER CITY CACard 2801","24.99","","Posted","144.18"
"6/23/2023","","Withdrawal POS #000000242084/SUNOCO 8002212501 4234 SW 20TH AVEGAINESVILLE FLCard 2801","23.3","","Posted","169.17"
"6/23/2023","","Withdrawal ACH FLUENT-Gainesvil/TYPE: PAYMENT ID: 1371804719CO: FLUENT-GainesvilEntry Class Code: PPD","103.5","","Posted","192.47"
"6/23/2023","","Withdrawal POS #000003333814/GOOGLE *Google Storage 1600 AmphitheatreParkw Mountain View CACard 2801","1.99","","Posted","295.97"
"6/22/2023","","Withdrawal POS #000000782615/Instacart 50 Beal St Suite 600 SanFrancisco CACard 2801","5","","Posted","297.96"
"6/22/2023","","Withdrawal POS #000000772154/Instacart 50 Beal St Suite 600 SanFrancisco CACard 2801","71.37","","Posted","302.96"
"6/21/2023","","Recurring Withdrawal Debit Card MC Debit/CANVA* I03822-21318506 CAMDEN DEDate 06/20/23 0 3171858479 0 7221Card 2801","12.99","","Posted","374.33"
"6/21/2023","","Deposit Home Banking Transfer 0090/From CHAPLINSKI,LEON 3496297 Share 0090","","300","Posted","387.32"
"6/21/2023","","Withdrawal POS #000000127849/SUNOCO 8002212501 4234 SW 20TH AVEGAINESVILLE FLCard 2801","27.5","","Posted","87.32"
"6/20/2023","","Withdrawal POS #000003216179/GOOGLE *YouTubePremium 1600 AmphitheatreParkw Mountain View CACard 2801","13.64","","Posted","114.82"
"6/20/2023","","Withdrawal POS #000000524315/AMAZON.COM*S65085A63 SEATTLE WACard 2801","23.09","","Posted","128.46"
"6/20/2023","","Withdrawal POS #000000000002/AMAZON.COM*AW2X61683 SEATTLE WACard 2801","20.4","","Posted","151.55"
"6/20/2023","","Withdrawal POS #000000059871/PUBLIX 3930 SW ARCHER ROAD GAINESVILLECard 2801","73.35","","Posted","171.95"
"6/19/2023","","Withdrawal POS #000000013264/SUNOCO 8002212501 4234 SW 20TH AVEGAINESVILLE FLCard 2801","32.87","","Posted","245.3"
"6/18/2023","","Recurring Withdrawal Debit Card MC Debit/APPLE.COM/BILL 866-712-7753 CADate 06/18/23 0 3169087519 1 5818Card 2801","2.99","","Posted","278.17"
"6/17/2023","","Withdrawal POS #000000802789/Instacart 50 Beal St Suite 600 SanFrancisco CACard 2801","60.7","","Posted","281.16"
"6/16/2023","","Withdrawal Debit Card MC Debit/EXXON FAST TRACK #200 GAINESVILLE FLDate 06/15/23 0 3166206451 1 5541Card 2801","25.45","","Posted","341.86"
"6/16/2023","","Withdrawal POS #000000088222/PUBLIX 3930 SW ARCHER ROAD GAINESVILLECard 2801","60.36","","Posted","367.31"
"6/11/2023","","Withdrawal POS #000000000008/AMAZON.COM*ND2SO9E83 SEATTLE WACard 2801","14.91","","Posted","427.67"
"6/11/2023","","Withdrawal POS #000096293505/FAST TRACK #200 GAINESVILLE FLCard 2801","26.12","","Posted","442.58"
"6/11/2023","","Withdrawal POS #000000047112/PUBLIX 3930 SW ARCHER ROAD GAINESVILLECard 2801","65.67","","Posted","468.7"
"6/9/2023","","Withdrawal POS #000000476031/SUNOCO 8002212501 4234 SW 20TH AVEGAINESVILLE FLCard 2801","28.55","","Posted","534.37"
"6/9/2023","","Recurring Withdrawal Debit Card MC Debit/WEB*HOSTGATOR.COM BURLINGTON MADate 06/08/23 0 3159061206 1 4816Card 2801","12.95","","Posted","562.92"
"6/8/2023","","Recurring Withdrawal Debit Card MC Debit/MIDJOURNEY INC. SOUTH SAN FR CADate 06/07/23 0 3158865788 0 5734Card 2801","30","","Posted","575.87"
"6/7/2023","","Withdrawal ACH FLUENT-Gainesvil/TYPE: PAYMENT ID: 1371804719CO: FLUENT-GainesvilEntry Class Code: PPD","64","","Posted","605.87"
"6/6/2023","","Recurring Withdrawal Debit Card MC Debit/APPLE.COM/BILL 866-712-7753 CADate 06/06/23 0 3157022514 1 5818Card 2801","15.99","","Posted","669.87"
"6/6/2023","","Recurring Withdrawal Bill Payment - #000000020916/NETFLIX COM LOS GATOS CACard 2801","11","","Posted","685.86"
"6/6/2023","","Withdrawal POS #000000000009/AMAZON.COM*SC6LS1M63 SEATTLE WACard 2801","10.19","","Posted","696.86"
"6/6/2023","","Withdrawal POS #000000000002/AMAZON.COM*N067J03N3 SEATTLE WACard 2801","23.41","","Posted","707.05"
"6/6/2023","","Withdrawal POS #000000957633/AMAZON.COM*EP2505QZ3 SEATTLE WACard 2801","21.93","","Posted","730.46"
"6/6/2023","","Withdrawal POS #000000960323/AMAZON.COM*T45738AZ3 SEATTLE WACard 2801","16.98","","Posted","752.39"
"6/6/2023","","Withdrawal POS #000000957627/AMAZON.COM*ZY9484853 SEATTLE WACard 2801","10.19","","Posted","769.37"
"6/6/2023","","Withdrawal POS #000000010636/CIRCLE K # 26146 3525 GAINESVILLE FLCard 2801","30.63","","Posted","779.56"
"6/5/2023","","Withdrawal POS #000000000000/AMAZON.COM*9H8K93WL3 SEATTLE WACard 2801","21.5","","Posted","810.19"
"6/5/2023","","Withdrawal Debit Card MC Debit/DISNEY PLUS 8889057888 CADate 06/04/23 0 3155948064 0 4899Card 2801","12.66","","Posted","831.69"
"6/5/2023","","Recurring Withdrawal Debit Card MC Debit/ADOBE *STOCK 4085366000 CADate 06/04/23 0 3155943134 0 5734Card 2801","29.99","","Posted","844.35"
"6/4/2023","","Withdrawal POS #000000802305/Instacart 50 Beal St Suite 600 SanFrancisco CACard 2801","73.58","","Posted","874.34"
"6/4/2023","","Recurring Withdrawal Debit Card MC Debit/PARAMOUNT+ SAN FRANCISC CADate 06/02/23 0 3153147659 1 4899Card 2801","13.81","","Posted","947.92"
"6/4/2023","","Recurring Withdrawal Debit Card MC Debit/PLAYERAUCTIONS 800-342-0768 DEDate 06/04/23 0 3155992645 1 5816Card 2801","55.88","","Posted","961.73"
"6/4/2023","","Recurring Withdrawal Debit Card MC Debit/APPLE.COM/BILL 866-712-7753 CADate 06/03/23 0 3154231741 1 5818Card 2801","2.99","","Posted","1017.61"
"6/4/2023","","Recurring Withdrawal Debit Card MC Debit/APPLE.COM/BILL 866-712-7753 CADate 06/03/23 0 3154231740 1 5818Card 2801","2.99","","Posted","1020.6"
"6/4/2023","","Withdrawal POS #000000172479/SUNOCO 8002212501 4234 SW 20TH AVEGAINESVILLE FLCard 2801","32.87","","Posted","1023.59"
"6/3/2023","","Withdrawal POS #000000711433/AMAZON.COM*X31NO1LV3 SEATTLE WACard 2801","23.92","","Posted","1056.46"
"6/2/2023","","Withdrawal ACH FLUENT-Gainesvil/TYPE: PAYMENT ID: 1371804719CO: FLUENT-GainesvilEntry Class Code: PPD","63.2","","Posted","1080.38"
"6/1/2023","","Recurring Withdrawal Debit Card MC Debit/PLAYERAUCTIONS 800-342-0768 DEDate 05/31/23 0 3151335470 0 5816Card 2801","42.58","","Posted","1143.58"
"6/1/2023","","Withdrawal Debit Card MC Debit/GRU/EZ-PAY WEB PYMT 352-334-3434 FLDate 05/31/23 0 3151334916 0 4900Card 2801","143.84","","Posted","1186.16"
"6/1/2023","","Withdrawal Debit Card MC Debit/COX GAINESVILLE COMM 800-234-3993 FLDate 05/31/23 0 3151812468 0 4899Card 2801","125.03","","Posted","1330"
"6/1/2023","","Withdrawal ACH Watson Realty Co/TYPE: WEB PMTS ID: 9000321157CO: Watson Realty CoNAME: Steven chaplinskiEntry Class Code: WEB","1045","","Posted","1455.03"
"6/1/2023","","Withdrawal POS #000000214108/AMAZON.COM*SX6AJ5UE3 SEATTLE WACard 2801","24","","Posted","2500.03"
"6/1/2023","","Withdrawal POS #000000802369/Instacart 50 Beal St Suite 600 SanFrancisco CACard 2801","2","","Posted","2524.03"
"6/1/2023","","Withdrawal POS #000000802939/Instacart 50 Beal St Suite 600 SanFrancisco CACard 2801","99.81","","Posted","2526.03"
"5/31/2023","","Withdrawal Adjustment Debit Card - Credit Voucher/MARMALEAD, LLC 4079065736 FLDate 05/30/23 0 3150013131 1 5045Card 2801","","19","Posted","2625.84"
"5/31/2023","","Withdrawal POS #000000621670/SUNOCO 8002212501 4234 SW 20TH AVEGAINESVILLE FLCard 2801","56.52","","Posted","2606.84"
"5/30/2023","","Recurring Withdrawal Adjustment - Debit Card Credit Voucher/WEB*HOSTGATOR.COM BURLINGTON MADate 05/29/23 0 3149790112 0 4816Card 2801","","45.09","Posted","2663.36"
"5/30/2023","","Deposit Home Banking Transfer expenses/From CHAPLINSKI,LEON 3496297 Share 0090","","2600","Posted","2618.27"
"5/29/2023","","Withdrawal POS #000000524971/SUNOCO 8002212501 4234 SW 20TH AVEGAINESVILLE FLCard 2801","24.13","","Posted","18.27"
"5/29/2023","","Deposit Home Banking Transfer - From Share 0000/Funds Transfer via Online","","9","Posted","42.4"
"5/28/2023","","Deposit Home Banking Transfer - From Share 0000/Funds Transfer via Online","","30","Posted","33.4"
"5/28/2023","","Withdrawal Debit Card MC Debit/WALGREENS #5024 GAINESVILLE FLDate 05/26/23 0 3146498831 2 5912Card 2801","35.99","","Posted","3.4"
"5/28/2023","","Withdrawal Debit Card MC Debit/CIRCLE K # 06782 GAINESVILLE FLDate 05/26/23 0 3146939363 0 5499Card 2801","17.3","","Posted","39.39"
"5/28/2023","","Recurring Withdrawal Debit Card MC Debit/MARMALEAD, LLC 4079065736 FLDate 05/26/23 0 3146966475 1 5045Card 2801","19","","Posted","56.69"
"5/28/2023","","Recurring Withdrawal Debit Card MC Debit/ADOBE *CREATIVE CLOUD 4085366000 CADate 05/27/23 0 3147959637 0 5734Card 2801","29.99","","Posted","75.69"
"5/26/2023","","Withdrawal POS #000000718669/AMAZON.COM*NY38Y1WA3 SEATTLE WACard 2801","27.54","","Posted","105.68"
"5/25/2023","","Recurring Withdrawal Debit Card Fee/MASTERCARD ISSUER CROSS-BORDER FEEDate 05/25/23 0 3145842155 0 5734Card 2801","0.08","","Posted","133.22"
"5/25/2023","","Recurring Withdrawal Debit Card MC Debit/SP NIGHTCAFE AI ART MARRICKVILLE NSDate 05/25/23 0 3145842155 0 5734Card 2801","9.99","","Posted","133.3"
"5/24/2023","","Withdrawal POS #000096296101/FAST TRACK #200 GAINESVILLE FLCard 2801","24.93","","Posted","143.29"
"5/24/2023","","Withdrawal POS #000000056302/PUBLIX 3930 SW ARCHER ROAD GAINESVILLECard 2801","92.46","","Posted","168.22"
"5/24/2023","","Recurring Withdrawal Debit Card MC Debit/VIDIQ PRO SAN FRANCISC CADate 05/23/23 0 3143843222 0 5734Card 2801","10","","Posted","260.68"
"5/24/2023","","Deposit Home Banking Transfer food/From CHAPLINSKI,LEON 3496297 Share 0090","","200","Posted","270.68"
"5/24/2023","","Withdrawal ACH FLUENT-Gainesvil/TYPE: PAYMENT ID: 1371804719CO: FLUENT-GainesvilEntry Class Code: PPD","70.9","","Posted","70.68"
"5/23/2023","","Withdrawal POS #000000000000/AMAZON.COM*5R3AK5KB3 SEATTLE WACard 2801","27.54","","Posted","141.58"
"5/23/2023","","Withdrawal POS #000003381642/GOOGLE *Google Storage 1600 AmphitheatreParkw Mountain View CACard 2801","1.99","","Posted","169.12"
"5/22/2023","","Withdrawal POS #000096296751/FAST TRACK #200 GAINESVILLE FLCard 2801","19.55","","Posted","171.11"
"5/22/2023","","Withdrawal POS #000000044582/PUBLIX 3930 SW ARCHER ROAD GAINESVILLECard 2801","49.07","","Posted","190.66"
"5/22/2023","","Withdrawal POS #000000004110/CIRCLE K # 26146 3525 GAINESVILLE FLCard 2801","7.07","","Posted","239.73"
"5/22/2023","","Withdrawal POS #000000737762/PUBLIX 3315 W. UNIVERSITY AVE.FLCard 2801","45.69","","Posted","246.8"
"5/22/2023","","Withdrawal Debit Card MC Debit/PIZZA HUT 27918 GAINESVILLE FLDate 05/20/23 0 3140936778 0 5812Card 2801","40","","Posted","292.49"
"5/22/2023","","Deposit Home Banking Transfer dr appt/From CHAPLINSKI,LEON 3496297 Share 0090","","200","Posted","332.49"
"5/21/2023","","Recurring Withdrawal Debit Card MC Debit/CANVA* I03791-14478190 CAMDEN DEDate 05/20/23 0 3140925062 0 7221Card 2801","12.99","","Posted","132.49"
"5/20/2023","","Deposit Home Banking Transfer - From Share 0000/Funds Transfer via Online","","100","Posted","145.48"
"5/20/2023","","Withdrawal POS #000003319884/GOOGLE *YouTubePremium 1600 AmphitheatreParkw Mountain View CACard 2801","13.64","","Posted","45.48"
"5/19/2023","","Withdrawal POS #000000405290/SUNOCO 8002212501 4234 SW 20TH AVEGAINESVILLE FLCard 2801","32.87","","Posted","59.12"
"5/18/2023","","Recurring Withdrawal Debit Card MC Debit/APPLE.COM/BILL 866-712-7753 CADate 05/18/23 0 3138075089 1 5818Card 2801","2.99","","Posted","91.99"
"5/17/2023","","Withdrawal POS #000000000004/AMAZON.COM*G37H72YL3 SEATTLE WACard 2801","13.18","","Posted","94.98"
"5/17/2023","","Withdrawal POS #000000011560/CIRCLE K # 01313 4221 GAINESVILLE FLCard 2801","20.02","","Posted","108.16"
"5/16/2023","","Recurring Withdrawal Debit Card Fee/MASTERCARD ISSUER CROSS-BORDER FEEDate 05/15/23 0 3135870887 0 5734Card 2801","0.14","","Posted","128.18"
"5/16/2023","","Recurring Withdrawal Debit Card MC Debit/SUBPALS8888819070 BADEN ONDate 05/15/23 0 3135870887 0 5734Card 2801","17","","Posted","128.32"
"5/15/2023","","Recurring Withdrawal Debit Card Fee/MASTERCARD ISSUER CROSS-BORDER FEEDate 05/14/23 0 3134938310 0 8299Card 2801","0.04","","Posted","145.32"
"5/15/2023","","Recurring Withdrawal Debit Card MC Debit/WWW.W3SCHOOLS.COM SANDNES DUDate 05/14/23 0 3134938310 0 8299Card 2801","4.99","","Posted","145.36"
"5/14/2023","","Recurring Withdrawal Debit Card MC Debit/CHATGPT SUBSCRIPTION SAN FRANCISC CADate 05/12/23 0 3132943704 1 5734Card 2801","20","","Posted","150.35"
"5/14/2023","","Recurring Withdrawal Debit Card Fee/MASTERCARD ISSUER CROSS-BORDER FEEDate 05/12/23 0 3132437615 1 5734Card 2801","0.07","","Posted","170.35"
"5/14/2023","","Recurring Withdrawal Debit Card MC Debit/DRIVE EXPLORER ADDON MADURAI TNDate 05/12/23 0 3132437615 1 5734Card 2801","9","","Posted","170.42"
"5/11/2023","","Withdrawal Debit Card MC Debit/ARCHER ANIMAL HOSPITAL ARCHER FLDate 05/10/23 0 3130327214 0 0742Card 2801","134.98","","Posted","179.42"
"5/10/2023","","Withdrawal POS #000000363822/PLAYSTATION.COM US FOSTER CITY CACard 2801","59.99","","Posted","314.4"
"5/9/2023","","Withdrawal POS #000096293976/FAST TRACK #200 GAINESVILLE FLCard 2801","22.77","","Posted","374.39"
"5/9/2023","","Withdrawal POS #000000065467/PUBLIX 3930 SW ARCHER ROAD GAINESVILLECard 2801","80.14","","Posted","397.16"
"5/9/2023","","Withdrawal POS #000000781853/PUBLIX 3100 SW 35TH BLVD GAINESVILLE FLCard 2801","81.07","","Posted","477.3"
"5/9/2023","","Recurring Withdrawal Debit Card Fee/MASTERCARD ISSUER CROSS-BORDER FEEDate 05/08/23 0 3128816170 0 5734Card 2801","0.14","","Posted","558.37"
"5/9/2023","","Recurring Withdrawal Debit Card MC Debit/SUBPALS8888819070 BADEN ONDate 05/08/23 0 3128816170 0 5734Card 2801","17","","Posted","558.51"
"5/9/2023","","Recurring Withdrawal Debit Card MC Debit/WEB*HOSTGATOR.COM BURLINGTON MADate 05/08/23 0 3128979219 0 4816Card 2801","12.95","","Posted","575.51"
"5/9/2023","","Withdrawal ACH FLUENT-Gainesvil/TYPE: PAYMENT ID: 1371804719CO: FLUENT-GainesvilEntry Class Code: PPD","92","","Posted","588.46"
"5/8/2023","","Withdrawal POS #000000233071/AMAZON.COM*DU6086F03 SEATTLE WACard 2801","12.52","","Posted","680.46"
"5/8/2023","","Withdrawal POS #000000230713/AMAZON.COM*6N8HF6DJ3 SEATTLE WACard 2801","12.52","","Posted","692.98"
"5/8/2023","","Recurring Withdrawal Debit Card MC Debit/MIDJOURNEY INC. SOUTH SAN FR CADate 05/07/23 0 3127950086 0 5734Card 2801","30","","Posted","705.5"
"5/7/2023","","Withdrawal POS #000000421007/AMAZON.COM*Q77YK4D53 SEATTLE WACard 2801","23.09","","Posted","735.5"
"5/7/2023","","Recurring Withdrawal Debit Card MC Debit/QUILLBOT OAK BROOK ILDate 05/05/23 0 3125730860 0 5734Card 2801","19.95","","Posted","758.59"
"5/7/2023","","Recurring Withdrawal Debit Card MC Debit/PLAYERAUCTIONS 800-342-0768 DEDate 05/05/23 0 3125817713 1 5816Card 2801","60.6","","Posted","778.54"
"5/7/2023","","Recurring Withdrawal Debit Card MC Debit/APPLE.COM/BILL 866-712-7753 CADate 05/06/23 0 3126467249 2 5818Card 2801","17.82","","Posted","839.14"
"5/6/2023","","Withdrawal POS #000000011600/CIRCLE K # 26146 3525 GAINESVILLE FLCard 2801","23.55","","Posted","856.96"
"5/6/2023","","Withdrawal POS #000000746376/PUBLIX 3100 SW 35TH BLVD GAINESVILLE FLCard 2801","48.78","","Posted","880.51"
"5/6/2023","","Recurring Withdrawal Bill Payment - #000000355261/NETFLIX COM LOS GATOS CACard 2801","11","","Posted","929.29"
"5/6/2023","","Withdrawal POS #000000000008/AMAZON.COM*YC20F1ZU3 SEATTLE WACard 2801","26.16","","Posted","940.29"
"5/6/2023","","Withdrawal POS #000000143034/AMAZON.COM*GM4422Z53 SEATTLE WACard 2801","20.64","","Posted","966.45"
"5/5/2023","","Recurring Withdrawal Debit Card MC Debit/ADOBE *STOCK 4085366000 CADate 05/04/23 0 3124734629 0 5734Card 2801","29.99","","Posted","987.09"
"5/5/2023","","Withdrawal POS #000000322211/AMAZON.COM*K83SN0S13 SEATTLE WACard 2801","20.4","","Posted","1017.08"
"5/5/2023","","Withdrawal POS #000000000000/AMAZON PAYMENTS SEATTLE WACard 2801","21.82","","Posted","1037.48"
"5/4/2023","","Withdrawal Debit Card MC Debit/KRATOM-K 888-8912895 NVDate 05/03/23 0 3123046755 1 5499Card 2801","19.64","","Posted","1059.3"
"5/4/2023","","Withdrawal Debit Card MC Debit/KRATOM-K 888-8912895 NVDate 05/03/23 0 3123046754 1 5499Card 2801","24.88","","Posted","1078.94"
"5/4/2023","","Withdrawal Debit Card MC Debit/YVETTE GODET DMD PA GAINESVILLE FLDate 05/03/23 0 3123864926 0 8011Card 2801","133.8","","Posted","1103.82"
"5/4/2023","","Recurring Withdrawal Debit Card MC Debit/WEB*HOSTGATOR.COM BURLINGTON MADate 05/03/23 0 3123045013 1 4816Card 2801","60.01","","Posted","1237.62"
"5/4/2023","","Withdrawal Debit Card MC Debit/WALGREENS #5024 GAINESVILLE FLDate 05/03/23 0 3123067040 1 5912Card 2801","37.4","","Posted","1297.63"
"5/4/2023","","Deposit Home Banking Transfer dr godet/From CHAPLINSKI,LEON 3496297 Share 0090","","134","Posted","1335.03"
"5/3/2023","","Withdrawal POS #000000000477/CIRCLE K # 06782 5237 GAINESVILLE FLCard 2801","41.52","","Posted","1201.03"
"5/3/2023","","Withdrawal Debit Card MC Debit/PIZZA HUT 27918 GAINESVILLE FLDate 05/01/23 0 3121896652 0 5812Card 2801","40.84","","Posted","1242.55"
"5/3/2023","","Recurring Withdrawal Debit Card MC Debit/PARAMOUNT+ SAN FRANCISC CADate 05/02/23 0 3122896566 0 4899Card 2801","13.81","","Posted","1283.39"
"5/3/2023","","Recurring Withdrawal Debit Card MC Debit/APPLE.COM/BILL 866-712-7753 CADate 05/03/23 0 3123073296 1 5818Card 2801","2.99","","Posted","1297.2"
"5/2/2023","","Recurring Withdrawal Debit Card MC Debit/WEB*HOSTGATOR.COM BURLINGTON MADate 05/01/23 0 3121102563 1 4816Card 2801","0.42","","Posted","1300.19"
"5/2/2023","","Withdrawal Debit Card MC Debit/GRU/EZ-PAY WEB PYMT 352-334-3434 FLDate 05/01/23 0 3121373269 0 4900Card 2801","175.09","","Posted","1300.61"
"5/2/2023","","Withdrawal Debit Card MC Debit/COX GAINESVILLE COMM 800-234-3993 FLDate 05/01/23 0 3121932105 0 4899Card 2801","125.03","","Posted","1475.7"
"5/2/2023","","Withdrawal ACH Watson Realty Co/TYPE: WEB PMTS ID: 9000321157CO: Watson Realty CoNAME: Steven chaplinskiEntry Class Code: WEB","995","","Posted","1600.73"
"5/2/2023","","Withdrawal ACH FLUENT-Gainesvil/TYPE: PAYMENT ID: 1371804719CO: FLUENT-GainesvilEntry Class Code: PPD","93.2","","Posted","2595.73"
"5/1/2023","","Withdrawal POS #000000853317/AMAZON.COM*HM8GC4P91 SEATTLE WACard 2801","74.08","","Posted","2688.93"
"4/30/2023","","Withdrawal Debit Card MC Debit/SAMSUNG ELECTRONICS RIDGEFIELD P NJDate 04/30/23 0 3120042497 1 5734Card 2801","15.99","","Posted","2763.01"
"4/30/2023","","Recurring Withdrawal Debit Card MC Debit/APPLE.COM/BILL 866-712-7753 CADate 04/28/23 0 3118955995 1 5818Card 2801","2.99","","Posted","2779"
"4/30/2023","","Withdrawal POS #000000020527/CIRCLE K # 26146 3525 GAINESVILLE FLCard 2801","23.51","","Posted","2781.99"
"4/28/2023","","Deposit Home Banking Transfer expenses/From CHAPLINSKI,LEON 3496297 Share 0090","","2600","Posted","2805.5"
"4/28/2023","","Withdrawal Debit Card MC Debit/PIZZA HUT 27918 GAINESVILLE FLDate 04/26/23 0 3116850573 0 5812Card 2801","40.98","","Posted","205.5"
"4/28/2023","","Withdrawal Debit Card MC Debit/PUBLIX #1312 GAINESVILLE FLDate 04/27/23 0 3117072013 1 5411Card 2801","71.15","","Posted","246.48"
"4/28/2023","","Recurring Withdrawal Debit Card MC Debit/ADOBE *CREATIVE CLOUD 4085366000 CADate 04/27/23 0 3117844835 0 5734Card 2801","29.99","","Posted","317.63"
"4/27/2023","","Withdrawal POS #000000733873/PUBLIX 3930 SW ARCHER ROAD GAINESVILLECard 2801","22.36","","Posted","347.62"
"4/27/2023","","Deposit Home Banking Transfer food/From CHAPLINSKI,LEON 3496297 Share 0090","","200","Posted","369.98"
"4/27/2023","","Deposit Home Banking Transfer - From Share 0000/Funds Transfer via Mobile","","100","Posted","169.98"
"4/27/2023","","Withdrawal POS #000000755101/WAWA 5325 2373 SW ARCHER ROADFLCard 2801","33.53","","Posted","69.98"
"4/27/2023","","Withdrawal POS #000058941600/WAWA 5325 2373 SW ARCHER ROADFLCard 2801","7.09","","Posted","103.51"
"4/27/2023","","Recurring Withdrawal Debit Card MC Debit/MARMALEAD, LLC 4079065736 FLDate 04/26/23 0 3116865877 0 5045Card 2801","19","","Posted","110.6"
"4/26/2023","","Withdrawal POS #000000576572/AMAZON.COM*HF7S16U30 SEATTLE WACard 2801","60.03","","Posted","129.6"
"4/26/2023","","Deposit Home Banking Transfer - From Share 0000/Funds Transfer via Mobile","","100","Posted","189.63"
"4/26/2023","","Recurring Withdrawal Debit Card Fee/MASTERCARD ISSUER CROSS-BORDER FEEDate 04/26/23 0 3116321416 0 5734Card 2801","0.16","","Posted","89.63"
"4/26/2023","","Recurring Withdrawal Debit Card MC Debit/VANCEAI CENTRAL HODate 04/26/23 0 3116321416 0 5734Card 2801","19.9","","Posted","89.79"
"4/25/2023","","Recurring Withdrawal Debit Card Fee/MASTERCARD ISSUER CROSS-BORDER FEEDate 04/25/23 0 3115347529 0 5734Card 2801","0.08","","Posted","109.69"
"4/25/2023","","Recurring Withdrawal Debit Card MC Debit/SP NIGHTCAFE AI ART MARRICKVILLE NSDate 04/25/23 0 3115347529 0 5734Card 2801","9.99","","Posted","109.77"
"4/24/2023","","Recurring Withdrawal Debit Card MC Debit/VIDIQ PRO SAN FRANCISC CADate 04/23/23 0 3113672486 0 5734Card 2801","10","","Posted","119.76"
"4/24/2023","","Withdrawal POS #000000059732/AMAZON.COM*HF3681O32 SEATTLE WACard 2801","70.71","","Posted","129.76"
"4/23/2023","","Withdrawal POS #000003101724/GOOGLE *Google Storage 1600 AmphitheatreParkw Mountain View CACard 2801","1.99","","Posted","200.47"
"4/21/2023","","Recurring Withdrawal Debit Card Fee/MASTERCARD ISSUER CROSS-BORDER FEEDate 04/20/23 0 3110864064 0 7333Card 2801","0.1","","Posted","202.46"
"4/21/2023","","Recurring Withdrawal Debit Card MC Debit/CANVA* 03761-18735695 SYDNEY AUDate 04/20/23 0 3110864064 0 7333Card 2801","12.99","","Posted","202.56"
"4/21/2023","","Withdrawal POS #000000962967/AMAZON.COM*HF5T68O40 SEATTLE WACard 2801","20.4","","Posted","215.55"
"4/20/2023","","Withdrawal POS #000000834697/SUNOCO 8002212501 4234 SW 20TH AVEGAINESVILLE FLCard 2801","32.87","","Posted","235.95"
"4/20/2023","","Withdrawal Debit Card MC Debit/ETSY.COM - FUNKYFOXXST BROOKLYN NYDate 04/19/23 0 3109872544 0 5699Card 2801","3.21","","Posted","268.82"
"4/20/2023","","Withdrawal POS #000003115333/GOOGLE *YouTubePremium 1600 AmphitheatreParkw Mountain View CACard 2801","13.64","","Posted","272.03"
"4/19/2023","","Deposit Home Banking Transfer food/From CHAPLINSKI,LEON 3496297 Share 0090","","200","Posted","285.67"
"4/19/2023","","Withdrawal Debit Card MC Debit/DRI*ID.MYCOMMERCE.COM MINNETONKA MNDate 04/18/23 0 3108341181 0 5732Card 2801","23.05","","Posted","85.67"
"4/19/2023","","Withdrawal POS #000000764726/SUNOCO 8002212501 4234 SW 20TH AVEGAINESVILLE FLCard 2801","36.52","","Posted","108.72"
"4/18/2023","","Withdrawal ACH FLUENT-Gainesvil/TYPE: PAYMENT ID: 1371804719CO: FLUENT-GainesvilEntry Class Code: PPD","99.6","","Posted","145.24"
"4/17/2023","","Withdrawal Debit Card MC Debit/PUBLIX #680 GAINESVILLE FLDate 04/16/23 0 3106911969 0 5411Card 2801","62.63","","Posted","244.84"
"4/16/2023","","Withdrawal POS #000000009656/CIRCLE K # 26146 3525 GAINESVILLE FLCard 2801","30.15","","Posted","307.47"
"4/16/2023","","Deposit Home Banking Transfer - From Share 0000/Funds Transfer via Mobile","","200","Posted","337.62"
"4/16/2023","","Withdrawal Debit Card Fee/MASTERCARD ISSUER CROSS-BORDER FEEDate 04/14/23 0 3104333014 1 8299Card 2801","0.04","","Posted","137.62"
"4/16/2023","","Withdrawal Debit Card MC Debit/WWW.W3SCHOOLS.COM SANDNES DUDate 04/14/23 0 3104333014 1 8299Card 2801","4.99","","Posted","137.66"
"4/16/2023","","Recurring Withdrawal Debit Card MC Debit/WEB*HOSTGATOR.COM BURLINGTON MADate 04/14/23 0 3104457576 2 4816Card 2801","27.85","","Posted","142.65"
"4/14/2023","","Withdrawal POS #000000188363/SUNOCO 8002212501 4234 SW 20TH AVEGAINESVILLE FLCard 2801","32.87","","Posted","170.5"
"4/13/2023","","Recurring Withdrawal Debit Card MC Debit/CHATGPT SUBSCRIPTION SAN FRANCISC CADate 04/12/23 0 3102824632 0 5734Card 2801","20","","Posted","203.37"
"4/13/2023","","Recurring Withdrawal Debit Card Fee/MASTERCARD ISSUER CROSS-BORDER FEEDate 04/12/23 0 3102997706 0 5734Card 2801","0.07","","Posted","223.37"
"4/13/2023","","Recurring Withdrawal Debit Card MC Debit/DRIVE EXPLORER ADDON MADURAI TNDate 04/12/23 0 3102997706 0 5734Card 2801","9","","Posted","223.44"
"4/10/2023","","Recurring Withdrawal Bill Payment - #000000016737/SIE PLAYST 2207 BRIDGEPOINTE PUS SANCACard 2801","17.99","","Posted","232.44"
"4/10/2023","","Withdrawal ACH APPLECARD GSBANK/TYPE: PAYMENT ID: 9999999999CO: APPLECARD GSBANKNAME: Steven ChaplinskiEntry Class Code: WEB","93","","Posted","250.43"
"4/10/2023","","Withdrawal POS #000000000001/AMAZON.COM*HJ0RS1CJ1 SEATTLE WACard 2801","12.26","","Posted","343.43"
"4/9/2023","","Recurring Withdrawal Debit Card MC Debit/MIDJOURNEY INC. SOUTH SAN FR CADate 04/07/23 0 3097803585 1 5734Card 2801","30","","Posted","355.69"
"4/9/2023","","Withdrawal Debit Card MC Debit/CANNAMD 855-4209170 FLDate 04/07/23 0 3097109858 2 8011Card 2801","195","","Posted","385.69"
"4/9/2023","","Withdrawal Debit Card MC Debit/PUBLIX #680 GAINESVILLE FLDate 04/07/23 0 3097298491 2 5411Card 2801","27.94","","Posted","580.69"
"4/9/2023","","Withdrawal Debit Card MC Debit/PUBLIX #1784 GAINESVILLE FLDate 04/07/23 0 3097298395 2 5411Card 2801","74.12","","Posted","608.63"
"4/9/2023","","Withdrawal Debit Card MC Debit/PUBLIX #1312 GAINESVILLE FLDate 04/07/23 0 3097298259 2 5411Card 2801","31.68","","Posted","682.75"
"4/9/2023","","Withdrawal Debit Card MC Debit/ARCHER ANIMAL HOSPITAL ARCHER FLDate 04/07/23 0 3097620252 0 0742Card 2801","522.39","","Posted","714.43"
"4/9/2023","","Recurring Withdrawal Debit Card MC Debit/APPLE.COM/BILL 866-712-7753 CADate 04/08/23 0 3098865383 0 5818Card 2801","2.99","","Posted","1236.82"
"4/9/2023","","Recurring Withdrawal Debit Card MC Debit/APPLE.COM/BILL 866-712-7753 CADate 04/08/23 0 3098865381 0 5818Card 2801","2.99","","Posted","1239.81"
"4/9/2023","","Recurring Withdrawal Debit Card MC Debit/APPLE.COM/BILL 866-712-7753 CADate 04/08/23 0 3098865380 0 5818Card 2801","2.99","","Posted","1242.8"
"4/9/2023","","Recurring Withdrawal Debit Card MC Debit/APPLE.COM/BILL 866-712-7753 CADate 04/08/23 0 3098865377 0 5818Card 2801","24.99","","Posted","1245.79"
"4/9/2023","","Deposit Home Banking Transfer vet/From CHAPLINSKI,LEON 3496297 Share 0090","","125","Posted","1270.78"
"4/8/2023","","Withdrawal POS #000096294136/FAST TRACK #200 GAINESVILLE FLCard 2801","22.77","","Posted","1145.78"
"4/7/2023","","Withdrawal Debit Card MC Debit/GUM.CO/CC* LASER EYE B SAN FRANCISC CADate 04/07/23 0 3097010256 1 5192Card 2801","10","","Posted","1168.55"
"4/7/2023","","Withdrawal POS #000000726290/AMAZON.COM*HS7T42BW1 SEATTLE WACard 2801","20.4","","Posted","1178.55"
"4/7/2023","","Withdrawal POS #000000485633/PLAYSTATIO 919 E HILLSDALE BLVUS FOSTERCITY CACard 2801","89.99","","Posted","1198.95"
"4/6/2023","","Withdrawal POS #000000266687/SUNOCO 8002212501 4234 SW 20TH AVEGAINESVILLE FLCard 2801","32.87","","Posted","1288.94"
"4/6/2023","","Recurring Withdrawal Debit Card MC Debit/QUILLBOT OAK BROOK ILDate 04/05/23 0 3095272019 0 5734Card 2801","19.95","","Posted","1321.81"
"4/6/2023","","Recurring Withdrawal Bill Payment - #000000850915/Netflix US 2A NETFLIX.COM LOS GATOS CACard 2801","11","","Posted","1341.76"
"4/5/2023","","Withdrawal Debit Card MC Debit/PIZZA HUT 27918 3523739402 FLDate 04/03/23 0 3093832414 0 5812Card 2801","47.22","","Posted","1352.76"
"4/5/2023","","Withdrawal Debit Card MC Debit/CIRCLE K # 06782 GAINESVILLE FLDate 04/03/23 0 3093021190 1 5499Card 2801","26.94","","Posted","1399.98"
"4/5/2023","","Recurring Withdrawal Debit Card MC Debit/ADOBE *STOCK 4085366000 CADate 04/04/23 0 3094826889 0 5734Card 2801","29.99","","Posted","1426.92"
"4/5/2023","","Withdrawal ACH FLUENT-Gainesvil/TYPE: PAYMENT ID: 1371804719CO: FLUENT-GainesvilEntry Class Code: PPD","102.5","","Posted","1456.91"
"4/5/2023","","Withdrawal POS #000000378202/PLAYSTATION.COM US FOSTER CITY CACard 2801","24.99","","Posted","1559.41"
"4/4/2023","","Recurring Withdrawal Debit Card MC Debit/PLAYERAUCTIONS 800-342-0768 DEDate 04/04/23 0 3094023872 1 5816Card 2801","51.36","","Posted","1584.4"
"4/4/2023","","Recurring Withdrawal Debit Card MC Debit/PLAYERAUCTIONS 800-342-0768 DEDate 04/03/23 0 3093077614 1 5816Card 2801","48.87","","Posted","1635.76"
"4/4/2023","","Withdrawal Debit Card MC Debit/WALGREENS #5024 800-289-2273 FLDate 04/03/23 0 3093023575 1 5912Card 2801","27.97","","Posted","1684.63"
"4/4/2023","","Withdrawal Debit Card MC Debit/GRU/EZ-PAY WEB PYMT 352-334-3434 FLDate 04/03/23 0 3093331542 0 4900Card 2801","170.66","","Posted","1712.6"
"4/4/2023","","Withdrawal ACH DISCOVER/TYPE: E-PAYMENT ID: 2510020270CO: DISCOVER NAME: CHAPLINSKI STEVENEntry Class Code: WEB","25","","Posted","1883.26"
"4/3/2023","","Withdrawal POS #000000281026/AMAZON.COM*HS0958FO1 SEATTLE WACard 2801","10.72","","Posted","1908.26"
"4/3/2023","","Withdrawal POS #000000210513/AMAZON.COM*HS09S0PY0 SEATTLE WACard 2801","42.99","","Posted","1918.98"
"4/3/2023","","Deposit Home Banking Transfer expenses/From CHAPLINSKI,LEON 3496297 Share 0090","","400","Posted","1961.97"
"4/3/2023","","Recurring Withdrawal Debit Card MC Debit/PARAMOUNT+ 8882745343 CADate 04/02/23 0 3092991731 0 4899Card 2801","13.81","","Posted","1561.97"
"4/3/2023","","Withdrawal ACH Watson Realty Co/TYPE: WEB PMTS ID: 9000321157CO: Watson Realty CoNAME: Steven chaplinskiEntry Class Code: WEB","995","","Posted","1575.78"
"4/2/2023","","Withdrawal Debit Card MC Debit/COX GAINESVILLE COMM 800-234-3993 FLDate 04/02/23 0 3092722594 0 4899Card 2801","125.03","","Posted","2570.78"
"4/2/2023","","Withdrawal Debit Card MC Debit/CIRCLE K # 06782 GAINESVILLE FLDate 03/30/23 0 3089415767 2 5499Card 2801","26.94","","Posted","2695.81"
"4/2/2023","","Recurring Withdrawal Debit Card MC Debit/CHEGG ORDER 8558681054 CADate 03/31/23 0 3090879254 1 5942Card 2801","15.95","","Posted","2722.75"
"4/2/2023","","Withdrawal POS #000000698438/AMAZON.COM*HY3F18532 SEATTLE WACard 2801","54.54","","Posted","2738.7"
"3/31/2023","","Recurring Withdrawal Debit Card MC Debit/JASPER.AI ROLLINGWOOD TXDate 03/30/23 0 3089949341 0 7399Card 2801","59","","Posted","2793.24"
"3/31/2023","","Withdrawal Debit Card MC Debit/WALGREENS #5024 800-289-2273 FLDate 03/30/23 0 3089029984 1 5912Card 2801","9.43","","Posted","2852.24"
"3/31/2023","","Withdrawal POS #000000000005/AMAZON.COM*HY6Q875J1 SEATTLE WACard 2801","75.06","","Posted","2861.67"
"3/29/2023","","Deposit Home Banking Transfer expenses/From CHAPLINSKI,LEON 3496297 Share 0090","","2600","Posted","2936.73"
"3/29/2023","","Withdrawal ACH FLUENT-Gainesvil/TYPE: PAYMENT ID: 1371804719CO: FLUENT-GainesvilEntry Class Code: PPD","61.2","","Posted","336.73"
"3/28/2023","","Withdrawal Debit Card MC Debit/WWW.CVS.COM 888-607-4287 RIDate 03/26/23 0 3085940730 0 5912Card 2801","9.85","","Posted","397.93"
"3/28/2023","","Recurring Withdrawal Debit Card MC Debit/ADOBE *CREATIVE CLOUD 4085366000 CADate 03/28/23 0 3087992284 0 5734Card 2801","29.99","","Posted","407.78"
"3/28/2023","","Deposit ACH Etsy/TYPE: PAYOUT ID: 4263863381 CO: EtsyEntry Class Code: CCD","","12.24","Posted","437.77"
"3/28/2023","","Withdrawal POS #000000015189/CIRCLE K # 26146 3525 GAINESVILLE FLCard 2801","27.05","","Posted","425.53"
"3/27/2023","","Withdrawal Debit Card Fee/MASTERCARD ISSUER CROSS-BORDER FEEDate 03/26/23 0 3085080672 1 7399Card 2801","0.23","","Posted","452.58"
"3/27/2023","","Withdrawal Debit Card MC Debit/CREATIVE FABRICA AMSTERDAM NHDate 03/26/23 0 3085080672 1 7399Card 2801","29","","Posted","452.81"
"3/27/2023","","Withdrawal Debit Card MC Debit/PUBLIX #1312 GAINESVILLE FLDate 03/26/23 0 3085901485 0 5411Card 2801","123.07","","Posted","481.81"
"3/27/2023","","Withdrawal Debit Card MC Debit/SCRUBS CARWASH - GAINE GAINESVILLE FLDate 03/26/23 0 3085900969 0 7542Card 2801","4","","Posted","604.88"
"3/27/2023","","Withdrawal Debit Card MC Debit/MARMALEAD, LLC 4079065736 FLDate 03/26/23 0 3085922801 0 5045Card 2801","19","","Posted","608.88"
"3/27/2023","","Deposit ACH PAYPAL/TYPE: TRANSFER ID: PAYPALSD11 CO: PAYPALEntry Class Code: PPD","","149.5","Posted","627.88"
"3/27/2023","","Withdrawal POS #000000744668/PUBLIX 3100 SW 35TH BLVD GAINESVILLE FLCard 2801","34.99","","Posted","478.38"
"3/27/2023","","Deposit Home Banking Transfer - From Share 0000/Funds Transfer via Mobile","","300","Posted","513.37"
"3/26/2023","","Withdrawal POS #000000340607/AMAZON.COM*HY48R1NK0 SEATTLE WACard 2801","20.08","","Posted","213.37"
"3/26/2023","","Withdrawal POS #000000336133/AMAZON.COM*H70M05V42 SEATTLE WACard 2801","5.92","","Posted","233.45"
"3/26/2023","","Withdrawal POS #000000138395/AMAZON.COM*H712507Z1 SEATTLE WACard 2801","31.96","","Posted","239.37"
"3/26/2023","","Withdrawal POS #000000135755/AMAZON.COM*H74ZC69O1 SEATTLE WACard 2801","24.44","","Posted","271.33"
"3/26/2023","","Recurring Withdrawal Debit Card Fee/MASTERCARD ISSUER CROSS-BORDER FEEDate 03/25/23 0 3084851596 1 5734Card 2801","0.08","","Posted","295.77"
"3/26/2023","","Recurring Withdrawal Debit Card MC Debit/SP NIGHTCAFE AI ART MARRICKVILLE NSDate 03/25/23 0 3084851596 1 5734Card 2801","9.99","","Posted","295.85"
"3/26/2023","","Withdrawal Debit Card Fee/MASTERCARD ISSUER CROSS-BORDER FEEDate 03/26/23 0 3085241338 0 5734Card 2801","0.16","","Posted","305.84"
"3/26/2023","","Withdrawal Debit Card MC Debit/VANCEAI CENTRAL HODate 03/26/23 0 3085241338 0 5734Card 2801","19.9","","Posted","306"
"3/26/2023","","Deposit Home Banking Transfer - From Share 0000/Funds Transfer via Online","","300","Posted","325.9"
"3/25/2023","","Withdrawal POS #000000000005/AMAZON.COM*HY2208FJ0 SEATTLE WACard 2801","38.69","","Posted","25.9"
"3/25/2023","","Withdrawal POS #000000066272/SUNOCO 8002212501 4234 SW 20TH AVEGAINESVILLE FLCard 2801","32.87","","Posted","64.59"
"3/25/2023","","Withdrawal Transfer fee","8","","Posted","97.46"
"3/25/2023","","Deposit Transfer From Share 0000","","100","Posted","105.46"
"3/24/2023","","Withdrawal Debit Card MC Debit/ERANK STOW OHDate 03/23/23 0 3082859656 0 7392Card 2801","5.99","","Posted","5.46"
"3/24/2023","","Withdrawal Debit Card MC Debit/VIDIQ PRO SAN FRANCISC CADate 03/23/23 0 3082859575 0 5734Card 2801","10","","Posted","11.45"
"3/24/2023","","Withdrawal ACH FLUENT-Gainesvil/TYPE: PAYMENT ID: 1371804719CO: FLUENT-GainesvilEntry Class Code: PPD","107.4","","Posted","21.45"
"3/24/2023","","Withdrawal POS #000000787829/AMAZON.COM*H72K264J2 SEATTLE WACard 2801","20.4","","Posted","128.85"
"3/23/2023","","Recurring Withdrawal Debit Card Fee/MASTERCARD ISSUER CROSS-BORDER FEEDate 03/23/23 0 3082815708 0 7333Card 2801","0.1","","Posted","149.25"
"3/23/2023","","Recurring Withdrawal Debit Card MC Debit/CANVA* 03730-17166918 SYDNEY AUDate 03/23/23 0 3082815708 0 7333Card 2801","12.99","","Posted","149.35"
"3/23/2023","","Withdrawal POS #000003206129/GOOGLE *Google Storage 1600 AmphitheatreParkw Mountain View CACard 2801","1.99","","Posted","162.34"
"3/23/2023","","Withdrawal POS #000000112986/AMAZON.COM*H754906V0 SEATTLE WACard 2801","40.82","","Posted","164.33"
"3/23/2023","","Withdrawal ATM Fee/EFT 6419 W Newberry Rd Gainesville FLCard 2801","2","","Posted","205.15"
"3/23/2023","","Withdrawal at ATM #000000530088/EFT 6419 W Newberry Rd Gainesville FLCard 2801","113","","Posted","207.15"
"3/22/2023","","Withdrawal POS #000000000000/AMAZON.COM*HC0GX27P2 SEATTLE WACard 2801","22.03","","Posted","320.15"
"3/22/2023","","Withdrawal Debit Card Fee/MASTERCARD ISSUER CROSS-BORDER FEEDate 03/21/23 0 3080316690 0 4816Card 2801","0.48","","Posted","342.18"
"3/22/2023","","Withdrawal Debit Card MC Debit/IMF CITY 17 CANT HKDate 03/21/23 0 3080316690 0 4816Card 2801","59.9","","Posted","342.66"
"3/22/2023","","Withdrawal ACH DISCOVER/TYPE: E-PAYMENT ID: 2510020270CO: DISCOVER NAME: CHAPLINSKI STEVENEntry Class Code: WEB","101","","Posted","402.56"
"3/22/2023","","Withdrawal POS #000000922364/SUNOCO 8002212501 4234 SW 20TH AVEGAINESVILLE FLCard 2801","32.87","","Posted","503.56"
"3/22/2023","","Withdrawal POS #000000345359/AMAZON.COM*HC5H01692 SEATTLE WACard 2801","24.46","","Posted","536.43"
"3/21/2023","","Deposit Home Banking Transfer - From Share 0000/Funds Transfer via Online","","250","Posted","560.89"
"3/20/2023","","Recurring Withdrawal Debit Card MC Debit/PRINTFUL INC. 86293473 CHARLOTTE NCDate 03/19/23 0 3078904027 0 5691Card 2801","6.19","","Posted","310.89"
"3/20/2023","","Withdrawal ACH FLUENT-Gainesvil/TYPE: PAYMENT ID: 1371804719CO: FLUENT-GainesvilEntry Class Code: PPD","97.9","","Posted","317.08"
"3/20/2023","","Withdrawal POS #000003114546/GOOGLE *YouTubePremium 1600 AmphitheatreParkw Mountain View CACard 2801","13.64","","Posted","414.98"
"3/19/2023","","Withdrawal POS #000000400824/AMAZON.COM*HC3O110O2 SEATTLE WACard 2801","25.8","","Posted","428.62"
"3/19/2023","","Recurring Withdrawal Debit Card MC Debit/ENVATO 61383766284 UTDate 03/19/23 0 3078360759 1 5815Card 2801","23","","Posted","454.42"
"3/19/2023","","Withdrawal POS #000096294034/FAST TRACK #200 GAINESVILLE FLCard 2801","30.3","","Posted","477.42"
"3/16/2023","","Withdrawal POS #000000006320/CIRCLE K # 26146 3525 GAINESVILLE FLCard 2801","16.77","","Posted","507.72"
"3/13/2023","","Recurring Withdrawal Debit Card MC Debit/SALESAMURAI.IO BOULDER CODate 03/12/23 0 3071028002 1 5734Card 2801","7.99","","Posted","524.49"
"3/13/2023","","Recurring Withdrawal Debit Card MC Debit/CHATGPT SUBSCRIPTION SAN FRANCISC CADate 03/12/23 0 3071998456 0 5734Card 2801","20","","Posted","532.48"
"3/13/2023","","Recurring Withdrawal Debit Card Fee/MASTERCARD ISSUER CROSS-BORDER FEEDate 03/12/23 0 3071027471 1 5734Card 2801","0.07","","Posted","552.48"
"3/13/2023","","Recurring Withdrawal Debit Card MC Debit/DRIVE EXPLORER ADDON MADURAI TNDate 03/12/23 0 3071027471 1 5734Card 2801","9","","Posted","552.55"
"3/12/2023","","Withdrawal POS #000000545175/SUNOCO 8002212501 4234 SW 20TH AVEGAINESVILLE FLCard 2801","32.87","","Posted","561.55"
"3/12/2023","","Withdrawal POS #000000058553/AMAZON.COM*HG75N7YD0 SEATTLE WACard 2801","10.2","","Posted","594.42"
"3/10/2023","","Withdrawal POS #000000763024/SUNOCO 8002212501 4234 SW 20TH AVEGAINESVILLE FLCard 2801","32.87","","Posted","604.62"
"3/10/2023","","Recurring Withdrawal Bill Payment - #000000462424/SIE PLAYST 2207 BRIDGEPOINTE PUS SANCACard 2801","17.99","","Posted","637.49"
"3/10/2023","","Withdrawal ACH PAYPAL/TYPE: INST XFER ID: PAYPALSI77CO: PAYPAL NAME: STEVEN CHAPLINSKIEntry Class Code: WEB","42.76","","Posted","655.48"
"3/10/2023","","Withdrawal POS #000000000005/AMAZON.COM*H50716IP2 SEATTLE WACard 2801","73.36","","Posted","698.24"
"3/8/2023","","Withdrawal POS #000096291252/FAST TRACK #200 GAINESVILLE FLCard 2801","30.28","","Posted","771.6"
"3/8/2023","","Withdrawal POS #000000381131/AMAZON.COM*H52KJ2612 SEATTLE WACard 2801","12.52","","Posted","801.88"
"3/8/2023","","Recurring Withdrawal Debit Card MC Debit/TUBEBUDDYCOM* 8668823239 CADate 03/07/23 0 3066855966 0 5045Card 2801","86.4","","Posted","814.4"
"3/8/2023","","Withdrawal ACH FLUENT-Gainesvil/TYPE: PAYMENT ID: 1371804719CO: FLUENT-GainesvilEntry Class Code: PPD","156","","Posted","900.8"
"3/8/2023","","Withdrawal POS #000000038748/PLAYSTATIO 919 E HILLSDALE BLVUS FOSTERCITY CACard 2801","139.99","","Posted","1056.8"
"3/7/2023","","Recurring Withdrawal Debit Card MC Debit/MIDJOURNEY INC. SOUTH SAN FR CADate 03/07/23 0 3066020945 1 5734Card 2801","30","","Posted","1196.79"
"3/7/2023","","Recurring Withdrawal Debit Card MC Debit/PARAMOUNT+ 8882745343 CADate 03/06/23 0 3065832383 0 4899Card 2801","2.03","","Posted","1226.79"
"3/7/2023","","Withdrawal Debit Card MC Debit/PARAMOUNT+ 8882745343 CADate 03/06/23 0 3065832382 0 4899Card 2801","11.5","","Posted","1228.82"
"3/7/2023","","Withdrawal Debit Card Fee/MASTERCARD ISSUER CROSS-BORDER FEEDate 03/06/23 0 3065061180 1 5734Card 2801","0.32","","Posted","1240.32"
"3/7/2023","","Withdrawal Debit Card MC Debit/EQMAC - BITGAPP LTD. LONDON LNDate 03/06/23 0 3065061180 1 5734Card 2801","40","","Posted","1240.64"
"3/7/2023","","Withdrawal Debit Card MC Debit/GRU/EZ-PAY WEB PYMT 352-334-3434 FLDate 03/06/23 0 3065368008 0 4900Card 2801","160.16","","Posted","1280.64"
"3/7/2023","","Withdrawal Adjustment POS #000000665147/AMAZON.COM SEATTLE WACard 2801","","32.24","Posted","1440.8"
"3/7/2023","","Withdrawal Adjustment POS #000000657774/AMAZON.COM SEATTLE WACard 2801","","13.96","Posted","1408.56"
"3/6/2023","","Withdrawal POS #000000006070/KOHLS 1242 3501 SW ARCHER RD GAINESVILLEFLCard 2801","13.96","","Posted","1394.6"
"3/6/2023","","Withdrawal POS #000000006841/CIRCLE K # 26146 3525 GAINESVILLE FLCard 2801","43.4","","Posted","1408.56"
"3/6/2023","","Withdrawal POS #000000766574/PUBLIX 3100 SW 35TH BLVD GAINESVILLE FLCard 2801","36.47","","Posted","1451.96"
"3/6/2023","","Recurring Withdrawal Debit Card MC Debit/SESAME CARE - HEALTH MIAMI FLDate 03/05/23 0 3064037865 1 8099Card 2801","38","","Posted","1488.43"
"3/6/2023","","Withdrawal Debit Card MC Debit/QUILLBOT OAK BROOK ILDate 03/05/23 0 3064036552 1 5734Card 2801","19.95","","Posted","1526.43"
"3/6/2023","","Withdrawal Debit Card MC Debit/WALGREENS #5024 800-289-2273 FLDate 03/05/23 0 3064951835 0 5912Card 2801","15","","Posted","1546.38"
"3/6/2023","","Withdrawal Debit Card MC Debit/COX GAINESVILLE COMM 800-234-3993 FLDate 03/05/23 0 3064030192 1 4899Card 2801","125.03","","Posted","1561.38"
"3/6/2023","","Recurring Withdrawal Bill Payment - #000000250157/NETFLIX COM LOS GATOS CACard 2801","11","","Posted","1686.41"
"3/5/2023","","Withdrawal Debit Card MC Debit/PIZZA HUT 27918 3523739402 FLDate 03/03/23 0 3062954486 0 5812Card 2801","47.22","","Posted","1697.41"
"3/5/2023","","Withdrawal Debit Card MC Debit/WALGREENS #5024 800-289-2273 FLDate 03/04/23 0 3063095080 1 5912Card 2801","26.55","","Posted","1744.63"
"3/5/2023","","Recurring Withdrawal Debit Card MC Debit/ADOBE *STOCK 4085366000 CADate 03/04/23 0 3063953820 0 5734Card 2801","29.99","","Posted","1771.18"
"3/4/2023","","Withdrawal POS #000000047929/PUBLIX 3100 SW 35TH BLVD GAINESVILLE FLCard 2801","47.92","","Posted","1801.17"
"3/4/2023","","Withdrawal POS #000012000556/WALGREENS 2415 SW 75TH GAINESVILLE FLCard 2801","8.68","","Posted","1849.09"
"3/2/2023","","Recurring Withdrawal Debit Card MC Debit/GOOGLE ADS7127436844 MOUNTAIN VIE CADate 03/01/23 0 3060855857 0 7311Card 2801","3.38","","Posted","1857.77"
"3/2/2023","","Withdrawal ACH Watson Realty Co/TYPE: WEB PMTS ID: 9000321157CO: Watson Realty CoNAME: Steven chaplinskiEntry Class Code: WEB","995","","Posted","1861.15"
"3/2/2023","","Withdrawal Adjustment POS #000000675060/AMAZON.COM*H53JK91D0 SEATTLE WACard 2801","","37.1","Posted","2856.15"
"3/2/2023","","Withdrawal Adjustment POS #000000000005/AMAZON.COM*H52J391X0 SEATTLE WACard 2801","","26.86","Posted","2819.05"
"3/2/2023","","Withdrawal POS #000000675060/AMAZON.COM*H53JK91D0 SEATTLE WACard 2801","37.1","","Posted","2792.19"
"3/2/2023","","Withdrawal POS #000000675060/AMAZON.COM*H53JK91D0 SEATTLE WACard 2801","37.1","","Posted","2829.29"
"3/2/2023","","Withdrawal POS #000000000005/AMAZON.COM*H52J391X0 SEATTLE WACard 2801","26.86","","Posted","2866.39"
"3/2/2023","","Withdrawal POS #000000000005/AMAZON.COM*H52J391X0 SEATTLE WACard 2801","26.86","","Posted","2893.25"
"3/1/2023","","Withdrawal POS #000000320317/SUNOCO 8002212501 4234 SW 20TH AVEGAINESVILLE FLCard 2801","32.87","","Posted","2920.11"
"3/1/2023","","Recurring Withdrawal Debit Card MC Debit/JASPER.AI ROLLINGWOOD TXDate 02/28/23 0 3059133816 1 7399Card 2801","59","","Posted","2952.98"
"3/1/2023","","Recurring Withdrawal Debit Card MC Debit/CHEGG ORDER 8558681054 CADate 02/28/23 0 3059959357 0 5942Card 2801","15.95","","Posted","3011.98"
"3/1/2023","","Withdrawal POS #000000000009/AMAZON.COM*HD4IH3VM2 SEATTLE WACard 2801","10.2","","Posted","3027.93"
"2/28/2023","","Recurring Withdrawal Debit Card MC Debit/ADOBE *CREATIVE CLOUD 4085366000 CADate 02/27/23 0 3058034263 1 5734Card 2801","19.99","","Posted","3038.13"
"2/27/2023","","Deposit Home Banking Transfer - monthly expenses/From CHAPLINSKI,LEON 3496297 Share 0090","","2500","Posted","3058.12"
"2/26/2023","","Withdrawal POS #000000209567/SUNOCO 8002212501 4234 SW 20TH AVEGAINESVILLE FLCard 2801","30.71","","Posted","558.12"
"2/26/2023","","Recurring Withdrawal Debit Card Fee/MASTERCARD ISSUER CROSS-BORDER FEEDate 02/25/23 0 3056274739 1 5734Card 2801","0.08","","Posted","588.83"
"2/26/2023","","Recurring Withdrawal Debit Card MC Debit/SP NIGHTCAFE AI ART MARRICKVILLE NSDate 02/25/23 0 3056274739 1 5734Card 2801","9.99","","Posted","588.91"
"2/26/2023","","Recurring Withdrawal Debit Card MC Debit/PLAYERAUCTIONS 800-342-0768 DEDate 02/25/23 0 3056809736 0 5816Card 2801","84.69","","Posted","598.9"
"2/25/2023","","Deposit Home Banking Transfer - From Share 0000/Funds Transfer via Online","","500","Posted","683.59"
"2/22/2023","","Withdrawal Debit Card MC Debit/SCRUBS CARWASH - GAINE GAINESVILLE FLDate 02/21/23 0 3052004389 1 7542Card 2801","5.25","","Posted","183.59"
"2/22/2023","","Withdrawal POS #000096296743/FAST TRACK #200 GAINESVILLE FLCard 2801","22.77","","Posted","188.84"
"2/22/2023","","Withdrawal POS #000000077624/PUBLIX 3930 SW ARCHER ROAD GAINESVILLECard 2801","152.94","","Posted","211.61"
"2/21/2023","","Withdrawal ACH FLUENT-Gainesvil/TYPE: PAYMENT ID: 1371804719CO: FLUENT-GainesvilEntry Class Code: PPD","184.1","","Posted","364.55"
"2/21/2023","","Withdrawal ACH PAYPAL/TYPE: INST XFER ID: PAYPALSI77CO: PAYPAL NAME: STEVEN CHAPLINSKIEntry Class Code: WEB","149.5","","Posted","548.65"
"2/20/2023","","Withdrawal POS #000000949163/AMAZON.COM*HP6O69Z32 SEATTLE WACard 2801","25.79","","Posted","698.15"
"2/20/2023","","Withdrawal POS #000002021491/GOOGLE *YouTubePremium 1600 AmphitheatreParkw Mountain View CACard 2801","13.64","","Posted","723.94"
"2/20/2023","","Withdrawal POS #000096292503/FAST TRACK #200 GAINESVILLE FLCard 2801","24.93","","Posted","737.58"
"2/19/2023","","Recurring Withdrawal Debit Card MC Debit/ENVATO 61383766284 UTDate 02/19/23 0 3050084762 1 5815Card 2801","23","","Posted","762.51"
"2/17/2023","","Withdrawal ACH PAYPAL/TYPE: INST XFER ID: PAYPALSI77CO: PAYPAL NAME: STEVEN CHAPLINSKIEntry Class Code: WEB","50","","Posted","785.51"
"2/17/2023","","Withdrawal ACH PAYPAL/TYPE: INST XFER ID: PAYPALSI77CO: PAYPAL NAME: STEVEN CHAPLINSKIEntry Class Code: WEB","24.95","","Posted","835.51"
"2/17/2023","","Withdrawal POS #000000204206/SUNOCO 8002212501 4234 SW 20TH AVEGAINESVILLE FLCard 2801","25.34","","Posted","860.46"
"2/17/2023","","Withdrawal POS #000000053779/PUBLIX 3100 SW 35TH BLVD GAINESVILLE FLCard 2801","74.69","","Posted","885.8"
"2/16/2023","","Withdrawal ACH PAYMENT FOR AMZ/TYPE: STORECARD ID: 9069872103CO: PAYMENT FOR AMZNAME: 6045781157416487Entry Class Code: WEB","55","","Posted","960.49"
"2/16/2023","","Withdrawal ACH PAYPAL/TYPE: INST XFER ID: PAYPALSI77CO: PAYPAL NAME: STEVEN CHAPLINSKIEntry Class Code: WEB","8.99","","Posted","1015.49"
"2/16/2023","","Withdrawal POS #000000000007/AMAZON.COM*HE4KW8MP1 SEATTLE WACard 2801","81.33","","Posted","1024.48"
"2/15/2023","","Recurring Withdrawal Debit Card MC Debit/PLAYERAUCTIONS 800-342-0768 DEDate 02/14/23 0 3045347652 0 5816Card 2801","38.56","","Posted","1105.81"
"2/15/2023","","Withdrawal POS #000000248548/AMAZON.COM*HP6YD2C00 SEATTLE WACard 2801","28.63","","Posted","1144.37"
"2/15/2023","","Withdrawal POS #000000996169/SUNOCO 8002212501 4234 SW 20TH AVEGAINESVILLE FLCard 2801","25.34","","Posted","1173"
"2/14/2023","","Deposit Home Banking Transfer - From Share 0000/Funds Transfer via Online","","1111.11","Posted","1198.34"
"2/14/2023","","Withdrawal POS #000000000009/AMAZON.COM*HE1YT8T61 SEATTLE WACard 2801","10.2","","Posted","87.23"
"2/13/2023","","Recurring Withdrawal Debit Card MC Debit/CHATGPT SUBSCRIPTION SAN FRANCISC CADate 02/12/23 0 3043740707 0 5734Card 2801","20","","Posted","97.43"
"2/13/2023","","Recurring Withdrawal Debit Card Fee/MASTERCARD ISSUER CROSS-BORDER FEEDate 02/12/23 0 3043066757 1 5734Card 2801","0.07","","Posted","117.43"
"2/13/2023","","Recurring Withdrawal Debit Card MC Debit/DRIVE EXPLORER ADDON MADURAI TNDate 02/12/23 0 3043066757 1 5734Card 2801","9","","Posted","117.5"
"2/13/2023","","Withdrawal ACH PAYPAL/TYPE: INST XFER ID: PAYPALSI77CO: PAYPAL NAME: STEVEN CHAPLINSKIEntry Class Code: WEB","17.99","","Posted","126.5"
"2/13/2023","","Withdrawal POS #000000135175/AMAZON.COM*HE18446F0 SEATTLE WACard 2801","58.92","","Posted","144.49"
"2/12/2023","","Withdrawal POS #000000910135/SUNOCO 8002212501 4234 SW 20TH AVEGAINESVILLE FLCard 2801","25.34","","Posted","203.41"
"2/10/2023","","Deposit Home Banking Transfer food/From CHAPLINSKI,LEON 3496297 Share 0090","","125","Posted","228.75"
"2/10/2023","","Withdrawal ACH ENVATO/CO: ENVATOTYPE: IAT PAYPAL ID: 770510487CEntry Class Code: IAT","39","","Posted","103.75"
"2/10/2023","","Withdrawal ACH FLUENT-Gainesvil/TYPE: PAYMENT ID: 1371804719CO: FLUENT-GainesvilEntry Class Code: PPD","84.4","","Posted","142.75"
"2/10/2023","","Withdrawal POS #000000513814/AMAZON.COM*6E9OG2F93 SEATTLE WACard 2801","10.72","","Posted","227.15"
"2/10/2023","","Withdrawal POS #000000922564/AMAZON.COM*VJ71T1BJ3 SEATTLE WACard 2801","49.44","","Posted","237.87"
"2/9/2023","","Withdrawal POS #000000036003/PUBLIX 3930 SW ARCHER ROAD GAINESVILLECard 2801","136.42","","Posted","287.31"
"2/9/2023","","Withdrawal POS #000000069683/PUBLIX 5200 S W 34TH STREET GAINESVILLECard 2801","57.87","","Posted","423.73"
"2/8/2023","","Withdrawal POS #000000011248/CIRCLE K # 23913 3424 GAINESVILLE FLCard 2801","20.25","","Posted","481.6"
"2/8/2023","","Withdrawal Debit Card MC Debit/MIDJOURNEY INC. SOUTH SAN FR CADate 02/07/23 0 3038831030 0 5734Card 2801","10","","Posted","501.85"
"2/8/2023","","Withdrawal POS #000005221556/PAYPAL *VIDIQ 2211 North First StreetJose CACard 2801","10","","Posted","511.85"
"2/8/2023","","Withdrawal POS #000000000007/AMAZON.COM*6N0DO0XQ3 SEATTLE WACard 2801","322.49","","Posted","521.85"
"2/7/2023","","Withdrawal ACH BEST BUY/TYPE: PAYMENT ID: CITIGPUFDRCO: BEST BUYEntry Class Code: TEL","392","","Posted","844.34"
"2/7/2023","","Withdrawal ACH BEST BUY/TYPE: PAYMENT ID: CITIGPUFDRCO: BEST BUYEntry Class Code: TEL","253.11","","Posted","1236.34"
"2/7/2023","","Withdrawal POS #000000042691/FAST TRACK #200 3960 SW ARCHER RDGAINESVILLE FLCard 2801","25.45","","Posted","1489.45"
"2/7/2023","","Withdrawal POS #000000052937/SUNOCO 8002212501 4234 SW 20TH AVEGAINESVILLE FLCard 2801","3.21","","Posted","1514.9"
"2/6/2023","","Withdrawal POS #000000000000/AMAZON.COM*SB18C4QI3 SEATTLE WACard 2801","21.36","","Posted","1518.11"
"2/6/2023","","Withdrawal POS #000000000000/AMAZON.COM*6D1U84VI3 SEATTLE WACard 2801","21.7","","Posted","1539.47"
"2/6/2023","","Withdrawal ACH VERIFONE PAYMENT/CO: VERIFONE PAYMENTS B.V.TYPE: IAT PAYPAL ID: 770510487CEntry Class Code: IAT","139.95","","Posted","1561.17"
"2/6/2023","","Withdrawal ACH PAYPAL/TYPE: INST XFER ID: PAYPALSI77CO: PAYPAL NAME: STEVEN CHAPLINSKIEntry Class Code: WEB","17.26","","Posted","1701.12"
"2/6/2023","","Withdrawal ACH PAYPAL/TYPE: INST XFER ID: PAYPALSI77CO: PAYPAL NAME: STEVEN CHAPLINSKIEntry Class Code: WEB","14.99","","Posted","1718.38"
"2/6/2023","","Withdrawal ACH PAYPAL/TYPE: INST XFER ID: PAYPALSI77CO: PAYPAL NAME: STEVEN CHAPLINSKIEntry Class Code: WEB","5.69","","Posted","1733.37"
"2/6/2023","","Withdrawal ACH PAYPAL/TYPE: INST XFER ID: PAYPALSI77CO: PAYPAL NAME: STEVEN CHAPLINSKIEntry Class Code: WEB","2.99","","Posted","1739.06"
"2/6/2023","","Recurring Withdrawal Bill Payment - #000000275192/NETFLIX COM LOS GATOS CACard 2801","11","","Posted","1742.05"
"2/5/2023","","Deposit Home Banking Transfer - From Share 0000/Funds Transfer via Online","","1500","Posted","1753.05"
"2/5/2023","","Withdrawal Debit Card MC Debit/WALGREENS #5024 800-289-2273 FLDate 02/04/23 0 3035110401 1 5912Card 2801","85.45","","Posted","253.05"
"2/5/2023","","Withdrawal Debit Card MC Debit/PRIME VIDEO *TD1QC2IU3 888-802-3080 WADate 02/04/23 0 3035915273 0 5818Card 2801","19.99","","Posted","338.5"
"2/5/2023","","Recurring Withdrawal Debit Card MC Debit/ADOBE *ADOBE 4085366000 CADate 02/05/23 0 3036107602 1 5734Card 2801","29.99","","Posted","358.49"
"2/5/2023","","Withdrawal POS #000000972401/AMAZON.COM*FG8QU8T23 SEATTLE WACard 2801","27.06","","Posted","388.48"
"2/5/2023","","Withdrawal POS #000000000000/AMAZON.COM*V40RU1143 SEATTLE WACard 2801","367.5","","Posted","415.54"
"2/3/2023","","Withdrawal POS #000000001861/CIRCLE K # 26162 7302 GAINESVILLE FLCard 2801","20.25","","Posted","783.04"
"2/3/2023","","Withdrawal POS #000000000122/CIRCLE K # 26162 7302 GAINESVILLE FLCard 2801","20.18","","Posted","803.29"
"2/2/2023","","Withdrawal ACH PAYPAL/TYPE: INST XFER ID: PAYPALSI77CO: PAYPAL NAME: STEVEN CHAPLINSKIEntry Class Code: WEB","11.5","","Posted","823.47"
"2/1/2023","","Withdrawal POS #000000078298/PUBLIX 3315 W. UNIVERSITY AVE.FLCard 2801","65.13","","Posted","834.97"
"2/1/2023","","Withdrawal Debit Card MC Debit/GRU/EZ-PAY WEB PYMT 352-334-3434 FLDate 01/31/23 0 3031924789 1 4900Card 2801","241.09","","Posted","900.1"
"2/1/2023","","Recurring Withdrawal Debit Card MC Debit/CHEGG ORDER 8558681054 CADate 01/31/23 0 3031924283 1 5942Card 2801","15.95","","Posted","1141.19"
"2/1/2023","","Withdrawal ACH CAPITAL ONE/TYPE: ONLINE PMT ID: 9279744391CO: CAPITAL ONE NAME: STEVEN CHAPLINSKIEntry Class Code: WEB","25","","Posted","1157.14"
"2/1/2023","","Withdrawal ACH PAYPAL/TYPE: INST XFER ID: PAYPALSI77CO: PAYPAL NAME: STEVEN CHAPLINSKIEntry Class Code: WEB","149.99","","Posted","1182.14"
"2/1/2023","","Withdrawal ACH PAYPAL/TYPE: INST XFER ID: PAYPALSI77CO: PAYPAL NAME: STEVEN CHAPLINSKIEntry Class Code: WEB","2.83","","Posted","1332.13"
"1/31/2023","","Withdrawal POS #000000853822/AMAZON.COM*WF14F7B53 SEATTLE WACard 2801","16.19","","Posted","1334.96"
"1/31/2023","","Recurring Withdrawal Debit Card MC Debit/JASPER.AI ROLLINGWOOD TXDate 01/30/23 0 3030913449 0 7399Card 2801","59","","Posted","1351.15"
"1/31/2023","","Withdrawal Debit Card MC Debit/COX GAINESVILLE COMM 800-234-3993 FLDate 01/31/23 0 3031894286 0 4899Card 2801","125.03","","Posted","1410.15"
"1/31/2023","","Withdrawal ACH PADDLE.COM MARKE/CO: PADDLE.COM MARKET LIMITEDTYPE: IAT PAYPAL ID: 770510487CEntry Class Code: IAT","2.99","","Posted","1535.18"
"1/31/2023","","Deposit Home Banking Transfer - From Share 0000/Funds Transfer via Online","","1000","Posted","1538.17"
"1/31/2023","","Withdrawal ACH Watson Realty Co/TYPE: WEB PMTS ID: 9000321157CO: Watson Realty CoNAME: Steven chaplinskiEntry Class Code: WEB","995","","Posted","538.17"
"1/31/2023","","Withdrawal POS #000000555799/AMAZON.COM*CX16X5MU3 SEATTLE WACard 2801","10.2","","Posted","1533.17"
"1/31/2023","","Withdrawal POS #000000508955/AMAZON.COM*UA77K78R3 SEATTLE WACard 2801","37.6","","Posted","1543.37"
"1/30/2023","","Withdrawal POS #000000178279/SUNOCO 8002212501 4234 SW 20TH AVEGAINESVILLE FLCard 2801","32.23","","Posted","1580.97"
"1/30/2023","","Withdrawal ACH CAPITAL ONE/TYPE: ONLINE PMT ID: 9279744391CO: CAPITAL ONE NAME: STEVEN CHAPLINSKIEntry Class Code: WEB","191","","Posted","1613.2"
"1/30/2023","","Withdrawal ACH APPLECARD GSBANK/TYPE: PAYMENT ID: 9999999999CO: APPLECARD GSBANKNAME: Steven ChaplinskiEntry Class Code: WEB","125","","Posted","1804.2"
"1/30/2023","","Withdrawal ACH TARGET CARD SRVC/TYPE: BILL PAY ID: 5411721813CO: TARGET CARD SRVCNAME: S CHAPLINSKI TEntry Class Code: WEB","125","","Posted","1929.2"
"1/30/2023","","Withdrawal ACH DISCOVER/TYPE: E-PAYMENT ID: 2510020270CO: DISCOVER NAME: CHAPLINSKI STEVENEntry Class Code: WEB","97.52","","Posted","2054.2"
"1/30/2023","","Withdrawal ACH PAYPAL/TYPE: INST XFER ID: PAYPALSI77CO: PAYPAL NAME: STEVEN CHAPLINSKIEntry Class Code: WEB","14.99","","Posted","2151.72"
"1/30/2023","","Withdrawal ACH PAYPAL/TYPE: INST XFER ID: PAYPALSI77CO: PAYPAL NAME: STEVEN CHAPLINSKIEntry Class Code: WEB","2.99","","Posted","2166.71"
"1/30/2023","","Deposit ACH PAYPAL/TYPE: TRANSFER ID: PAYPALSD11 CO: PAYPALEntry Class Code: PPD","","10","Posted","2169.7"
"1/29/2023","","Recurring Withdrawal Debit Card MC Debit/ADOBE *CREATIVE CLOUD 4085366000 CADate 01/27/23 0 3027321474 1 5734Card 2801","19.99","","Posted","2159.7"
"1/28/2023","","Withdrawal POS #000000000000/AMAZON.COM*NK97S60U3 SEATTLE WACard 2801","73.08","","Posted","2179.69"
"1/28/2023","","Withdrawal POS #000000286964/AMAZON.COM*D40II7Y03 SEATTLE WACard 2801","61.26","","Posted","2252.77"
"1/27/2023","","Recurring Withdrawal Adjustment - Debit Card Credit Voucher/AFFIRM.COM PAYMENTS SAN FRANCISC CADate 01/26/23 0 3026982326 0 5999Card 2801","","16.25","Posted","2314.03"
"1/27/2023","","Withdrawal ACH PAYPAL/TYPE: INST XFER ID: PAYPALSI77CO: PAYPAL NAME: STEVEN CHAPLINSKIEntry Class Code: WEB","99.99","","Posted","2297.78"
"1/27/2023","","Withdrawal ACH PAYPAL/TYPE: INST XFER ID: PAYPALSI77CO: PAYPAL NAME: STEVEN CHAPLINSKIEntry Class Code: WEB","49.99","","Posted","2397.77"
"1/27/2023","","Withdrawal ACH PAYPAL/TYPE: INST XFER ID: PAYPALSI77CO: PAYPAL NAME: STEVEN CHAPLINSKIEntry Class Code: WEB","2.99","","Posted","2447.76"
"1/26/2023","","Withdrawal POS #000000000096/CIRCLE K # 26162 7302 GAINESVILLE FLCard 2801","19.39","","Posted","2450.75"
"1/26/2023","","Withdrawal POS #000000036956/PUBLIX 5801 SW 75TH ST GAINESVILLE FLCard 2801","41.9","","Posted","2470.14"
"1/26/2023","","Withdrawal ACH PAYPAL/TYPE: INST XFER ID: PAYPALSI77CO: PAYPAL NAME: STEVEN CHAPLINSKIEntry Class Code: WEB","4.5","","Posted","2512.04"
"1/25/2023","","Recurring Withdrawal Debit Card Fee/MASTERCARD ISSUER CROSS-BORDER FEEDate 01/25/23 0 3025796879 0 5734Card 2801","0.08","","Posted","2516.54"
"1/25/2023","","Recurring Withdrawal Debit Card MC Debit/SP NIGHTCAFE AI ART MARRICKVILLE NSDate 01/25/23 0 3025796879 0 5734Card 2801","9.99","","Posted","2516.62"
"1/25/2023","","Deposit Home Banking Transfer - Feb expenses/From CHAPLINSKI,LEON 3496297 Share 0090","","2500","Posted","2526.61"
"1/23/2023","","Withdrawal ACH CANVA PTY LIMITE/CO: CANVA PTY LIMITEDTYPE: IAT PAYPAL ID: 770510487CEntry Class Code: IAT","12.99","","Posted","26.61"
"1/23/2023","","Withdrawal ACH PAYPAL/TYPE: INST XFER ID: PAYPALSI77CO: PAYPAL NAME: STEVEN CHAPLINSKIEntry Class Code: WEB","79.99","","Posted","39.6"
"1/23/2023","","Withdrawal ACH PAYPAL/TYPE: INST XFER ID: PAYPALSI77CO: PAYPAL NAME: STEVEN CHAPLINSKIEntry Class Code: WEB","4.99","","Posted","119.59"
"1/22/2023","","Withdrawal Debit Card MC Debit/PUBLIX #527 GAINESVILLE FLDate 01/20/23 0 3020078496 4 5411Card 2801","202.28","","Posted","124.58"
"1/21/2023","","Withdrawal POS #000010067691/PAYPAL *QUILLBOT 2211 North First StreetSan Jose CACard 2801","19.95","","Posted","326.86"
"1/20/2023","","Withdrawal ATM Fee/EFT 6419 W Newberry Rd Gainesville FLCard 2801","2","","Posted","346.81"
"1/20/2023","","Withdrawal at ATM #000000473707/EFT 6419 W Newberry Rd Gainesville FLCard 2801","178","","Posted","348.81"
"1/20/2023","","Deposit Home Banking Transfer MEDS/From CHAPLINSKI,LEON 3496297 Share 0090","","200","Posted","526.81"
"1/20/2023","","Deposit Home Banking Transfer MEDS/From CHAPLINSKI,LEON 3496297 Share 0090","","200","Posted","326.81"
"1/20/2023","","Withdrawal POS #000002069571/GOOGLE *YouTubePremium 1600 AmphitheatreParkw Mountain View CACard 2801","13.64","","Posted","126.81"
"1/17/2023","","Withdrawal ACH FLUENT-Gainesvil/TYPE: PAYMENT ID: 1371804719CO: FLUENT-GainesvilEntry Class Code: PPD","48","","Posted","140.45"
"1/17/2023","","Withdrawal ACH PAYPAL/TYPE: INST XFER ID: PAYPALSI77CO: PAYPAL NAME: STEVEN CHAPLINSKIEntry Class Code: WEB","24.95","","Posted","188.45"
"1/17/2023","","Withdrawal ACH PAYPAL/TYPE: INST XFER ID: PAYPALSI77CO: PAYPAL NAME: STEVEN CHAPLINSKIEntry Class Code: WEB","8.99","","Posted","213.4"
"1/17/2023","","Withdrawal POS #000000174482/AMAZON.COM*XC5QI21R3 SEATTLE WACard 2801","10.2","","Posted","222.39"
"1/15/2023","","Withdrawal Debit Card MC Debit/PUBLIX #735 GAINESVILLE FLDate 01/13/23 0 3013278962 2 5411Card 2801","103.83","","Posted","232.59"
"1/13/2023","","Withdrawal POS #000000261616/FAST TRACK #200 3960 SW ARCHER RDGAINESVILLE FLCard 2801","28.14","","Posted","336.42"
"1/12/2023","","Recurring Withdrawal Bill Payment - #000000233587/AFFIRM PAY YSM SAN FRANCISCO CACard 2801","16.25","","Posted","364.56"
"1/12/2023","","Recurring Withdrawal Debit Card Fee/MASTERCARD ISSUER CROSS-BORDER FEEDate 01/11/23 0 3011789326 0 5734Card 2801","0.07","","Posted","380.81"
"1/12/2023","","Recurring Withdrawal Debit Card MC Debit/PAYPAL *LINKTREEPTY 4029357733 AUDate 01/11/23 0 3011789326 0 5734Card 2801","9","","Posted","380.88"
"1/11/2023","","Recurring Withdrawal Debit Card MC Debit/JASPER.AI ROLLINGWOOD TXDate 01/10/23 0 3010785541 0 7399Card 2801","20","","Posted","389.88"
"1/11/2023","","Withdrawal ACH BRAINLY/CO: BRAINLYTYPE: IAT PAYPAL ID: 770510487CEntry Class Code: IAT","10","","Posted","409.88"
"1/11/2023","","Withdrawal ACH PAYPAL/TYPE: INST XFER ID: PAYPALSI77CO: PAYPAL NAME: STEVEN CHAPLINSKIEntry Class Code: WEB","9.99","","Posted","419.88"
"1/11/2023","","Withdrawal ACH PAYPAL/TYPE: INST XFER ID: PAYPALSI77CO: PAYPAL NAME: STEVEN CHAPLINSKIEntry Class Code: WEB","1","","Posted","429.87"
"1/10/2023","","Withdrawal ACH ENVATO/CO: ENVATOTYPE: IAT PAYPAL ID: 770510487CEntry Class Code: IAT","39","","Posted","430.87"
"1/10/2023","","Withdrawal POS #000000260400/SUNOCO 8002212501 4234 SW 20TH AVEGAINESVILLE FLCard 2801","29.85","","Posted","469.87"
"1/9/2023","","Withdrawal ACH ENVATO/CO: ENVATOTYPE: IAT PAYPAL ID: 770510487CEntry Class Code: IAT","6.9","","Posted","499.72"
"1/8/2023","","Withdrawal Debit Card MC Debit/WALGREENS #5024 800-289-2273 FLDate 01/06/23 0 3006523704 2 5912Card 2801","63.05","","Posted","506.62"
"1/8/2023","","Withdrawal Debit Card MC Debit/MAIL.COM, 1&amp;1 MAM INC. CHESTERBROOK PADate 01/04/23 0 3004718222 0 4816Card 2801","14.95","","Posted","569.67"
"1/8/2023","","Withdrawal POS #000005207059/PAYPAL *VIDIQ 2211 North First StreetJose CACard 2801","10","","Posted","584.62"
"1/7/2023","","Withdrawal POS #000000103980/SUNOCO 8002212501 4234 SW 20TH AVEGAINESVILLE FLCard 2801","19.11","","Posted","594.62"
"1/7/2023","","Withdrawal POS #000000514080/SUNOCO 8002212501 4234 SW 20TH AVEGAINESVILLE FLCard 2801","15","","Posted","613.73"
"1/6/2023","","Withdrawal ACH PAYPAL/TYPE: INST XFER ID: PAYPALSI77CO: PAYPAL NAME: STEVEN CHAPLINSKIEntry Class Code: WEB","5.69","","Posted","628.73"
"1/6/2023","","Recurring Withdrawal Bill Payment - #000000097375/NETFLIX COM LOS GATOS CACard 2801","11","","Posted","634.42"
"1/5/2023","","Withdrawal Debit Card MC Debit/PUBLIX #1784 GAINESVILLE FLDate 01/04/23 0 3004983001 0 5411Card 2801","129.08","","Posted","645.42"
"1/5/2023","","Withdrawal Debit Card MC Debit/WALGREENS #5024 800-289-2273 FLDate 01/04/23 0 3004979683 0 5912Card 2801","9.43","","Posted","774.5"
"1/5/2023","","Withdrawal ACH PAYPAL/TYPE: INST XFER ID: PAYPALSI77CO: PAYPAL NAME: STEVEN CHAPLINSKIEntry Class Code: WEB","17.26","","Posted","783.93"
"1/4/2023","","Withdrawal ACH PAYPAL/TYPE: INST XFER ID: PAYPALSI77CO: PAYPAL NAME: STEVEN CHAPLINSKIEntry Class Code: WEB","14.99","","Posted","801.19"
"1/4/2023","","Withdrawal ACH PAYPAL/TYPE: INST XFER ID: PAYPALSI77CO: PAYPAL NAME: STEVEN CHAPLINSKIEntry Class Code: WEB","2.99","","Posted","816.18"
"1/3/2023","","Withdrawal POS #000000000003/AMAZON.COM*ED0352XR3 SEATTLE WACard 2801","10.2","","Posted","819.17"
"1/3/2023","","Withdrawal POS #000000297007/SUNOCO 8002212501 4234 SW 20TH AVEGAINESVILLE FLCard 2801","27.35","","Posted","829.37"
"1/3/2023","","Withdrawal ACH PADDLE.COM MARKE/CO: PADDLE.COM MARKET LIMITEDTYPE: IAT PAYPAL ID: 770510487CEntry Class Code: IAT","69","","Posted","856.72"
"1/3/2023","","Withdrawal ACH PADDLE.COM MARKE/CO: PADDLE.COM MARKET LIMITEDTYPE: IAT PAYPAL ID: 770510487CEntry Class Code: IAT","2.99","","Posted","925.72"
"1/3/2023","","Withdrawal ACH FLUENT-Gainesvil/TYPE: PAYMENT ID: 1371804719CO: FLUENT-GainesvilEntry Class Code: PPD","80.1","","Posted","928.71"
"1/3/2023","","Withdrawal ACH PAYPAL/TYPE: INST XFER ID: PAYPALSI77CO: PAYPAL NAME: STEVEN CHAPLINSKIEntry Class Code: WEB","11.5","","Posted","1008.81"
"1/3/2023","","Withdrawal ACH PAYPAL/TYPE: INST XFER ID: PAYPALSI77CO: PAYPAL NAME: STEVEN CHAPLINSKIEntry Class Code: WEB","3","","Posted","1020.31"
"1/2/2023","","Withdrawal Debit Card MC Debit/PUBLIX #680 GAINESVILLE FLDate 01/01/23 0 3001725148 0 5411Card 2801","44.96","","Posted","1023.31"
"1/2/2023","","Withdrawal Debit Card MC Debit/PUBLIX #1312 GAINESVILLE FLDate 01/01/23 0 3001725047 0 5411Card 2801","88.01","","Posted","1068.27"
"1/2/2023","","Recurring Withdrawal Debit Card MC Debit/CHEGG ORDER 8558681054 CADate 12/31/22 0 2365640452 1 5942Card 2801","15.95","","Posted","1156.28"
"1/1/2023","","Withdrawal POS #000000009136/CIRCLE K # 26146 3525 GAINESVILLE FLCard 2801","22.8","","Posted","1172.23"
"12/31/2022","","Recurring Withdrawal Debit Card MC Debit/JASPER.AI ROLLINGWOOD TXDate 12/30/22 0 2364331374 0 7399Card 2801","10","","Posted","1195.03"
"12/31/2022","","Recurring Withdrawal Debit Card MC Debit/JASPER.AI ROLLINGWOOD TXDate 12/30/22 0 2364331373 0 7399Card 2801","49","","Posted","1205.03"
"12/31/2022","","Withdrawal Debit Card MC Debit/ETSY INC SELLER FEES BROOKLYN NYDate 12/31/22 0 2365030004 1 7311Card 2801","0.2","","Posted","1254.03"
"12/29/2022","","Withdrawal Debit Card MC Debit/GRU/EZ-PAY WEB PYMT 352-334-3434 FLDate 12/28/22 0 2362352713 0 4900Card 2801","222.94","","Posted","1254.23"
"12/29/2022","","Withdrawal Debit Card MC Debit/COX GAINESVILLE COMM 800-234-3993 FLDate 12/28/22 0 2362822190 0 4899Card 2801","124.96","","Posted","1477.17"
"12/29/2022","","Withdrawal ACH Watson Realty Co/TYPE: WEB PMTS ID: 9000321157CO: Watson Realty CoNAME: Steven chaplinskiEntry Class Code: WEB","995","","Posted","1602.13"
"12/29/2022","","Withdrawal ACH PAYPAL/TYPE: INST XFER ID: PAYPALSI77CO: PAYPAL NAME: STEVEN CHAPLINSKIEntry Class Code: WEB","2.99","","Posted","2597.13"
"12/28/2022","","Recurring Withdrawal Debit Card MC Debit/ADOBE *CREATIVE CLOUD 4085366000 CADate 12/27/22 0 2361749868 0 5734Card 2801","19.99","","Posted","2600.12"
"12/28/2022","","Deposit Home Banking Transfer - monthly expenses/From CHAPLINSKI,LEON 3496297 Share 0090","","2500","Posted","2620.11"
"12/28/2022","","Withdrawal ACH PAYPAL/TYPE: INST XFER ID: PAYPALSI77CO: PAYPAL NAME: STEVEN CHAPLINSKIEntry Class Code: WEB","14.99","","Posted","120.11"
"12/27/2022","","Withdrawal POS #000000594073/SUNOCO 8002212501 4234 SW 20TH AVEGAINESVILLE FLCard 2801","33.32","","Posted","135.1"
"12/27/2022","","Deposit Home Banking Transfer - From Share 0000/Funds Transfer via Online","","10","Posted","168.42"
"12/27/2022","","Deposit Faster Payments/RTP deposit from COINBASE","","26.43","Posted","158.42"
"12/27/2022","","Withdrawal ACH FLUENT-Gainesvil/TYPE: PAYMENT ID: 1371804719CO: FLUENT-GainesvilEntry Class Code: PPD","111","","Posted","131.99"
"12/27/2022","","Withdrawal ACH PAYPAL/TYPE: INST XFER ID: PAYPALSI77CO: PAYPAL NAME: STEVEN CHAPLINSKIEntry Class Code: WEB","89.99","","Posted","242.99"
"12/27/2022","","Withdrawal ACH AMZ_STORECRD_PMT/TYPE: PAYMENT ID: 9069872000CO: AMZ_STORECRD_PMTNAME: 6045781157416487Entry Class Code: WEB","37","","Posted","332.98"
"12/27/2022","","Withdrawal ACH PAYPAL/TYPE: INST XFER ID: PAYPALSI77CO: PAYPAL NAME: STEVEN CHAPLINSKIEntry Class Code: WEB","33.17","","Posted","369.98"
"12/27/2022","","Withdrawal ACH PAYPAL/TYPE: INST XFER ID: PAYPALSI77CO: PAYPAL NAME: STEVEN CHAPLINSKIEntry Class Code: WEB","4.5","","Posted","403.15"
"12/27/2022","","Withdrawal ACH PAYPAL/TYPE: INST XFER ID: PAYPALSI77CO: PAYPAL NAME: STEVEN CHAPLINSKIEntry Class Code: WEB","2.99","","Posted","407.65"
"12/25/2022","","Withdrawal Debit Card Fee/MASTERCARD ISSUER CROSS-BORDER FEEDate 12/25/22 0 2359739765 0 5734Card 2801","0.08","","Posted","410.64"
"12/25/2022","","Withdrawal Debit Card MC Debit/SP NIGHTCAFE AI ART MARRICKVILLE NSDate 12/25/22 0 2359739765 0 5734Card 2801","9.99","","Posted","410.72"
"12/23/2022","","Withdrawal POS #000000013317/CIRCLE K # 26162 7302 GAINESVILLE FLCard 2801","19.39","","Posted","420.71"
"12/23/2022","","Deposit Home Banking Transfer trf/From CHAPLINSKI,LEON 3496297 Share 0090","","200","Posted","440.1"
"12/20/2022","","Withdrawal Debit Card MC Debit/WALGREENS #5024 800-289-2273 FLDate 12/19/22 0 2353181854 1 5912Card 2801","12.26","","Posted","240.1"
"12/20/2022","","Withdrawal ACH FLUENT-Gainesvil/TYPE: PAYMENT ID: 1371804719CO: FLUENT-GainesvilEntry Class Code: PPD","72","","Posted","252.36"
"12/20/2022","","Withdrawal ACH PAYPAL/TYPE: INST XFER ID: PAYPALSI77CO: PAYPAL NAME: STEVEN CHAPLINSKIEntry Class Code: WEB","12.63","","Posted","324.36"
"12/20/2022","","Withdrawal POS #000002238379/GOOGLE *YouTubePremium 1600 AmphitheatreParkw Mountain View CACard 2801","13.62","","Posted","336.99"
"12/20/2022","","Withdrawal POS #000000000071/AMAZON.COM*B98QW9ZM3 SEATTLE WACard 2801","10.15","","Posted","350.61"
"12/19/2022","","Withdrawal Debit Card MC Debit/PUBLIX #680 GAINESVILLE FLDate 12/18/22 0 2352007675 1 5411Card 2801","39.52","","Posted","360.76"
"12/19/2022","","Withdrawal ACH PAYPAL/TYPE: INST XFER ID: PAYPALSI77CO: PAYPAL NAME: STEVEN CHAPLINSKIEntry Class Code: WEB","24.95","","Posted","400.28"
"12/19/2022","","Deposit ACH PAYPAL/TYPE: TRANSFER ID: PAYPALSD11 CO: PAYPALEntry Class Code: PPD","","172.88","Posted","425.23"
"12/18/2022","","Withdrawal POS #000000767942/PUBLIX 3930 SW ARCHER ROAD GAINESVILLECard 2801","28.92","","Posted","252.35"
"12/18/2022","","Withdrawal Debit Card MC Debit/PIZZA HUT 27918 3523739402 FLDate 12/16/22 0 2350808582 1 5812Card 2801","32.37","","Posted","281.27"
"12/16/2022","","Withdrawal ACH PAYPAL/TYPE: INST XFER ID: PAYPALSI77CO: PAYPAL NAME: STEVEN CHAPLINSKIEntry Class Code: WEB","8.99","","Posted","313.64"
"12/15/2022","","Withdrawal POS #000000002373/CIRCLE K # 06782 5237 GAINESVILLE FLCard 2801","19.39","","Posted","322.63"
"12/15/2022","","Withdrawal POS #000014159788/WALGREENS 2415 SW 75TH GAINESVILLE FLCard 2801","64.68","","Posted","342.02"
"12/15/2022","","Withdrawal ACH VERIFONE PAYMENT/CO: VERIFONE PAYMENTS B.V.TYPE: IAT PAYPAL ID: 770510487CEntry Class Code: IAT","172.88","","Posted","406.7"
"12/14/2022","","Withdrawal ACH APPLECARD GSBANK/TYPE: PAYMENT ID: 9999999999CO: APPLECARD GSBANKNAME: Steven ChaplinskiEntry Class Code: WEB","10","","Posted","579.58"
"12/14/2022","","Withdrawal ACH CANVA PTY LIMITE/CO: CANVA PTY LIMITEDTYPE: IAT PAYPAL ID: 770510487CEntry Class Code: IAT","12.99","","Posted","589.58"
"12/14/2022","","Withdrawal ACH PAYPAL/TYPE: INST XFER ID: PAYPALSI77CO: PAYPAL NAME: STEVEN CHAPLINSKIEntry Class Code: WEB","5","","Posted","602.57"
"12/13/2022","","Withdrawal ACH COINBASE INC./TYPE: 8889087930 ID: 1327000623CO: COINBASE INC.NAME: STEVEN J CHAPLINSKIEntry Class Code: WEB","10","","Posted","607.57"
"12/13/2022","","Withdrawal POS #000000297266/SUNOCO 8002212501 4234 SW 20TH AVEGAINESVILLE FLCard 2801","24.58","","Posted","617.57"
"12/13/2022","","Deposit Faster Payments/RTP deposit from COINBASE","","2.84","Posted","642.15"
"12/13/2022","","Withdrawal Adjustment Debit Card - Credit Voucher/DOCTORS RADIOLOGY GROU 352-3319729 FLDate 12/10/22 0 2344845606 0 8011Card 2801","","30","Posted","639.31"
"12/13/2022","","Withdrawal ACH FLUENT-Gainesvil/TYPE: PAYMENT ID: 1371804719CO: FLUENT-GainesvilEntry Class Code: PPD","105","","Posted","609.31"
"12/13/2022","","Withdrawal ACH COINBASE INC./TYPE: 8889087930 ID: 1327000623CO: COINBASE INC.NAME: STEVEN J CHAPLINSKIEntry Class Code: WEB","10","","Posted","714.31"
"12/13/2022","","Withdrawal ACH COINBASE INC./TYPE: 8889087930 ID: 1327000623CO: COINBASE INC.NAME: STEVEN J CHAPLINSKIEntry Class Code: WEB","10","","Posted","724.31"
"12/12/2022","","Recurring Withdrawal Debit Card Fee/MASTERCARD ISSUER CROSS-BORDER FEEDate 12/11/22 0 2345994966 0 5734Card 2801","0.07","","Posted","734.31"
"12/12/2022","","Recurring Withdrawal Debit Card MC Debit/PAYPAL *LINKTREEPTY 4029357733 AUDate 12/11/22 0 2345994966 0 5734Card 2801","9","","Posted","734.38"
"12/12/2022","","Withdrawal ACH APPLECARD GSBANK/TYPE: PAYMENT ID: 9999999999CO: APPLECARD GSBANKNAME: Steven ChaplinskiEntry Class Code: WEB","4.64","","Posted","743.38"
"12/12/2022","","Withdrawal ACH ENVATO/CO: ENVATOTYPE: IAT PAYPAL ID: 770510487CEntry Class Code: IAT","39","","Posted","748.02"
"12/12/2022","","Withdrawal ACH BRAINLY/CO: BRAINLYTYPE: IAT PAYPAL ID: 770510487CEntry Class Code: IAT","10","","Posted","787.02"
"12/12/2022","","Withdrawal ACH TARGET CARD SRVC/TYPE: BILL PAY ID: T510215170CO: TARGET CARD SRVCNAME: 7S CH0000000APLINSKI TEntry Class Code: WEB","90.2","","Posted","797.02"
"12/12/2022","","Withdrawal ACH PAYPAL/TYPE: INST XFER ID: PAYPALSI77CO: PAYPAL NAME: STEVEN CHAPLINSKIEntry Class Code: WEB","9.99","","Posted","887.22"
"12/11/2022","","Recurring Withdrawal Debit Card MC Debit/AFFIRM.COM PAYMENTS SAN FRANCISC CADate 12/10/22 0 2344036677 1 5999Card 2801","16.25","","Posted","897.21"
"12/11/2022","","Withdrawal Debit Card MC Debit/LASTPASS.COM MADate 12/09/22 0 2343819673 0 5968Card 2801","36","","Posted","913.46"
"12/10/2022","","Withdrawal POS #000000142991/SUNOCO 8002212501 4234 SW 20TH AVEGAINESVILLE FLCard 2801","26.73","","Posted","949.46"
"12/9/2022","","Deposit POS #000010299509/PAYPAL*CHAPLINSKI ST San Jose CACard 2801","","78.6","Posted","976.19"
"12/9/2022","","Withdrawal Debit Card MC Debit/WALGREENS #5024 800-289-2273 FLDate 12/08/22 0 2342147730 1 5912Card 2801","7.42","","Posted","897.59"
"12/8/2022","","Withdrawal POS #000000749592/PUBLIX 9200 NW 39TH AVE GAINESVILLE FLCard 2801","43.26","","Posted","905.01"
"12/8/2022","","Withdrawal Debit Card MC Debit/GATE 1445 Q80 GAINESVILLE FLDate 12/07/22 0 2341109713 1 5541Card 2801","33.23","","Posted","948.27"
"12/8/2022","","Withdrawal POS #000005024823/PAYPAL *VIDIQ 2211 North First StreetJose CACard 2801","10","","Posted","981.5"
"12/6/2022","","Withdrawal Debit Card MC Debit/PUBLIX #680 GAINESVILLE FLDate 12/05/22 0 2339114199 1 5411Card 2801","48.09","","Posted","991.5"
"12/6/2022","","Withdrawal ACH PAYPAL/TYPE: INST XFER ID: PAYPALSI77CO: PAYPAL NAME: STEVEN CHAPLINSKIEntry Class Code: WEB","5.66","","Posted","1039.59"
"12/6/2022","","Withdrawal ACH PAYPAL/TYPE: INST XFER ID: PAYPALSI77CO: PAYPAL NAME: STEVEN CHAPLINSKIEntry Class Code: WEB","4.99","","Posted","1045.25"
"12/6/2022","","Withdrawal POS #000000000006/AMAZON.COM*EX9514ED3 SEATTLE WACard 2801","10.15","","Posted","1050.24"
"12/6/2022","","Recurring Withdrawal Bill Payment - #000000471011/NETFLIX COM LOS GATOS CACard 2801","10.98","","Posted","1060.39"
"12/5/2022","","Withdrawal POS #000093424601/BP#8996613SUNRI GAINESVILLE FLCard 2801","30.98","","Posted","1071.37"
"12/5/2022","","Withdrawal ACH ENVATO/CO: ENVATOTYPE: IAT PAYPAL ID: 770510487CEntry Class Code: IAT","23","","Posted","1102.35"
"12/5/2022","","Withdrawal ACH Watson Realty Co/TYPE: WEB PMTS ID: 9000321157CO: Watson Realty CoNAME: Steven chaplinskiEntry Class Code: WEB","995","","Posted","1125.35"
"12/5/2022","","Withdrawal ACH PAYPAL/TYPE: INST XFER ID: PAYPALSI77CO: PAYPAL NAME: STEVEN CHAPLINSKIEntry Class Code: WEB","17.23","","Posted","2120.35"
"12/5/2022","","Withdrawal ACH PAYPAL/TYPE: INST XFER ID: PAYPALSI77CO: PAYPAL NAME: STEVEN CHAPLINSKIEntry Class Code: WEB","14.99","","Posted","2137.58"
"12/5/2022","","Withdrawal ACH PAYPAL/TYPE: INST XFER ID: PAYPALSI77CO: PAYPAL NAME: STEVEN CHAPLINSKIEntry Class Code: WEB","2.99","","Posted","2152.57"
"12/4/2022","","Recurring Withdrawal Debit Card MC Debit/PLAYERAUCTIONS 800-342-0768 DEDate 12/03/22 0 2337672541 0 7993Card 2801","70.99","","Posted","2155.56"
"12/2/2022","","Withdrawal ACH PAYPAL/TYPE: INST XFER ID: PAYPALSI77CO: PAYPAL NAME: STEVEN CHAPLINSKIEntry Class Code: WEB","11.48","","Posted","2226.55"
"12/1/2022","","Recurring Withdrawal Debit Card MC Debit/CHEGG ORDER 8558681054 CADate 11/30/22 0 2334889051 0 5942Card 2801","15.95","","Posted","2238.03"
"12/1/2022","","Withdrawal ACH PADDLE.COM MARKE/CO: PADDLE.COM MARKET LIMITEDTYPE: IAT PAYPAL ID: 770510487CEntry Class Code: IAT","2.99","","Posted","2253.98"
"12/1/2022","","Withdrawal POS #000000073914/PUBLIX 3930 SW ARCHER ROAD GAINESVILLECard 2801","127.63","","Posted","2256.97"
"12/1/2022","","Withdrawal ACH PAYPAL/TYPE: INST XFER ID: PAYPALSI77CO: PAYPAL NAME: STEVEN CHAPLINSKIEntry Class Code: WEB","3","","Posted","2384.6"
"11/30/2022","","Withdrawal Debit Card MC Debit/GAINESVILLE ORAL AND I GAINESVILLE FLDate 11/29/22 0 2333085865 1 8021Card 2801","284.2","","Posted","2387.6"
"11/30/2022","","Withdrawal Debit Card MC Debit/GRU/EZ-PAY WEB PYMT 352-334-3434 FLDate 11/29/22 0 2333314423 0 4900Card 2801","174.23","","Posted","2671.8"
"11/30/2022","","Withdrawal Debit Card MC Debit/COX GAINESVILLE COMM 800-234-3993 FLDate 11/29/22 0 2333886169 0 4899Card 2801","124.96","","Posted","2846.03"
"11/30/2022","","Deposit Home Banking Transfer - dental surgeon/From CHAPLINSKI,LEON 3496297 Share 0090","","280","Posted","2970.99"
"11/30/2022","","Withdrawal ACH DISCOVER/TYPE: E-PAYMENT ID: 2510020270CO: DISCOVER NAME: CHAPLINSKI STEVENEntry Class Code: WEB","34","","Posted","2690.99"
"11/29/2022","","Deposit Home Banking Transfer - monthly bills/From CHAPLINSKI,LEON 3496297 Share 0090","","2600","Posted","2724.99"
"11/29/2022","","Deposit POS #000008361677/PAYPAL*CHAPLINSKI ST San Jose CACard 2801","","98.25","Posted","124.99"
"11/29/2022","","Withdrawal ACH FLUENT-Gainesvil/TYPE: PAYMENT ID: 1371804719CO: FLUENT-GainesvilEntry Class Code: PPD","90","","Posted","26.74"
"11/29/2022","","Withdrawal ACH PAYPAL/TYPE: INST XFER ID: PAYPALSI77CO: PAYPAL NAME: STEVEN CHAPLINSKIEntry Class Code: WEB","2.99","","Posted","116.74"
"11/28/2022","","Withdrawal Debit Card MC Debit/PUBLIX #680 GAINESVILLE FLDate 11/27/22 0 2331917962 0 5411Card 2801","92.23","","Posted","119.73"
"11/28/2022","","Recurring Withdrawal Debit Card MC Debit/JASPER.AI ROLLINGWOOD TXDate 11/27/22 0 2331918341 0 7399Card 2801","29","","Posted","211.96"
"11/28/2022","","Withdrawal Debit Card MC Debit/CIRCLE K # 26146 GAINESVILLE FLDate 11/27/22 0 2331080335 1 5541Card 2801","19.49","","Posted","240.96"
"11/28/2022","","Recurring Withdrawal Debit Card MC Debit/ADOBE *CREATIVE CLOUD 4085366000 CADate 11/27/22 0 2331079708 1 5734Card 2801","19.99","","Posted","260.45"
"11/28/2022","","Withdrawal ACH PAYPAL/TYPE: INST XFER ID: PAYPALSI77CO: PAYPAL NAME: STEVEN CHAPLINSKIEntry Class Code: WEB","29.99","","Posted","280.44"
"11/28/2022","","Withdrawal ACH PAYPAL/TYPE: INST XFER ID: PAYPALSI77CO: PAYPAL NAME: STEVEN CHAPLINSKIEntry Class Code: WEB","14.99","","Posted","310.43"
"11/28/2022","","Withdrawal ACH PAYPAL/TYPE: INST XFER ID: PAYPALSI77CO: PAYPAL NAME: STEVEN CHAPLINSKIEntry Class Code: WEB","4.5","","Posted","325.42"
"11/28/2022","","Withdrawal ACH PAYPAL/TYPE: INST XFER ID: PAYPALSI77CO: PAYPAL NAME: STEVEN CHAPLINSKIEntry Class Code: WEB","2.99","","Posted","329.92"
"11/27/2022","","Withdrawal POS #000000196178/AMAZON.COM*HZ05L0OS1 SEATTLE WACard 2801","23.18","","Posted","332.91"
"11/27/2022","","Deposit Home Banking Transfer - From Share 0000/Funds Transfer via Mobile","","135","Posted","356.09"
"11/27/2022","","Deposit POS #000005616481/PAYPAL*CHAPLINSKI ST San Jose CACard 2801","","122.81","Posted","221.09"
"11/25/2022","","Withdrawal POS #000000802128/SUNOCO 8002212501 4234 SW 20TH AVEGAINESVILLE FLCard 2801","32.08","","Posted","98.28"
"11/25/2022","","Deposit Home Banking Transfer - From Share 0000/Funds Transfer via Mobile","","75","Posted","130.36"
"11/25/2022","","Withdrawal ACH AMZ_STORECRD_PMT/TYPE: PAYMENT ID: 9069872000CO: AMZ_STORECRD_PMTNAME: 6045781157416487Entry Class Code: WEB","37","","Posted","55.36"
"11/24/2022","","Withdrawal Debit Card MC Debit/SESAME CARE - HEALTH MIAMI FLDate 11/23/22 0 2327908189 0 8099Card 2801","30.4","","Posted","92.36"
"11/24/2022","","Recurring Withdrawal Debit Card MC Debit/PLAYERAUCTIONS 800-342-0768 DEDate 11/24/22 0 2328315966 1 7993Card 2801","34.31","","Posted","122.76"
"11/24/2022","","Withdrawal Debit Card MC Debit/WALGREENS #5024 800-289-2273 FLDate 11/23/22 0 2327045498 1 5912Card 2801","10.27","","Posted","157.07"
"11/23/2022","","Withdrawal Debit Card MC Debit/PUBLIX #1312 GAINESVILLE FLDate 11/22/22 0 2326197102 1 5411Card 2801","69.38","","Posted","167.34"
"11/23/2022","","Withdrawal POS #000000475170/AMAZON.COM*HI6FA2YH2 SEATTLE WACard 2801","10.68","","Posted","236.72"
"11/22/2022","","Withdrawal POS #000000174475/SUNOCO 8002212501 4234 SW 20TH AVEGAINESVILLE FLCard 2801","21.38","","Posted","247.4"
"11/22/2022","","Deposit Home Banking Transfer - From Share 0000/Funds Transfer via Mobile","","150","Posted","268.78"
"11/22/2022","","Withdrawal ACH FLUENT-Gainesvil/TYPE: PAYMENT ID: 1371804719CO: FLUENT-GainesvilEntry Class Code: PPD","91.01","","Posted","118.78"
"11/22/2022","","Withdrawal POS #000000000873/AMAZON.COM*HI8SN2DS2 SEATTLE WACard 2801","10.15","","Posted","209.79"
"11/21/2022","","Withdrawal Debit Card MC Debit/WALGREENS #5024 800-289-2273 FLDate 11/20/22 0 2324948463 0 5912Card 2801","3.91","","Posted","219.94"
"11/21/2022","","Withdrawal ACH PAYPAL/TYPE: INST XFER ID: PAYPALSI77CO: PAYPAL NAME: STEVEN CHAPLINSKIEntry Class Code: WEB","9.18","","Posted","223.85"
"11/20/2022","","Withdrawal POS #000000003339/CIRCLE K # 26146 3525 GAINESVILLE FLCard 2801","19.49","","Posted","233.03"
"11/20/2022","","Withdrawal POS #000002394786/GOOGLE *YouTubePremium 1600 AmphitheatreParkw Mountain View CACard 2801","13.62","","Posted","252.52"
"11/18/2022","","Recurring Withdrawal Debit Card MC Debit/PLAYERAUCTIONS 800-342-0768 DEDate 11/17/22 0 2321371857 0 7993Card 2801","63.74","","Posted","266.14"
"11/18/2022","","Withdrawal ACH PAYPAL/TYPE: INST XFER ID: PAYPALSI77CO: PAYPAL NAME: STEVEN CHAPLINSKIEntry Class Code: WEB","99.99","","Posted","329.88"
"11/17/2022","","Deposit Home Banking Transfer - From Share 0000/Funds Transfer via Online","","165","Posted","429.87"
"11/17/2022","","Withdrawal ACH PAYPAL/TYPE: INST XFER ID: PAYPALSI77CO: PAYPAL NAME: STEVEN CHAPLINSKIEntry Class Code: WEB","24.95","","Posted","264.87"
"11/16/2022","","Withdrawal ACH PAYPAL/TYPE: INST XFER ID: PAYPALSI77CO: PAYPAL NAME: STEVEN CHAPLINSKIEntry Class Code: WEB","8.99","","Posted","289.82"
"11/15/2022","","Withdrawal Debit Card MC Debit/PUBLIX #1312 GAINESVILLE FLDate 11/14/22 0 2318057599 1 5411Card 2801","135.45","","Posted","298.81"
"11/14/2022","","Withdrawal POS #000096292125/FAST TRACK #200 GAINESVILLE FLCard 2801","19.46","","Posted","434.26"
"11/14/2022","","Withdrawal ACH CANVA PTY LIMITE/CO: CANVA PTY LIMITEDTYPE: IAT PAYPAL ID: 770510487CEntry Class Code: IAT","12.99","","Posted","453.72"
"11/14/2022","","Withdrawal ACH BRAINLY/CO: BRAINLYTYPE: IAT PAYPAL ID: 770510487CEntry Class Code: IAT","10","","Posted","466.71"
"11/14/2022","","Withdrawal ACH TARGET CARD SRVC/TYPE: BILL PAY ID: T510215170CO: TARGET CARD SRVCNAME: 7S CH0000000APLINSKI TEntry Class Code: WEB","90.2","","Posted","476.71"
"11/14/2022","","Withdrawal ACH PAYPAL/TYPE: INST XFER ID: PAYPALSI77CO: PAYPAL NAME: STEVEN CHAPLINSKIEntry Class Code: WEB","9.99","","Posted","566.91"
"11/14/2022","","Withdrawal POS #000000293725/AMAZON.COM*HB3H53TR2 SEATTLE WACard 2801","23.18","","Posted","576.9"
"11/13/2022","","Recurring Withdrawal Debit Card Fee/MASTERCARD ISSUER CROSS-BORDER FEEDate 11/11/22 0 2315649444 1 5734Card 2801","0.07","","Posted","600.08"
"11/13/2022","","Recurring Withdrawal Debit Card MC Debit/PAYPAL *LINKTREEPTY 4029357733 AUDate 11/11/22 0 2315649444 1 5734Card 2801","9","","Posted","600.15"
"11/11/2022","","Withdrawal POS #000000000586/AMAZON.COM*HB8IG9X21 SEATTLE WACard 2801","20.32","","Posted","609.15"
"11/10/2022","","Withdrawal Debit Card MC Debit/PUBLIX #1312 GAINESVILLE FLDate 11/09/22 0 2313064607 1 5411Card 2801","65.66","","Posted","629.47"
"11/10/2022","","Withdrawal Debit Card MC Debit/WALGREENS #5024 800-289-2273 FLDate 11/09/22 0 2313061342 1 5912Card 2801","60.66","","Posted","695.13"
"11/10/2022","","Withdrawal ACH ENVATO/CO: ENVATOTYPE: IAT PAYPAL ID: 770510487CEntry Class Code: IAT","39","","Posted","755.79"
"11/10/2022","","Withdrawal POS #000000000004/AMAZON.COM*HB21Z6M20 SEATTLE WACard 2801","8.55","","Posted","794.79"
"11/8/2022","","Withdrawal POS #000000173052/AMAZON.COM*H21U27Y71 SEATTLE WACard 2801","9.51","","Posted","803.34"
"11/8/2022","","Withdrawal POS #000005069927/PAYPAL *VIDIQ 2211 North First StreetJose CACard 2801","10","","Posted","812.85"
"11/7/2022","","Withdrawal ACH ENVATO/CO: ENVATOTYPE: IAT PAYPAL ID: 770510487CEntry Class Code: IAT","23","","Posted","822.85"
"11/7/2022","","Withdrawal ACH PAYPAL/TYPE: INST XFER ID: PAYPALSI77CO: PAYPAL NAME: STEVEN CHAPLINSKIEntry Class Code: WEB","5.66","","Posted","845.85"
"11/7/2022","","Withdrawal ACH PAYPAL/TYPE: INST XFER ID: PAYPALSI77CO: PAYPAL NAME: STEVEN CHAPLINSKIEntry Class Code: WEB","4.99","","Posted","851.51"
"11/6/2022","","Withdrawal POS #000000763450/SUNOCO 8002212501 4234 SW 20TH AVEGAINESVILLE FLCard 2801","21.38","","Posted","856.5"
"11/6/2022","","Withdrawal POS #000000342915/SUNOCO 8002212501 4234 SW 20TH AVEGAINESVILLE FLCard 2801","8.55","","Posted","877.88"
"11/6/2022","","Withdrawal POS #000000498317/AMAZON.COM*H20LE3DA1 SEATTLE WACard 2801","23.18","","Posted","886.43"
"11/6/2022","","Recurring Withdrawal Bill Payment - #000000026409/NETFLIX COM LOS GATOS CACard 2801","10.98","","Posted","909.61"
"11/6/2022","","Withdrawal POS #000000213746/AMAZON.COM*H20Y57OX2 SEATTLE WACard 2801","50.84","","Posted","920.59"
"11/4/2022","","Withdrawal POS #000000190083/WAWA 5325 2373 SW ARCHER ROADFLCard 2801","24.55","","Posted","971.43"
"11/4/2022","","Withdrawal Debit Card MC Debit/GRU/EZ-PAY WEB PYMT 352-334-3434 FLDate 11/03/22 0 2307358881 0 4900Card 2801","205.33","","Posted","995.98"
"11/4/2022","","Withdrawal Debit Card MC Debit/COX GAINESVILLE COMM 800-234-3993 FLDate 11/03/22 0 2307872387 0 4899Card 2801","117.89","","Posted","1201.31"
"11/4/2022","","Withdrawal ACH PAYPAL/TYPE: INST XFER ID: PAYPALSI77CO: PAYPAL NAME: STEVEN CHAPLINSKIEntry Class Code: WEB","14.99","","Posted","1319.2"
"11/4/2022","","Withdrawal ACH PAYPAL/TYPE: INST XFER ID: PAYPALSI77CO: PAYPAL NAME: STEVEN CHAPLINSKIEntry Class Code: WEB","2.99","","Posted","1334.19"
"11/2/2022","","Withdrawal POS #000000497604/SUNOCO 8002212501 4234 SW 20TH AVEGAINESVILLE FLCard 2801","29.93","","Posted","1337.18"
"11/2/2022","","Withdrawal Debit Card MC Debit/ACI*CREDIT ONE BANK, N 877-825-3242 NVDate 11/01/22 0 2305147365 1 6012Card 2801","180","","Posted","1367.11"
"11/2/2022","","Withdrawal ACH Watson Realty Co/TYPE: WEB PMTS ID: 9000321157CO: Watson Realty CoNAME: Steven chaplinskiEntry Class Code: WEB","995","","Posted","1547.11"
"11/2/2022","","Withdrawal ACH FLUENT-Gainesvil/TYPE: PAYMENT ID: 1371804719CO: FLUENT-GainesvilEntry Class Code: PPD","153.4","","Posted","2542.11"
"11/2/2022","","Withdrawal ACH PAYPAL/TYPE: INST XFER ID: PAYPALSI77CO: PAYPAL NAME: STEVEN CHAPLINSKIEntry Class Code: WEB","11.48","","Posted","2695.51"
"11/2/2022","","Withdrawal ACH PAYPAL/TYPE: INST XFER ID: PAYPALSI77CO: PAYPAL NAME: STEVEN CHAPLINSKIEntry Class Code: WEB","3","","Posted","2706.99"
"11/1/2022","","Recurring Withdrawal Debit Card MC Debit/CHEGG ORDER 8558681054 CADate 10/31/22 0 2304767975 0 5942Card 2801","15.95","","Posted","2709.99"
"11/1/2022","","Withdrawal ACH PADDLE.COM MARKE/CO: PADDLE.COM MARKET LIMITEDTYPE: IAT PAYPAL ID: 770510487CEntry Class Code: IAT","2.99","","Posted","2725.94"
"10/31/2022","","Deposit Home Banking Transfer Birthday/From CHAPLINSKI,LEON 3496297 Share 0090","","50","Posted","2728.93"
"10/31/2022","","Withdrawal ACH PAYPAL/TYPE: INST XFER ID: PAYPALSI77CO: PAYPAL NAME: STEVEN CHAPLINSKIEntry Class Code: WEB","2.99","","Posted","2678.93"
"10/31/2022","","Withdrawal POS #000000000081/AMAZON.COM*H28L57OD0 SEATTLE WACard 2801","23.18","","Posted","2681.92"
"10/30/2022","","Withdrawal POS #000000915693/SUNOCO 8002212501 4234 SW 20TH AVEGAINESVILLE FLCard 2801","26.73","","Posted","2705.1"
"10/30/2022","","Deposit Home Banking Transfer trf/From CHAPLINSKI,LEON 3496297 Share 0090","","2500","Posted","2731.83"
"10/28/2022","","Withdrawal Debit Card MC Debit/NEW SAMS.COM MEM# 888-746-7726 ARDate 10/26/22 0 2299821095 0 5300Card 2801","25","","Posted","231.83"
"10/28/2022","","Recurring Withdrawal Debit Card MC Debit/ADOBE *CREATIVE CLOUD 4085366000 CADate 10/27/22 0 2300818282 0 5734Card 2801","19.99","","Posted","256.83"
"10/28/2022","","Withdrawal ACH APPLECARD GSBANK/TYPE: PAYMENT ID: 9999999999CO: APPLECARD GSBANKNAME: Steven ChaplinskiEntry Class Code: WEB","42.99","","Posted","276.82"
"10/28/2022","","Withdrawal ACH PAYPAL/TYPE: INST XFER ID: PAYPALSI77CO: PAYPAL NAME: STEVEN CHAPLINSKIEntry Class Code: WEB","14.99","","Posted","319.81"
"10/28/2022","","Withdrawal ACH PAYPAL/TYPE: INST XFER ID: PAYPALSI77CO: PAYPAL NAME: STEVEN CHAPLINSKIEntry Class Code: WEB","14.62","","Posted","334.8"
"10/27/2022","","Withdrawal Debit Card MC Debit/WALGREENS #5024 800-289-2273 FLDate 10/26/22 0 2299017690 1 5912Card 2801","15","","Posted","349.42"
"10/27/2022","","Withdrawal ACH TARGET DEBIT CRD/Location - TARGET -0687Gainesville FL / Terminal ID: 172TYPE: ACH TRAN ID: 1410215170CO: TARGET DEBIT CRDEntry Class C","24.9","","Posted","364.42"
"10/27/2022","","Withdrawal ACH PAYPAL/TYPE: INST XFER ID: PAYPALSI77CO: PAYPAL NAME: STEVEN CHAPLINSKIEntry Class Code: WEB","2.99","","Posted","389.32"
"10/26/2022","","Withdrawal POS #000000177822/SUNOCO 8002212501 4234 SW 20TH AVEGAINESVILLE FLCard 2801","42.77","","Posted","392.31"
"10/26/2022","","Withdrawal Debit Card MC Debit/PUBLIX #1376 GAINESVILLE FLDate 10/25/22 0 2298992341 0 5411Card 2801","66.88","","Posted","435.08"
"10/26/2022","","Withdrawal ACH PAYPAL/TYPE: INST XFER ID: PAYPALSI77CO: PAYPAL NAME: STEVEN CHAPLINSKIEntry Class Code: WEB","4.5","","Posted","501.96"
"10/25/2022","","Withdrawal Debit Card MC Debit/PIZZA HUT 27918 3523739402 FLDate 10/23/22 0 2296800127 0 5812Card 2801","36.37","","Posted","506.46"
"10/25/2022","","Withdrawal POS #000000000016/AMAZON.COM*H87HE1UT1 SEATTLE WACard 2801","8.63","","Posted","542.83"
"10/24/2022","","Withdrawal POS #000013106221/WALGREENS 2415 SW 75TH GAINESVILLE FLCard 2801","23.6","","Posted","551.46"
"10/24/2022","","Deposit Home Banking Transfer - From Share 0000/Funds Transfer via Mobile","","500","Posted","575.06"
"10/24/2022","","Withdrawal ACH FLUENT-Gainesvil/TYPE: PAYMENT ID: 1371804719CO: FLUENT-GainesvilEntry Class Code: PPD","84.4","","Posted","75.06"
"10/23/2022","","Withdrawal Debit Card MC Debit/PIZZA HUT 27918 3523739402 FLDate 10/21/22 0 2294861161 0 5812Card 2801","38.5","","Posted","159.46"
"10/21/2022","","Withdrawal POS #000000943732/AMAZON.COM*HT1GK8UE2 SEATTLE WACard 2801","10.02","","Posted","197.96"
"10/21/2022","","Withdrawal Debit Card MC Debit/WALGREENS #5024 GAINESVILLE FLDate 10/20/22 0 2293128318 1 5912Card 2801","20.83","","Posted","207.98"
"10/21/2022","","Withdrawal ACH PAYPAL/TYPE: INST XFER ID: PAYPALSI77CO: PAYPAL NAME: STEVEN CHAPLINSKIEntry Class Code: WEB","149.99","","Posted","228.81"
"10/21/2022","","Withdrawal POS #000000000006/AMAZON.COM*HT5TG4K52 SEATTLE WACard 2801","62.33","","Posted","378.8"
"10/20/2022","","Withdrawal POS #000000000411/CIRCLE K # 26146 3525 GAINESVILLE FLCard 2801","19.45","","Posted","441.13"
"10/20/2022","","Recurring Withdrawal Debit Card Fee/MASTERCARD ISSUER CROSS-BORDER FEEDate 10/19/22 0 2292820530 0 5734Card 2801","0.1","","Posted","460.58"
"10/20/2022","","Recurring Withdrawal Debit Card MC Debit/SWB* TRIAL OVER WELLINGTON NZDate 10/19/22 0 2292820530 0 5734Card 2801","12","","Posted","460.68"
"10/20/2022","","Withdrawal ACH PAYPAL/TYPE: INST XFER ID: PAYPALSI77CO: PAYPAL NAME: STEVEN CHAPLINSKIEntry Class Code: WEB","9.18","","Posted","472.68"
"10/20/2022","","Withdrawal ACH PAYPAL/TYPE: INST XFER ID: PAYPALSI77CO: PAYPAL NAME: STEVEN CHAPLINSKIEntry Class Code: WEB","6.48","","Posted","481.86"
"10/20/2022","","Withdrawal POS #000003027695/GOOGLE *YouTubePremium 1600 AmphitheatreParkw Mountain View CACard 2801","13.62","","Posted","488.34"
"10/18/2022","","Withdrawal ACH CAPITAL ONE/TYPE: MOBILE PMT ID: 9279744380CO: CAPITAL ONE NAME: STEVEN CHAPLINSKIEntry Class Code: WEB","37","","Posted","501.96"
"10/17/2022","","Withdrawal ACH PADDLE.COM MARKE/CO: PADDLE.COM MARKET LIMITEDTYPE: IAT PAYPAL ID: 770510487CEntry Class Code: IAT","12.49","","Posted","538.96"
"10/17/2022","","Recurring Withdrawal Debit Card MC Debit/JASPER.AI ROLLINGWOOD TXDate 10/16/22 0 2289052781 1 7399Card 2801","59","","Posted","551.45"
"10/17/2022","","Withdrawal POS #000000603486/SUNOCO 8002212501 4234 SW 20TH AVEGAINESVILLE FLCard 2801","29.93","","Posted","610.45"
"10/17/2022","","Withdrawal ACH TARGET CARD SRVC/TYPE: BILL PAY ID: T510215170CO: TARGET CARD SRVCNAME: 7S CH0000000APLINSKI TEntry Class Code: WEB","250","","Posted","640.38"
"10/17/2022","","Withdrawal ACH PAYPAL/TYPE: INST XFER ID: PAYPALSI77CO: PAYPAL NAME: STEVEN CHAPLINSKIEntry Class Code: WEB","149.35","","Posted","890.38"
"10/17/2022","","Withdrawal ACH PAYPAL/TYPE: INST XFER ID: PAYPALSI77CO: PAYPAL NAME: STEVEN CHAPLINSKIEntry Class Code: WEB","74.87","","Posted","1039.73"
"10/17/2022","","Withdrawal ACH PAYPAL/TYPE: INST XFER ID: PAYPALSI77CO: PAYPAL NAME: STEVEN CHAPLINSKIEntry Class Code: WEB","74.67","","Posted","1114.6"
"10/17/2022","","Withdrawal ACH PAYPAL/TYPE: INST XFER ID: PAYPALSI77CO: PAYPAL NAME: STEVEN CHAPLINSKIEntry Class Code: WEB","37.44","","Posted","1189.27"
"10/17/2022","","Withdrawal ACH PAYPAL/TYPE: INST XFER ID: PAYPALSI77CO: PAYPAL NAME: STEVEN CHAPLINSKIEntry Class Code: WEB","24.95","","Posted","1226.71"
"10/17/2022","","Withdrawal ACH PAYPAL/TYPE: INST XFER ID: PAYPALSI77CO: PAYPAL NAME: STEVEN CHAPLINSKIEntry Class Code: WEB","8.99","","Posted","1251.66"
"10/16/2022","","Deposit POS #000010881115/PAYPAL*CHAPLINSKI ST San Jose CACard 2801","","88.42","Posted","1260.65"
"10/14/2022","","Withdrawal Debit Card Fee/MASTERCARD ISSUER CROSS-BORDER FEEDate 10/13/22 0 2286863628 0 5045Card 2801","0.12","","Posted","1172.23"
"10/14/2022","","Withdrawal Debit Card MC Debit/BZFUTURE HONG KONG HKDate 10/13/22 0 2286863628 0 5045Card 2801","15.48","","Posted","1172.35"
"10/14/2022","","Withdrawal Debit Card MC Debit/PUBLIX #680 GAINESVILLE FLDate 10/13/22 0 2286695837 0 5411Card 2801","119.02","","Posted","1187.83"
"10/14/2022","","Recurring Withdrawal Debit Card MC Debit/PLAYERAUCTIONS 800-342-0768 DEDate 10/13/22 0 2286345901 0 7993Card 2801","80.42","","Posted","1306.85"
"10/14/2022","","Withdrawal ACH CANVA PTY LIMITE/CO: CANVA PTY LIMITEDTYPE: IAT PAYPAL ID: 770510487CEntry Class Code: IAT","12.99","","Posted","1387.27"
"10/14/2022","","Withdrawal ACH AMADORU GALAPPAT/CO: AMADORU GALAPPATHTHIGE RADIKA SAJEETYPE: IAT PAYPAL ID: 770510487CEntry Class Code: IAT","10","","Posted","1400.26"
"10/13/2022","","Deposit Home Banking Transfer - From Share 0000/Funds Transfer via Mobile","","800","Posted","1410.26"
"10/13/2022","","Recurring Withdrawal Debit Card MC Debit/PLAYERAUCTIONS 800-342-0768 DEDate 10/12/22 0 2285395918 0 7993Card 2801","61.85","","Posted","610.26"
"10/13/2022","","Withdrawal POS #000096291737/FAST TRACK #200 GAINESVILLE FLCard 2801","19.46","","Posted","672.11"
"10/12/2022","","Withdrawal POS #000000000006/AMAZON.COM*HT07Z9FA1 SEATTLE WACard 2801","19.06","","Posted","691.57"
"10/12/2022","","Recurring Withdrawal Debit Card Fee/MASTERCARD ISSUER CROSS-BORDER FEEDate 10/11/22 0 2284797441 0 5734Card 2801","0.05","","Posted","710.63"
"10/12/2022","","Recurring Withdrawal Debit Card MC Debit/PAYPAL *LINKTREEPTY 4029357733 AUDate 10/11/22 0 2284797441 0 5734Card 2801","6","","Posted","710.68"
"10/11/2022","","Withdrawal ACH ENVATO/CO: ENVATOTYPE: IAT PAYPAL ID: 770510487CEntry Class Code: IAT","39","","Posted","716.68"
"10/11/2022","","Withdrawal ACH BRAINLY/CO: BRAINLYTYPE: IAT PAYPAL ID: 770510487CEntry Class Code: IAT","10","","Posted","755.68"
"10/11/2022","","Withdrawal ACH FLUENT-Gainesvil/TYPE: PAYMENT ID: 1371804719CO: FLUENT-GainesvilEntry Class Code: PPD","198.09","","Posted","765.68"
"10/11/2022","","Withdrawal ACH TARGET CARD SRVC/TYPE: BILL PAY ID: T510215170CO: TARGET CARD SRVCNAME: 7S CH0000000APLINSKI TEntry Class Code: WEB","90.2","","Posted","963.77"
"10/11/2022","","Withdrawal ACH PAYPAL/TYPE: INST XFER ID: PAYPALSI77CO: PAYPAL NAME: STEVEN CHAPLINSKIEntry Class Code: WEB","37.44","","Posted","1053.97"
"10/11/2022","","Withdrawal ACH PAYPAL/TYPE: INST XFER ID: PAYPALSI77CO: PAYPAL NAME: STEVEN CHAPLINSKIEntry Class Code: WEB","9.99","","Posted","1091.41"
"10/11/2022","","Withdrawal ACH PAYPAL/TYPE: INST XFER ID: PAYPALSI77CO: PAYPAL NAME: STEVEN CHAPLINSKIEntry Class Code: WEB","2","","Posted","1101.4"
"10/11/2022","","Withdrawal POS #000000086984/AMAZON.COM*1K9XT1911 SEATTLE WACard 2801","8.63","","Posted","1103.4"
"10/9/2022","","Withdrawal Debit Card MC Debit/PMT*FL LICENSE/TAG/ASM GAINESVILLE FLDate 10/06/22 0 2279613925 1 9399Card 2801","56.75","","Posted","1112.03"
"10/8/2022","","Withdrawal POS #000006205356/PAYPAL *VIDIQ 2211 North First StreetJose CACard 2801","10","","Posted","1168.78"
"10/8/2022","","Withdrawal POS #000000848934/AMAZON.COM*1K1J94VV0 SEATTLE WACard 2801","10.31","","Posted","1178.78"
"10/8/2022","","Withdrawal POS #000000000054/AMAZON.COM*1K97X11G1 SEATTLE WACard 2801","26.04","","Posted","1189.09"
"10/7/2022","","Withdrawal POS #000000156168/WAWA 5325 2373 SW ARCHER ROADFLCard 2801","34.27","","Posted","1215.13"
"10/7/2022","","Withdrawal Debit Card MC Debit/CANNAMD 855-4209170 FLDate 10/06/22 0 2279964864 0 8011Card 2801","195","","Posted","1249.4"
"10/7/2022","","Withdrawal Debit Card MC Debit/PUBLIX #680 GAINESVILLE FLDate 10/06/22 0 2279091717 1 5411Card 2801","122.46","","Posted","1444.4"
"10/7/2022","","Recurring Withdrawal Debit Card MC Debit/NETFLIX.COM CADate 10/06/22 0 2279815139 0 4899Card 2801","10.98","","Posted","1566.86"
"10/7/2022","","Withdrawal ACH PADDLE.COM MARKE/CO: PADDLE.COM MARKET LIMITEDTYPE: IAT PAYPAL ID: 770510487CEntry Class Code: IAT","29.99","","Posted","1577.84"
"10/7/2022","","Deposit Home Banking Transfer food/From CHAPLINSKI,LEON 3496297 Share 0090","","112","Posted","1607.83"
"10/7/2022","","Withdrawal ACH PAYPAL/TYPE: INST XFER ID: PAYPALSI77CO: PAYPAL NAME: STEVEN CHAPLINSKIEntry Class Code: WEB","74.67","","Posted","1495.83"
"10/6/2022","","Withdrawal POS #000000000235/CIRCLE K # 23913 3424 GAINESVILLE FLCard 2801","19.34","","Posted","1570.5"
"10/6/2022","","Deposit ATM Transaction","","18","Posted","1589.84"
"10/6/2022","","Withdrawal ACH PAYPAL/TYPE: INST XFER ID: PAYPALSI77CO: PAYPAL NAME: STEVEN CHAPLINSKIEntry Class Code: WEB","5.66","","Posted","1571.84"
"10/5/2022","","Recurring Withdrawal Debit Card MC Debit/WWW.CLEANDRIVE.APP SEATTLE WADate 10/04/22 0 2277349400 0 5734Card 2801","7.8","","Posted","1577.5"
"10/5/2022","","Recurring Withdrawal Debit Card MC Debit/WWW.CLEANDRIVE.APP SEATTLE WADate 10/04/22 0 2277808522 0 5734Card 2801","1.58","","Posted","1585.3"
"10/5/2022","","Withdrawal ACH ENVATO/CO: ENVATOTYPE: IAT PAYPAL ID: 770510487CEntry Class Code: IAT","23","","Posted","1586.88"
"10/4/2022","","Deposit ACH 913514137/TYPE: REVERSAL ID: 2510407970CO: BARCLAYCARD US NAME: 913514137Entry Class Code: WEB","","249.42","Posted","1609.88"
"10/4/2022","","Withdrawal Debit Card MC Debit/GRU/EZ-PAY WEB PYMT 352-334-3434 FLDate 10/03/22 0 2276349419 0 4900Card 2801","213.12","","Posted","1360.46"
"10/4/2022","","Withdrawal ACH BARCLAYCARD US/TYPE: CREDITCARD ID: 2510407970CO: BARCLAYCARD USNAME: STEVEN CHAPLINSKIEntry Class Code: WEB","249.42","","Posted","1573.58"
"10/4/2022","","Withdrawal ACH PAYPAL/TYPE: INST XFER ID: PAYPALSI77CO: PAYPAL NAME: STEVEN CHAPLINSKIEntry Class Code: WEB","33.87","","Posted","1823"
"10/4/2022","","Withdrawal ACH PAYPAL/TYPE: INST XFER ID: PAYPALSI77CO: PAYPAL NAME: STEVEN CHAPLINSKIEntry Class Code: WEB","14.99","","Posted","1856.87"
"10/4/2022","","Withdrawal ACH PAYPAL/TYPE: INST XFER ID: PAYPALSI77CO: PAYPAL NAME: STEVEN CHAPLINSKIEntry Class Code: WEB","5.35","","Posted","1871.86"
"10/4/2022","","Withdrawal ACH PAYPAL/TYPE: INST XFER ID: PAYPALSI77CO: PAYPAL NAME: STEVEN CHAPLINSKIEntry Class Code: WEB","3.06","","Posted","1877.21"
"10/4/2022","","Withdrawal ACH PAYPAL/TYPE: INST XFER ID: PAYPALSI77CO: PAYPAL NAME: STEVEN CHAPLINSKIEntry Class Code: WEB","2.99","","Posted","1880.27"
"10/3/2022","","Withdrawal POS #000096293292/FAST TRACK #200 GAINESVILLE FLCard 2801","19.46","","Posted","1883.26"
"10/3/2022","","Withdrawal ACH BEST BUY/TYPE: PAYMENT ID: CITIGPUFDRCO: BEST BUYEntry Class Code: PPD","577","","Posted","1902.72"
"10/3/2022","","Withdrawal ACH CAPITAL ONE/TYPE: ONLINE PMT ID: 9279744391CO: CAPITAL ONE NAME: STEVEN CHAPLINSKIEntry Class Code: WEB","37","","Posted","2479.72"
"10/3/2022","","Withdrawal ACH Watson Realty Co/TYPE: WEB PMTS ID: 9000321157CO: Watson Realty CoNAME: Steven chaplinskiEntry Class Code: WEB","995","","Posted","2516.72"
"10/3/2022","","Withdrawal ACH BARCLAYCARD US/TYPE: CREDITCARD ID: 2510407970CO: BARCLAYCARD USNAME: STEVEN CHAPLINSKIEntry Class Code: WEB","249.42","","Posted","3511.72"
"10/3/2022","","Withdrawal ACH BEST BUY/TYPE: PAYMENT ID: CITIGPUFDRCO: BEST BUYEntry Class Code: PPD","58","","Posted","3761.14"
"10/3/2022","","Withdrawal ACH PAYMENT FOR AMZ/TYPE: STORECARD ID: 9069872103CO: PAYMENT FOR AMZNAME: 6045781157416487Entry Class Code: WEB","50","","Posted","3819.14"
"10/3/2022","","Withdrawal ACH PAYPAL/TYPE: INST XFER ID: PAYPALSI77CO: PAYPAL NAME: STEVEN CHAPLINSKIEntry Class Code: WEB","19.95","","Posted","3869.14"
"10/3/2022","","Withdrawal ACH PAYPAL/TYPE: INST XFER ID: PAYPALSI77CO: PAYPAL NAME: STEVEN CHAPLINSKIEntry Class Code: WEB","11.48","","Posted","3889.09"
"10/2/2022","","Withdrawal Debit Card MC Debit/COX GAINESVILLE COMM 800-234-3993 FLDate 10/01/22 0 2274819048 0 4899Card 2801","117.89","","Posted","3900.57"
"10/2/2022","","Recurring Withdrawal Debit Card MC Debit/CHEGG ORDER 8558681054 CADate 09/30/22 0 2273714063 1 5942Card 2801","15.95","","Posted","4018.46"
"10/1/2022","","Withdrawal POS #000000407993/SUNOCO 8002212501 4234 SW 20TH AVEGAINESVILLE FLCard 2801","13.89","","Posted","4034.41"
"9/29/2022","","Recurring Withdrawal Debit Card MC Debit/ADOBE CREATIVE CLOUD 4085366000 CADate 09/28/22 0 2271807482 0 5734Card 2801","19.99","","Posted","4048.3"
"9/29/2022","","Deposit Home Banking Transfer trf/From CHAPLINSKI,LEON 3496297 Share 0090","","2500","Posted","4068.29"
"9/29/2022","","Withdrawal ACH FLUENT-Gainesvil/TYPE: PAYMENT ID: 1371804719CO: FLUENT-GainesvilEntry Class Code: PPD","75.5","","Posted","1568.29"
"9/29/2022","","Withdrawal ACH PAYPAL/TYPE: INST XFER ID: PAYPALSI77CO: PAYPAL NAME: STEVEN CHAPLINSKIEntry Class Code: WEB","2.99","","Posted","1643.79"
"9/28/2022","","Recurring Withdrawal Debit Card MC Debit/WWW.CLEANDRIVE.APP SEATTLE WADate 09/28/22 0 2271104160 1 5734Card 2801","7.99","","Posted","1646.78"
"9/28/2022","","Withdrawal Debit Card MC Debit/PUBLIX #1038 GAINESVILLE FLDate 09/27/22 0 2270102412 1 5411Card 2801","73.35","","Posted","1654.77"
"9/28/2022","","Withdrawal ACH PAYPAL/TYPE: INST XFER ID: PAYPALSI77CO: PAYPAL NAME: STEVEN CHAPLINSKIEntry Class Code: WEB","14.99","","Posted","1728.12"
"9/28/2022","","Withdrawal POS #000000019465/AMAZON.COM*1U6B04IO0 SEATTLE WACard 2801","66.74","","Posted","1743.11"
"9/27/2022","","Withdrawal POS #000093423756/BP#8996613SUNRI GAINESVILLE FLCard 2801","23.72","","Posted","1809.85"
"9/27/2022","","Withdrawal POS #000000888946/AMAZON.COM*1U4ZR78L2 SEATTLE WACard 2801","8.63","","Posted","1833.57"
"9/27/2022","","Withdrawal ACH PAYPAL/TYPE: INST XFER ID: PAYPALSI77CO: PAYPAL NAME: STEVEN CHAPLINSKIEntry Class Code: WEB","2.99","","Posted","1842.2"
"9/26/2022","","Recurring Withdrawal Debit Card MC Debit/JASPER.AI AUSTIN TXDate 09/25/22 0 2268000612 1 7399Card 2801","21.16","","Posted","1845.19"
"9/26/2022","","Withdrawal ACH BEST BUY/TYPE: PAYMENT ID: CITIGPUFDRCO: BEST BUYEntry Class Code: PPD","150","","Posted","1866.35"
"9/26/2022","","Withdrawal ACH APPLECARD GSBANK/TYPE: PAYMENT ID: 9999999999CO: APPLECARD GSBANKNAME: Steven ChaplinskiEntry Class Code: WEB","100","","Posted","2016.35"
"9/26/2022","","Withdrawal ACH CAPITAL ONE/TYPE: ONLINE PMT ID: 9279744991CO: CAPITAL ONE NAME: STEVEN CHAPLINSKIEntry Class Code: WEB","75","","Posted","2116.35"
"9/26/2022","","Withdrawal ACH TARGET CARD SRVC/TYPE: BILL PAY ID: 5411721813CO: TARGET CARD SRVCNAME: S CHAPLINSKI TEntry Class Code: WEB","354","","Posted","2191.35"
"9/26/2022","","Withdrawal ACH BEST BUY/TYPE: PAYMENT ID: CITIGPUFDRCO: BEST BUYEntry Class Code: PPD","346.97","","Posted","2545.35"
"9/26/2022","","Withdrawal ACH DISCOVER/TYPE: E-PAYMENT ID: 2510020270CO: DISCOVER NAME: CHAPLINSKI STEVENEntry Class Code: WEB","191.91","","Posted","2892.32"
"9/26/2022","","Withdrawal ACH PAYMENT FOR AMZ/TYPE: STORECARD ID: 9069872103CO: PAYMENT FOR AMZNAME: 6045781157416487Entry Class Code: WEB","175","","Posted","3084.23"
"9/26/2022","","Withdrawal ACH PAYPAL/TYPE: INST XFER ID: PAYPALSI77CO: PAYPAL NAME: STEVEN CHAPLINSKIEntry Class Code: WEB","149.99","","Posted","3259.23"
"9/26/2022","","Withdrawal ACH WAWA CREDIT CARD/TYPE: ONLINE PMT ID: CITICTPCO: WAWA CREDIT CARDNAME: STEVEN CHAPLINSKIEntry Class Code: WEB","143.83","","Posted","3409.22"
"9/26/2022","","Withdrawal ACH BARCLAYCARD US/TYPE: CREDITCARD ID: 2510407970CO: BARCLAYCARD USNAME: STEVEN CHAPLINSKIEntry Class Code: WEB","128.36","","Posted","3553.05"
"9/26/2022","","Withdrawal ACH PAYPAL/TYPE: INST XFER ID: PAYPALSI77CO: PAYPAL NAME: STEVEN CHAPLINSKIEntry Class Code: WEB","99.99","","Posted","3681.41"
"9/26/2022","","Withdrawal ACH AMZ_STORECRD_PMT/TYPE: PAYMENT ID: 9069872000CO: AMZ_STORECRD_PMTNAME: 6045781157416487Entry Class Code: WEB","32","","Posted","3781.4"
"9/26/2022","","Withdrawal ACH PAYPAL/TYPE: INST XFER ID: PAYPALSI77CO: PAYPAL NAME: STEVEN CHAPLINSKIEntry Class Code: WEB","4.5","","Posted","3813.4"
"9/25/2022","","Withdrawal Debit Card MC Debit/WALGREENS #5024 800-289-2273 FLDate 09/23/22 0 2266343180 2 5912Card 2801","83.07","","Posted","3817.9"
"9/25/2022","","Withdrawal POS #000000041929/SUNOCO 8002212501 4234 SW 20TH AVEGAINESVILLE FLCard 2801","30.24","","Posted","3900.97"
"9/23/2022","","Deposit Home Banking Transfer - From Share 0000/Funds Transfer via Online","","2000","Posted","3931.21"
"9/23/2022","","Deposit Home Banking Transfer trf/From CHAPLINSKI,LEON 3496297 Share 0090","","100","Posted","1931.21"
"9/23/2022","","Withdrawal Debit Card MC Debit/PUBLIX #680 GAINESVILLE FLDate 09/22/22 0 2265055591 1 5411Card 2801","43.48","","Posted","1831.21"
"9/22/2022","","Withdrawal POS #000000352639/SUNOCO 8002212501 4234 SW 20TH AVEGAINESVILLE FLCard 2801","24.89","","Posted","1874.69"
"9/20/2022","","Withdrawal ACH PAYPAL/TYPE: INST XFER ID: PAYPALSI77CO: PAYPAL NAME: STEVEN CHAPLINSKIEntry Class Code: WEB","2.29","","Posted","1899.58"
"9/20/2022","","Withdrawal POS #000003041632/GOOGLE *YouTubePremium 1600 AmphitheatreParkw Mountain View CACard 2801","13.62","","Posted","1901.87"
"9/19/2022","","Withdrawal ACH DISCOVER/TYPE: E-PAYMENT ID: 2510020270CO: DISCOVER NAME: CHAPLINSKI STEVENEntry Class Code: WEB","250","","Posted","1915.49"
"9/19/2022","","Withdrawal ACH PAYPAL/TYPE: INST XFER ID: PAYPALSI77CO: PAYPAL NAME: STEVEN CHAPLINSKIEntry Class Code: WEB","24.95","","Posted","2165.49"
"9/18/2022","","Withdrawal Debit Card MC Debit/WELLSAID LABS SEATTLE WADate 09/16/22 0 2259782243 1 5734Card 2801","49","","Posted","2190.44"
"9/18/2022","","Recurring Withdrawal Debit Card MC Debit/JASPER.AI AUSTIN TXDate 09/16/22 0 2259933032 1 7399Card 2801","29","","Posted","2239.44"
"9/18/2022","","Recurring Withdrawal Debit Card MC Debit/PLAYERAUCTIONS 800-342-0768 DEDate 09/17/22 0 2260857045 0 7993Card 2801","66.25","","Posted","2268.44"
"9/18/2022","","Withdrawal Debit Card MC Debit/WALGREENS #5024 800-289-2273 FLDate 09/17/22 0 2260124597 1 5912Card 2801","7.49","","Posted","2334.69"
"9/17/2022","","Withdrawal POS #000000000323/CIRCLE K # 26146 3525 GAINESVILLE FLCard 2801","29.05","","Posted","2342.18"
"9/17/2022","","Withdrawal ATM Fee/EFT 6419 W Newberry Rd Gainesville FLCard 2801","2","","Posted","2371.23"
"9/17/2022","","Withdrawal at ATM #000000000077/EFT 6419 W Newberry Rd Gainesville FLCard 2801","73","","Posted","2373.23"
"9/16/2022","","Withdrawal POS #000000550998/SUNOCO 8002212501 4234 SW 20TH AVEGAINESVILLE FLCard 2801","30.24","","Posted","2446.23"
"9/14/2022","","Recurring Withdrawal Debit Card MC Debit/EIG*BLUEHOST.COM 888-4014678 UTDate 09/13/22 0 2256946058 0 5968Card 2801","19.99","","Posted","2476.47"
"9/14/2022","","Withdrawal ACH APPLECARD GSBANK/TYPE: PAYMENT ID: 9999999999CO: APPLECARD GSBANKNAME: Steven ChaplinskiEntry Class Code: WEB","174","","Posted","2496.46"
"9/14/2022","","Withdrawal ACH CANVA PTY LIMITE/CO: CANVA PTY LIMITEDTYPE: IAT PAYPAL ID: 770510487CEntry Class Code: IAT","12.99","","Posted","2670.46"
"9/14/2022","","Withdrawal ACH BARCLAYCARD US/TYPE: CREDITCARD ID: 2510407970CO: BARCLAYCARD USNAME: STEVEN CHAPLINSKIEntry Class Code: WEB","250","","Posted","2683.45"
"9/13/2022","","Deposit Home Banking Transfer - From Share 0000/Funds Transfer via Online","","2500","Posted","2933.45"
"9/13/2022","","Recurring Withdrawal Debit Card MC Debit/EIG*BLUEHOST.COM 888-4014678 UTDate 09/12/22 0 2255927552 0 5968Card 2801","119.88","","Posted","433.45"
"9/13/2022","","Withdrawal ACH PAYPAL/TYPE: INST XFER ID: PAYPALSI77CO: PAYPAL NAME: STEVEN CHAPLINSKIEntry Class Code: WEB","73.82","","Posted","553.33"
"9/13/2022","","Withdrawal ACH PAYPAL/TYPE: INST XFER ID: PAYPALSI77CO: PAYPAL NAME: STEVEN CHAPLINSKIEntry Class Code: WEB","43.83","","Posted","627.15"
"9/13/2022","","Withdrawal ACH PAYMENT FOR AMZ/TYPE: STORECARD ID: 9069872103CO: PAYMENT FOR AMZNAME: 6045781157416487Entry Class Code: WEB","5","","Posted","670.98"
"9/12/2022","","Deposit Home Banking Transfer - From Share 0000/Funds Transfer via Online","","600","Posted","675.98"
"9/12/2022","","Withdrawal POS #000000626675/AMAZON.COM*1F8259P12 SEATTLE WACard 2801","8.63","","Posted","75.98"
"9/12/2022","","Withdrawal POS #000000000008/AMAZON.COM*1F9PJ82A0 SEATTLE WACard 2801","29.26","","Posted","84.61"
"9/12/2022","","Withdrawal Transfer fee","8","","Posted","113.87"
"9/12/2022","","Deposit Transfer From Share 0000","","100","Posted","121.87"
"9/12/2022","","Withdrawal POS #000000346729/SUNOCO 8002212501 4234 SW 20TH AVEGAINESVILLE FLCard 2801","28.09","","Posted","21.87"
"9/12/2022","","Recurring Withdrawal Debit Card Fee/MASTERCARD ISSUER CROSS-BORDER FEEDate 09/11/22 0 2254978797 0 5734Card 2801","0.05","","Posted","49.96"
"9/12/2022","","Recurring Withdrawal Debit Card MC Debit/PAYPAL *LINKTREEPTY 4029357733 AUDate 09/11/22 0 2254978797 0 5734Card 2801","6","","Posted","50.01"
"9/12/2022","","Withdrawal ACH ENVATO/CO: ENVATOTYPE: IAT PAYPAL ID: 770510487CEntry Class Code: IAT","39","","Posted","56.01"
"9/12/2022","","Withdrawal ACH PAYPAL/TYPE: INST XFER ID: PAYPALSI77CO: PAYPAL NAME: STEVEN CHAPLINSKIEntry Class Code: WEB","39.99","","Posted","95.01"
"9/12/2022","","Withdrawal ACH PAYPAL/TYPE: INST XFER ID: PAYPALSI77CO: PAYPAL NAME: STEVEN CHAPLINSKIEntry Class Code: WEB","9.99","","Posted","135"
"9/11/2022","","Withdrawal Debit Card MC Debit/PUBLIX #680 GAINESVILLE FLDate 09/10/22 0 2253492453 1 5411Card 2801","47.34","","Posted","144.99"
"9/11/2022","","Recurring Withdrawal Debit Card MC Debit/PLAYERAUCTIONS 800-342-0768 DEDate 09/10/22 0 2253689154 2 7993Card 2801","45.93","","Posted","192.33"
"9/10/2022","","Withdrawal ATM Fee/EFT 3401 W University Ave Gainesville FLCard 2801","2","","Posted","238.26"
"9/10/2022","","Withdrawal at ATM #000000000054/EFT 3401 W University Ave Gainesville FLCard 2801","78","","Posted","240.26"
"9/10/2022","","Withdrawal POS #000096292296/FAST TRACK #200 GAINESVILLE FLCard 2801","22.66","","Posted","318.26"
"9/8/2022","","Withdrawal ACH PAYPAL/TYPE: INST XFER ID: PAYPALSI77CO: PAYPAL NAME: STEVEN CHAPLINSKIEntry Class Code: WEB","39.99","","Posted","340.92"
"9/8/2022","","Withdrawal ACH PAYPAL/TYPE: INST XFER ID: PAYPALSI77CO: PAYPAL NAME: STEVEN CHAPLINSKIEntry Class Code: WEB","39.99","","Posted","380.91"
"9/8/2022","","Withdrawal POS #000006032550/PAYPAL *VIDIQ 2211 North First StreetJose CACard 2801","10","","Posted","420.9"
"9/7/2022","","Withdrawal POS #000000966379/WAWA 5325 2373 SW ARCHER ROADFLCard 2801","37.37","","Posted","430.9"
"9/6/2022","","Withdrawal POS #000000464658/SUNOCO 8002212501 4234 SW 20TH AVEGAINESVILLE FLCard 2801","28.09","","Posted","468.27"
"9/6/2022","","Deposit Home Banking Transfer - From Share 0000/Funds Transfer via Online","","145","Posted","496.36"
"9/6/2022","","Withdrawal Debit Card MC Debit/PARCHMENT-UNIV DOCS 480-719-1646 AZDate 09/05/22 0 2248770013 0 7372Card 2801","9","","Posted","351.36"
"9/6/2022","","Withdrawal Debit Card MC Debit/GRU/EZ-PAY WEB PYMT 352-334-3434 FLDate 09/05/22 0 2248310426 0 4900Card 2801","242.33","","Posted","360.36"
"9/6/2022","","Recurring Withdrawal Bill Payment - #000000223090/NETFLIX COM LOS GATOS CACard 2801","10.98","","Posted","602.69"
"9/6/2022","","Withdrawal ACH DISCOVER/TYPE: E-PAYMENT ID: 2510020270CO: DISCOVER NAME: CHAPLINSKI STEVENEntry Class Code: WEB","55","","Posted","613.67"
"9/6/2022","","Withdrawal ACH PAYPAL/TYPE: INST XFER ID: PAYPALSI77CO: PAYPAL NAME: STEVEN CHAPLINSKIEntry Class Code: WEB","39.99","","Posted","668.67"
"9/6/2022","","Withdrawal ACH PAYPAL/TYPE: INST XFER ID: PAYPALSI77CO: PAYPAL NAME: STEVEN CHAPLINSKIEntry Class Code: WEB","19.95","","Posted","708.66"
"9/6/2022","","Withdrawal ACH PAYPAL/TYPE: INST XFER ID: PAYPALSI77CO: PAYPAL NAME: STEVEN CHAPLINSKIEntry Class Code: WEB","14.99","","Posted","728.61"
"9/6/2022","","Withdrawal ACH PAYPAL/TYPE: INST XFER ID: PAYPALSI77CO: PAYPAL NAME: STEVEN CHAPLINSKIEntry Class Code: WEB","5.66","","Posted","743.6"
"9/6/2022","","Withdrawal ACH PAYPAL/TYPE: INST XFER ID: PAYPALSI77CO: PAYPAL NAME: STEVEN CHAPLINSKIEntry Class Code: WEB","2.99","","Posted","749.26"
"9/5/2022","","Withdrawal Debit Card MC Debit/PUBLIX #680 GAINESVILLE FLDate 09/04/22 0 2247925737 0 5411Card 2801","39.14","","Posted","752.25"
"9/4/2022","","Withdrawal ATM Fee/EFT 3401 W University Ave Gainesville FLCard 2801","2","","Posted","791.39"
"9/4/2022","","Withdrawal at ATM #000000000111/EFT 3401 W University Ave Gainesville FLCard 2801","83","","Posted","793.39"
"9/4/2022","","Recurring Withdrawal Debit Card MC Debit/PLAYERAUCTIONS 800-342-0768 DEDate 09/03/22 0 2246441191 0 7993Card 2801","45.51","","Posted","876.39"
"9/4/2022","","Withdrawal Debit Card MC Debit/COX GAINESVILLE COMM 800-234-3993 FLDate 09/03/22 0 2246615886 0 4899Card 2801","117.89","","Posted","921.9"
"9/3/2022","","Withdrawal POS #000000292954/SUNOCO 8002212501 4234 SW 20TH AVEGAINESVILLE FLCard 2801","30.24","","Posted","1039.79"
"9/2/2022","","Withdrawal ACH Watson Realty Co/TYPE: WEB PMTS ID: 9000321157CO: Watson Realty CoNAME: Steven chaplinskiEntry Class Code: WEB","995","","Posted","1070.03"
"9/2/2022","","Withdrawal ACH PAYPAL/TYPE: INST XFER ID: PAYPALSI77CO: PAYPAL NAME: STEVEN CHAPLINSKIEntry Class Code: WEB","39.99","","Posted","2065.03"
"9/2/2022","","Withdrawal ACH PAYPAL/TYPE: INST XFER ID: PAYPALSI77CO: PAYPAL NAME: STEVEN CHAPLINSKIEntry Class Code: WEB","11.48","","Posted","2105.02"
"9/2/2022","","Withdrawal POS #000000027265/AMAZON.COM*1V1FM9EV0 SEATTLE WACard 2801","32.07","","Posted","2116.5"
"9/1/2022","","Withdrawal Debit Card MC Debit/PUBLIX #435 GAINESVILLE FLDate 08/31/22 0 2243083753 1 5411Card 2801","19.27","","Posted","2148.57"
"9/1/2022","","Withdrawal Debit Card MC Debit/CHEGG ORDER 8558681054 CADate 09/01/22 0 2244077661 1 5942Card 2801","15.95","","Posted","2167.84"
"9/1/2022","","Withdrawal ACH PAYPAL/TYPE: INST XFER ID: PAYPALSI77CO: PAYPAL NAME: STEVEN CHAPLINSKIEntry Class Code: WEB","39.99","","Posted","2183.79"
"9/1/2022","","Deposit Home Banking Transfer trf/From CHAPLINSKI,LEON 3496297 Share 0090","","2000","Posted","2223.78"
"8/31/2022","","Withdrawal POS #000000000388/CIRCLE K # 26146 3525 GAINESVILLE FLCard 2801","19.45","","Posted","223.78"
"8/31/2022","","Withdrawal ATM Fee/EFT 3401 W University Ave Gainesville FLCard 2801","2","","Posted","243.23"
"8/31/2022","","Withdrawal at ATM #000000000065/EFT 3401 W University Ave Gainesville FLCard 2801","33","","Posted","245.23"
"8/31/2022","","Withdrawal/Cash Disbursed 35.00","35","","Posted","278.23"
"8/31/2022","","Withdrawal ACH DISCOVER/TYPE: E-PAYMENT ID: 2510020270CO: DISCOVER NAME: CHAPLINSKI STEVENEntry Class Code: WEB","33","","Posted","313.23"
"8/31/2022","","Withdrawal POS #000000960895/AMAZON.COM*NZ8UC5PW3 SEATTLE WACard 2801","16.68","","Posted","346.23"
"8/30/2022","","Withdrawal ACH PAYPAL/TYPE: INST XFER ID: PAYPALSI77CO: PAYPAL NAME: STEVEN CHAPLINSKIEntry Class Code: WEB","39.99","","Posted","362.91"
"8/30/2022","","Withdrawal POS #000000630901/AMAZON.COM*ZA2053S23 SEATTLE WACard 2801","10.15","","Posted","402.9"
"8/30/2022","","Withdrawal POS #000000000021/CIRCLE K # 26146 3525 GAINESVILLE FLCard 2801","25.85","","Posted","413.05"
"8/30/2022","","Withdrawal ATM Fee/EFT 3401 W University Ave Gainesville FLCard 2801","2","","Posted","438.9"
"8/30/2022","","Withdrawal at ATM #000000000050/EFT 3401 W University Ave Gainesville FLCard 2801","63","","Posted","440.9"
"8/29/2022","","Deposit Home Banking Transfer trf/From CHAPLINSKI,LEON 3496297 Share 0090","","500","Posted","503.9"
"8/29/2022","","Recurring Withdrawal Debit Card MC Debit/ADOBE CREATIVE CLOUD 4085366000 CADate 08/28/22 0 2240015432 1 5734Card 2801","19.99","","Posted","3.9"
"8/29/2022","","Withdrawal ACH PAYPAL/TYPE: INST XFER ID: PAYPALSI77CO: PAYPAL NAME: STEVEN CHAPLINSKIEntry Class Code: WEB","14.99","","Posted","23.89"
"8/29/2022","","Withdrawal ACH PAYPAL/TYPE: INST XFER ID: PAYPALSI77CO: PAYPAL NAME: STEVEN CHAPLINSKIEntry Class Code: WEB","2.99","","Posted","38.88"
"8/29/2022","","Withdrawal ACH PAYPAL/TYPE: INST XFER ID: PAYPALSI77CO: PAYPAL NAME: STEVEN CHAPLINSKIEntry Class Code: WEB","2.99","","Posted","41.87"
"8/29/2022","","Withdrawal POS #000088529500/FAST TRACK #200 3960 SW ARCHER RDGAINESVILLE FLCard 2801","9.88","","Posted","44.86"
"8/28/2022","","Withdrawal Debit Card MC Debit/WALGREENS #5024 800-289-2273 FLDate 08/26/22 0 2238277635 2 5912Card 2801","15","","Posted","54.74"
"8/26/2022","","Withdrawal POS #000000789325/SUNOCO 8002212501 4234 SW 20TH AVEGAINESVILLE FLCard 2801","22.74","","Posted","69.74"
"8/26/2022","","Withdrawal ACH PAYPAL/TYPE: INST XFER ID: PAYPALSI77CO: PAYPAL NAME: STEVEN CHAPLINSKIEntry Class Code: WEB","4.5","","Posted","92.48"
"8/25/2022","","Withdrawal Debit Card MC Debit/PUBLIX #680 GAINESVILLE FLDate 08/24/22 0 2236025671 1 5411Card 2801","40.29","","Posted","96.98"
"8/25/2022","","Withdrawal Debit Card MC Debit/DOCTORS RADIOLOGY GROU 352-3319729 FLDate 08/24/22 0 2236023780 1 8011Card 2801","184.7","","Posted","137.27"
"8/25/2022","","Withdrawal Debit Card MC Debit/BESTBUYCOM806672104504 888BESTBUY MNDate 08/24/22 0 2236332547 0 5732Card 2801","26.73","","Posted","321.97"
"8/25/2022","","Withdrawal ACH SABRINA AZAMBUJA/CO: SABRINA AZAMBUJATYPE: IAT PAYPAL ID: 770510487CEntry Class Code: IAT","22","","Posted","348.7"
"8/24/2022","","Withdrawal ATM Fee/EFT 6419 W Newberry Rd Gainesville FLCard 2801","2","","Posted","370.7"
"8/24/2022","","Withdrawal at ATM #000000000781/EFT 6419 W Newberry Rd Gainesville FLCard 2801","83","","Posted","372.7"
"8/24/2022","","Deposit Home Banking Transfer trf/From CHAPLINSKI,LEON 3496297 Share 0090","","400","Posted","455.7"
"8/24/2022","","Withdrawal ACH DISCOVER/TYPE: E-PAYMENT ID: 2510020270CO: DISCOVER NAME: CHAPLINSKI STEVENEntry Class Code: WEB","15","","Posted","55.7"
"8/24/2022","","Withdrawal POS #000096291462/FAST TRACK #200 GAINESVILLE FLCard 2801","27.48","","Posted","70.7"
"8/23/2022","","Withdrawal POS #000000642926/SUNOCO 8002212501 4234 SW 20TH AVEGAINESVILLE FLCard 2801","18.32","","Posted","98.18"
"8/23/2022","","Withdrawal Debit Card MC Debit/DOCTORS RADIOLOGY GROU 352-3319729 FLDate 08/22/22 0 2234957871 0 8011Card 2801","30","","Posted","116.5"
"8/20/2022","","Withdrawal POS #000003108754/GOOGLE *YouTubePremium 1600 AmphitheatreParkw Mountain View CACard 2801","13.62","","Posted","146.5"
"8/20/2022","","Withdrawal POS #000000032357/SUNOCO 8002212501 4234 SW 20TH AVEGAINESVILLE FLCard 2801","18.32","","Posted","160.12"
"8/18/2022","","Withdrawal Debit Card MC Debit/WALGREENS #5024 800-289-2273 FLDate 08/17/22 0 2229033652 1 5912Card 2801","7.49","","Posted","178.44"
"8/17/2022","","Recurring Withdrawal Debit Card MC Debit/PLAYERAUCTIONS 800-342-0768 DEDate 08/16/22 0 2228778394 0 7993Card 2801","21.84","","Posted","185.93"
"8/16/2022","","Withdrawal POS #000000001638/CIRCLE K # 06527 9404 GAINESVILLE FLCard 2801","19.6","","Posted","207.77"
"8/15/2022","","Withdrawal POS #000000765169/SUNOCO 8002212501 4234 SW 20TH AVEGAINESVILLE FLCard 2801","30.24","","Posted","227.37"
"8/15/2022","","Withdrawal ACH CANVA PTY LIMITE/CO: CANVA PTY LIMITEDTYPE: IAT PAYPAL ID: 770510487CEntry Class Code: IAT","12.99","","Posted","257.61"
"8/15/2022","","Withdrawal ACH PAYMENT FOR AMZ/TYPE: STORECARD ID: 9069872103CO: PAYMENT FOR AMZNAME: 6045781157416487Entry Class Code: WEB","5","","Posted","270.6"
"8/14/2022","","Withdrawal Debit Card MC Debit/ODH-BIRTH CERTIF 614-466-2531 OHDate 08/13/22 0 2225808784 0 9399Card 2801","21.5","","Posted","275.6"
"8/12/2022","","Recurring Withdrawal Debit Card Fee/MASTERCARD ISSUER CROSS-BORDER FEEDate 08/11/22 0 2223767056 0 5734Card 2801","0.05","","Posted","297.1"
"8/12/2022","","Recurring Withdrawal Debit Card MC Debit/PAYPAL *LINKTREEPTY 4029357733 AUDate 08/11/22 0 2223767056 0 5734Card 2801","6","","Posted","297.15"
"8/11/2022","","Withdrawal Debit Card MC Debit/PUBLIX #1312 GAINESVILLE FLDate 08/10/22 0 2222058464 1 5411Card 2801","86.85","","Posted","303.15"
"8/11/2022","","Withdrawal ACH PAYPAL/TYPE: INST XFER ID: PAYPALSI77CO: PAYPAL NAME: STEVEN CHAPLINSKIEntry Class Code: WEB","9.99","","Posted","390"
"8/11/2022","","Withdrawal POS #000000736780/AMAZON.COM*U78AZ3Q63 SEATTLE WACard 2801","10.15","","Posted","399.99"
"8/10/2022","","Deposit Home Banking Transfer trf/From CHAPLINSKI,LEON 3496297 Share 0090","","85","Posted","410.14"
"8/10/2022","","Withdrawal ATM Fee/EFT 6419 W Newberry Rd Gainesville FLCard 2801","2","","Posted","325.14"
"8/10/2022","","Withdrawal at ATM #000000000571/EFT 6419 W Newberry Rd Gainesville FLCard 2801","63","","Posted","327.14"
"8/10/2022","","Withdrawal POS #000055843900/WAWA 5325 2373 SW ARCHER ROADFLCard 2801","2.64","","Posted","390.14"
"8/10/2022","","Withdrawal Debit Card MC Debit/DOCTORS RADIOLOGY GROU 352-3319729 FLDate 08/09/22 0 2221023616 1 8011Card 2801","55","","Posted","392.78"
"8/10/2022","","Withdrawal ACH ENVATO/CO: ENVATOTYPE: IAT PAYPAL ID: 770510487CEntry Class Code: IAT","39","","Posted","447.78"
"8/8/2022","","Withdrawal POS #000000734498/SUNOCO 8002212501 4234 SW 20TH AVEGAINESVILLE FLCard 2801","20.47","","Posted","486.78"
"8/8/2022","","Withdrawal ACH SABRINA AZAMBUJA/CO: SABRINA AZAMBUJATYPE: IAT PAYPAL ID: 770510487CEntry Class Code: IAT","42","","Posted","507.25"
"8/8/2022","","Withdrawal ACH PAYPAL/TYPE: INST XFER ID: PAYPALSI77CO: PAYPAL NAME: STEVEN CHAPLINSKIEntry Class Code: WEB","14.99","","Posted","549.25"
"8/8/2022","","Withdrawal POS #000007022835/PAYPAL *VIDIQ 2211 North First StreetJose CACard 2801","10","","Posted","564.24"
"8/6/2022","","Recurring Withdrawal Bill Payment - #000000400342/NETFLIX COM LOS GATOS CACard 2801","10.98","","Posted","574.24"
"8/5/2022","","Withdrawal ACH DISCOVER/TYPE: E-PAYMENT ID: 2510020270CO: DISCOVER NAME: CHAPLINSKI STEVENEntry Class Code: WEB","10","","Posted","585.22"
"8/4/2022","","Withdrawal ACH BEST BUY/TYPE: PAYMENT ID: CITIGPUFDRCO: BEST BUYEntry Class Code: PPD","15","","Posted","595.22"
"8/4/2022","","Withdrawal ACH BEST BUY/TYPE: PAYMENT ID: CITIGPUFDRCO: BEST BUYEntry Class Code: PPD","25","","Posted","610.22"
"8/4/2022","","Withdrawal ACH PAYPAL/TYPE: INST XFER ID: PAYPALSI77CO: PAYPAL NAME: STEVEN CHAPLINSKIEntry Class Code: WEB","2.99","","Posted","635.22"
"8/3/2022","","Withdrawal POS #000000054086/SUNOCO 8002212501 4234 SW 20TH AVEGAINESVILLE FLCard 2801","28.09","","Posted","638.21"
"8/3/2022","","Withdrawal ACH PAYPAL/TYPE: INST XFER ID: PAYPALSI77CO: PAYPAL NAME: STEVEN CHAPLINSKIEntry Class Code: WEB","14.99","","Posted","666.3"
"8/3/2022","","Withdrawal ACH PAYPAL/TYPE: INST XFER ID: PAYPALSI77CO: PAYPAL NAME: STEVEN CHAPLINSKIEntry Class Code: WEB","1.99","","Posted","681.29"
"8/2/2022","","Withdrawal ACH PAYPAL/TYPE: INST XFER ID: PAYPALSI77CO: PAYPAL NAME: STEVEN CHAPLINSKIEntry Class Code: WEB","11.48","","Posted","683.28"
"8/2/2022","","Withdrawal POS #000000337080/AMAZON.COM*3S5OR1RN3 SEATTLE WACard 2801","10.15","","Posted","694.76"
"8/1/2022","","Withdrawal ACH Watson Realty Co/TYPE: WEB PMTS ID: 9000321157CO: Watson Realty CoNAME: Steven chaplinskiEntry Class Code: WEB","995","","Posted","704.91"
"8/1/2022","","Withdrawal ACH GRU/EZ-PAY PHONE/TYPE: UTILITIES ID: 0000007041CO: GRU/EZ-PAY PHONEEntry Class Code: TEL","225.35","","Posted","1699.91"
"8/1/2022","","Withdrawal ACH PAYPAL/TYPE: INST XFER ID: PAYPALSI77CO: PAYPAL NAME: STEVEN CHAPLINSKIEntry Class Code: WEB","3.99","","Posted","1925.26"
"8/1/2022","","Withdrawal ACH PAYPAL/TYPE: INST XFER ID: PAYPALSI77CO: PAYPAL NAME: STEVEN CHAPLINSKIEntry Class Code: WEB","3.99","","Posted","1929.25"
"8/1/2022","","Withdrawal POS #000000255319/SUNOCO 8002212501 4234 SW 20TH AVEGAINESVILLE FLCard 2801","22.74","","Posted","1933.24"
"7/31/2022","","Withdrawal Debit Card MC Debit/PUBLIX #1038 GAINESVILLE FLDate 07/29/22 0 2210149844 2 5411Card 2801","125.79","","Posted","1955.98"
"7/31/2022","","Recurring Withdrawal Debit Card MC Debit/PLAYERAUCTIONS 800-342-0768 DEDate 07/30/22 0 2211746194 0 7993Card 2801","37.55","","Posted","2081.77"
"7/31/2022","","Withdrawal Debit Card MC Debit/COX GAINESVILLE COMM 800-234-3993 FLDate 07/29/22 0 2210539477 1 4899Card 2801","117.89","","Posted","2119.32"
"7/29/2022","","Withdrawal ATM Fee/EFT 3401 W University Ave Gainesville FLCard 2801","2","","Posted","2237.21"
"7/29/2022","","Withdrawal at ATM #000000000102/EFT 3401 W University Ave Gainesville FLCard 2801","163","","Posted","2239.21"
"7/29/2022","","Recurring Withdrawal Debit Card MC Debit/ADOBE CREATIVE CLOUD 4085366000 CADate 07/28/22 0 2209831549 0 5734Card 2801","19.99","","Posted","2402.21"
"7/29/2022","","Withdrawal Debit Card MC Debit/WALGREENS #5024 800-289-2273 FLDate 07/28/22 0 2209059762 1 5912Card 2801","67.54","","Posted","2422.2"
"7/29/2022","","Withdrawal Debit Card MC Debit/AMAZON PRIME*AH5FK9BT3 AMZN.COM/BIL WADate 07/29/22 0 2210009971 1 5968Card 2801","15.13","","Posted","2489.74"
"7/29/2022","","Withdrawal ACH PAYPAL/TYPE: INST XFER ID: PAYPALSI77CO: PAYPAL NAME: STEVEN CHAPLINSKIEntry Class Code: WEB","2.99","","Posted","2504.87"
"7/28/2022","","Deposit Home Banking Transfer trf/From CHAPLINSKI,LEON 3496297 Share 0000","","500","Posted","2507.86"
"7/28/2022","","Withdrawal Debit Card MC Debit/PIZZA HUT 27918 3523739402 FLDate 07/26/22 0 2207797243 0 5812Card 2801","36.52","","Posted","2007.86"
"7/28/2022","","Withdrawal POS #000000980939/SUNOCO 8002212501 4234 SW 20TH AVEGAINESVILLE FLCard 2801","28.09","","Posted","2044.38"
"7/28/2022","","Withdrawal ACH PAYPAL/TYPE: INST XFER ID: PAYPALSI77CO: PAYPAL NAME: STEVEN CHAPLINSKIEntry Class Code: WEB","24.99","","Posted","2072.47"
"7/28/2022","","Withdrawal ACH PAYPAL/TYPE: INST XFER ID: PAYPALSI77CO: PAYPAL NAME: STEVEN CHAPLINSKIEntry Class Code: WEB","14.99","","Posted","2097.46"
"7/27/2022","","Deposit Home Banking Transfer trf/From CHAPLINSKI,LEON 3496297 Share 0090","","2000","Posted","2112.45"
"7/27/2022","","Withdrawal ACH PAYPAL/TYPE: INST XFER ID: PAYPALSI77CO: PAYPAL NAME: STEVEN CHAPLINSKIEntry Class Code: WEB","2.99","","Posted","112.45"
"7/26/2022","","Withdrawal Debit Card MC Debit/PIZZA HUT 27918 3523739402 FLDate 07/25/22 0 2206773805 0 5812Card 2801","36.52","","Posted","115.44"
"7/26/2022","","Withdrawal ACH PAYPAL/TYPE: INST XFER ID: PAYPALSI77CO: PAYPAL NAME: STEVEN CHAPLINSKIEntry Class Code: WEB","4.5","","Posted","151.96"
"7/25/2022","","Withdrawal ACH PAYPAL/TYPE: INST XFER ID: PAYPALSI77CO: PAYPAL NAME: STEVEN CHAPLINSKIEntry Class Code: WEB","44.41","","Posted","156.46"
"7/25/2022","","Withdrawal POS #000000271313/AMAZON.COM*BA54M5XZ3 SEATTLE WACard 2801","35.76","","Posted","200.87"
"7/23/2022","","Withdrawal POS #000000683464/SUNOCO 8002212501 4234 SW 20TH AVEGAINESVILLE FLCard 2801","30.24","","Posted","236.63"
"7/23/2022","","Deposit Home Banking Transfer trf/From CHAPLINSKI,LEON 3496297 Share 0090","","200","Posted","266.87"
"7/23/2022","","Withdrawal POS #000000600037/SUNOCO 8002212501 4234 SW 20TH AVEGAINESVILLE FLCard 2801","18.32","","Posted","66.87"
"7/21/2022","","Recurring Withdrawal Debit Card MC Debit/ZIP.CO* BEST BUY NEW YORK NYDate 07/20/22 0 2201728200 0 5399Card 2801","36.92","","Posted","85.19"
"7/20/2022","","Withdrawal POS #000003052032/GOOGLE *YouTubePremium 1600 AmphitheatreParkw Mountain View CACard 2801","11.99","","Posted","122.11"
"7/18/2022","","Withdrawal POS #000000411427/SUNOCO 8002212501 4234 SW 20TH AVEGAINESVILLE FLCard 2801","20","","Posted","134.1"
"7/18/2022","","Withdrawal POS #000000403720/SUNOCO 8002212501 4234 SW 20TH AVEGAINESVILLE FLCard 2801","28.09","","Posted","154.1"
"7/18/2022","","Withdrawal ACH PAYPAL/TYPE: INST XFER ID: PAYPALSI77CO: PAYPAL NAME: STEVEN CHAPLINSKIEntry Class Code: WEB","8.89","","Posted","182.19"
"7/15/2022","","Withdrawal ACH PAYPAL/TYPE: INST XFER ID: PAYPALSI77CO: PAYPAL NAME: STEVEN CHAPLINSKIEntry Class Code: WEB","14.99","","Posted","191.08"
"7/14/2022","","Withdrawal POS #000000062086/PUBLIX 3100 SW 35TH BLVD GAINESVILLE FLCard 2801","17.58","","Posted","206.07"
"7/14/2022","","Withdrawal POS #000000000558/CIRCLE K # 26146 3525 GAINESVILLE FLCard 2801","33.37","","Posted","223.65"
"7/14/2022","","Withdrawal ATM Fee/EFT 3401 W University Ave Gainesville FLCard 2801","2","","Posted","257.02"
"7/14/2022","","Withdrawal at ATM #000000000098/EFT 3401 W University Ave Gainesville FLCard 2801","58","","Posted","259.02"
"7/14/2022","","Withdrawal ACH CANVA PTY LIMITE/CO: CANVA PTY LIMITEDTYPE: IAT PAYPAL ID: 770510487CEntry Class Code: IAT","12.99","","Posted","317.02"
"7/14/2022","","Withdrawal POS #000000991850/AMAZON.COM*7Q29B9KF3 SEATTLE WACard 2801","10.15","","Posted","330.01"
"7/13/2022","","Withdrawal Debit Card MC Debit/PUBLIX #527 GAINESVILLE FLDate 07/12/22 0 2193036098 1 5411Card 2801","84.05","","Posted","340.16"
"7/13/2022","","Withdrawal Debit Card MC Debit/WALGREENS #5024 800-289-2273 FLDate 07/12/22 0 2193032769 1 5912Card 2801","15.48","","Posted","424.21"
"7/13/2022","","Withdrawal Debit Card MC Debit/AMAZON PRIME*MG74E16U3 AMZN.COM/BIL WADate 07/13/22 0 2194975902 0 5968Card 2801","2.01","","Posted","439.69"
"7/13/2022","","Withdrawal ACH SABRINA AZAMBUJA/CO: SABRINA AZAMBUJATYPE: IAT PAYPAL ID: 770510487CEntry Class Code: IAT","37","","Posted","441.7"
"7/13/2022","","Withdrawal ACH PAYMENT FOR AMZ/TYPE: STORECARD ID: 9069872103CO: PAYMENT FOR AMZNAME: 6045781157416487Entry Class Code: WEB","5","","Posted","478.7"
"7/13/2022","","Withdrawal POS #000000000008/AMAZON.COM*AH6A64SD3 SEATTLE WACard 2801","21.39","","Posted","483.7"
"7/12/2022","","Withdrawal POS #000000183316/GATE 1445 506 NW 13TH GAINESVILLE FLCard 2801","21.1","","Posted","505.09"
"7/12/2022","","Recurring Withdrawal Debit Card Fee/MASTERCARD ISSUER CROSS-BORDER FEEDate 07/11/22 0 2192747961 0 5734Card 2801","0.05","","Posted","526.19"
"7/12/2022","","Recurring Withdrawal Debit Card MC Debit/PAYPAL *LINKTREEPTY 4029357733 AUDate 07/11/22 0 2192747961 0 5734Card 2801","6","","Posted","526.24"
"7/11/2022","","Withdrawal ACH TARGET CARD SRVC/TYPE: BILL PAY ID: 5411721813CO: TARGET CARD SRVCNAME: S CHAPLINSKI TEntry Class Code: WEB","20","","Posted","532.24"
"7/11/2022","","Withdrawal ACH PAYPAL/TYPE: INST XFER ID: PAYPALSI77CO: PAYPAL NAME: STEVEN CHAPLINSKIEntry Class Code: WEB","14.99","","Posted","552.24"
"7/8/2022","","Withdrawal POS #000096291670/FAST TRACK #200 GAINESVILLE FLCard 2801","19.46","","Posted","567.23"
"7/8/2022","","Withdrawal POS #000000384676/SUNOCO 8002212501 4234 SW 20TH AVEGAINESVILLE FLCard 2801","10.7","","Posted","586.69"
"7/8/2022","","Withdrawal POS #000006266765/PAYPAL *VIDIQ 2211 North First StreetJose CACard 2801","10","","Posted","597.39"
"7/7/2022","","Deposit POS #000001529785/PAYPAL*CHAPLINSKI ST San Jose CACard 2801","","29.4","Posted","607.39"
"7/6/2022","","Withdrawal POS #000000192090/SUNOCO 8002212501 4234 SW 20TH AVEGAINESVILLE FLCard 2801","28.09","","Posted","577.99"
"7/6/2022","","Recurring Withdrawal Bill Payment - #000000253554/NETFLIX COM LOS GATOS CACard 2801","10.98","","Posted","606.08"
"7/5/2022","","Withdrawal Debit Card MC Debit/DOCTORS RADIOLOGY GROU 352-3319729 FLDate 07/04/22 0 2185730588 0 8011Card 2801","55","","Posted","617.06"
"7/5/2022","","Recurring Withdrawal Debit Card MC Debit/PLAYERAUCTIONS 800-342-0768 DEDate 07/04/22 0 2185265396 0 7993Card 2801","49.08","","Posted","672.06"
"7/5/2022","","Withdrawal POS #000000074662/AMAZON.COM*DH4RM6253 SEATTLE WACard 2801","10.15","","Posted","721.14"
"7/5/2022","","Withdrawal ACH PAYPAL/TYPE: INST XFER ID: PAYPALSI77CO: PAYPAL NAME: STEVEN CHAPLINSKIEntry Class Code: WEB","14.98","","Posted","731.29"
"7/5/2022","","Withdrawal ACH PAYPAL/TYPE: INST XFER ID: PAYPALSI77CO: PAYPAL NAME: STEVEN CHAPLINSKIEntry Class Code: WEB","11.48","","Posted","746.27"
"7/5/2022","","Withdrawal ACH PAYPAL/TYPE: INST XFER ID: PAYPALSI77CO: PAYPAL NAME: STEVEN CHAPLINSKIEntry Class Code: WEB","2.99","","Posted","757.75"
"7/4/2022","","Recurring Withdrawal Debit Card MC Debit/ZIP.CO* BEST BUY NEW YORK NYDate 07/03/22 0 2184993464 0 5399Card 2801","42.05","","Posted","760.74"
"7/3/2022","","Withdrawal POS #000000610804/SUNOCO 8002212501 4234 SW 20TH AVEGAINESVILLE FLCard 2801","24.89","","Posted","802.79"
"7/3/2022","","Withdrawal Debit Card MC Debit/PIZZA HUT 27918 3523739402 FLDate 07/02/22 0 2183861104 0 5812Card 2801","28.43","","Posted","827.68"
"7/1/2022","","Recurring Withdrawal Debit Card MC Debit/PLAYERAUCTIONS 800-342-0768 DEDate 06/30/22 0 2181794560 0 7993Card 2801","42.79","","Posted","856.11"
"7/1/2022","","Withdrawal Debit Card MC Debit/GRU/EZ-PAY WEB PYMT 352-334-3434 FLDate 06/30/22 0 2181194793 0 4900Card 2801","254.1","","Posted","898.9"
"7/1/2022","","Withdrawal Debit Card MC Debit/COX GAINESVILLE COMM 800-234-3993 FLDate 06/30/22 0 2181792489 0 4899Card 2801","117.89","","Posted","1153"
"6/30/2022","","Withdrawal ATM Fee/EFT 6419 W Newberry Rd Gainesville FLCard 2801","2","","Posted","1270.89"
"6/30/2022","","Withdrawal at ATM #000000000114/EFT 6419 W Newberry Rd Gainesville FLCard 2801","113","","Posted","1272.89"
"6/30/2022","","Deposit Home Banking Transfer trf/From CHAPLINSKI,LEON 3496297 Share 0090","","500","Posted","1385.89"
"6/30/2022","","Recurring Withdrawal Debit Card MC Debit/PLAYERAUCTIONS 800-342-0768 DEDate 06/29/22 0 2180001243 1 7993Card 2801","42.79","","Posted","885.89"
"6/30/2022","","Recurring Withdrawal Debit Card MC Debit/PLAYERAUCTIONS 800-342-0768 DEDate 06/29/22 0 2180293381 0 7993Card 2801","42.1","","Posted","928.68"
"6/30/2022","","Withdrawal ACH CAPITAL ONE/TYPE: ONLINE PMT ID: 9279744991CO: CAPITAL ONE NAME: STEVEN CHAPLINSKIEntry Class Code: WEB","55","","Posted","970.78"
"6/30/2022","","Withdrawal ACH APPLECARD GSBANK/TYPE: PAYMENT ID: 9999999999CO: APPLECARD GSBANKNAME: Steven ChaplinskiEntry Class Code: WEB","3.38","","Posted","1025.78"
"6/30/2022","","Withdrawal ACH Watson Realty Co/TYPE: WEB PMTS ID: 9000321157CO: Watson Realty CoNAME: Steven chaplinskiEntry Class Code: WEB","935","","Posted","1029.16"
"6/30/2022","","Withdrawal ACH WAWA CREDIT CARD/TYPE: PAYMENT ID: CITIGPUFDRCO: WAWA CREDIT CARDEntry Class Code: PPD","81","","Posted","1964.16"
"6/30/2022","","Withdrawal ACH DISCOVER/TYPE: E-PAYMENT ID: 2510020270CO: DISCOVER NAME: CHAPLINSKI STEVENEntry Class Code: WEB","34.6","","Posted","2045.16"
"6/30/2022","","Deposit POS #000005777463/PAYPAL*CHAPLINSKI ST San Jose CACard 2801","","19.65","Posted","2079.76"
"6/29/2022","","Withdrawal POS #000000000246/CIRCLE K # 06782 5237 GAINESVILLE FLCard 2801","21.79","","Posted","2060.11"
"6/29/2022","","Withdrawal POS #000012043432/WALGREENS 2415 SW 75TH GAINESVILLE FLCard 2801","4.28","","Posted","2081.9"
"6/29/2022","","Withdrawal POS #000012033280/WALGREENS 2415 SW 75TH GAINESVILLE FLCard 2801","36.92","","Posted","2086.18"
"6/29/2022","","Recurring Withdrawal Debit Card MC Debit/ADOBE CREATIVE CLOUD 4085366000 CADate 06/28/22 0 2179824627 0 5734Card 2801","19.99","","Posted","2123.1"
"6/29/2022","","Deposit Home Banking Transfer trf/From CHAPLINSKI,LEON 3496297 Share 0090","","2100","Posted","2143.09"
"6/29/2022","","Withdrawal ACH PAYPAL/TYPE: INST XFER ID: PAYPALSI77CO: PAYPAL NAME: STEVEN CHAPLINSKIEntry Class Code: WEB","2.99","","Posted","43.09"
"6/28/2022","","Withdrawal ACH PAYPAL/TYPE: INST XFER ID: PAYPALSI77CO: PAYPAL NAME: STEVEN CHAPLINSKIEntry Class Code: WEB","14.99","","Posted","46.08"
"6/27/2022","","Withdrawal ACH PAYPAL/TYPE: INST XFER ID: PAYPALSI77CO: PAYPAL NAME: STEVEN CHAPLINSKIEntry Class Code: WEB","4.5","","Posted","61.07"
"6/27/2022","","Withdrawal ACH PAYPAL/TYPE: INST XFER ID: PAYPALSI77CO: PAYPAL NAME: STEVEN CHAPLINSKIEntry Class Code: WEB","2.99","","Posted","65.57"
"6/26/2022","","Withdrawal POS #000096297648/FAST TRACK #200 GAINESVILLE FLCard 2801","22.33","","Posted","68.56"
"6/26/2022","","Withdrawal POS #000000021747/PUBLIX 3930 SW ARCHER ROA GAINESVILLE FLCard 2801","39.7","","Posted","90.89"
"6/24/2022","","Withdrawal Debit Card MC Debit/B2P* FL OMMU MJ MED CA 877-767-6148 FLDate 06/23/22 0 2174976284 0 4900Card 2801","77.75","","Posted","130.59"
"6/23/2022","","Recurring Withdrawal Debit Card MC Debit/ZIP.CO* BEST BUY NEW YORK NYDate 06/22/22 0 2173764872 0 5399Card 2801","42.05","","Posted","208.34"
"6/23/2022","","Withdrawal Debit Card MC Debit/WALGREENS #5024 800-289-2273 FLDate 06/22/22 0 2173993795 0 5912Card 2801","3.71","","Posted","250.39"
"6/22/2022","","Withdrawal POS #000000439148/SUNOCO 8002212501 4234 SW 20TH AVEGAINESVILLE FLCard 2801","28.09","","Posted","254.1"
"6/22/2022","","Withdrawal Adjustment Debit Card - Credit Voucher/EVERLYWELL DIAGNOSTICS DALLAS TXDate 06/21/22 0 2172958865 0 8071Card 2801","","34","Posted","282.19"
"6/20/2022","","Deposit Home Banking Transfer trf/From CHAPLINSKI,LEON 3496297 Share 0090","","200","Posted","248.19"
"6/20/2022","","Withdrawal Debit Card MC Debit/WALGREENS #5024 800-289-2273 FLDate 06/19/22 0 2170973553 0 5912Card 2801","16.55","","Posted","48.19"
"6/20/2022","","Withdrawal POS #000003265400/GOOGLE *YouTubePremium 1600 AmphitheatreParkw Mountain View CACard 2801","11.99","","Posted","64.74"
"6/19/2022","","Deposit ATM Transaction","","18","Posted","76.73"
"6/19/2022","","Withdrawal ATM Fee/FLUENT DISPE-375207 3400 SW 34TH STREEGAINESVILLE FLCard 2801","2","","Posted","58.73"
"6/19/2022","","Withdrawal at ATM #000000007588/FLUENT DISPE-375207 3400 SW 34TH STREEGAINESVILLE FLCard 2801","43","","Posted","60.73"
"6/19/2022","","Withdrawal POS #000016464450/WALGREENS 2415 SW 75TH GAINESVILLE FLCard 2801","5.35","","Posted","103.73"
"6/19/2022","","Recurring Withdrawal Debit Card MC Debit/PLAYERAUCTIONS 800-342-0768 DEDate 06/19/22 0 2170016985 1 7993Card 2801","40.28","","Posted","109.08"
"6/18/2022","","Withdrawal POS #000000246955/SUNOCO 8002212501 4234 SW 20TH AVEGAINESVILLE FLCard 2801","24.89","","Posted","149.36"
"6/17/2022","","Withdrawal POS #000000032587/PUBLIX 3100 SW 35TH BLVD GAINESVILLE FLCard 2801","8.94","","Posted","174.25"
"6/17/2022","","Withdrawal POS #000000741852/PUBLIX 3930 SW ARCHER ROA GAINESVILLE FLCard 2801","5.99","","Posted","183.19"
"6/16/2022","","Recurring Withdrawal Adjustment - Debit Card Credit Voucher/PLAYERAUCTIONS 800-342-0768 DEDate 06/16/22 0 2167077360 1 7993Card 2801","","39.44","Posted","189.18"
"6/16/2022","","Withdrawal ACH PAYPAL/TYPE: INST XFER ID: PAYPALSI77CO: PAYPAL NAME: STEVEN CHAPLINSKIEntry Class Code: WEB","8.89","","Posted","149.74"
"6/16/2022","","Withdrawal POS #000000296803/AMAZON.COM*W79KJ68A3 SEATTLE WACard 2801","9.73","","Posted","158.63"
"6/15/2022","","Withdrawal Home Banking Transfer/To CHAPLINSKI,LEONA 3496297 Share 0090Funds Transfer via Online","550","","Posted","168.36"
"6/15/2022","","Recurring Withdrawal Debit Card MC Debit/PLAYERAUCTIONS 800-342-0768 DEDate 06/15/22 0 2166056029 1 7993Card 2801","40.7","","Posted","718.36"
"6/15/2022","","Recurring Withdrawal Debit Card MC Debit/PLAYERAUCTIONS 800-342-0768 DEDate 06/14/22 0 2165922687 0 7993Card 2801","39.44","","Posted","759.06"
"6/15/2022","","Withdrawal ACH PAYMENT FOR AMZ/TYPE: STORECARD ID: 9069872103CO: PAYMENT FOR AMZNAME: 6045781157416487Entry Class Code: WEB","45","","Posted","798.5"
"6/14/2022","","Withdrawal ACH CAPITAL ONE/TYPE: ONLINE PMT ID: 9279744991CO: CAPITAL ONE NAME: STEVEN CHAPLINSKIEntry Class Code: WEB","50","","Posted","843.5"
"6/14/2022","","Withdrawal ACH BEST BUY/TYPE: PAYMENT ID: CITICTP CO: BEST BUYNAME: STEVEN J CHAPLINSKIEntry Class Code: WEB","74","","Posted","893.5"
"6/14/2022","","Withdrawal ACH TARGET CARD SRVC/TYPE: BILL PAY ID: 5411721813CO: TARGET CARD SRVCNAME: S CHAPLINSKI TEntry Class Code: WEB","55","","Posted","967.5"
"6/13/2022","","Recurring Withdrawal Debit Card Fee/MASTERCARD ISSUER CROSS-BORDER FEEDate 06/11/22 0 2162900620 0 5734Card 2801","0.05","","Posted","1022.5"
"6/13/2022","","Recurring Withdrawal Debit Card MC Debit/PAYPAL *LINKTREEPTY 4029357733 AUDate 06/11/22 0 2162900620 0 5734Card 2801","6","","Posted","1022.55"
"6/13/2022","","Withdrawal ACH PAYMENT FOR AMZ/TYPE: STORECARD ID: 9069872103CO: PAYMENT FOR AMZNAME: 6045781157416487Entry Class Code: WEB","5","","Posted","1028.55"
"6/13/2022","","Withdrawal POS #000000906869/SUNOCO 8002212501 4234 SW 20TH AVEGAINESVILLE FLCard 2801","24.89","","Posted","1033.55"
"6/9/2022","","Withdrawal Debit Card MC Debit/PUBLIX #527 GAINESVILLE FLDate 06/08/22 0 2159954918 0 5411Card 2801","78.53","","Posted","1058.44"
"6/9/2022","","Recurring Withdrawal Debit Card MC Debit/ZIP.CO* BEST BUY NEW YORK NYDate 06/08/22 0 2159765976 0 5399Card 2801","42.04","","Posted","1136.97"
"6/9/2022","","Withdrawal Debit Card MC Debit/WALGREENS #5024 800-289-2273 FLDate 06/08/22 0 2159030924 1 5912Card 2801","6.56","","Posted","1179.01"
"6/9/2022","","Withdrawal Debit Card MC Debit/WALGREENS #5024 800-289-2273 FLDate 06/08/22 0 2159030923 1 5912Card 2801","3.71","","Posted","1185.57"
"6/9/2022","","Withdrawal ACH WAWA CREDIT CARD/TYPE: PAYMENT ID: CITIGPUFDRCO: WAWA CREDIT CARDEntry Class Code: PPD","30","","Posted","1189.28"
"6/9/2022","","Withdrawal ACH PAYPAL/TYPE: INST XFER ID: PAYPALSI77CO: PAYPAL NAME: STEVEN CHAPLINSKIEntry Class Code: WEB","14.99","","Posted","1219.28"
"6/8/2022","","Withdrawal Debit Card MC Debit/PUBLIX #1312 GAINESVILLE FLDate 06/07/22 0 2158976004 0 5411Card 2801","101.42","","Posted","1234.27"
"6/8/2022","","Withdrawal POS #000010405957/WALGREENS 2415 SW 75TH GAINESVILLE FLCard 2801","10.9","","Posted","1335.69"
"6/8/2022","","Deposit Home Banking Transfer dental/From CHAPLINSKI,LEON 3496297 Share 0000","","860","Posted","1346.59"
"6/8/2022","","Deposit Home Banking Transfer trf/From CHAPLINSKI,LEON 3496297 Share 0090","","102","Posted","486.59"
"6/8/2022","","Withdrawal POS #000007063712/PAYPAL *VIDIQ 2211 North First StreetJose CACard 2801","10","","Posted","384.59"
"6/7/2022","","Recurring Withdrawal Adjustment - Debit Card Credit Voucher/PLAYERAUCTIONS 800-342-0768 DEDate 06/06/22 0 2157312384 0 7993Card 2801","","38.6","Posted","394.59"
"6/7/2022","","Recurring Withdrawal Debit Card MC Debit/NETFLIX.COM 866-5797172 CADate 06/06/22 0 2157765586 0 4899Card 2801","10.98","","Posted","355.99"
"6/7/2022","","Withdrawal ACH DISCOVER/TYPE: E-PAYMENT ID: 2510020270CO: DISCOVER NAME: CHAPLINSKI STEVENEntry Class Code: WEB","65","","Posted","366.97"
"6/7/2022","","Deposit ACH PAYPAL/TYPE: TRANSFER ID: PAYPALSD11 CO: PAYPALEntry Class Code: PPD","","81.05","Posted","431.97"
"6/6/2022","","Withdrawal ACH ACANVASARTT/CO: ACANVASARTTTYPE: IAT PAYPAL ID: 770510487CEntry Class Code: IAT","75.95","","Posted","350.92"
"6/6/2022","","Recurring Withdrawal Debit Card MC Debit/PLAYERAUCTIONS 800-342-0768 DEDate 06/05/22 0 2156255006 0 7993Card 2801","40.63","","Posted","426.87"
"6/6/2022","","Withdrawal Debit Card MC Debit/WALGREENS #5024 800-289-2273 FLDate 06/05/22 0 2156870796 0 5912Card 2801","3.91","","Posted","467.5"
"6/6/2022","","Withdrawal ACH PAYPAL/TYPE: INST XFER ID: PAYPALSI77CO: PAYPAL NAME: STEVEN CHAPLINSKIEntry Class Code: WEB","81.05","","Posted","471.41"
"6/6/2022","","Withdrawal ACH PAYPAL/TYPE: INST XFER ID: PAYPALSI77CO: PAYPAL NAME: STEVEN CHAPLINSKIEntry Class Code: WEB","2.99","","Posted","552.46"
"6/5/2022","","Deposit Home Banking Transfer/From CHAPLINSKI,LEON 3496297 Share 0090Funds Transfer via Online","","5","Posted","555.45"
"6/5/2022","","Deposit Home Banking Transfer trf/From CHAPLINSKI,LEON 3496297 Share 0090","","124","Posted","550.45"
"6/5/2022","","Withdrawal ATM Fee/ASAI 3400 B SW 34th St. Gainesville FLCard 2801","2","","Posted","426.45"
"6/5/2022","","Withdrawal at ATM #000000000323/ASAI 3400 B SW 34th St. Gainesville FLCard 2801","128","","Posted","428.45"
"6/5/2022","","Withdrawal Debit Card MC Debit/EVERLYWELL DIAGNOSTICS DALLAS TXDate 06/05/22 0 2156212746 1 8071Card 2801","49","","Posted","556.45"
"6/5/2022","","Recurring Withdrawal Debit Card MC Debit/PLAYERAUCTIONS 800-342-0768 DEDate 06/05/22 0 2156207038 1 7993Card 2801","38.6","","Posted","605.45"
"6/4/2022","","Withdrawal POS #000000392594/SUNOCO 8002212501 4234 SW 20TH AVEGAINESVILLE FLCard 2801","24.89","","Posted","644.05"
"6/4/2022","","Deposit Home Banking Transfer trf/From CHAPLINSKI,LEON 3496297 Share 0090","","85","Posted","668.94"
"6/2/2022","","Withdrawal Debit Card MC Debit/PUBLIX #1312 GAINESVILLE FLDate 06/01/22 0 2152104117 1 5411Card 2801","123.21","","Posted","583.94"
"6/2/2022","","Withdrawal POS #000000000052/AMAZON.COM*N77HP2U23 SEATTLE WACard 2801","6.74","","Posted","707.15"
"6/2/2022","","Deposit Home Banking Transfer trf/From CHAPLINSKI,LEON 3496297 Share 0090","","180","Posted","713.89"
"6/1/2022","","Withdrawal ATM Transaction","80","","Posted","533.89"
"6/1/2022","","Withdrawal Adjustment Debit Card - Credit Voucher/AMAZON PRIME AMZN.COM/BIL WADate 06/01/22 0 2152981488 0 5968Card 2801","","15.13","Posted","613.89"
"6/1/2022","","Withdrawal Debit Card MC Debit/WALGREENS #5024 800-289-2273 FLDate 05/31/22 0 2151982468 0 5912Card 2801","15","","Posted","598.76"
"6/1/2022","","Withdrawal ACH Watson Realty Co/TYPE: WEB PMTS ID: 9000321157CO: Watson Realty CoNAME: Steven chaplinskiEntry Class Code: WEB","885","","Posted","613.76"
"6/1/2022","","Withdrawal ACH DISCOVER/TYPE: E-PAYMENT ID: 2510020270CO: DISCOVER NAME: CHAPLINSKI STEVENEntry Class Code: WEB","15","","Posted","1498.76"
"6/1/2022","","Withdrawal ACH PAYPAL/TYPE: INST XFER ID: PAYPALSI77CO: PAYPAL NAME: STEVEN CHAPLINSKIEntry Class Code: WEB","14.99","","Posted","1513.76"
"6/1/2022","","Deposit POS #000000105200/PAYPAL*chaplinski stev San Jose CACard 2801","","29.55","Posted","1528.75"
"5/31/2022","","Withdrawal POS #000000219124/SUNOCO 8002212501 4234 SW 20TH AVEGAINESVILLE FLCard 2801","22.74","","Posted","1499.2"
"5/31/2022","","Withdrawal ACH APPLECARD GSBANK/TYPE: PAYMENT ID: 9999999999CO: APPLECARD GSBANKNAME: Steven ChaplinskiEntry Class Code: WEB","43","","Posted","1521.94"
"5/31/2022","","Withdrawal ACH PAYMENT FOR AMZ/TYPE: STORECARD ID: 9069872103CO: PAYMENT FOR AMZNAME: 6045781157416487Entry Class Code: WEB","25","","Posted","1564.94"
"5/31/2022","","Withdrawal ACH PAYPAL/TYPE: INST XFER ID: PAYPALSI77CO: PAYPAL NAME: STEVEN CHAPLINSKIEntry Class Code: WEB","14.99","","Posted","1589.94"
"5/31/2022","","Withdrawal ACH PAYPAL/TYPE: INST XFER ID: PAYPALSI77CO: PAYPAL NAME: STEVEN CHAPLINSKIEntry Class Code: WEB","2.99","","Posted","1604.93"
"5/30/2022","","Withdrawal Debit Card MC Debit/PUBLIX #1312 GAINESVILLE FLDate 05/29/22 0 2149812561 0 5411Card 2801","79.11","","Posted","1607.92"
"5/29/2022","","Recurring Withdrawal Debit Card MC Debit/ADOBE CREATIVE CLOUD 4085366000 CADate 05/28/22 0 2148889909 0 5734Card 2801","19.99","","Posted","1687.03"
"5/27/2022","","Withdrawal ACH CANVA PTY LIMITE/CO: CANVA PTY LIMITEDTYPE: IAT PAYPAL ID: 770510487CEntry Class Code: IAT","12.99","","Posted","1707.02"
"5/27/2022","","Withdrawal Debit Card MC Debit/AMAZON PRIME*1R55T47L2 AMZN.COM/BIL WADate 05/27/22 0 2147054474 1 5968Card 2801","15.13","","Posted","1720.01"
"5/27/2022","","Withdrawal Debit Card MC Debit/GRU/EZ-PAY WEB PYMT 352-334-3434 FLDate 05/26/22 0 2146308771 0 4900Card 2801","169.7","","Posted","1735.14"
"5/27/2022","","Withdrawal Debit Card MC Debit/COX GAINESVILLE COMM 800-234-3993 FLDate 05/26/22 0 2146802258 0 4899Card 2801","117.89","","Posted","1904.84"
"5/27/2022","","Withdrawal ACH PAYPAL/TYPE: INST XFER ID: PAYPALSI77CO: PAYPAL NAME: STEVEN CHAPLINSKIEntry Class Code: WEB","2.99","","Posted","2022.73"
"5/27/2022","","Withdrawal POS #000000041009/PUBLIX 3930 SW ARCHER ROA GAINESVILLE FLCard 2801","43.8","","Posted","2025.72"
"5/26/2022","","Withdrawal Adjustment Debit Card - Credit Voucher/KINDLE UNLTD 866-321-8851 WADate 05/25/22 0 2145782625 0 5818Card 2801","","9.99","Posted","2069.52"
"5/26/2022","","Deposit Home Banking Transfer trf/From CHAPLINSKI,LEON 3496297 Share 0000","","2000","Posted","2059.53"
"5/26/2022","","Withdrawal ACH PAYPAL/TYPE: INST XFER ID: PAYPALSI77CO: PAYPAL NAME: STEVEN CHAPLINSKIEntry Class Code: WEB","4.5","","Posted","59.53"
"5/25/2022","","Withdrawal Debit Card MC Debit/KINDLE UNLTD*WC29623B3 866-321-8851 WADate 05/24/22 0 2144970619 0 5818Card 2801","9.99","","Posted","64.03"
"5/25/2022","","Withdrawal POS #000096297551/FAST TRACK #200 GAINESVILLE FLCard 2801","19.45","","Posted","74.02"
"5/25/2022","","Withdrawal POS #000000073251/PUBLIX 3930 SW ARCHER ROA GAINESVILLE FLCard 2801","57.01","","Posted","93.47"
"5/24/2022","","Withdrawal POS #000000000001/AMAZON.COM*Z37JL9KM3 SEATTLE WACard 2801","7.21","","Posted","150.48"
"5/23/2022","","Withdrawal ACH PAYPAL/TYPE: INST XFER ID: PAYPALSI77CO: PAYPAL NAME: STEVEN CHAPLINSKIEntry Class Code: WEB","11.99","","Posted","157.69"
"5/23/2022","","Withdrawal ACH DISCOVER/TYPE: E-PAYMENT ID: 2510020270CO: DISCOVER NAME: CHAPLINSKI STEVENEntry Class Code: WEB","4.18","","Posted","169.68"
"5/22/2022","","Withdrawal Debit Card MC Debit/WALGREENS #5024 800-289-2273 FLDate 05/21/22 0 2141999930 0 5912Card 2801","14.28","","Posted","173.86"
"5/21/2022","","Withdrawal POS #000000639499/SUNOCO 8002212501 4234 SW 20TH AVEGAINESVILLE FLCard 2801","22.74","","Posted","188.14"
"5/17/2022","","Withdrawal Debit Card MC Debit/PUBLIX #1312 GAINESVILLE FLDate 05/16/22 0 2136986442 0 5411Card 2801","103.95","","Posted","210.88"
"5/16/2022","","Withdrawal POS #000000399046/SUNOCO 8002212501 4234 SW 20TH AVEGAINESVILLE FLCard 2801","22.74","","Posted","314.83"
"5/16/2022","","Recurring Withdrawal Debit Card MC Debit/ZIP.CO* NEWEGG NEW YORK NYDate 05/16/22 0 2136907205 0 5399Card 2801","42.77","","Posted","337.57"
"5/16/2022","","Withdrawal ACH PAYMENT FOR AMZ/TYPE: STORECARD ID: 9069872103CO: PAYMENT FOR AMZNAME: 6045781157416487Entry Class Code: WEB","5","","Posted","380.34"
"5/16/2022","","Withdrawal ACH PAYPAL/TYPE: INST XFER ID: PAYPALSI77CO: PAYPAL NAME: STEVEN CHAPLINSKIEntry Class Code: WEB","1.43","","Posted","385.34"
"5/15/2022","","Deposit Home Banking Transfer trf/From CHAPLINSKI,LEON 3496297 Share 0090","","200","Posted","386.77"
"5/14/2022","","Withdrawal ATM Transaction","45","","Posted","186.77"
"5/13/2022","","Withdrawal Debit Card MC Debit/DOCTORS RADIOLOGY GROU 352-3319729 FLDate 05/12/22 0 2132061814 1 8011Card 2801","5","","Posted","231.77"
"5/13/2022","","Withdrawal ACH CAPITAL ONE/TYPE: ONLINE PMT ID: 9279744991CO: CAPITAL ONE NAME: STEVEN CHAPLINSKIEntry Class Code: WEB","5","","Posted","236.77"
"5/13/2022","","Withdrawal ACH DISCOVER/TYPE: E-PAYMENT ID: 2510020270CO: DISCOVER NAME: CHAPLINSKI STEVENEntry Class Code: WEB","5","","Posted","241.77"
"5/13/2022","","Withdrawal ACH TARGET CARD SRVC/TYPE: BILL PAY ID: T510215170CO: TARGET CARD SRVCNAME: 7S CH0000000APLINSKI TEntry Class Code: WEB","5","","Posted","246.77"
"5/13/2022","","Withdrawal ACH PAYPAL/TYPE: INST XFER ID: PAYPALSI77CO: PAYPAL NAME: STEVEN CHAPLINSKIEntry Class Code: WEB","2.86","","Posted","251.77"
"5/12/2022","","Recurring Withdrawal Debit Card MC Debit/PAYPAL *LINKTREEPTY 4029357733 CADate 05/11/22 0 2131030580 1 5734Card 2801","6","","Posted","254.63"
"5/10/2022","","Recurring Withdrawal Debit Card MC Debit/PLAYERAUCTIONS 800-342-0768 DEDate 05/09/22 0 2129742511 0 7993Card 2801","40.7","","Posted","260.63"
"5/10/2022","","Withdrawal POS #000000900705/AMAZON.COM*134LE0B92 SEATTLE WACard 2801","7.21","","Posted","301.33"
"5/9/2022","","Recurring Withdrawal Debit Card MC Debit/ADOBE CREATIVE CLOUD 4085366000 CADate 05/08/22 0 2128950507 0 5734Card 2801","19.99","","Posted","308.54"
"5/9/2022","","Withdrawal Debit Card MC Debit/WALGREENS #5024 800-289-2273 FLDate 05/08/22 0 2128974293 0 5912Card 2801","12.97","","Posted","328.53"
"5/9/2022","","Withdrawal ACH DISCOVER/TYPE: E-PAYMENT ID: 2510020270CO: DISCOVER NAME: CHAPLINSKI STEVENEntry Class Code: WEB","10","","Posted","341.5"
"5/8/2022","","Withdrawal POS #000016124369/WALGREENS 2415 SW 75TH GAINESVILLE FLCard 2801","5.35","","Posted","351.5"
"5/8/2022","","Withdrawal POS #000007247911/PAYPAL *VIDIQ San Jose CACard 2801","10","","Posted","356.85"
"5/8/2022","","Withdrawal Adjustment Debit Card - Credit Voucher/SANTAFECCOLBKSTOR #341 352-395-5240 FLDate 05/06/22 0 2126243991 0 5942Card 2801","","158.41","Posted","366.85"
"5/8/2022","","Withdrawal Debit Card MC Debit/PUBLIX #527 GAINESVILLE FLDate 05/06/22 0 2126310396 2 5411Card 2801","37.07","","Posted","208.44"
"5/6/2022","","Withdrawal POS #000000000275/CIRCLE K # 26146 3525 GAINESVILLE FLCard 2801","25.08","","Posted","245.51"
"5/6/2022","","Withdrawal ATM Fee/ASAI 3400 B SW 34th St. Gainesville FLCard 2801","2","","Posted","270.59"
"5/6/2022","","Withdrawal at ATM #000000000051/ASAI 3400 B SW 34th St. Gainesville FLCard 2801","78","","Posted","272.59"
"5/6/2022","","Withdrawal Debit Card MC Debit/PUBLIX #1312 GAINESVILLE FLDate 05/05/22 0 2125034182 1 5411Card 2801","28.52","","Posted","350.59"
"5/6/2022","","Deposit Home Banking Transfer trf/From CHAPLINSKI,LEON 3496297 Share 0090","","200","Posted","379.11"
"5/6/2022","","Recurring Deposit POS #000008156796/AFFIRM PAYMENT REFUND SAN FRANCISCO CACard 2801","","26.92","Posted","179.11"
"5/6/2022","","Recurring Deposit POS #000008156735/AFFIRM PAYMENT REFUND SAN FRANCISCO CACard 2801","","26.92","Posted","152.19"
"5/6/2022","","Recurring Deposit POS #000008156662/AFFIRM PAYMENT REFUND SAN FRANCISCO CACard 2801","","26.92","Posted","125.27"
"5/6/2022","","Recurring Withdrawal Bill Payment - #000008065471/NETFLIX COM LOS GATOS CACard 2801","10.98","","Posted","98.35"
"5/5/2022","","Withdrawal Debit Card MC Debit/SANTAFECCOLBKSTOR #341 352-395-5240 FLDate 05/04/22 0 2124074809 1 5942Card 2801","174.25","","Posted","109.33"
"5/5/2022","","Withdrawal Debit Card MC Debit/WALGREENS #5024 800-289-2273 FLDate 05/04/22 0 2124070501 1 5912Card 2801","23.16","","Posted","283.58"
"5/5/2022","","Withdrawal ACH PAYMENT FOR AMZ/TYPE: STORECARD ID: 9069872103CO: PAYMENT FOR AMZNAME: 6045781157416487Entry Class Code: WEB","25","","Posted","306.74"
"5/4/2022","","Withdrawal POS #000000000140/CIRCLE K # 06782 5237 GAINESVILLE FLCard 2801","18.59","","Posted","331.74"
"5/4/2022","","Withdrawal ACH PAYPAL/TYPE: INST XFER ID: PAYPALSI77CO: PAYPAL NAME: STEVEN CHAPLINSKIEntry Class Code: WEB","2.99","","Posted","350.33"
"5/3/2022","","Recurring Withdrawal Debit Card MC Debit/ZIP.CO* NEWEGG NEW YORK NYDate 05/02/22 0 2122798522 0 5399Card 2801","42.77","","Posted","353.32"
"5/3/2022","","Withdrawal ACH TARGET CARD SRVC/TYPE: BILL PAY ID: 5411721813CO: TARGET CARD SRVCNAME: S CHAPLINSKI TEntry Class Code: WEB","40","","Posted","396.09"
"5/3/2022","","Withdrawal ACH PAYPAL/TYPE: INST XFER ID: PAYPALSI77CO: PAYPAL NAME: STEVEN CHAPLINSKIEntry Class Code: WEB","14.99","","Posted","436.09"
"5/2/2022","","Withdrawal POS #000000675678/SUNOCO 8002212501 4234 SW 20TH AVEGAINESVILLE FLCard 2801","24.89","","Posted","451.08"
"5/2/2022","","Withdrawal Home Banking Transfer - To Share 0000/Funds Transfer via Mobile","5","","Posted","475.97"
"5/2/2022","","Withdrawal ACH APPLECARD GSBANK/TYPE: PAYMENT ID: 9999999999CO: APPLECARD GSBANKNAME: Steven ChaplinskiEntry Class Code: WEB","17","","Posted","480.97"
"5/2/2022","","Withdrawal Debit Card MC Debit/WALGREENS #5024 800-289-2273 FLDate 05/01/22 0 2121942003 0 5912Card 2801","39.6","","Posted","497.97"
"5/2/2022","","Withdrawal ACH Watson Realty Co/TYPE: WEB PMTS ID: 9000321157CO: Watson Realty CoNAME: Steven chaplinskiEntry Class Code: WEB","885","","Posted","537.57"
"5/1/2022","","Recurring Withdrawal Bill Payment - #000019084874/AFFIRM PAY CHYKSKQD SAN FRANCISCO CACard 2801","26.92","","Posted","1422.57"
"5/1/2022","","Withdrawal POS #000000738174/PUBLIX 3930 SW ARCHER ROA GAINESVILLE FLCard 2801","23.78","","Posted","1449.49"
"4/30/2022","","Withdrawal Debit Card MC Debit/GRU/EZ-PAY WEB PYMT 352-334-3434 FLDate 04/29/22 0 2119231842 0 4900Card 2801","218.91","","Posted","1473.27"
"4/30/2022","","Withdrawal Debit Card MC Debit/COX GAINESVILLE COMM 800-234-3993 FLDate 04/29/22 0 2119829506 0 4899Card 2801","115.39","","Posted","1692.18"
"4/30/2022","","Withdrawal ATM Fee/ASAI 3400 B SW 34th St. Gainesville FLCard 2801","2","","Posted","1807.57"
"4/30/2022","","Withdrawal at ATM #000000001804/ASAI 3400 B SW 34th St. Gainesville FLCard 2801","127.75","","Posted","1809.57"
"4/30/2022","","Withdrawal POS #000000585470/FAST TRACK #200 3960 SW ARCHER RDGAINESVILLE FLCard 2801","19.45","","Posted","1937.32"
"4/30/2022","","Withdrawal POS #000000737718/PUBLIX 3930 SW ARCHER ROA GAINESVILLE FLCard 2801","46.19","","Posted","1956.77"
"4/29/2022","","Deposit Home Banking Transfer trf/From CHAPLINSKI,LEON 3496297 Share 0090","","800","Posted","2002.96"
"4/29/2022","","Deposit Home Banking Transfer trf/From CHAPLINSKI,LEON 3496297 Share 0090","","1200","Posted","1202.96"
"4/29/2022","","Withdrawal ACH PAYPAL/TYPE: INST XFER ID: PAYPALSI77CO: PAYPAL NAME: STEVEN CHAPLINSKIEntry Class Code: WEB","2.99","","Posted","2.96"
"4/28/2022","","Withdrawal Debit Card MC Debit/COLLEGE TRANSCRIPT 847-716-3000 ILDate 04/27/22 0 2117043656 1 7375Card 2801","3","","Posted","5.95"
"4/27/2022","","Deposit ATM Transaction","","12","Posted","8.95"
"4/27/2022","","Recurring Withdrawal Debit Card MC Debit/HELP.HBOMAX.COM NEW YORK NYDate 04/27/22 0 2117023223 1 5815Card 2801","17.23","","Posted","-3.05"
"4/27/2022","","Deposit Transfer From Share 0000","","0.18","Posted","14.18"
"4/27/2022","","Withdrawal ACH CANVA PTY LIMITE/CO: CANVA PTY LIMITEDTYPE: IAT PAYPAL ID: 770510487CEntry Class Code: IAT","12.99","","Posted","14"
"4/27/2022","","Withdrawal ACH PAYPAL/TYPE: INST XFER ID: PAYPALSI77CO: PAYPAL NAME: STEVEN CHAPLINSKIEntry Class Code: WEB","2.99","","Posted","26.99"
"4/27/2022","","Deposit Home Banking Transfer - From Share 0000/Funds Transfer via Mobile","","4","Posted","29.98"
"4/27/2022","","Recurring Withdrawal Bill Payment - #000021122613/AFFIRM PAY 2KXLN0HP SAN FRANCISCO CACard 2801","26.92","","Posted","25.98"
"4/26/2022","","Deposit Home Banking Transfer - From Share 0000/Funds Transfer via Mobile","","30","Posted","52.9"
"4/26/2022","","Withdrawal Debit Card MC Debit/PUBLIX #680 GAINESVILLE FLDate 04/25/22 0 2115965172 0 5411Card 2801","33.33","","Posted","22.9"
"4/26/2022","","Withdrawal Debit Card MC Debit/AMAZON.COM*1Q8DL7DY1 AMZN.COM/BIL WADate 04/26/22 0 2116907583 0 5942Card 2801","35.76","","Posted","56.23"
"4/26/2022","","Withdrawal ACH PAYPAL/TYPE: INST XFER ID: PAYPALSI77CO: PAYPAL NAME: STEVEN CHAPLINSKIEntry Class Code: WEB","8.89","","Posted","91.99"
"4/26/2022","","Withdrawal ACH PAYPAL/TYPE: INST XFER ID: PAYPALSI77CO: PAYPAL NAME: STEVEN CHAPLINSKIEntry Class Code: WEB","4.5","","Posted","100.88"
"4/26/2022","","Withdrawal POS #000000407601/SUNOCO 8002212501 4234 SW 20TH AVEGAINESVILLE FLCard 2801","12.97","","Posted","105.38"
"4/25/2022","","Withdrawal Debit Card MC Debit/COLLEGENET *FLORIDA, 8772143932 FLDate 04/24/22 0 2114014607 1 8220Card 2801","30","","Posted","118.35"
"4/25/2022","","Withdrawal Debit Card MC Debit/KINDLE UNLTD*1Q3V82MS1 866-321-8851 WADate 04/24/22 0 2114009003 1 5818Card 2801","9.99","","Posted","148.35"
"4/23/2022","","Withdrawal POS #000000338186/FAST TRACK #200 3960 SW ARCHER RDGAINESVILLE FLCard 2801","25.21","","Posted","158.34"
"4/23/2022","","Withdrawal POS #000000736088/PUBLIX 3930 SW ARCHER ROA GAINESVILLE FLCard 2801","41.8","","Posted","183.55"
"4/22/2022","","Withdrawal ACH WAWA CREDIT CARD/TYPE: ONLINE PMT ID: CITICTPCO: WAWA CREDIT CARDNAME: STEVEN CHAPLINSKIEntry Class Code: WEB","29","","Posted","225.35"
"4/21/2022","","Recurring Withdrawal Debit Card MC Debit/JASPER.AI AUSTIN TXDate 04/20/22 0 2110444189 0 7399Card 2801","21.62","","Posted","254.35"
"4/21/2022","","Withdrawal ACH PAYPAL/TYPE: INST XFER ID: PAYPALSI77CO: PAYPAL NAME: STEVEN CHAPLINSKIEntry Class Code: WEB","15.99","","Posted","275.97"
"4/21/2022","","Withdrawal ACH PAYPAL/TYPE: INST XFER ID: PAYPALSI77CO: PAYPAL NAME: STEVEN CHAPLINSKIEntry Class Code: WEB","11.99","","Posted","291.96"
"4/21/2022","","Withdrawal POS #000000000011/AMAZON.COM*1O6A36FN2 SEATTLE WACard 2801","7.71","","Posted","303.95"
"4/20/2022","","Withdrawal POS #000000830952/AMAZON.COM*1A8JG3W82 SEATTLE WACard 2801","19.2","","Posted","311.66"
"4/19/2022","","Withdrawal at ATM #000000001389/PAI ISO 318 NW 13TH ST GAINESVILLE FLCard 2801","53.5","","Posted","330.86"
"4/19/2022","","Recurring Withdrawal Debit Card MC Debit/ZIP.CO* NEWEGG NEW YORK NYDate 04/18/22 0 2108628572 0 5399Card 2801","42.77","","Posted","384.36"
"4/18/2022","","Withdrawal ACH PAYPAL/TYPE: INST XFER ID: PAYPALSI77CO: PAYPAL NAME: STEVEN CHAPLINSKIEntry Class Code: WEB","64.99","","Posted","427.13"
"4/18/2022","","Withdrawal ACH PAYPAL/TYPE: INST XFER ID: PAYPALSI77CO: PAYPAL NAME: STEVEN CHAPLINSKIEntry Class Code: WEB","18.25","","Posted","492.12"
"4/18/2022","","Deposit ACH PAYPAL/TYPE: TRANSFER ID: PAYPALSD11 CO: PAYPALEntry Class Code: PPD","","20","Posted","510.37"
"4/17/2022","","Withdrawal Debit Card MC Debit/PUBLIX #1312 GAINESVILLE FLDate 04/16/22 0 2106080947 1 5411Card 2801","49.92","","Posted","490.37"
"4/17/2022","","Deposit POS #000000448256/PAYPAL*chaplinski stev San Jose CACard 2801","","295.5","Posted","540.29"
"4/16/2022","","Withdrawal POS #000019892829/SHELL SERVICE S GAINESVILLE FLCard 2801","35.51","","Posted","244.79"
"4/16/2022","","Withdrawal ATM Fee/ASAI 3400 B SW 34th St. Gainesville FLCard 2801","2","","Posted","280.3"
"4/16/2022","","Withdrawal at ATM #000000001554/ASAI 3400 B SW 34th St. Gainesville FLCard 2801","92.75","","Posted","282.3"
"4/16/2022","","Deposit Home Banking Transfer - From Share 0000/Funds Transfer via Online","","75","Posted","375.05"
"4/15/2022","","Withdrawal ACH PAYPAL/TYPE: INST XFER ID: PAYPALSI77CO: PAYPAL NAME: STEVEN CHAPLINSKIEntry Class Code: WEB","18.24","","Posted","300.05"
"4/15/2022","","Withdrawal POS #000000930774/FAST TRACK #200 3960 SW ARCHER RDGAINESVILLE FLCard 2801","30.97","","Posted","318.29"
"4/15/2022","","Recurring Withdrawal Bill Payment - #000000254133/AFFIRM PAY O725AJ97 SAN FRANCISCO CACard 2801","26.92","","Posted","349.26"
"4/12/2022","","Withdrawal Debit Card MC Debit/YVETTE GODET DMD GAINESVILLE FLDate 04/11/22 0 2101019240 1 8021Card 2801","35.8","","Posted","376.18"
"4/12/2022","","Withdrawal Debit Card MC Debit/WALGREENS #5024 800-289-2273 FLDate 04/11/22 0 2101016047 1 5912Card 2801","20.92","","Posted","411.98"
"4/12/2022","","Recurring Withdrawal Debit Card MC Debit/PAYPAL *LINKTREEPTY 4029357733 CADate 04/11/22 0 2101984105 0 5734Card 2801","6","","Posted","432.9"
"4/12/2022","","Withdrawal ACH PAYPAL/TYPE: INST XFER ID: PAYPALSI77CO: PAYPAL NAME: STEVEN CHAPLINSKIEntry Class Code: WEB","9.99","","Posted","438.9"
"4/11/2022","","Withdrawal POS #000000000072/CIRCLE K # 06782 5237 GAINESVILLE FLCard 2801","24.65","","Posted","448.89"
"4/11/2022","","Withdrawal POS #000014436615/WALGREENS 2415 SW 75TH GAINESVILLE FLCard 2801","8.56","","Posted","473.54"
"4/11/2022","","Deposit Home Banking Transfer - From Share 0000/Funds Transfer via Mobile","","200","Posted","482.1"
"4/11/2022","","Withdrawal ACH PAYPAL INC./CO: PAYPAL INC.TYPE: IAT PAYPAL ID: 770510487CEntry Class Code: IAT","20","","Posted","282.1"
"4/11/2022","","Withdrawal ACH PAYPAL/TYPE: INST XFER ID: PAYPALSI77CO: PAYPAL NAME: STEVEN CHAPLINSKIEntry Class Code: WEB","6.75","","Posted","302.1"
"4/9/2022","","Deposit POS #000000016903/PAYPAL*chaplinski stev San Jose CACard 2801","","59.1","Posted","308.85"
"4/8/2022","","Withdrawal POS #000007043708/PAYPAL *VIDIQ San Jose CACard 2801","10","","Posted","249.75"
"4/7/2022","","Withdrawal POS #000000922694/AMAZON.COM*1H1WA7880 SEATTLE WACard 2801","10.87","","Posted","259.75"
"4/6/2022","","Withdrawal POS #000000000067/CIRCLE K # 26146 3525 GAINESVILLE FLCard 2801","24.76","","Posted","270.62"
"4/6/2022","","Withdrawal ATM Fee/ASAI 3400 B SW 34th St. Gainesville FLCard 2801","2","","Posted","295.38"
"4/6/2022","","Withdrawal at ATM #000000000388/ASAI 3400 B SW 34th St. Gainesville FLCard 2801","137.75","","Posted","297.38"
"4/6/2022","","Withdrawal Debit Card MC Debit/WALGREENS #5024 800-289-2273 FLDate 04/05/22 0 2095019278 1 5912Card 2801","29.15","","Posted","435.13"
"4/6/2022","","Recurring Withdrawal Bill Payment - #000008370732/NETFLIX COM LOS GATOS CACard 2801","10.98","","Posted","464.28"
"4/5/2022","","Withdrawal POS #000000517521/SUNOCO 8002212501 4234 SW 20TH AVEGAINESVILLE FLCard 2801","23.82","","Posted","475.26"
"4/5/2022","","Withdrawal Debit Card MC Debit/GRU/EZ-PAY WEB PYMT 352-334-3434 FLDate 04/04/22 0 2094304849 0 4900Card 2801","181.6","","Posted","499.08"
"4/5/2022","","Withdrawal Debit Card MC Debit/COX GAINESVILLE COMM 800-234-3993 FLDate 04/04/22 0 2094304808 0 4899Card 2801","115.39","","Posted","680.68"
"4/5/2022","","Withdrawal ACH PAYPAL/TYPE: INST XFER ID: PAYPALSI77CO: PAYPAL NAME: STEVEN CHAPLINSKIEntry Class Code: WEB","37.04","","Posted","796.07"
"4/5/2022","","Withdrawal ACH PAYPAL/TYPE: INST XFER ID: PAYPALSI77CO: PAYPAL NAME: STEVEN CHAPLINSKIEntry Class Code: WEB","36.51","","Posted","833.11"
"4/5/2022","","Withdrawal ACH PAYPAL/TYPE: INST XFER ID: PAYPALSI77CO: PAYPAL NAME: STEVEN CHAPLINSKIEntry Class Code: WEB","14.95","","Posted","869.62"
"4/4/2022","","Withdrawal ACH BARCLAYCARD US/TYPE: CREDITCARD ID: 2510407970CO: BARCLAYCARD USNAME: STEVEN CHAPLINSKIEntry Class Code: WEB","68.77","","Posted","884.57"
"4/4/2022","","Withdrawal ACH CAPITAL ONE/TYPE: MOBILE PMT ID: 9279744980CO: CAPITAL ONE NAME: STEVEN CHAPLINSKIEntry Class Code: WEB","55","","Posted","953.34"
"4/4/2022","","Withdrawal ACH APPLECARD GSBANK/TYPE: PAYMENT ID: 9999999999CO: APPLECARD GSBANKNAME: Steven ChaplinskiEntry Class Code: WEB","25","","Posted","1008.34"
"4/4/2022","","Withdrawal Debit Card MC Debit/ZIP.CO* NEWEGG NEW YORK NYDate 04/03/22 0 2093025644 1 5399Card 2801","42.76","","Posted","1033.34"
"4/4/2022","","Withdrawal ACH Watson Realty Co/TYPE: WEB PMTS ID: 9000321157CO: Watson Realty CoNAME: Steven chaplinskiEntry Class Code: WEB","885","","Posted","1076.1"
"4/4/2022","","Withdrawal ACH DISCOVER/TYPE: E-PAYMENT ID: 2510020270CO: DISCOVER NAME: CHAPLINSKI STEVENEntry Class Code: WEB","33","","Posted","1961.1"
"4/4/2022","","Withdrawal ACH PAYPAL/TYPE: INST XFER ID: PAYPALSI77CO: PAYPAL NAME: STEVEN CHAPLINSKIEntry Class Code: WEB","24.97","","Posted","1994.1"
"4/4/2022","","Withdrawal ACH PAYPAL/TYPE: INST XFER ID: PAYPALSI77CO: PAYPAL NAME: STEVEN CHAPLINSKIEntry Class Code: WEB","14.99","","Posted","2019.07"
"4/4/2022","","Withdrawal ACH PAYPAL/TYPE: INST XFER ID: PAYPALSI77CO: PAYPAL NAME: STEVEN CHAPLINSKIEntry Class Code: WEB","2.99","","Posted","2034.06"
"4/3/2022","","Withdrawal Debit Card MC Debit/WALGREENS #5024 800-289-2273 FLDate 04/01/22 0 2091305278 2 5912Card 2801","23.56","","Posted","2037.05"
"4/1/2022","","Withdrawal POS #000000389731/FAST TRACK #200 3960 SW ARCHER RDGAINESVILLE FLCard 2801","18.79","","Posted","2060.61"
"4/1/2022","","Withdrawal POS #000000745669/PUBLIX 3930 SW ARCHER ROA GAINESVILLE FLCard 2801","51.65","","Posted","2079.4"
"4/1/2022","","Withdrawal ACH PAYPAL/TYPE: INST XFER ID: PAYPALSI77CO: PAYPAL NAME: STEVEN CHAPLINSKIEntry Class Code: WEB","18.24","","Posted","2131.05"
"3/31/2022","","Deposit Home Banking Transfer trf/From CHAPLINSKI,LEON 3496297 Share 0090","","2000","Posted","2149.29"
"3/31/2022","","Withdrawal ACH PAYPAL/TYPE: INST XFER ID: PAYPALSI77CO: PAYPAL NAME: STEVEN CHAPLINSKIEntry Class Code: WEB","49","","Posted","149.29"
"3/30/2022","","Withdrawal POS #000000247486/SUNOCO 8002212501 4234 SW 20TH AVEGAINESVILLE FLCard 2801","23.82","","Posted","198.29"
"3/29/2022","","Withdrawal ACH PAYPAL/TYPE: INST XFER ID: PAYPALSI77CO: PAYPAL NAME: STEVEN CHAPLINSKIEntry Class Code: WEB","11.48","","Posted","222.11"
"3/29/2022","","Withdrawal ACH PAYPAL/TYPE: INST XFER ID: PAYPALSI77CO: PAYPAL NAME: STEVEN CHAPLINSKIEntry Class Code: WEB","2.99","","Posted","233.59"
"3/28/2022","","Withdrawal ACH CANVA PTY LIMITE/CO: CANVA PTY LIMITEDTYPE: IAT PAYPAL ID: 770510487CEntry Class Code: IAT","12.99","","Posted","236.58"
"3/28/2022","","Withdrawal ACH PAYPAL/TYPE: INST XFER ID: PAYPALSI77CO: PAYPAL NAME: STEVEN CHAPLINSKIEntry Class Code: WEB","19.99","","Posted","249.57"
"3/28/2022","","Withdrawal ACH PAYPAL/TYPE: INST XFER ID: PAYPALSI77CO: PAYPAL NAME: STEVEN CHAPLINSKIEntry Class Code: WEB","15.15","","Posted","269.56"
"3/28/2022","","Withdrawal ACH PAYPAL/TYPE: INST XFER ID: PAYPALSI77CO: PAYPAL NAME: STEVEN CHAPLINSKIEntry Class Code: WEB","8.89","","Posted","284.71"
"3/28/2022","","Withdrawal ACH PAYPAL/TYPE: INST XFER ID: PAYPALSI77CO: PAYPAL NAME: STEVEN CHAPLINSKIEntry Class Code: WEB","4.5","","Posted","293.6"
"3/28/2022","","Withdrawal ACH PAYPAL/TYPE: INST XFER ID: PAYPALSI77CO: PAYPAL NAME: STEVEN CHAPLINSKIEntry Class Code: WEB","2.99","","Posted","298.1"
"3/28/2022","","Deposit ACH PAYPAL/TYPE: TRANSFER ID: PAYPALSD11 CO: PAYPALEntry Class Code: PPD","","19.99","Posted","301.09"
"3/27/2022","","Recurring Withdrawal Debit Card MC Debit/HELP.HBOMAX.COM NEW YORK NYDate 03/27/22 0 2086013781 1 5815Card 2801","17.23","","Posted","281.1"
"3/25/2022","","Withdrawal at ATM #000000000601/Gainesville Inn 1250 W UniversityGainesville FLCard 2801","108.5","","Posted","298.33"
"3/25/2022","","Withdrawal POS #000000143143/GATE 1445 506 NW 13TH GAINESVILLE FLCard 2801","15.22","","Posted","406.83"
"3/25/2022","","Deposit Home Banking Transfer - From Share 0000/Funds Transfer via Mobile","","200","Posted","422.05"
"3/25/2022","","Withdrawal Debit Card MC Debit/KINDLE UNLTD*1N4IN7U80 866-321-8851 WADate 03/24/22 0 2083036398 1 5818Card 2801","9.99","","Posted","222.05"
"3/25/2022","","Withdrawal ACH PAYPAL INC./CO: PAYPAL INC.TYPE: IAT PAYPAL ID: 770510487CEntry Class Code: IAT","5","","Posted","232.04"
"3/25/2022","","Withdrawal ACH PAYPAL/TYPE: INST XFER ID: PAYPALSI77CO: PAYPAL NAME: STEVEN CHAPLINSKIEntry Class Code: WEB","49","","Posted","237.04"
"3/24/2022","","Withdrawal POS #000000193528/AMAZON.COM*169EL7T31 SEATTLE WACard 2801","10.87","","Posted","286.04"
"3/22/2022","","Withdrawal Debit Card MC Debit/PUBLIX #1376 GAINESVILLE FLDate 03/21/22 0 2080977324 0 5411Card 2801","18.17","","Posted","296.91"
"3/22/2022","","Withdrawal ACH PAYPAL/TYPE: INST XFER ID: PAYPALSI77CO: PAYPAL NAME: STEVEN CHAPLINSKIEntry Class Code: WEB","19.99","","Posted","315.08"
"3/21/2022","","Withdrawal POS #000000000107/CIRCLE K # 01313 4221 GAINESVILLE FLCard 2801","37.27","","Posted","335.07"
"3/21/2022","","Withdrawal ACH PAYPAL/TYPE: INST XFER ID: PAYPALSI77CO: PAYPAL NAME: STEVEN CHAPLINSKIEntry Class Code: WEB","70.03","","Posted","372.34"
"3/21/2022","","Withdrawal ACH PAYPAL/TYPE: INST XFER ID: PAYPALSI77CO: PAYPAL NAME: STEVEN CHAPLINSKIEntry Class Code: WEB","11.99","","Posted","442.37"
"3/20/2022","","Withdrawal Debit Card MC Debit/PUBLIX #1312 GAINESVILLE FLDate 03/19/22 0 2078423092 1 5411Card 2801","91.88","","Posted","454.36"
"3/19/2022","","Withdrawal POS #000000773167/SUNOCO 8002212501 4234 SW 20TH AVEGAINESVILLE FLCard 2801","19.54","","Posted","546.24"
"3/18/2022","","Withdrawal ACH PAYPAL/TYPE: INST XFER ID: PAYPALSI77CO: PAYPAL NAME: STEVEN CHAPLINSKIEntry Class Code: WEB","18.24","","Posted","565.78"
"3/17/2022","","Withdrawal ACH PAYPAL/TYPE: INST XFER ID: PAYPALSI77CO: PAYPAL NAME: STEVEN CHAPLINSKIEntry Class Code: WEB","19.99","","Posted","584.02"
"3/16/2022","","Withdrawal Debit Card MC Debit/PUBLIX #435 GAINESVILLE FLDate 03/15/22 0 2074063906 1 5411Card 2801","58.14","","Posted","604.01"
"3/15/2022","","Withdrawal POS #000000576488/SUNOCO 8002212501 4234 SW 20TH AVEGAINESVILLE FLCard 2801","19.54","","Posted","662.15"
"3/15/2022","","Withdrawal ACH PAYPAL INC./CO: PAYPAL INC.TYPE: IAT PAYPAL ID: 770510487CEntry Class Code: IAT","8.9","","Posted","681.69"
"3/15/2022","","Withdrawal POS #000000186025/AMAZON.COM*1N8QH9FJ1 SEATTLE WACard 2801","10.87","","Posted","690.59"
"3/14/2022","","Withdrawal POS #000000000003/AMAZON.COM*1Z8447YO1 SEATTLE WACard 2801","22.88","","Posted","701.46"
"3/14/2022","","Withdrawal Debit Card MC Debit/PUBLIX #1312 GAINESVILLE FLDate 03/13/22 0 2072901006 0 5411Card 2801","64.48","","Posted","724.34"
"3/14/2022","","Withdrawal ACH PAYPAL/TYPE: INST XFER ID: PAYPALSI77CO: PAYPAL NAME: STEVEN CHAPLINSKIEntry Class Code: WEB","9.99","","Posted","788.82"
"3/13/2022","","Withdrawal ATM Fee/ASAI 3400 B SW 34th St. Gainesville FLCard 2801","2","","Posted","798.81"
"3/13/2022","","Withdrawal at ATM #000000000151/ASAI 3400 B SW 34th St. Gainesville FLCard 2801","97.75","","Posted","800.81"
"3/13/2022","","Deposit Home Banking Transfer - From Share 0000/Funds Transfer via Mobile","","500","Posted","898.56"
"3/13/2022","","Withdrawal POS #000000519839/FAST TRACK #200 3960 SW ARCHER RDGAINESVILLE FLCard 2801","21.67","","Posted","398.56"
"3/13/2022","","Recurring Withdrawal Debit Card MC Debit/PAYPAL *LINKTREEPTY 4029357733 CADate 03/11/22 0 2070556529 1 5734Card 2801","6","","Posted","420.23"
"3/10/2022","","Withdrawal Debit Card MC Debit/PRIME VIDEO*1Z06F6ZI0 888-802-3080 WADate 03/10/22 0 2069976770 0 5818Card 2801","4.53","","Posted","426.23"
"3/10/2022","","Withdrawal ACH PAYPAL INC./CO: PAYPAL INC.TYPE: IAT PAYPAL ID: 770510487CEntry Class Code: IAT","20","","Posted","430.76"
"3/10/2022","","Withdrawal ACH PAYPAL/TYPE: INST XFER ID: PAYPALSI77CO: PAYPAL NAME: STEVEN CHAPLINSKIEntry Class Code: WEB","15","","Posted","450.76"
"3/10/2022","","Withdrawal ACH PAYPAL/TYPE: INST XFER ID: PAYPALSI77CO: PAYPAL NAME: STEVEN CHAPLINSKIEntry Class Code: WEB","10","","Posted","465.76"
"3/9/2022","","Withdrawal Debit Card MC Debit/SUNOCO 8002212501 QPS GAINESVILLE FLDate 03/08/22 0 2067990525 0 5541Card 2801","23.82","","Posted","475.76"
"3/8/2022","","Withdrawal POS #000006282715/PAYPAL *VIDIQ San Jose CACard 2801","10","","Posted","499.58"
"3/8/2022","","Withdrawal Debit Card MC Debit/CANNAMD 855-4209170 FLDate 03/07/22 0 2066971853 0 8011Card 2801","195","","Posted","509.58"
"3/8/2022","","Withdrawal Debit Card MC Debit/PUBLIX #795 GAINESVILLE FLDate 03/07/22 0 2066965570 0 5411Card 2801","49.26","","Posted","704.58"
"3/8/2022","","Withdrawal Debit Card MC Debit/WALGREENS #5024 800-289-2273 FLDate 03/07/22 0 2066962196 0 5912Card 2801","19.83","","Posted","753.84"
"3/8/2022","","Withdrawal POS #000045519887/NNT URGENTVET - GAI002555 2680 CLARKBUTLER GAINESVILLE FLCard 2801","560.61","","Posted","773.67"
"3/7/2022","","Deposit POS #000000808676/PAYPAL*chaplinski stev San Jose CACard 2801","","142.82","Posted","1334.28"
"3/7/2022","","Deposit POS #000000889705/PAYPAL*chaplinski stev San Jose CACard 2801","","132.97","Posted","1191.46"
"3/7/2022","","Withdrawal Debit Card MC Debit/OCALA SNACK VENDING GAINESVILLE FLDate 03/06/22 0 2065060173 1 5814Card 2801","2.1","","Posted","1058.49"
"3/7/2022","","Withdrawal ACH PAYPAL/TYPE: INST XFER ID: PAYPALSI77CO: PAYPAL NAME: STEVEN CHAPLINSKIEntry Class Code: WEB","59.99","","Posted","1060.59"
"3/7/2022","","Withdrawal ACH PAYPAL/TYPE: INST XFER ID: PAYPALSI77CO: PAYPAL NAME: STEVEN CHAPLINSKIEntry Class Code: WEB","14.95","","Posted","1120.58"
"3/7/2022","","Withdrawal ACH PAYPAL/TYPE: INST XFER ID: PAYPALSI77CO: PAYPAL NAME: STEVEN CHAPLINSKIEntry Class Code: WEB","12","","Posted","1135.53"
"3/7/2022","","Withdrawal ACH PAYPAL/TYPE: INST XFER ID: PAYPALSI77CO: PAYPAL NAME: STEVEN CHAPLINSKIEntry Class Code: WEB","1.99","","Posted","1147.53"
"3/7/2022","","Withdrawal ACH PAYPAL/TYPE: INST XFER ID: PAYPALSI77CO: PAYPAL NAME: STEVEN CHAPLINSKIEntry Class Code: WEB","1.99","","Posted","1149.52"
"3/7/2022","","Deposit Home Banking Transfer - From Share 0000/Funds Transfer via Mobile","","950","Posted","1151.51"
"3/6/2022","","Recurring Withdrawal Bill Payment - #000006911729/NETFLIX COM LOS GATOS CACard 2801","10.98","","Posted","201.51"
"3/4/2022","","Withdrawal Debit Card MC Debit/COX GAINESVILLE COMM 800-234-3993 FLDate 03/03/22 0 2062854829 0 4899Card 2801","95.39","","Posted","212.49"
"3/4/2022","","Withdrawal ACH CAPITAL ONE/TYPE: MOBILE PMT ID: 9279744980CO: CAPITAL ONE NAME: STEVEN CHAPLINSKIEntry Class Code: WEB","55","","Posted","307.88"
"3/4/2022","","Withdrawal ACH BARCLAYCARD US/TYPE: CREDITCARD ID: 2510407970CO: BARCLAYCARD USNAME: STEVEN CHAPLINSKIEntry Class Code: WEB","50","","Posted","362.88"
"3/4/2022","","Withdrawal POS #000000000216/CIRCLE K # 26146 3525 GAINESVILLE FLCard 2801","17.27","","Posted","412.88"
"3/4/2022","","Withdrawal ATM Transaction","125","","Posted","430.15"
"3/4/2022","","Withdrawal ACH PAYPAL/TYPE: INST XFER ID: PAYPALSI77CO: PAYPAL NAME: STEVEN CHAPLINSKIEntry Class Code: WEB","79","","Posted","555.15"
"3/4/2022","","Withdrawal ACH TARGET CARD SRVC/TYPE: BILL PAY ID: T510215170CO: TARGET CARD SRVCNAME: 7S CH0000000APLINSKI TEntry Class Code: WEB","75","","Posted","634.15"
"3/4/2022","","Withdrawal ACH WAWA CREDIT CARD/TYPE: PAYMENT ID: CITIGPUFDRCO: WAWA CREDIT CARDEntry Class Code: PPD","63","","Posted","709.15"
"3/4/2022","","Withdrawal ACH DISCOVER/TYPE: E-PAYMENT ID: 2510020270CO: DISCOVER NAME: CHAPLINSKI STEVENEntry Class Code: WEB","60","","Posted","772.15"
"3/4/2022","","Withdrawal ACH PAYPAL/TYPE: INST XFER ID: PAYPALSI77CO: PAYPAL NAME: STEVEN CHAPLINSKIEntry Class Code: WEB","14.99","","Posted","832.15"
"3/4/2022","","Withdrawal ACH PAYPAL/TYPE: INST XFER ID: PAYPALSI77CO: PAYPAL NAME: STEVEN CHAPLINSKIEntry Class Code: WEB","14.95","","Posted","847.14"
"3/4/2022","","Withdrawal ACH PAYPAL/TYPE: INST XFER ID: PAYPALSI77CO: PAYPAL NAME: STEVEN CHAPLINSKIEntry Class Code: WEB","2.99","","Posted","862.09"
"3/3/2022","","Withdrawal Debit Card MC Debit/WALGREENS #5024 800-289-2273 FLDate 03/02/22 0 2061067429 1 5912Card 2801","15","","Posted","865.08"
"3/3/2022","","Withdrawal ACH PAYMENT FOR AMZ/TYPE: STORECARD ID: 9069872103CO: PAYMENT FOR AMZNAME: 6045781157416487Entry Class Code: WEB","197","","Posted","880.08"
"3/2/2022","","Withdrawal POS #000018259061/WALGREENS 2415 SW 75TH GAINESVILLE FLCard 2801","12.29","","Posted","1077.08"
"3/2/2022","","Withdrawal ACH BEST BUY/TYPE: PAYMENT ID: CITIGPUFDRCO: BEST BUYEntry Class Code: PPD","200","","Posted","1089.37"
"3/2/2022","","Withdrawal ACH APPLECARD GSBANK/TYPE: PAYMENT ID: 9999999999CO: APPLECARD GSBANKNAME: Steven ChaplinskiEntry Class Code: WEB","150","","Posted","1289.37"
"3/2/2022","","Withdrawal ACH BARCLAYCARD US/TYPE: CREDITCARD ID: 2510407970CO: BARCLAYCARD USNAME: STEVEN CHAPLINSKIEntry Class Code: WEB","77.79","","Posted","1439.37"
"3/2/2022","","Withdrawal ACH CAPITAL ONE/TYPE: MOBILE PMT ID: 9279744980CO: CAPITAL ONE NAME: STEVEN CHAPLINSKIEntry Class Code: WEB","25","","Posted","1517.16"
"3/2/2022","","Withdrawal ACH Watson Realty Co/TYPE: WEB PMTS ID: 9000321157CO: Watson Realty CoNAME: Steven chaplinskiEntry Class Code: WEB","885","","Posted","1542.16"
"3/2/2022","","Withdrawal ACH BEST BUY/TYPE: PAYMENT ID: CITIGPUFDRCO: BEST BUYEntry Class Code: PPD","132.3","","Posted","2427.16"
"3/2/2022","","Withdrawal ACH PAYPAL/TYPE: INST XFER ID: PAYPALSI77CO: PAYPAL NAME: STEVEN CHAPLINSKIEntry Class Code: WEB","59","","Posted","2559.46"
"3/2/2022","","Withdrawal ACH DISCOVER/TYPE: E-PAYMENT ID: 2510020270CO: DISCOVER NAME: CHAPLINSKI STEVENEntry Class Code: WEB","35","","Posted","2618.46"
"3/1/2022","","Withdrawal POS #000000000550/CIRCLE K # 06782 5237 GAINESVILLE FLCard 2801","20","","Posted","2653.46"
"3/1/2022","","Withdrawal POS #000013115732/WALGREENS 2415 SW 75TH GAINESVILLE FLCard 2801","40.63","","Posted","2673.46"
"3/1/2022","","Withdrawal ACH PAYPAL/TYPE: INST XFER ID: PAYPALSI77CO: PAYPAL NAME: STEVEN CHAPLINSKIEntry Class Code: WEB","49","","Posted","2714.09"
"3/1/2022","","Withdrawal ACH PAYPAL/TYPE: INST XFER ID: PAYPALSI77CO: PAYPAL NAME: STEVEN CHAPLINSKIEntry Class Code: WEB","11.48","","Posted","2763.09"
"3/1/2022","","Withdrawal ACH PAYPAL/TYPE: INST XFER ID: PAYPALSI77CO: PAYPAL NAME: STEVEN CHAPLINSKIEntry Class Code: WEB","2.99","","Posted","2774.57"
"2/28/2022","","Withdrawal Debit Card MC Debit/WALGREENS #5024 800-289-2273 FLDate 02/27/22 0 2058964465 0 5912Card 2801","18.32","","Posted","2777.56"
"2/28/2022","","Withdrawal ACH CANVA PTY LIMITE/CO: CANVA PTY LIMITEDTYPE: IAT PAYPAL ID: 770510487CEntry Class Code: IAT","12.99","","Posted","2795.88"
"2/28/2022","","Withdrawal ACH PAYPAL/TYPE: INST XFER ID: PAYPALSI77CO: PAYPAL NAME: STEVEN CHAPLINSKIEntry Class Code: WEB","13.13","","Posted","2808.87"
"2/28/2022","","Withdrawal ACH PAYPAL/TYPE: INST XFER ID: PAYPALSI77CO: PAYPAL NAME: STEVEN CHAPLINSKIEntry Class Code: WEB","8.89","","Posted","2822"
"2/28/2022","","Withdrawal ACH PAYPAL/TYPE: INST XFER ID: PAYPALSI77CO: PAYPAL NAME: STEVEN CHAPLINSKIEntry Class Code: WEB","4.5","","Posted","2830.89"
"2/28/2022","","Withdrawal ACH PAYPAL/TYPE: INST XFER ID: PAYPALSI77CO: PAYPAL NAME: STEVEN CHAPLINSKIEntry Class Code: WEB","2.99","","Posted","2835.39"
"2/27/2022","","Withdrawal POS #000000238565/SUNOCO 8002212501 4234 SW 20TH AVEGAINESVILLE FLCard 2801","23.82","","Posted","2838.38"
"2/27/2022","","Recurring Withdrawal Debit Card MC Debit/HELP.HBOMAX.COM NEW YORK NYDate 02/27/22 0 2058092418 1 5815Card 2801","17.23","","Posted","2862.2"
"2/27/2022","","Withdrawal Debit Card MC Debit/GRU/EZ-PAY WEB PYMT 352-334-3434 FLDate 02/25/22 0 2056621461 0 4900Card 2801","220.97","","Posted","2879.43"
"2/25/2022","","Withdrawal Debit Card MC Debit/KINDLE UNLTD*1B3UF0UI2 866-321-8851 WADate 02/24/22 0 2055055205 1 5818Card 2801","9.99","","Posted","3100.4"
"2/24/2022","","Withdrawal POS #000000000004/AMAZON.COM*1I2DX3EV0 SEATTLE WACard 2801","10.87","","Posted","3110.39"
"2/24/2022","","Deposit Home Banking Transfer trf/From CHAPLINSKI,LEON 3496297 Share 0090","","2000","Posted","3121.26"
"2/23/2022","","Withdrawal POS #000000732083/PUBLIX 3930 SW ARCHER ROA GAINESVILLE FLCard 2801","35.49","","Posted","1121.26"
"2/23/2022","","Withdrawal Debit Card MC Debit/PRIME VIDEO*QI3ZR57V3 888-802-3080 WADate 02/22/22 0 2053875656 0 5818Card 2801","9.99","","Posted","1156.75"
"2/23/2022","","Withdrawal Debit Card MC Debit/PRIME VIDEO*DF3LU6DP3 888-802-3080 WADate 02/22/22 0 2053875651 0 5818Card 2801","9.99","","Posted","1166.74"
"2/22/2022","","Withdrawal ACH PAYPAL/TYPE: INST XFER ID: PAYPALSI77CO: PAYPAL NAME: STEVEN CHAPLINSKIEntry Class Code: WEB","39.98","","Posted","1176.73"
"2/22/2022","","Withdrawal ACH PAYPAL/TYPE: INST XFER ID: PAYPALSI77CO: PAYPAL NAME: STEVEN CHAPLINSKIEntry Class Code: WEB","11.99","","Posted","1216.71"
"2/21/2022","","Withdrawal POS #000000129608/FAST TRACK #200 3960 SW ARCHER RDGAINESVILLE FLCard 2801","21.67","","Posted","1228.7"
"2/21/2022","","Withdrawal POS #000000089340/PUBLIX 3930 SW ARCHER ROA GAINESVILLE FLCard 2801","54.95","","Posted","1250.37"
"2/20/2022","","Withdrawal Debit Card MC Debit/PRIME VIDEO*1I03U0LH1 888-802-3080 WADate 02/19/22 0 2050297887 0 5818Card 2801","9.99","","Posted","1305.32"
"2/20/2022","","Withdrawal Debit Card MC Debit/PRIME VIDEO*4V7RJ4QL3 888-802-3080 WADate 02/18/22 0 2049172668 2 5818Card 2801","7.99","","Posted","1315.31"
"2/17/2022","","Withdrawal POS #000000000029/CIRCLE K # 26146 3525 GAINESVILLE FLCard 2801","30.07","","Posted","1323.3"
"2/17/2022","","Withdrawal ATM Fee/ASAI 3400 B SW 34th St. Gainesville FLCard 2801","2","","Posted","1353.37"
"2/17/2022","","Withdrawal at ATM #000000000624/ASAI 3400 B SW 34th St. Gainesville FLCard 2801","72.75","","Posted","1355.37"
"2/17/2022","","Withdrawal ACH TARGET CARD SRVC/TYPE: BILL PAY ID: T510215170CO: TARGET CARD SRVCNAME: 7S CH0000000APLINSKI TEntry Class Code: WEB","100","","Posted","1428.12"
"2/16/2022","","Withdrawal POS #000000730199/PUBLIX 3930 SW ARCHER ROA GAINESVILLE FLCard 2801","32.28","","Posted","1528.12"
"2/14/2022","","Withdrawal ACH PAYPAL/TYPE: INST XFER ID: PAYPALSI77CO: PAYPAL NAME: STEVEN CHAPLINSKIEntry Class Code: WEB","9.99","","Posted","1560.4"
"2/13/2022","","Recurring Withdrawal Debit Card MC Debit/PAYPAL *LINKTREEPTY 4029357733 CADate 02/11/22 0 2042196699 1 5734Card 2801","6","","Posted","1570.39"
"2/11/2022","","Withdrawal Debit Card MC Debit/YVETTE GODET DMD GAINESVILLE FLDate 02/09/22 0 2040046562 1 8021Card 2801","309.8","","Posted","1576.39"
"2/10/2022","","Withdrawal POS #000000000000/AMAZON.COM*OY9RM3IQ3 SEATTLE WACard 2801","10.69","","Posted","1886.19"
"2/10/2022","","Withdrawal POS #000000000015/AMAZON.COM*QT8AR01Y3 SEATTLE WACard 2801","10.87","","Posted","1896.88"
"2/10/2022","","Withdrawal POS #000000338900/AMAZON.COM*AD9WT2H83 SEATTLE WACard 2801","42.9","","Posted","1907.75"
"2/10/2022","","Withdrawal POS #000000342204/AMAZON.COM*PJ37R3343 SEATTLE WACard 2801","6.41","","Posted","1950.65"
"2/10/2022","","Withdrawal Adjustment POS #000000000000/AMAZON.COM SEATTLE WACard 2801","","42.9","Posted","1957.06"
"2/10/2022","","Withdrawal POS #000000319757/AMAZON.COM*7M3MV8SV3 SEATTLE WACard 2801","42.9","","Posted","1914.16"
"2/9/2022","","Deposit Home Banking Transfer trf/From CHAPLINSKI,LEON 3496297 Share 0090","","360","Posted","1957.06"
"2/9/2022","","Withdrawal POS #000000543099/SUNOCO 8002212501 4234 SW 20TH AVEGAINESVILLE FLCard 2801","23.82","","Posted","1597.06"
"2/9/2022","","Deposit Home Banking Transfer - From Share 0000/Funds Transfer via Mobile","","1000","Posted","1620.88"
"2/9/2022","","Deposit ACH PAYPAL/TYPE: TRANSFER ID: PAYPALSD11 CO: PAYPALEntry Class Code: PPD","","63.67","Posted","620.88"
"2/8/2022","","Withdrawal POS #000000021622/PUBLIX 3100 SW 35TH BLVD GAINESVILLE FLCard 2801","3.44","","Posted","557.21"
"2/8/2022","","Withdrawal POS #000000024721/PUBLIX 3930 SW ARCHER ROA GAINESVILLE FLCard 2801","39.62","","Posted","560.65"
"2/8/2022","","Withdrawal POS #000000000122/CIRCLE K # 26146 3525 GAINESVILLE FLCard 2801","22.43","","Posted","600.27"
"2/8/2022","","Withdrawal ACH PAYPAL/TYPE: INST XFER ID: PAYPALSI77CO: PAYPAL NAME: STEVEN CHAPLINSKIEntry Class Code: WEB","162.93","","Posted","622.7"
"2/8/2022","","Withdrawal ACH PAYPAL/TYPE: INST XFER ID: PAYPALSI77CO: PAYPAL NAME: STEVEN CHAPLINSKIEntry Class Code: WEB","3.05","","Posted","785.63"
"2/8/2022","","Withdrawal Bill Payment #000005023648/PAYPAL *VIDIQ San Jose CACard 2801","10","","Posted","788.68"
"2/8/2022","","Deposit ACH PAYPAL/TYPE: TRANSFER ID: PAYPALSD11 CO: PAYPALEntry Class Code: PPD","","10.29","Posted","798.68"
"2/7/2022","","Withdrawal Debit Card MC Debit/WALGREENS #5024 800-289-2273 FLDate 02/06/22 0 2037175384 1 5912Card 2801","12.59","","Posted","788.39"
"2/7/2022","","Recurring Withdrawal Debit Card MC Debit/NETFLIX.COM CADate 02/07/22 0 2038364942 1 4899Card 2801","10.98","","Posted","800.98"
"2/7/2022","","Withdrawal ACH PAYPAL/TYPE: INST XFER ID: PAYPALSI77CO: PAYPAL NAME: STEVEN CHAPLINSKIEntry Class Code: WEB","67.8","","Posted","811.96"
"2/7/2022","","Withdrawal ACH PAYPAL/TYPE: INST XFER ID: PAYPALSI77CO: PAYPAL NAME: STEVEN CHAPLINSKIEntry Class Code: WEB","49.99","","Posted","879.76"
"2/7/2022","","Withdrawal ACH PAYPAL/TYPE: INST XFER ID: PAYPALSI77CO: PAYPAL NAME: STEVEN CHAPLINSKIEntry Class Code: WEB","46","","Posted","929.75"
"2/7/2022","","Withdrawal ACH PAYPAL/TYPE: INST XFER ID: PAYPALSI77CO: PAYPAL NAME: STEVEN CHAPLINSKIEntry Class Code: WEB","14.95","","Posted","975.75"
"2/7/2022","","Withdrawal ACH PAYPAL/TYPE: INST XFER ID: PAYPALSI77CO: PAYPAL NAME: STEVEN CHAPLINSKIEntry Class Code: WEB","14.95","","Posted","990.7"
"2/7/2022","","Withdrawal ACH PAYPAL/TYPE: INST XFER ID: PAYPALSI77CO: PAYPAL NAME: STEVEN CHAPLINSKIEntry Class Code: WEB","9","","Posted","1005.65"
"2/6/2022","","Withdrawal POS #000011504557/WALGREENS 2415 SW 75TH GAINESVILLE FLCard 2801","26.8","","Posted","1014.65"
"2/5/2022","","Deposit POS #000000482735/PAYPAL*chaplinski stev San Jose CACard 2801","","75.84","Posted","1041.45"
"2/5/2022","","Deposit POS #000000105511/PAYPAL*chaplinski stev San Jose CACard 2801","","88.65","Posted","965.61"
"2/4/2022","","Withdrawal Debit Card MC Debit/PUBLIX #1312 GAINESVILLE FLDate 02/03/22 0 2034252762 1 5411Card 2801","88.58","","Posted","876.96"
"2/4/2022","","Withdrawal ACH BARCLAYCARD US/TYPE: CREDITCARD ID: 2510407970CO: BARCLAYCARD USNAME: STEVEN CHAPLINSKIEntry Class Code: WEB","287.06","","Posted","965.54"
"2/4/2022","","Withdrawal ACH TARGET CARD SRVC/TYPE: BILL PAY ID: T510215170CO: TARGET CARD SRVCNAME: 7S CH0000000APLINSKI TEntry Class Code: WEB","75","","Posted","1252.6"
"2/4/2022","","Withdrawal ACH PAYPAL/TYPE: INST XFER ID: PAYPALSI77CO: PAYPAL NAME: STEVEN CHAPLINSKIEntry Class Code: WEB","2.99","","Posted","1327.6"
"2/3/2022","","Withdrawal POS #000000274617/FAST TRACK #200 3960 SW ARCHER RDGAINESVILLE FLCard 2801","21.67","","Posted","1330.59"
"2/3/2022","","Deposit ATM Transaction","","76","Posted","1352.26"
"2/2/2022","","Withdrawal Debit Card MC Debit/WALGREENS #5024 800-289-2273 FLDate 02/01/22 0 2032451065 1 5912Card 2801","19.28","","Posted","1276.26"
"2/2/2022","","Withdrawal ACH PAYPAL/TYPE: INST XFER ID: PAYPALSI77CO: PAYPAL NAME: STEVEN CHAPLINSKIEntry Class Code: WEB","10.29","","Posted","1295.54"
"2/2/2022","","Deposit ACH PAYPAL/TYPE: TRANSFER ID: PAYPALSD11 CO: PAYPALEntry Class Code: PPD","","95.17","Posted","1305.83"
"2/2/2022","","Withdrawal POS #000000281965/SUNOCO 8002212501 4234 SW 20TH AVEGAINESVILLE FLCard 2801","23.82","","Posted","1210.66"
"2/1/2022","","Withdrawal ACH APPLECARD GSBANK/TYPE: PAYMENT ID: 9999999999CO: APPLECARD GSBANKNAME: Steven ChaplinskiEntry Class Code: WEB","150","","Posted","1234.48"
"2/1/2022","","Withdrawal ACH CAPITAL ONE/TYPE: MOBILE PMT ID: 9279744980CO: CAPITAL ONE NAME: STEVEN CHAPLINSKIEntry Class Code: WEB","100","","Posted","1384.48"
"2/1/2022","","Withdrawal ACH Watson Realty Co/TYPE: WEB PMTS ID: 9000321157CO: Watson Realty CoNAME: Steven chaplinskiEntry Class Code: WEB","885","","Posted","1484.48"
"2/1/2022","","Withdrawal ACH PAYPAL/TYPE: INST XFER ID: PAYPALSI77CO: PAYPAL NAME: STEVEN CHAPLINSKIEntry Class Code: WEB","126.59","","Posted","2369.48"
"2/1/2022","","Withdrawal ACH DISCOVER/TYPE: E-PAYMENT ID: 2510020270CO: DISCOVER NAME: CHAPLINSKI STEVENEntry Class Code: WEB","100","","Posted","2496.07"
"2/1/2022","","Withdrawal ACH PAYPAL/TYPE: INST XFER ID: PAYPALSI77CO: PAYPAL NAME: STEVEN CHAPLINSKIEntry Class Code: WEB","95.17","","Posted","2596.07"
"2/1/2022","","Withdrawal ACH PAYPAL/TYPE: INST XFER ID: PAYPALSI77CO: PAYPAL NAME: STEVEN CHAPLINSKIEntry Class Code: WEB","60.97","","Posted","2691.24"
"2/1/2022","","Withdrawal ACH PAYPAL/TYPE: INST XFER ID: PAYPALSI77CO: PAYPAL NAME: STEVEN CHAPLINSKIEntry Class Code: WEB","24.99","","Posted","2752.21"
"2/1/2022","","Withdrawal ACH PAYPAL/TYPE: INST XFER ID: PAYPALSI77CO: PAYPAL NAME: STEVEN CHAPLINSKIEntry Class Code: WEB","9.99","","Posted","2777.2"
"2/1/2022","","Withdrawal ACH PAYPAL/TYPE: INST XFER ID: PAYPALSI77CO: PAYPAL NAME: STEVEN CHAPLINSKIEntry Class Code: WEB","3.99","","Posted","2787.19"
"1/31/2022","","Withdrawal ACH TARGET CARD SRVC/TYPE: BILL PAY ID: 5411721813CO: TARGET CARD SRVCNAME: S CHAPLINSKI TEntry Class Code: WEB","200","","Posted","2791.18"
"1/31/2022","","Withdrawal ACH PAYPAL/TYPE: INST XFER ID: PAYPALSI77CO: PAYPAL NAME: STEVEN CHAPLINSKIEntry Class Code: WEB","129.67","","Posted","2991.18"
"1/31/2022","","Withdrawal ACH PAYPAL/TYPE: INST XFER ID: PAYPALSI77CO: PAYPAL NAME: STEVEN CHAPLINSKIEntry Class Code: WEB","59","","Posted","3120.85"
"1/31/2022","","Withdrawal ACH PAYPAL/TYPE: INST XFER ID: PAYPALSI77CO: PAYPAL NAME: STEVEN CHAPLINSKIEntry Class Code: WEB","49","","Posted","3179.85"
"1/31/2022","","Withdrawal ACH PAYPAL/TYPE: INST XFER ID: PAYPALSI77CO: PAYPAL NAME: STEVEN CHAPLINSKIEntry Class Code: WEB","20","","Posted","3228.85"
"1/31/2022","","Withdrawal ACH PAYPAL/TYPE: INST XFER ID: PAYPALSI77CO: PAYPAL NAME: STEVEN CHAPLINSKIEntry Class Code: WEB","11.48","","Posted","3248.85"
"1/31/2022","","Withdrawal ACH PAYPAL/TYPE: INST XFER ID: PAYPALSI77CO: PAYPAL NAME: STEVEN CHAPLINSKIEntry Class Code: WEB","2.99","","Posted","3260.33"
"1/30/2022","","Withdrawal POS #000000171647/FAST TRACK #200 3960 SW ARCHER RDGAINESVILLE FLCard 2801","23.69","","Posted","3263.32"
"1/30/2022","","Withdrawal POS #000000044398/PUBLIX 3930 SW ARCHER ROA GAINESVILLE FLCard 2801","57.47","","Posted","3287.01"
"1/30/2022","","Withdrawal ATM Fee/ASAI 3400 B SW 34th St. Gainesville FLCard 2801","2","","Posted","3344.48"
"1/30/2022","","Withdrawal at ATM #000000001785/ASAI 3400 B SW 34th St. Gainesville FLCard 2801","92.75","","Posted","3346.48"
"1/28/2022","","Withdrawal Debit Card MC Debit/WALGREENS #5024 800-289-2273 FLDate 01/27/22 0 2027311351 1 5912Card 2801","12.97","","Posted","3439.23"
"1/28/2022","","Withdrawal Debit Card MC Debit/GRU/EZ-PAY WEB PYMT 352-334-3434 FLDate 01/27/22 0 2027417961 0 4900Card 2801","219.24","","Posted","3452.2"
"1/28/2022","","Deposit Home Banking Transfer trf/From CHAPLINSKI,LEON 3496297 Share 0090","","2000","Posted","3671.44"
"1/28/2022","","Withdrawal ACH CJS SALES   SERV/CO: CJS SALES SERVICES LIMITEDTYPE: IAT PAYPAL ID: 770510487CEntry Class Code: IAT","14.07","","Posted","1671.44"
"1/28/2022","","Withdrawal ACH PAYMENT FOR AMZ/TYPE: STORECARD ID: 9069872103CO: PAYMENT FOR AMZNAME: 6045781157416487Entry Class Code: WEB","199","","Posted","1685.51"
"1/28/2022","","Withdrawal ACH PAYPAL/TYPE: INST XFER ID: PAYPALSI77CO: PAYPAL NAME: STEVEN CHAPLINSKIEntry Class Code: WEB","37.86","","Posted","1884.51"
"1/28/2022","","Withdrawal ACH PAYPAL/TYPE: INST XFER ID: PAYPALSI77CO: PAYPAL NAME: STEVEN CHAPLINSKIEntry Class Code: WEB","0.9","","Posted","1922.37"
"1/27/2022","","Withdrawal POS #000000127575/GATE 1445 506 NW 13TH GAINESVILLE FLCard 2801","23.3","","Posted","1923.27"
"1/27/2022","","Withdrawal ATM Transaction","300","","Posted","1946.57"
"1/27/2022","","Withdrawal Debit Card MC Debit/PUBLIX #1312 GAINESVILLE FLDate 01/26/22 0 2026245945 1 5411Card 2801","46.48","","Posted","2246.57"
"1/27/2022","","Recurring Withdrawal Debit Card MC Debit/HELP.HBOMAX.COM NEW YORK NYDate 01/27/22 0 2027245862 1 5815Card 2801","17.23","","Posted","2293.05"
"1/27/2022","","Withdrawal Debit Card MC Debit/COX GAINESVILLE COMM 800-234-3993 FLDate 01/27/22 0 2027240681 1 4899Card 2801","95.39","","Posted","2310.28"
"1/27/2022","","Deposit Home Banking Transfer - From Share 0000/Funds Transfer via Online","","1500","Posted","2405.67"
"1/26/2022","","Withdrawal POS #000000969614/FAST TRACK #200 3960 SW ARCHER RDGAINESVILLE FLCard 2801","21.67","","Posted","905.67"
"1/26/2022","","Withdrawal POS #000000034916/PUBLIX 3100 SW 35TH BLVD GAINESVILLE FLCard 2801","31.84","","Posted","927.34"
"1/26/2022","","Withdrawal POS #000000734001/AMAZON.COM*GY8WZ4UH3 SEATTLE WACard 2801","10.87","","Posted","959.18"
"1/26/2022","","Withdrawal ACH PAYMENT FOR AMZ/TYPE: STORECARD ID: 9069872103CO: PAYMENT FOR AMZNAME: 6045781157416487Entry Class Code: WEB","55","","Posted","970.05"
"1/25/2022","","Deposit Home Banking Transfer - From Share 0000/Funds Transfer via Mobile","","850","Posted","1025.05"
"1/25/2022","","Withdrawal Debit Card MC Debit/KINDLE UNLTD*RI6NG8OB3 866-321-8851 WADate 01/24/22 0 2024161795 1 5818Card 2801","9.99","","Posted","175.05"
"1/25/2022","","Withdrawal ACH BEST BUY/TYPE: PAYMENT ID: CITIGPUFDRCO: BEST BUYEntry Class Code: PPD","65","","Posted","185.04"
"1/25/2022","","Withdrawal ACH BARCLAYCARD US/TYPE: CREDITCARD ID: 2510407970CO: BARCLAYCARD USNAME: STEVEN CHAPLINSKIEntry Class Code: WEB","55","","Posted","250.04"
"1/25/2022","","Withdrawal ACH CAPITAL ONE/TYPE: MOBILE PMT ID: 9279744980CO: CAPITAL ONE NAME: STEVEN CHAPLINSKIEntry Class Code: WEB","50","","Posted","305.04"
"1/25/2022","","Withdrawal ACH DISCOVER/TYPE: E-PAYMENT ID: 2510020270CO: DISCOVER NAME: CHAPLINSKI STEVENEntry Class Code: WEB","85","","Posted","355.04"
"1/25/2022","","Withdrawal ACH BEST BUY/TYPE: PAYMENT ID: CITIGPUFDRCO: BEST BUYEntry Class Code: PPD","55","","Posted","440.04"
"1/25/2022","","Withdrawal ACH WAWA CREDIT CARD/TYPE: ONLINE PMT ID: CITICTPCO: WAWA CREDIT CARDNAME: STEVEN CHAPLINSKIEntry Class Code: WEB","29","","Posted","495.04"
"1/24/2022","","Withdrawal POS #000000916698/FAST TRACK #200 3960 SW ARCHER RDGAINESVILLE FLCard 2801","21.67","","Posted","524.04"
"1/24/2022","","Withdrawal POS #000000024099/PUBLIX 3930 SW ARCHER ROA GAINESVILLE FLCard 2801","47.43","","Posted","545.71"
"1/24/2022","","Withdrawal ATM Transaction","100","","Posted","593.14"
"1/24/2022","","Deposit Home Banking Transfer - From Share 0000/Funds Transfer via Mobile","","665","Posted","693.14"
"1/23/2022","","Withdrawal POS #000000899960/SUNOCO 8002212501 4234 SW 20TH AVEGAINESVILLE FLCard 2801","19.54","","Posted","28.14"
"1/23/2022","","Withdrawal POS #000000734069/PUBLIX 3930 SW ARCHER ROA GAINESVILLE FLCard 2801","39.45","","Posted","47.68"
"1/21/2022","","Withdrawal ACH PAYPAL/TYPE: INST XFER ID: PAYPALSI77CO: PAYPAL NAME: STEVEN CHAPLINSKIEntry Class Code: WEB","6.99","","Posted","87.13"
"1/18/2022","","Withdrawal ACH PAYPAL/TYPE: INST XFER ID: PAYPALSI77CO: PAYPAL NAME: STEVEN CHAPLINSKIEntry Class Code: WEB","22.88","","Posted","94.12"
"1/18/2022","","Withdrawal ACH PAYPAL/TYPE: INST XFER ID: PAYPALSI77CO: PAYPAL NAME: STEVEN CHAPLINSKIEntry Class Code: WEB","17.11","","Posted","117"
"1/17/2022","","Withdrawal POS #000000049615/PUBLIX 3100 SW 35TH BLVD GAINESVILLE FLCard 2801","26.73","","Posted","134.11"
"1/14/2022","","Withdrawal ACH PAYPAL/TYPE: INST XFER ID: PAYPALSI77CO: PAYPAL NAME: STEVEN CHAPLINSKIEntry Class Code: WEB","2.01","","Posted","160.84"
"1/13/2022","","Withdrawal POS #000000123825/GATE 1445 506 NW 1 GAINESVILLE FLCard 2801","9.24","","Posted","162.85"
"1/13/2022","","Withdrawal ATM Transaction","80","","Posted","172.09"
"1/12/2022","","Withdrawal POS #000000050790/PUBLIX 3930 SW ARCHER ROA GAINESVILLE FLCard 2801","29.01","","Posted","252.09"
"1/12/2022","","Deposit Home Banking Transfer trf/From CHAPLINSKI,LEON 3496297 Share 0090","","200","Posted","281.1"
"1/12/2022","","Recurring Withdrawal Debit Card Fee/MASTERCARD ISSUER CROSS-BORDER FEEDate 01/11/22 0 2011933313 0 5817Card 2801","0.05","","Posted","81.1"
"1/12/2022","","Recurring Withdrawal Debit Card MC Debit/PAYPAL *LINKTREE 4029357733 AUDate 01/11/22 0 2011933313 0 5817Card 2801","6","","Posted","81.15"
"1/12/2022","","Withdrawal ACH GAMIVO.COM LIMIT/CO: GAMIVO.COM LIMITEDTYPE: IAT PAYPAL ID: 770510487CEntry Class Code: IAT","10.89","","Posted","87.15"
"1/12/2022","","Withdrawal ACH PAYPAL/TYPE: INST XFER ID: PAYPALSI77CO: PAYPAL NAME: STEVEN CHAPLINSKIEntry Class Code: WEB","9.99","","Posted","98.04"
"1/12/2022","","Withdrawal POS #000000737145/AMAZON.COM*UD0KC6Q23 SEATTLE WACard 2801","10.15","","Posted","108.03"
"1/11/2022","","Withdrawal Debit Card MC Debit/GRU/EZ-PAY WEB PYMT 352-334-3434 FLDate 01/10/22 0 2010416794 0 4900Card 2801","187.36","","Posted","118.18"
"1/10/2022","","Deposit Home Banking Transfer - From Share 0000/Funds Transfer via Mobile","","11","Posted","305.54"
"1/8/2022","","Withdrawal POS #000000188596/WAWA 5325 2373 SW ARCHER ROA GAINESVILLEFLCard 2801","18.34","","Posted","294.54"
"1/8/2022","","Withdrawal ATM Fee/ASAI 3400 B SW 34th St. Gainesville FLCard 2801","2","","Posted","312.88"
"1/8/2022","","Withdrawal at ATM #000000000088/ASAI 3400 B SW 34th St. Gainesville FLCard 2801","37.75","","Posted","314.88"
"1/8/2022","","Withdrawal ATM Fee/ASAI 3400 B SW 34th St. Gainesville FLCard 2801","2","","Posted","352.63"
"1/8/2022","","Withdrawal at ATM #000000000087/ASAI 3400 B SW 34th St. Gainesville FLCard 2801","87.75","","Posted","354.63"
"1/8/2022","","Deposit Home Banking Transfer trf/From CHAPLINSKI,LEON 3496297 Share 0090","","165","Posted","442.38"
"1/8/2022","","Withdrawal ATM Transaction","80","","Posted","277.38"
"1/8/2022","","Recurring Withdrawal Bill Payment - #000045891971/PAYPAL *VIDIQ 2211 North First S SanCACard 2801","10","","Posted","357.38"
"1/7/2022","","Deposit POS #000000508425/PAYPAL*chaplinski San Jose CACard 2801","","22.65","Posted","367.38"
"1/7/2022","","Withdrawal ACH Watson Realty Co/TYPE: WEB PMTS ID: 9000321157CO: Watson Realty CoNAME: Steven chaplinskiEntry Class Code: WEB","885","","Posted","344.73"
"1/7/2022","","Withdrawal ACH DISCOVER/TYPE: E-PAYMENT ID: 2510020270CO: DISCOVER NAME: CHAPLINSKI STEVENEntry Class Code: WEB","13","","Posted","1229.73"
"1/6/2022","","Withdrawal Debit Card MC Debit/PUBLIX #1312 GAINESVILLE FLDate 01/05/22 0 2005258752 1 5411Card 2801","108.9","","Posted","1242.73"
"1/6/2022","","Withdrawal Debit Card MC Debit/YVETTE GODET DMD GAINESVILLE FLDate 01/05/22 0 2005258437 1 8021Card 2801","138","","Posted","1351.63"
"1/6/2022","","Withdrawal Debit Card MC Debit/WALGREENS #5024 800-289-2273 FLDate 01/05/22 0 2005255724 1 5912Card 2801","21.67","","Posted","1489.63"
"1/6/2022","","Deposit ATM Transaction","","111","Posted","1511.3"
"1/6/2022","","Withdrawal POS #000000387313/WAWA 5325 2373 SW ARCHER ROA GAINESVILLEFLCard 2801","18.34","","Posted","1400.3"
"1/5/2022","","Withdrawal Debit Card MC Debit/PIZZA HUT 27918 3523739402 FLDate 01/04/22 0 2004889023 0 5812Card 2801","32.86","","Posted","1418.64"
"1/5/2022","","Deposit Home Banking Transfer trf/From CHAPLINSKI,LEON 3496297 Share 0090","","138","Posted","1451.5"
"1/5/2022","","Withdrawal ACH APPLECARD GSBANK/TYPE: PAYMENT ID: 9999999999CO: APPLECARD GSBANKNAME: Steven ChaplinskiEntry Class Code: WEB","42","","Posted","1313.5"
"1/5/2022","","Withdrawal ACH BARCLAYCARD US/TYPE: CREDITCARD ID: 2510407970CO: BARCLAYCARD USNAME: STEVEN CHAPLINSKIEntry Class Code: WEB","25","","Posted","1355.5"
"1/5/2022","","Withdrawal ACH PAYPAL/TYPE: INST XFER ID: PAYPALSI77CO: PAYPAL NAME: STEVEN CHAPLINSKIEntry Class Code: WEB","9","","Posted","1380.5"
"1/4/2022","","Withdrawal Debit Card MC Debit/WALGREENS #5024 800-289-2273 FLDate 01/03/22 0 2003268853 1 5912Card 2801","19.28","","Posted","1389.5"
"1/4/2022","","Withdrawal ACH BEST BUY/TYPE: PAYMENT ID: CITIGPUFDRCO: BEST BUYEntry Class Code: PPD","70","","Posted","1408.78"
"1/4/2022","","Withdrawal ACH PAYPAL/TYPE: INST XFER ID: PAYPALSI77CO: PAYPAL NAME: STEVEN CHAPLINSKIEntry Class Code: WEB","14.95","","Posted","1478.78"
"1/4/2022","","Withdrawal ACH PAYPAL/TYPE: INST XFER ID: PAYPALSI77CO: PAYPAL NAME: STEVEN CHAPLINSKIEntry Class Code: WEB","2.99","","Posted","1493.73"
"1/3/2022","","Withdrawal POS #000000219170/AMAZON.COM*CQ14M5TP3 SEATTLE WACard 2801","10.15","","Posted","1496.72"
"1/3/2022","","Withdrawal POS #000012562406/WALGREENS 2415 SW GAINESVILLE FLCard 2801","43.37","","Posted","1506.87"
"1/3/2022","","Withdrawal ACH PAYPAL/TYPE: INST XFER ID: PAYPALSI77CO: PAYPAL NAME: STEVEN CHAPLINSKIEntry Class Code: WEB","24.99","","Posted","1550.24"
"12/31/2021","","Deposit Home Banking Transfer trf/From CHAPLINSKI,LEON 3496297 Share 0090","","1000","Posted","1575.23"
"12/31/2021","","Withdrawal ACH PAYPAL/TYPE: INST XFER ID: PAYPALSI77CO: PAYPAL NAME: STEVEN CHAPLINSKIEntry Class Code: WEB","49","","Posted","575.23"
"12/31/2021","","Withdrawal ACH PAYPAL/TYPE: INST XFER ID: PAYPALSI77CO: PAYPAL NAME: STEVEN CHAPLINSKIEntry Class Code: WEB","6.52","","Posted","624.23"
"12/30/2021","","Withdrawal POS #000000037252/PUBLIX 3930 SW ARCHER ROA GAINESVILLE FLCard 2801","11.34","","Posted","630.75"
"12/30/2021","","Withdrawal POS #000000875122/FAST TRACK #200 3960 SW ARCHER RDGAINESVILLE FLCard 2801","18.79","","Posted","642.09"
"12/30/2021","","Withdrawal ATM Transaction","100","","Posted","660.88"
"12/29/2021","","Withdrawal POS #000000779962/FAST TRACK #200 3960 SW ARCHER RDGAINESVILLE FLCard 2801","21.56","","Posted","760.88"
"12/29/2021","","Withdrawal POS #000000737891/PUBLIX 3930 SW ARCHER ROA GAINESVILLE FLCard 2801","31.95","","Posted","782.44"
"12/29/2021","","Withdrawal ACH PAYPAL/TYPE: INST XFER ID: PAYPALSI77CO: PAYPAL NAME: STEVEN CHAPLINSKIEntry Class Code: WEB","11.48","","Posted","814.39"
"12/29/2021","","Withdrawal ACH PAYPAL/TYPE: INST XFER ID: PAYPALSI77CO: PAYPAL NAME: STEVEN CHAPLINSKIEntry Class Code: WEB","2.99","","Posted","825.87"
"12/28/2021","","Withdrawal ACH PAYPAL/TYPE: INST XFER ID: PAYPALSI77CO: PAYPAL NAME: STEVEN CHAPLINSKIEntry Class Code: WEB","21.38","","Posted","828.86"
"12/27/2021","","Recurring Withdrawal Debit Card MC Debit/HELP.HBOMAX.COM NEW YORK NYDate 12/27/21 0 1361077074 1 5815Card 2801","17.23","","Posted","850.24"
"12/27/2021","","Withdrawal Debit Card MC Debit/COX GAINESVILLE COMM 800-234-3993 FLDate 12/27/21 0 1361072441 1 4899Card 2801","95.39","","Posted","867.47"
"12/27/2021","","Withdrawal ACH CANVA PTY LIMITE/CO: CANVA PTY LIMITEDTYPE: IAT PAYPAL ID: 770510487CEntry Class Code: IAT","12.99","","Posted","962.86"
"12/27/2021","","Withdrawal ACH PAYPAL/TYPE: INST XFER ID: PAYPALSI77CO: PAYPAL NAME: STEVEN CHAPLINSKIEntry Class Code: WEB","4.5","","Posted","975.85"
"12/27/2021","","Withdrawal ACH PAYPAL/TYPE: INST XFER ID: PAYPALSI77CO: PAYPAL NAME: STEVEN CHAPLINSKIEntry Class Code: WEB","2.99","","Posted","980.35"
"12/26/2021","","Withdrawal ATM Transaction","80","","Posted","983.34"
"12/26/2021","","Withdrawal Debit Card MC Debit/PUBLIX #1312 GAINESVILLE FLDate 12/24/21 0 1358678113 1 5411Card 2801","37.6","","Posted","1063.34"
"12/26/2021","","Withdrawal Debit Card MC Debit/KINDLE UNLTD*YG62Q6YB3 866-321-8851 WADate 12/24/21 0 1358747903 1 5818Card 2801","9.99","","Posted","1100.94"
"12/24/2021","","Withdrawal POS #000000547940/FAST TRACK #200 3960 SW ARCHER RDGAINESVILLE FLCard 2801","9.39","","Posted","1110.93"
"12/24/2021","","Deposit Home Banking Transfer trf/From CHAPLINSKI,LEON 3496297 Share 0090","","1000","Posted","1120.32"
"12/22/2021","","Withdrawal ATM Transaction","60","","Posted","120.32"
"12/22/2021","","Withdrawal Debit Card MC Debit/PUBLIX #1312 GAINESVILLE FLDate 12/21/21 0 1355585485 1 5411Card 2801","46.84","","Posted","180.32"
"12/22/2021","","Deposit ACH ROBINHOOD/TYPE: CREDITS ID: 5321710001CO: ROBINHOODEntry Class Code: PPD","","67","Posted","227.16"
"12/22/2021","","Deposit POS #000000598363/PAYPAL*chaplinski San Jose CACard 2801","","13.77","Posted","160.16"
"12/21/2021","","Withdrawal ACH PAYPAL/TYPE: INST XFER ID: PAYPALSI77CO: PAYPAL NAME: STEVEN CHAPLINSKIEntry Class Code: WEB","6.99","","Posted","146.39"
"12/19/2021","","Recurring Withdrawal Adjustment - Debit Card Credit Voucher/JARVIS - CONVERSION.AI AUSTIN TXDate 12/17/21 0 1351740719 2 7399Card 2801","","29","Posted","153.38"
"12/18/2021","","Withdrawal ATM Fee/ASAI 3400 B SW 34th St. Gainesville FLCard 2801","2","","Posted","124.38"
"12/18/2021","","Withdrawal at ATM #000000001835/ASAI 3400 B SW 34th St. Gainesville FLCard 2801","12.75","","Posted","126.38"
"12/17/2021","","Recurring Withdrawal Debit Card MC Debit/JARVIS - CONVERSION.AI AUSTIN TXDate 12/16/21 0 1350165435 1 7399Card 2801","29","","Posted","139.13"
"12/17/2021","","Deposit ACH Coinbase.com/TYPE: 34JR7MCY ID: 1455293997CO: Coinbase.comEntry Class Code: PPD","","4.18","Posted","168.13"
"12/16/2021","","Withdrawal ACH Coinbase.com/TYPE: TKSAMGXM ID: 1455293997CO: Coinbase.comEntry Class Code: WEB","10","","Posted","163.95"
"12/16/2021","","Withdrawal ACH Coinbase.com/TYPE: 4N9CGTSG ID: 1455293997CO: Coinbase.comEntry Class Code: WEB","6","","Posted","173.95"
"12/16/2021","","Deposit ACH Coinbase.com/TYPE: 5GC5G74U ID: 1455293997CO: Coinbase.comEntry Class Code: PPD","","13.83","Posted","179.95"
"12/16/2021","","Withdrawal ACH AVANGATE B.V./CO: AVANGATE B.V.TYPE: IAT PAYPAL ID: 770510487CEntry Class Code: IAT","29.58","","Posted","166.12"
"12/16/2021","","Withdrawal ACH PAYPAL/TYPE: INST XFER ID: PAYPALSI77CO: PAYPALEntry Class Code: WEB","32.05","","Posted","195.7"
"12/16/2021","","Withdrawal ACH E*TRADE/TYPE: ACH TRNSFR ID: 1391321258CO: E*TRADEEntry Class Code: PPD","20","","Posted","227.75"
"12/16/2021","","Deposit ACH ROBINHOOD/TYPE: CREDITS ID: 5321710001CO: ROBINHOODEntry Class Code: PPD","","5","Posted","247.75"
"12/16/2021","","Withdrawal POS #000000247445/AMAZON.COM*A42ZY7OC3 SEATTLE WACard 2801","10.87","","Posted","242.75"
"12/15/2021","","Withdrawal POS #000000033409/PUBLIX 3100 SW 35TH BLVD GAINESVILLE FLCard 2801","32.82","","Posted","253.62"
"12/15/2021","","Withdrawal ATM Fee/ASAI 3400 B SW 34th St. Gainesville FLCard 2801","2","","Posted","286.44"
"12/15/2021","","Withdrawal at ATM #000000001792/ASAI 3400 B SW 34th St. Gainesville FLCard 2801","52.75","","Posted","288.44"
"12/14/2021","","Withdrawal ACH ROBINHOOD/TYPE: DEBITS ID: 5326394001CO: ROBINHOODEntry Class Code: WEB","20","","Posted","341.19"
"12/14/2021","","Deposit ACH EBAY/TYPE: EDI PYMNTS ID: 3263863381 CO: EBAYEntry Class Code: CCD","","226.62","Posted","361.19"
"12/13/2021","","Recurring Withdrawal Debit Card Fee/MASTERCARD ISSUER CROSS-BORDER FEEDate 12/11/21 0 1345316936 1 5817Card 2801","0.05","","Posted","134.57"
"12/13/2021","","Recurring Withdrawal Debit Card MC Debit/PAYPAL *LINKTREE 4029357733 AUDate 12/11/21 0 1345316936 1 5817Card 2801","6","","Posted","134.62"
"12/13/2021","","Withdrawal ACH PAYPAL INC./CO: PAYPAL INC.TYPE: IAT PAYPAL ID: 770510487CEntry Class Code: IAT","10.13","","Posted","140.62"
"12/13/2021","","Withdrawal ACH CDKEYS/CO: CDKEYSTYPE: IAT PAYPAL ID: 770510487CEntry Class Code: IAT","7.49","","Posted","150.75"
"12/13/2021","","Recurring Withdrawal Bill Payment - #000009064015/NETFLIX COM LOS GATOS CACard 2801","9.88","","Posted","158.24"
"12/13/2021","","Withdrawal ACH PAYPAL/TYPE: INST XFER ID: PAYPALSI77CO: PAYPALEntry Class Code: WEB","11.99","","Posted","168.12"
"12/13/2021","","Withdrawal ACH PAYPAL/TYPE: INST XFER ID: PAYPALSI77CO: PAYPALEntry Class Code: WEB","9.99","","Posted","180.11"
"12/13/2021","","Withdrawal ACH PAYPAL/TYPE: INST XFER ID: PAYPALSI77CO: PAYPALEntry Class Code: WEB","9.18","","Posted","190.1"
"12/13/2021","","Withdrawal ACH PAYPAL/TYPE: INST XFER ID: PAYPALSI77CO: PAYPALEntry Class Code: WEB","4.99","","Posted","199.28"
"12/13/2021","","Withdrawal ACH PAYPAL/TYPE: INST XFER ID: PAYPALSI77CO: PAYPALEntry Class Code: WEB","2.99","","Posted","204.27"
"12/12/2021","","Withdrawal Adjustment Debit Card - Credit Voucher/PP*APPLE.COM/BILL 402-935-7733 CADate 12/10/21 1 1344899190 0 5735Card 1140","","0.3","Posted","207.26"
"12/12/2021","","Withdrawal Debit Card MC Debit/PIZZA HUT 27918 3523739402 FLDate 12/11/21 0 1345093373 1 5812Card 2801","38.73","","Posted","206.96"
"12/12/2021","","Withdrawal Debit Card MC Debit/PUBLIX #1312 GAINESVILLE FLDate 12/11/21 0 1345536904 1 5411Card 2801","41.68","","Posted","245.69"
"12/11/2021","","Withdrawal ATM Fee/ASAI 3400 B SW 34th St. Gainesville FLCard 2801","2","","Posted","287.37"
"12/11/2021","","Withdrawal at ATM #000000001742/ASAI 3400 B SW 34th St. Gainesville FLCard 2801","62.75","","Posted","289.37"
"12/11/2021","","Withdrawal Adjustment POS #000000567127/AMAZON.COM SEATTLE WACard 2801","","10.87","Posted","352.12"
"12/10/2021","","Withdrawal POS #000000866633/SUNOCO 8002212501 4234 SW 20TH AVEGAINESVILLE FLCard 2801","23.52","","Posted","341.25"
"12/9/2021","","Withdrawal Debit Card MC Debit/PUBLIX #680 GAINESVILLE FLDate 12/08/21 0 1342465886 1 5411Card 2801","9.39","","Posted","364.77"
"12/9/2021","","Withdrawal Debit Card MC Debit/AMZN DIGITAL*1Q88M4VC3 888-802-3080 WADate 12/08/21 0 1342087624 1 5818Card 2801","60","","Posted","374.16"
"12/9/2021","","Withdrawal ACH BEST BUY/TYPE: PAYMENT ID: CITIGPUFDRCO: BEST BUYEntry Class Code: PPD","1072","","Posted","434.16"
"12/8/2021","","Deposit Home Banking Transfer trf/From CHAPLINSKI,LEON 3496297 Share 0090","","200","Posted","1506.16"
"12/8/2021","","Deposit Home Banking Transfer trf/From CHAPLINSKI,LEON 3496297 Share 0000","","1076","Posted","1306.16"
"12/8/2021","","Withdrawal ATM Fee/ASAI 3400 B SW 34th St. Gainesville FLCard 2801","2","","Posted","230.16"
"12/8/2021","","Withdrawal at ATM #000000001701/ASAI 3400 B SW 34th St. Gainesville FLCard 2801","52.75","","Posted","232.16"
"12/8/2021","","Withdrawal Bill Payment #000005244166/PAYPAL *VIDIQ San Jose CACard 2801","10","","Posted","284.91"
"12/7/2021","","Withdrawal Debit Card MC Debit/BURGER KING #2314 Q07 GAINESVILLE FLDate 12/06/21 0 1340414040 1 5814Card 2801","14.64","","Posted","294.91"
"12/7/2021","","Withdrawal Debit Card MC Debit/WALGREENS #5024 800-289-2273 FLDate 12/06/21 0 1340411522 1 5912Card 2801","4.5","","Posted","309.55"
"12/7/2021","","Withdrawal ACH PAYPAL/TYPE: INST XFER ID: PAYPALSI77CO: PAYPALEntry Class Code: WEB","19.99","","Posted","314.05"
"12/7/2021","","Withdrawal POS #000000000001/AMAZON.COM*1H2FW4UE3 SEATTLE WACard 2801","10.87","","Posted","334.04"
"12/6/2021","","Deposit Home Banking Transfer trf/From CHAPLINSKI,LEON 3496297 Share 0090","","50","Posted","344.91"
"12/6/2021","","Withdrawal ACH BEST BUY/TYPE: PAYMENT ID: CITIGPUFDRCO: BEST BUYEntry Class Code: PPD","62","","Posted","294.91"
"12/6/2021","","Withdrawal Debit Card MC Debit/PUBLIX #1312 GAINESVILLE FLDate 12/05/21 0 1339321130 1 5411Card 2801","28.24","","Posted","356.91"
"12/6/2021","","Withdrawal Debit Card MC Debit/PUBLIX #1312 GAINESVILLE FLDate 12/05/21 0 1339321129 1 5411Card 2801","39.16","","Posted","385.15"
"12/6/2021","","Withdrawal Debit Card MC Debit/WALGREENS #5024 800-289-2273 FLDate 12/05/21 0 1339318061 1 5912Card 2801","30.96","","Posted","424.31"
"12/6/2021","","Recurring Withdrawal Debit Card MC Debit/AMAZON PRIME*B135K3GA3 AMZN.COM/BIL WADate 12/05/21 0 1339329704 1 5968Card 2801","13.1","","Posted","455.27"
"12/6/2021","","Withdrawal ACH TARGET CARD SRVC/TYPE: BILL PAY ID: 5411721813CO: TARGET CARD SRVCEntry Class Code: WEB","98","","Posted","468.37"
"12/6/2021","","Withdrawal ACH PAYPAL/TYPE: INST XFER ID: PAYPALSI77CO: PAYPALEntry Class Code: WEB","35.99","","Posted","566.37"
"12/6/2021","","Withdrawal ACH PAYPAL/TYPE: INST XFER ID: PAYPALSI77CO: PAYPALEntry Class Code: WEB","14.95","","Posted","602.36"
"12/6/2021","","Withdrawal ACH PAYPAL/TYPE: INST XFER ID: PAYPALSI77CO: PAYPALEntry Class Code: WEB","2.99","","Posted","617.31"
"12/6/2021","","Deposit POS #000000386879/PAYPAL*chaplinski San Jose CACard 2801","","75.84","Posted","620.3"
"12/5/2021","","Withdrawal POS #000000691470/FAST TRACK #200 3960 SW ARCHER RDGAINESVILLE FLCard 2801","12.17","","Posted","544.46"
"12/5/2021","","Withdrawal ATM Fee/ASAI 3400 B SW 34th St. Gainesville FLCard 2801","2","","Posted","556.63"
"12/5/2021","","Withdrawal at ATM #000000001471/ASAI 3400 B SW 34th St. Gainesville FLCard 2801","37.75","","Posted","558.63"
"12/5/2021","","Withdrawal POS #000014264526/WALGREENS 2415 SW GAINESVILLE FLCard 2801","19.33","","Posted","596.38"
"12/5/2021","","Withdrawal Adjustment POS #000000158121/AMAZON.COM SEATTLE WACard 2801","","10.87","Posted","615.71"
"12/4/2021","","Withdrawal POS #000000000496/AMAZON.COM*PX74B4CW3 SEATTLE WACard 2801","10.87","","Posted","604.84"
"12/3/2021","","Withdrawal POS #000000053288/PUBLIX 3930 SW ARCHER ROA GAINESVILLE FLCard 2801","52.25","","Posted","615.71"
"12/3/2021","","Withdrawal POS #000000045074/CIRCLE K # 26146 3 GAINESVILLE FLCard 2801","30.83","","Posted","667.96"
"12/3/2021","","Withdrawal ATM Transaction","100","","Posted","698.79"
"12/3/2021","","Withdrawal ACH PAYPAL/TYPE: INST XFER ID: PAYPALSI77CO: PAYPALEntry Class Code: WEB","0.61","","Posted","798.79"
"12/2/2021","","Withdrawal Debit Card MC Debit/GRU/EZ-PAY WEB PYMT 352-334-3434 FLDate 12/01/21 0 1335452228 0 4900Card 2801","150.26","","Posted","799.4"
"12/2/2021","","Withdrawal Debit Card MC Debit/COX GAINESVILLE COMM 800-234-3993 FLDate 12/01/21 0 1335305470 1 4899Card 2801","94.32","","Posted","949.66"
"12/2/2021","","Withdrawal ACH Watson Realty Co/TYPE: WEB PMTS ID: 9000321157CO: Watson Realty CoEntry Class Code: WEB","885","","Posted","1043.98"
"12/2/2021","","Withdrawal ACH PAYPAL/TYPE: INST XFER ID: PAYPALSI77CO: PAYPALEntry Class Code: WEB","24.99","","Posted","1928.98"
"12/1/2021","","Withdrawal ACH APPLECARD GSBANK/TYPE: PAYMENT ID: 9999999999CO: APPLECARD GSBANKEntry Class Code: WEB","48.49","","Posted","1953.97"
"12/1/2021","","Withdrawal ACH CAPITAL ONE/TYPE: MOBILE PMT ID: 9279744980CO: CAPITAL ONEEntry Class Code: WEB","25","","Posted","2002.46"
"12/1/2021","","Withdrawal ACH DISCOVER/TYPE: E-PAYMENT ID: 2510020270CO: DISCOVEREntry Class Code: WEB","57","","Posted","2027.46"
"12/1/2021","","Withdrawal ACH PAYPAL/TYPE: INST XFER ID: PAYPALSI77CO: PAYPALEntry Class Code: WEB","49","","Posted","2084.46"
"11/30/2021","","Deposit Home Banking Transfer trf/From CHAPLINSKI,LEON 3496297 Share 0090","","2000","Posted","2133.46"
"11/30/2021","","Withdrawal ACH PAYPAL/TYPE: INST XFER ID: PAYPALSI77CO: PAYPALEntry Class Code: WEB","77.99","","Posted","133.46"
"11/29/2021","","Withdrawal ACH CANVA PTY LIMITE/CO: CANVA PTY LIMITEDTYPE: IAT PAYPAL ID: 770510487CEntry Class Code: IAT","12.99","","Posted","211.45"
"11/29/2021","","Withdrawal ACH PAYPAL/TYPE: INST XFER ID: PAYPALSI77CO: PAYPALEntry Class Code: WEB","11.48","","Posted","224.44"
"11/29/2021","","Withdrawal ACH PAYPAL/TYPE: INST XFER ID: PAYPALSI77CO: PAYPALEntry Class Code: WEB","2.99","","Posted","235.92"
"11/29/2021","","Withdrawal ACH PAYPAL/TYPE: INST XFER ID: PAYPALSI77CO: PAYPALEntry Class Code: WEB","2.99","","Posted","238.91"
"11/29/2021","","Deposit ACH PAYPAL/TYPE: TRANSFER ID: PAYPALSD11 CO: PAYPALEntry Class Code: PPD","","99","Posted","241.9"
"11/29/2021","","Deposit ACH PAYPAL/TYPE: TRANSFER ID: PAYPALSD11 CO: PAYPALEntry Class Code: PPD","","99","Posted","142.9"
"11/28/2021","","Withdrawal POS #000000374038/FAST TRACK #200 3960 SW ARCHER RDGAINESVILLE FLCard 2801","18.79","","Posted","43.9"
"11/28/2021","","Withdrawal POS #000000744128/PUBLIX 3930 SW ARCHER ROA GAINESVILLE FLCard 2801","49.89","","Posted","62.69"
"11/28/2021","","Deposit ATM Transaction","","40","Posted","112.58"
"11/28/2021","","Recurring Withdrawal Debit Card MC Debit/HELP.HBOMAX.COM NEW YORK NYDate 11/27/21 0 1331892549 2 5815Card 2801","17.23","","Posted","72.58"
"11/26/2021","","Withdrawal POS #000000041075/PUBLIX 3930 SW ARCHER ROA GAINESVILLE FLCard 2801","12.2","","Posted","89.81"
"11/26/2021","","Withdrawal ACH PAYPAL/TYPE: INST XFER ID: PAYPALSI77CO: PAYPALEntry Class Code: WEB","14","","Posted","102.01"
"11/26/2021","","Withdrawal ACH PAYPAL/TYPE: INST XFER ID: PAYPALSI77CO: PAYPALEntry Class Code: WEB","4.5","","Posted","116.01"
"11/26/2021","","Deposit ACH PAYPAL/TYPE: TRANSFER ID: PAYPALSD11 CO: PAYPALEntry Class Code: PPD","","14","Posted","120.51"
"11/25/2021","","Deposit POS #000000692389/PAYPAL*chaplinski San Jose CACard 2801","","39.4","Posted","106.51"
"11/25/2021","","Deposit Home Banking Transfer - From Share 0000/Funds Transfer via Online","","35","Posted","67.11"
"11/25/2021","","Recurring Withdrawal Debit Card MC Debit/WELLSAID LABS SEATTLE WADate 11/24/21 0 1328159011 1 5734Card 2801","49","","Posted","32.11"
"11/25/2021","","Withdrawal Debit Card MC Debit/KINDLE UNLTD*439YD1353 866-321-8851 WADate 11/24/21 0 1328430085 1 5818Card 2801","9.99","","Posted","81.11"
"11/25/2021","","Withdrawal POS #000000436948/SUNOCO 8002212501 4234 SW 20TH AVEGAINESVILLE FLCard 2801","22.44","","Posted","91.1"
"11/25/2021","","Withdrawal Transfer fee","8","","Posted","113.54"
"11/25/2021","","Deposit Transfer From Share 0000","","100","Posted","121.54"
"11/24/2021","","Withdrawal ACH PAYPAL/TYPE: INST XFER ID: PAYPALSI77CO: PAYPALEntry Class Code: WEB","99","","Posted","21.54"
"11/23/2021","","Withdrawal ACH WAWA CREDIT CARD/TYPE: ONLINE PMT ID: CITICTPCO: WAWA CREDIT CARDEntry Class Code: WEB","10.39","","Posted","120.54"
"11/22/2021","","Withdrawal POS #000000000009/AMAZON.COM*J21CC2E03 SEATTLE WACard 2801","10.15","","Posted","130.93"
"11/22/2021","","Withdrawal Debit Card MC Debit/PUBLIX #1312 GAINESVILLE FLDate 11/21/21 0 1325259660 1 5411Card 2801","52.16","","Posted","141.08"
"11/22/2021","","Withdrawal ACH CAPITAL ONE/TYPE: MOBILE PMT ID: 9279744980CO: CAPITAL ONEEntry Class Code: WEB","25","","Posted","193.24"
"11/22/2021","","Withdrawal ACH MYNOISE BV/CO: MYNOISE BVTYPE: IAT PAYPAL ID: 770510487CEntry Class Code: IAT","10","","Posted","218.24"
"11/22/2021","","Withdrawal ACH PAYPAL/TYPE: INST XFER ID: PAYPALSI77CO: PAYPALEntry Class Code: WEB","39.99","","Posted","228.24"
"11/22/2021","","Withdrawal ACH PAYPAL/TYPE: INST XFER ID: PAYPALSI77CO: PAYPALEntry Class Code: WEB","6.99","","Posted","268.23"
"11/21/2021","","Withdrawal POS #000000955321/SUNOCO 8002212501 4234 SW 20TH AVEGAINESVILLE FLCard 2801","19.24","","Posted","275.22"
"11/19/2021","","Withdrawal ACH CAPITAL ONE/TYPE: MOBILE PMT ID: 9279744980CO: CAPITAL ONEEntry Class Code: WEB","25","","Posted","294.46"
"11/19/2021","","Deposit POS #000000810210/PAYPAL*chaplinski San Jose CACard 2801","","59.1","Posted","319.46"
"11/18/2021","","Withdrawal POS #000000110304/GATE 1445 506 NW 1 GAINESVILLE FLCard 2801","22.98","","Posted","260.36"
"11/18/2021","","Withdrawal ACH PAYPAL/TYPE: INST XFER ID: PAYPALSI77CO: PAYPALEntry Class Code: WEB","29","","Posted","283.34"
"11/18/2021","","Deposit ACH PAYPAL/TYPE: TRANSFER ID: PAYPALSD11 CO: PAYPALEntry Class Code: PPD","","71.47","Posted","312.34"
"11/17/2021","","Withdrawal ACH PAYPAL INC./CO: PAYPAL INC.TYPE: IAT PAYPAL ID: 770510487CEntry Class Code: IAT","1","","Posted","240.87"
"11/17/2021","","Withdrawal ACH PAYPAL/TYPE: INST XFER ID: PAYPALSI77CO: PAYPALEntry Class Code: WEB","100.47","","Posted","241.87"
"11/17/2021","","Withdrawal ACH DISCOVER/TYPE: E-PAYMENT ID: 2510020270CO: DISCOVEREntry Class Code: WEB","35","","Posted","342.34"
"11/16/2021","","Deposit ATM Transaction","","63","Posted","377.34"
"11/16/2021","","Withdrawal ATM Transaction","100","","Posted","314.34"
"11/16/2021","","Deposit POS #000000265165/PAYPAL*chaplinski San Jose CACard 2801","","88.65","Posted","414.34"
"11/16/2021","","Withdrawal Debit Card MC Debit/PUBLIX #1312 GAINESVILLE FLDate 11/15/21 0 1319336042 1 5411Card 2801","55.11","","Posted","325.69"
"11/16/2021","","Deposit POS #000000151441/PAYPAL*chaplinski San Jose CACard 2801","","182.22","Posted","380.8"
"11/16/2021","","Withdrawal POS #000000750286/FAST TRACK #200 3960 SW ARCHER RDGAINESVILLE FLCard 2801","31.56","","Posted","198.58"
"11/16/2021","","Deposit Home Banking Transfer - From Share 0000/Funds Transfer via Mobile","","125","Posted","230.14"
"11/15/2021","","Withdrawal ACH BARCLAYCARD US/TYPE: CREDITCARD ID: 2510407970CO: BARCLAYCARD USEntry Class Code: WEB","80","","Posted","105.14"
"11/14/2021","","Recurring Withdrawal Debit Card MC Debit/NETFLIX.COM 866-5797172 CADate 11/13/21 0 1317106681 1 4899Card 2801","9.88","","Posted","185.14"
"11/12/2021","","Withdrawal Debit Card MC Debit/PUBLIX #1312 GAINESVILLE FLDate 11/11/21 0 1315441966 1 5411Card 2801","92.11","","Posted","195.02"
"11/12/2021","","Recurring Withdrawal Debit Card Fee/MASTERCARD ISSUER CROSS-BORDER FEEDate 11/11/21 0 1315054260 1 5817Card 2801","0.05","","Posted","287.13"
"11/12/2021","","Recurring Withdrawal Debit Card MC Debit/PAYPAL *LINKTREE 4029357733 AUDate 11/11/21 0 1315054260 1 5817Card 2801","6","","Posted","287.18"
"11/12/2021","","Withdrawal ACH PHOTOPEA/CO: PHOTOPEATYPE: IAT PAYPAL ID: 770510487CEntry Class Code: IAT","9","","Posted","293.18"
"11/12/2021","","Withdrawal ACH PAYPAL/TYPE: INST XFER ID: PAYPALSI77CO: PAYPALEntry Class Code: WEB","9.99","","Posted","302.18"
"11/12/2021","","Withdrawal ACH PAYPAL/TYPE: INST XFER ID: PAYPALSI77CO: PAYPALEntry Class Code: WEB","9.18","","Posted","312.17"
"11/11/2021","","Withdrawal POS #000000547105/FAST TRACK #200 3960 SW ARCHER RDGAINESVILLE FLCard 2801","18.79","","Posted","321.35"
"11/11/2021","","Withdrawal POS #000000790681/AMAZON.COM*1I32Z59U3 SEATTLE WACard 2801","10.15","","Posted","340.14"
"11/10/2021","","Withdrawal POS #000000436271/SUNOCO 8002212501 4234 SW 20TH AVEGAINESVILLE FLCard 2801","22.44","","Posted","350.29"
"11/10/2021","","Withdrawal POS #000000000000/AMAZON.COM*F02M82ZR3 SEATTLE WACard 2801","10.14","","Posted","372.73"
"11/9/2021","","Withdrawal Debit Card MC Debit/ELDERSCROLLSONLINE. 855-296-3170 MDDate 11/09/21 0 1313300656 1 5816Card 2801","14.99","","Posted","382.87"
"11/9/2021","","Withdrawal POS #000000000000/AMAZON.COM*7A1DQ5XY3 SEATTLE WACard 2801","22.98","","Posted","397.86"
"11/9/2021","","Withdrawal ACH PAYPAL/TYPE: INST XFER ID: PAYPALSI77CO: PAYPALEntry Class Code: WEB","2.99","","Posted","420.84"
"11/9/2021","","Withdrawal POS #000000000006/AMAZON.COM*TS5A16DQ3 SEATTLE WACard 2801","20.07","","Posted","423.83"
"11/9/2021","","Withdrawal POS #000000024289/AMAZON.COM*784SZ89W3 SEATTLE WACard 2801","18.49","","Posted","443.9"
"11/8/2021","","Withdrawal ACH PAYPAL/TYPE: INST XFER ID: PAYPALSI77CO: PAYPALEntry Class Code: WEB","24.99","","Posted","462.39"
"11/8/2021","","Withdrawal ACH PAYPAL/TYPE: INST XFER ID: PAYPALSI77CO: PAYPALEntry Class Code: WEB","12","","Posted","487.38"
"11/8/2021","","Recurring Withdrawal Bill Payment - #000032312626/PAYPAL *VIDIQ 2211 North First S SanCACard 2801","10","","Posted","499.38"
"11/7/2021","","Withdrawal Debit Card MC Debit/WALGREENS #5024 800-289-2273 FLDate 11/05/21 0 1309931160 1 5912Card 2801","29.21","","Posted","509.38"
"11/7/2021","","Withdrawal Debit Card MC Debit/AMAZON PRIME*QT9YK9973 AMZN.COM/BIL WADate 11/05/21 0 1309589789 2 5968Card 2801","13.08","","Posted","538.59"
"11/6/2021","","Withdrawal POS #000000099097/PUBLIX 5801 SW 75TH ST GAINESVILLE FLCard 2801","35","","Posted","551.67"
"11/6/2021","","Withdrawal ATM Transaction","100","","Posted","586.67"
"11/5/2021","","Withdrawal POS #000000015737/CIRCLE K # 06782 5 GAINESVILLE FLCard 2801","17.63","","Posted","686.67"
"11/5/2021","","Withdrawal POS #000010337484/WALGREENS 2415 SW GAINESVILLE FLCard 2801","25.47","","Posted","704.3"
"11/4/2021","","Withdrawal ACH PAYPAL/TYPE: INST XFER ID: PAYPALSI77CO: PAYPALEntry Class Code: WEB","14.95","","Posted","729.77"
"11/4/2021","","Withdrawal ACH PAYPAL/TYPE: INST XFER ID: PAYPALSI77CO: PAYPALEntry Class Code: WEB","2.99","","Posted","744.72"
"11/2/2021","","Withdrawal Debit Card MC Debit/GRU/EZ-PAY WEB PYMT 352-334-3434 FLDate 11/01/21 0 1305577800 0 4900Card 2801","186.13","","Posted","747.71"
"11/2/2021","","Withdrawal ACH Watson Realty Co/TYPE: WEB PMTS ID: 9000321157CO: Watson Realty CoEntry Class Code: WEB","885","","Posted","933.84"
"11/2/2021","","Withdrawal ACH PAYPAL/TYPE: INST XFER ID: PAYPALSI77CO: PAYPALEntry Class Code: WEB","2.99","","Posted","1818.84"
"11/1/2021","","Withdrawal Debit Card MC Debit/PUBLIX #1312 GAINESVILLE FLDate 10/31/21 0 1304501431 1 5411Card 2801","98.42","","Posted","1821.83"
"11/1/2021","","Withdrawal ACH BEST BUY/TYPE: PAYMENT ID: CITIGPUFDRCO: BEST BUYEntry Class Code: PPD","160","","Posted","1920.25"
"11/1/2021","","Withdrawal ACH PAYPAL/TYPE: INST XFER ID: PAYPALSI77CO: PAYPALEntry Class Code: WEB","49","","Posted","2080.25"
"11/1/2021","","Withdrawal ACH PAYPAL/TYPE: INST XFER ID: PAYPALSI77CO: PAYPALEntry Class Code: WEB","24.99","","Posted","2129.25"
"11/1/2021","","Withdrawal ACH PAYPAL/TYPE: INST XFER ID: PAYPALSI77CO: PAYPALEntry Class Code: WEB","14.95","","Posted","2154.24"
"11/1/2021","","Withdrawal POS #000000062826/FAST TRACK #200 3960 SW ARCHER RDGAINESVILLE FLCard 2801","20.28","","Posted","2169.19"
"10/30/2021","","Withdrawal POS #000000736697/AMAZON.COM*NF6QL3WJ3 SEATTLE WACard 2801","21.38","","Posted","2189.47"
"10/29/2021","","Withdrawal ACH PAYPAL/TYPE: INST XFER ID: PAYPALSI77CO: PAYPALEntry Class Code: WEB","11.48","","Posted","2210.85"
"10/29/2021","","Withdrawal ACH PAYPAL/TYPE: INST XFER ID: PAYPALSI77CO: PAYPALEntry Class Code: WEB","2.99","","Posted","2222.33"
"10/27/2021","","Recurring Withdrawal Debit Card MC Debit/HELP.HBOMAX.COM NEW YORK NYDate 10/27/21 0 1300655172 1 5815Card 2801","17.23","","Posted","2225.32"
"10/27/2021","","Withdrawal ACH CANVA PTY LIMITE/CO: CANVA PTY LIMITEDTYPE: IAT PAYPAL ID: 770510487CEntry Class Code: IAT","12.99","","Posted","2242.55"
"10/27/2021","","Withdrawal ACH PAYPAL/TYPE: INST XFER ID: PAYPALSI77CO: PAYPALEntry Class Code: WEB","2.99","","Posted","2255.54"
"10/27/2021","","Deposit Home Banking Transfer Trf/From CHAPLINSKI,LEON 3496297 Share 0090","","2000","Posted","2258.53"
"10/27/2021","","Withdrawal POS #000003510681/NNT URGENTVET - GAI000897 2680 CLARKBUTLER GAINESVILLE FLCard 2801","154.56","","Posted","258.53"
"10/26/2021","","Withdrawal Debit Card MC Debit/COX GAINESVILLE COMM 800-234-3993 FLDate 10/25/21 0 1298159501 1 4899Card 2801","94.32","","Posted","413.09"
"10/26/2021","","Withdrawal ACH PAYPAL/TYPE: INST XFER ID: PAYPALSI77CO: PAYPALEntry Class Code: WEB","39.99","","Posted","507.41"
"10/26/2021","","Withdrawal ACH PAYPAL/TYPE: INST XFER ID: PAYPALSI77CO: PAYPALEntry Class Code: WEB","39.99","","Posted","547.4"
"10/26/2021","","Withdrawal ACH PAYPAL/TYPE: INST XFER ID: PAYPALSI77CO: PAYPALEntry Class Code: WEB","4.99","","Posted","587.39"
"10/26/2021","","Withdrawal ACH PAYPAL/TYPE: INST XFER ID: PAYPALSI77CO: PAYPALEntry Class Code: WEB","4.5","","Posted","592.38"
"10/26/2021","","Withdrawal ACH PAYPAL/TYPE: INST XFER ID: PAYPALSI77CO: PAYPALEntry Class Code: WEB","2.99","","Posted","596.88"
"10/25/2021","","Deposit ATM Transaction","","65","Posted","599.87"
"10/25/2021","","Withdrawal Adjustment POS #000000639985/AMAZON.COM SEATTLE WACard 2801","","37.44","Posted","534.87"
"10/25/2021","","Withdrawal ATM Transaction","100","","Posted","497.43"
"10/25/2021","","Deposit Home Banking Transfer - From Share 0000/Funds Transfer via Mobile","","100","Posted","597.43"
"10/25/2021","","Withdrawal POS #000000006078/CIRCLE K # 26162 7 GAINESVILLE FLCard 2801","41.18","","Posted","497.43"
"10/25/2021","","Recurring Withdrawal Debit Card MC Debit/WELLSAID LABS SEATTLE WADate 10/24/21 0 1297467927 1 5734Card 2801","49","","Posted","538.61"
"10/25/2021","","Withdrawal Debit Card MC Debit/KINDLE UNLTD*V90GA4Y53 866-321-8851 WADate 10/25/21 0 1298659612 1 5818Card 2801","9.99","","Posted","587.61"
"10/25/2021","","Withdrawal ACH PAYPAL/TYPE: INST XFER ID: PAYPALSI77CO: PAYPALEntry Class Code: WEB","99","","Posted","597.6"
"10/25/2021","","Withdrawal ACH PAYPAL/TYPE: INST XFER ID: PAYPALSI77CO: PAYPALEntry Class Code: WEB","14","","Posted","696.6"
"10/25/2021","","Withdrawal POS #000000765754/FAST TRACK #200 3960 SW ARCHER RDGAINESVILLE FLCard 2801","23.6","","Posted","710.6"
"10/25/2021","","Withdrawal POS #000000039469/PUBLIX 3930 SW ARCHER ROA GAINESVILLE FLCard 2801","20.43","","Posted","734.2"
"10/24/2021","","Deposit Home Banking Transfer Trf/From CHAPLINSKI,LEON 3496297 Share 0000","","400","Posted","754.63"
"10/22/2021","","Withdrawal ACH PAYPAL/TYPE: INST XFER ID: PAYPALSI77CO: PAYPALEntry Class Code: WEB","24.99","","Posted","354.63"
"10/21/2021","","Withdrawal POS #000000529868/FAST TRACK #200 3960 SW ARCHER RDGAINESVILLE FLCard 2801","14.21","","Posted","379.62"
"10/21/2021","","Withdrawal ACH PAYPAL INC./CO: PAYPAL INC.TYPE: IAT PAYPAL ID: 770510487CEntry Class Code: IAT","13","","Posted","393.83"
"10/21/2021","","Withdrawal ACH PAYPAL/TYPE: INST XFER ID: PAYPALSI77CO: PAYPALEntry Class Code: WEB","11.64","","Posted","406.83"
"10/21/2021","","Withdrawal ACH PAYPAL/TYPE: INST XFER ID: PAYPALSI77CO: PAYPALEntry Class Code: WEB","6.99","","Posted","418.47"
"10/20/2021","","Deposit Home Banking Transfer - From Share 0000/Funds Transfer via Online","","350","Posted","425.46"
"10/20/2021","","Withdrawal ACH BEST BUY/TYPE: PAYMENT ID: CITIGPUFDRCO: BEST BUYEntry Class Code: PPD","75","","Posted","75.46"
"10/19/2021","","Withdrawal ACH PAYPAL INC./CO: PAYPAL INC.TYPE: IAT PAYPAL ID: 770510487CEntry Class Code: IAT","21","","Posted","150.46"
"10/19/2021","","Withdrawal ACH PAYPAL/TYPE: INST XFER ID: PAYPALSI77CO: PAYPALEntry Class Code: WEB","29","","Posted","171.46"
"10/19/2021","","Withdrawal ACH PAYPAL/TYPE: INST XFER ID: PAYPALSI77CO: PAYPALEntry Class Code: WEB","2.99","","Posted","200.46"
"10/18/2021","","Withdrawal Debit Card MC Debit/PUBLIX #527 GAINESVILLE FLDate 10/17/21 0 1290523534 1 5411Card 2801","46.9","","Posted","203.45"
"10/18/2021","","Withdrawal ACH PAYPAL/TYPE: INST XFER ID: PAYPALSI77CO: PAYPALEntry Class Code: WEB","108.95","","Posted","250.35"
"10/18/2021","","Withdrawal ACH PAYPAL/TYPE: INST XFER ID: PAYPALSI77CO: PAYPALEntry Class Code: WEB","50","","Posted","359.3"
"10/17/2021","","Withdrawal POS #000000181598/AMAZON.COM*2Y1M14JQ1 SEATTLE WACard 2801","34.22","","Posted","409.3"
"10/17/2021","","Withdrawal POS #000000021687/CIRCLE K # 21142 3 GAINESVILLE FLCard 2801","19.08","","Posted","443.52"
"10/17/2021","","Withdrawal POS #000000006950/CIRCLE K # 26162 7 GAINESVILLE FLCard 2801","17.63","","Posted","462.6"
"10/17/2021","","Recurring Withdrawal Debit Card MC Debit/JARVIS - CONVERSION.AI AUSTIN TXDate 10/16/21 0 1289123474 1 7399Card 2801","119","","Posted","480.23"
"10/17/2021","","Withdrawal Debit Card MC Debit/COUNTRY CRITTERS - 3 GAINESVILLE FLDate 10/14/21 0 1287686337 4 0742Card 2801","141.5","","Posted","599.23"
"10/16/2021","","Withdrawal POS #000000031532/CIRCLE K # 26146 3 GAINESVILLE FLCard 2801","17.74","","Posted","740.73"
"10/16/2021","","Withdrawal POS #000000368530/FAST TRACK #200 3960 SW ARCHER RDGAINESVILLE FLCard 2801","9.63","","Posted","758.47"
"10/15/2021","","Recurring Withdrawal Debit Card MC Debit/RYTR - AI WRITER WALNUT CADate 10/14/21 0 1287521485 0 7399Card 2801","29","","Posted","768.1"
"10/15/2021","","Withdrawal ACH PAYPAL/TYPE: INST XFER ID: PAYPALSI77CO: PAYPALEntry Class Code: WEB","131.83","","Posted","797.1"
"10/15/2021","","Withdrawal POS #000000267441/FAST TRACK #200 3960 SW ARCHER RDGAINESVILLE FLCard 2801","12.18","","Posted","928.93"
"10/14/2021","","Deposit Home Banking Transfer - From Share 0000/Funds Transfer via Mobile","","750","Posted","941.11"
"10/14/2021","","Recurring Withdrawal Debit Card MC Debit/NETFLIX.COM 866-5797172 CADate 10/13/21 0 1286180130 1 4899Card 2801","9.88","","Posted","191.11"
"10/14/2021","","Withdrawal ACH APPLECARD GSBANK/TYPE: PAYMENT ID: 9999999999CO: APPLECARD GSBANKEntry Class Code: WEB","80","","Posted","200.99"
"10/14/2021","","Withdrawal ACH DENES HALLOK/CO: DENES HALLOKTYPE: IAT PAYPAL ID: 770510487CEntry Class Code: IAT","2","","Posted","280.99"
"10/14/2021","","Withdrawal ACH PAYPAL/TYPE: INST XFER ID: PAYPALSI77CO: PAYPALEntry Class Code: WEB","33.17","","Posted","282.99"
"10/13/2021","102","Draft 102","860","","Posted","316.16"
"10/13/2021","","Withdrawal POS #000000259511/AMAZON.COM*2776K9KH0 SEATTLE WACard 2801","37.44","","Posted","1176.16"
"10/13/2021","","Withdrawal Debit Card MC Debit/PUBLIX #1312 GAINESVILLE FLDate 10/12/21 0 1285617424 1 5411Card 2801","80.41","","Posted","1213.6"
"10/13/2021","","Withdrawal Debit Card MC Debit/WALGREENS #5024 800-289-2273 FLDate 10/12/21 0 1285542496 1 5912Card 2801","4.5","","Posted","1294.01"
"10/12/2021","","Recurring Withdrawal Debit Card Fee/MASTERCARD ISSUER CROSS-BORDER FEEDate 10/11/21 0 1284171856 1 5817Card 2801","0.05","","Posted","1298.51"
"10/12/2021","","Recurring Withdrawal Debit Card MC Debit/PAYPAL *LINKTREE 4029357733 AUDate 10/11/21 0 1284171856 1 5817Card 2801","6","","Posted","1298.56"
"10/12/2021","","Withdrawal Debit Card MC Debit/ELDERSCROLLSONLINE. 855-296-3170 MDDate 10/11/21 0 1284168828 1 7994Card 2801","14.99","","Posted","1304.56"
"10/12/2021","","Withdrawal ACH BARCLAYCARD US/TYPE: CREDITCARD ID: 2510407970CO: BARCLAYCARD USEntry Class Code: WEB","82.94","","Posted","1319.55"
"10/12/2021","","Withdrawal ACH CAPITAL ONE/TYPE: MOBILE PMT ID: 9279744980CO: CAPITAL ONEEntry Class Code: WEB","50","","Posted","1402.49"
"10/12/2021","","Withdrawal ACH DISCOVER/TYPE: E-PAYMENT ID: 2510020270CO: DISCOVEREntry Class Code: WEB","65","","Posted","1452.49"
"10/12/2021","","Withdrawal ACH PAYMENT FOR AMZ/TYPE: STORECARD ID: 9069872103CO: PAYMENT FOR AMZEntry Class Code: WEB","50","","Posted","1517.49"
"10/12/2021","","Withdrawal ACH TARGET CARD SRVC/TYPE: BILL PAY ID: T510215170CO: TARGET CARD SRVCEntry Class Code: WEB","50","","Posted","1567.49"
"10/12/2021","","Withdrawal ACH DISCOVER/TYPE: E-PAYMENT ID: 2510020270CO: DISCOVEREntry Class Code: WEB","15","","Posted","1617.49"
"10/12/2021","","Withdrawal ACH PAYPAL/TYPE: INST XFER ID: PAYPALSI77CO: PAYPALEntry Class Code: WEB","9.99","","Posted","1632.49"
"10/12/2021","","Withdrawal ACH PAYPAL/TYPE: INST XFER ID: PAYPALSI77CO: PAYPALEntry Class Code: WEB","9.18","","Posted","1642.48"
"10/12/2021","","Withdrawal ACH PAYPAL/TYPE: INST XFER ID: PAYPALSI77CO: PAYPALEntry Class Code: WEB","2.99","","Posted","1651.66"
"10/12/2021","","Withdrawal ACH PAYPAL/TYPE: INST XFER ID: PAYPALSI77CO: PAYPALEntry Class Code: WEB","0.99","","Posted","1654.65"
"10/12/2021","","Withdrawal POS #000000838593/FAST TRACK #200 3960 SW ARCHER RDGAINESVILLE FLCard 2801","23.6","","Posted","1655.64"
"10/9/2021","","Withdrawal POS #000000028122/FAST TRACK #200 3960 SW ARCHER RDGAINESVILLE FLCard 2801","23.6","","Posted","1679.24"
"10/8/2021","","Withdrawal POS #000000099004/PUBLIX 5801 SW 75TH ST GAINESVILLE FLCard 2801","31.65","","Posted","1702.84"
"10/8/2021","","Withdrawal Debit Card MC Debit/WALGREENS #5024 800-289-2273 FLDate 10/07/21 0 1280804151 1 5912Card 2801","15","","Posted","1734.49"
"10/8/2021","","Recurring Withdrawal Bill Payment - #000014463277/PAYPAL *VIDIQ 2211 North First S SanCACard 2801","10","","Posted","1749.49"
"10/7/2021","","Withdrawal POS #000000005212/CIRCLE K # 06782 5 GAINESVILLE FLCard 2801","23.36","","Posted","1759.49"
"10/6/2021","","Withdrawal POS #000015449112/WALGREENS 2415 SW GAINESVILLE FLCard 2801","19.45","","Posted","1782.85"
"10/6/2021","","Recurring Withdrawal Debit Card MC Debit/PLAYERAUCTIONS 800-342-0768 DEDate 10/05/21 0 1278513790 1 7993Card 2801","129.21","","Posted","1802.3"
"10/6/2021","","Recurring Withdrawal Debit Card MC Debit/AMAZON PRIME*279H43C10 AMZN.COM/BIL WADate 10/05/21 0 1278183532 1 5968Card 2801","13.08","","Posted","1931.51"
"10/6/2021","","Withdrawal ACH PAYPAL/TYPE: INST XFER ID: PAYPALSI77CO: PAYPALEntry Class Code: WEB","58","","Posted","1944.59"
"10/5/2021","","Withdrawal POS #000000098717/GATE 1445 506 NW 1 GAINESVILLE FLCard 2801","18.17","","Posted","2002.59"
"10/5/2021","","Withdrawal ACH PAYPAL/TYPE: INST XFER ID: PAYPALSI77CO: PAYPALEntry Class Code: WEB","14.95","","Posted","2020.76"
"10/5/2021","","Withdrawal ACH PAYPAL/TYPE: INST XFER ID: PAYPALSI77CO: PAYPALEntry Class Code: WEB","2.99","","Posted","2035.71"
"10/4/2021","","Withdrawal Debit Card MC Debit/PIZZA HUT 27918 3523739402 FLDate 10/03/21 0 1276852449 4 5812Card 2801","39.4","","Posted","2038.7"
"10/4/2021","","Withdrawal Debit Card MC Debit/AMZN DIGITAL 888-802-3 888-802-3080 WADate 10/03/21 0 1276845465 4 5818Card 2801","49.99","","Posted","2078.1"
"10/4/2021","","Withdrawal ACH TARGET CARD SRVC/TYPE: BILL PAY ID: T510215170CO: TARGET CARD SRVCEntry Class Code: WEB","105","","Posted","2128.09"
"10/4/2021","","Withdrawal ACH PAYMENT FOR AMZ/TYPE: STORECARD ID: 9069872103CO: PAYMENT FOR AMZEntry Class Code: WEB","100","","Posted","2233.09"
"10/4/2021","","Withdrawal ACH PAYPAL/TYPE: INST XFER ID: PAYPALSI77CO: PAYPALEntry Class Code: WEB","99.99","","Posted","2333.09"
"10/4/2021","","Withdrawal ACH PAYPAL/TYPE: INST XFER ID: PAYPALSI77CO: PAYPALEntry Class Code: WEB","2.99","","Posted","2433.08"
"10/3/2021","","Withdrawal POS #000000027220/CIRCLE K # 26146 3 GAINESVILLE FLCard 2801","23.5","","Posted","2436.07"
"10/3/2021","","Withdrawal ATM Transaction","200","","Posted","2459.57"
"10/3/2021","","Withdrawal POS #000009352704/WALGREENS 2415 SW GAINESVILLE FLCard 2801","19.78","","Posted","2659.57"
"10/1/2021","","Withdrawal ACH PAYPAL INC./CO: PAYPAL INC.TYPE: IAT PAYPAL ID: 770510487CEntry Class Code: IAT","59.99","","Posted","2679.35"
"10/1/2021","","Withdrawal ACH PAYPAL/TYPE: INST XFER ID: PAYPALSI77CO: PAYPALEntry Class Code: WEB","14.95","","Posted","2739.34"
"9/30/2021","","Withdrawal Debit Card MC Debit/COUNTRY CRITTERS - 3 GAINESVILLE FLDate 09/29/21 0 1272704417 1 0742Card 2801","388.86","","Posted","2754.29"
"9/30/2021","","Deposit Home Banking Transfer trf/From CHAPLINSKI,LEON 3496297 Share 0090","","2000","Posted","3143.15"
"9/30/2021","","Withdrawal ACH PAYPAL/TYPE: INST XFER ID: PAYPALSI77CO: PAYPALEntry Class Code: WEB","19.99","","Posted","1143.15"
"9/29/2021","","Withdrawal POS #000015101412/GAINESVILLE RURAL KING 2801 NW 13TH STGAINESVILLE FLCard 2801","10.68","","Posted","1163.14"
"9/29/2021","","Deposit Home Banking Transfer - From Share 0000/Funds Transfer via Mobile","","1111.11","Posted","1173.82"
"9/29/2021","","Withdrawal ACH PAYPAL INC./CO: PAYPAL INC.TYPE: IAT PAYPAL ID: 770510487CEntry Class Code: IAT","4.95","","Posted","62.71"
"9/29/2021","","Withdrawal ACH PAYPAL INC./CO: PAYPAL INC.TYPE: IAT PAYPAL ID: 770510487CEntry Class Code: IAT","3.99","","Posted","67.66"
"9/29/2021","","Withdrawal ACH TARGET CARD SRVC/TYPE: BILL PAY ID: T510215170CO: TARGET CARD SRVCEntry Class Code: WEB","105","","Posted","71.65"
"9/29/2021","","Withdrawal Transfer fee","8","","Posted","176.65"
"9/29/2021","","Deposit Transfer From Share 0000","","100","Posted","184.65"
"9/29/2021","","Withdrawal ACH PAYPAL/TYPE: INST XFER ID: PAYPALSI77CO: PAYPALEntry Class Code: WEB","11.48","","Posted","84.65"
"9/29/2021","","Withdrawal ACH PAYPAL/TYPE: INST XFER ID: PAYPALSI77CO: PAYPALEntry Class Code: WEB","2.99","","Posted","96.13"
"9/28/2021","","Withdrawal Debit Card MC Debit/EIG*BLUEHOST.COM 888-4014678 UTDate 09/27/21 0 1270381943 1 5968Card 2801","59.4","","Posted","99.12"
"9/28/2021","","Recurring Withdrawal Debit Card MC Debit/EIG*BLUEHOST.COM 888-4014678 UTDate 09/27/21 0 1270381942 1 5968Card 2801","13.75","","Posted","158.52"
"9/28/2021","","Withdrawal Debit Card MC Debit/GRU/EZ-PAY WEB PYMT 352-334-3434 FLDate 09/27/21 0 1270573814 0 4900Card 2801","161.9","","Posted","172.27"
"9/28/2021","","Withdrawal ACH PAYPAL/TYPE: INST XFER ID: PAYPALSI77CO: PAYPALEntry Class Code: WEB","80.24","","Posted","334.17"
"9/28/2021","","Withdrawal ACH PAYPAL/TYPE: INST XFER ID: PAYPALSI77CO: PAYPALEntry Class Code: WEB","2.99","","Posted","414.41"
"9/27/2021","","Withdrawal Debit Card MC Debit/IBLOCKLIST.COM MIAMI FLDate 09/26/21 0 1269652765 4 7372Card 2801","9.99","","Posted","417.4"
"9/27/2021","","Recurring Withdrawal Debit Card MC Debit/HELP.HBOMAX.COM NEW YORK NYDate 09/27/21 0 1270428361 1 5815Card 2801","17.23","","Posted","427.39"
"9/27/2021","","Withdrawal Debit Card MC Debit/FS *STARDOCK 877-3278914 CADate 09/26/21 0 1269698586 1 5734Card 2801","19.99","","Posted","444.62"
"9/27/2021","","Withdrawal ACH PADDLE.COM MARKE/CO: PADDLE.COM MARKET LIMITEDTYPE: IAT PAYPAL ID: 770510487CEntry Class Code: IAT","9.99","","Posted","464.61"
"9/27/2021","","Withdrawal ACH PAYPAL/TYPE: INST XFER ID: PAYPALSI77CO: PAYPALEntry Class Code: WEB","58.5","","Posted","474.6"
"9/27/2021","","Withdrawal ACH PAYPAL/TYPE: INST XFER ID: PAYPALSI77CO: PAYPALEntry Class Code: WEB","23.99","","Posted","533.1"
"9/27/2021","","Withdrawal ACH PAYPAL/TYPE: INST XFER ID: PAYPALSI77CO: PAYPALEntry Class Code: WEB","7","","Posted","557.09"
"9/27/2021","","Withdrawal ACH PAYPAL/TYPE: INST XFER ID: PAYPALSI77CO: PAYPALEntry Class Code: WEB","7","","Posted","564.09"
"9/27/2021","","Withdrawal ACH PAYPAL/TYPE: INST XFER ID: PAYPALSI77CO: PAYPALEntry Class Code: WEB","4.5","","Posted","571.09"
"9/27/2021","","Withdrawal ACH PAYPAL/TYPE: INST XFER ID: PAYPALSI77CO: PAYPALEntry Class Code: WEB","2.99","","Posted","575.59"
"9/26/2021","","Withdrawal Debit Card MC Debit/WELLSAID LABS SEATTLE WADate 09/24/21 0 1267254630 1 5734Card 2801","49","","Posted","578.58"
"9/26/2021","","Withdrawal Debit Card MC Debit/KINDLE UNLTD*2C1FL7AZ1 866-321-8851 WADate 09/24/21 0 1267679150 1 5818Card 2801","9.99","","Posted","627.58"
"9/24/2021","","Withdrawal Debit Card MC Debit/PUBLIX #680 GAINESVILLE FLDate 09/23/21 0 1266591030 1 5411Card 2801","114.19","","Posted","637.57"
"9/24/2021","","Withdrawal Debit Card MC Debit/GOOGLE DOMAINS MOUNTAIN VIE CADate 09/24/21 0 1267589971 1 5816Card 2801","12","","Posted","751.76"
"9/24/2021","","Recurring Withdrawal Debit Card MC Debit/PLAYERAUCTIONS 800-342-0768 DEDate 09/23/21 0 1266586911 1 7993Card 2801","59.13","","Posted","763.76"
"9/24/2021","","Withdrawal Debit Card MC Debit/COX GAINESVILLE COMM 800-234-3993 FLDate 09/24/21 0 1267730655 1 4899Card 2801","94.32","","Posted","822.89"
"9/24/2021","","Withdrawal ACH PAYPAL/TYPE: INST XFER ID: PAYPALSI77CO: PAYPALEntry Class Code: WEB","99.99","","Posted","917.21"
"9/24/2021","","Withdrawal ACH PAYPAL/TYPE: INST XFER ID: PAYPALSI77CO: PAYPALEntry Class Code: WEB","39.99","","Posted","1017.2"
"9/23/2021","","Withdrawal POS #000000105340/GATE 1445 506 NW 1 GAINESVILLE FLCard 2801","13.74","","Posted","1057.19"
"9/21/2021","","Withdrawal ACH PAYPAL/TYPE: INST XFER ID: PAYPALSI77CO: PAYPALEntry Class Code: WEB","6.99","","Posted","1070.93"
"9/21/2021","","Withdrawal ACH PAYPAL/TYPE: INST XFER ID: PAYPALSI77CO: PAYPALEntry Class Code: WEB","2.99","","Posted","1077.92"
"9/20/2021","","Withdrawal Debit Card MC Debit/CRONUSMAX COM 434-2274394 VADate 09/17/21 0 1260344951 5 5732Card 2801","49.98","","Posted","1080.91"
"9/20/2021","","Withdrawal ACH PAYPAL/TYPE: INST XFER ID: PAYPALSI77CO: PAYPALEntry Class Code: WEB","29","","Posted","1130.89"
"9/20/2021","","Withdrawal ACH PAYPAL/TYPE: INST XFER ID: PAYPALSI77CO: PAYPALEntry Class Code: WEB","26.75","","Posted","1159.89"
"9/19/2021","","Withdrawal Debit Card MC Debit/DOG BYTES COMPUTERS, I GAINESVILLE FLDate 09/17/21 0 1260920418 1 5045Card 2801","267.5","","Posted","1186.64"
"9/18/2021","","Deposit Home Banking Transfer trf/From CHAPLINSKI,LEON 3496297 Share 0000","","268","Posted","1454.14"
"9/17/2021","","Withdrawal POS #000000132477/WAWA 5384 2305 NW 13TH ST GAINESVILLE FLCard 2801","26.75","","Posted","1186.14"
"9/17/2021","","Recurring Withdrawal Debit Card MC Debit/JARVIS - CONVERSION.AI AUSTIN TXDate 09/16/21 0 1259607288 1 7399Card 2801","88.09","","Posted","1212.89"
"9/17/2021","","Withdrawal Debit Card MC Debit/JARVIS - CONVERSION.AI AUSTIN TXDate 09/16/21 0 1259239886 1 7399Card 2801","29","","Posted","1300.98"
"9/17/2021","","Withdrawal ACH PAYPAL/TYPE: INST XFER ID: PAYPALSI77CO: PAYPALEntry Class Code: WEB","14.99","","Posted","1329.98"
"9/17/2021","","Deposit Home Banking Transfer - From Share 0000/Funds Transfer via Mobile","","700","Posted","1344.97"
"9/16/2021","101","Draft 101","860","","Posted","644.97"
"9/16/2021","","Withdrawal Debit Card MC Debit/NAME-CHEAP.COM PHOENIX AZDate 09/15/21 0 1258539850 0 7372Card 2801","47.86","","Posted","1504.97"
"9/16/2021","","Withdrawal Debit Card MC Debit/PUBLIX #1312 GAINESVILLE FLDate 09/15/21 0 1258745311 1 5411Card 2801","74.7","","Posted","1552.83"
"9/16/2021","","Withdrawal ACH BEST BUY/TYPE: PAYMENT ID: CITIGPUFDRCO: BEST BUYEntry Class Code: PPD","180","","Posted","1627.53"
"9/16/2021","","Withdrawal ACH PAYMENT FOR AMZ/TYPE: STORECARD ID: 9069872103CO: PAYMENT FOR AMZEntry Class Code: WEB","145","","Posted","1807.53"
"9/16/2021","","Deposit Home Banking Transfer - From Share 0000/Funds Transfer via Mobile","","1100","Posted","1952.53"
"9/15/2021","","Withdrawal POS #000000079769/TARGET T-0687 3970 SW Archer RdGainesville FLCard 2801","104.14","","Posted","852.53"
"9/15/2021","","Withdrawal Debit Card MC Debit/RYTR - AI WRITER WALNUT CADate 09/14/21 0 1257156154 1 7399Card 2801","29","","Posted","956.67"
"9/15/2021","","Withdrawal Debit Card MC Debit/AMZN DIGITAL*2G2YK1811 888-802-3080 WADate 09/15/21 0 1258632245 1 5818Card 2801","1.99","","Posted","985.67"
"9/15/2021","","Withdrawal ACH APPLECARD GSBANK/TYPE: PAYMENT ID: 9999999999CO: APPLECARD GSBANKEntry Class Code: WEB","100","","Posted","987.66"
"9/15/2021","","Withdrawal ACH BEST BUY/TYPE: PAYMENT ID: CITIGPUFDRCO: BEST BUYEntry Class Code: PPD","80","","Posted","1087.66"
"9/15/2021","","Withdrawal ACH CAPITAL ONE/TYPE: ONLINE PMT ID: 9279744991CO: CAPITAL ONEEntry Class Code: WEB","75","","Posted","1167.66"
"9/15/2021","","Withdrawal ACH BARCLAYCARD US/TYPE: CREDITCARD ID: 2510407970CO: BARCLAYCARD USEntry Class Code: WEB","75","","Posted","1242.66"
"9/15/2021","","Withdrawal ACH BEST BUY/TYPE: PAYMENT ID: CITIGPUFDRCO: BEST BUYEntry Class Code: PPD","120","","Posted","1317.66"
"9/15/2021","","Withdrawal ACH TARGET CARD SRVC/TYPE: BILL PAY ID: 5411721813CO: TARGET CARD SRVCEntry Class Code: WEB","105","","Posted","1437.66"
"9/15/2021","","Withdrawal ACH PAYPAL/TYPE: INST XFER ID: PAYPALSI77CO: PAYPALEntry Class Code: WEB","99.99","","Posted","1542.66"
"9/15/2021","","Withdrawal ACH DISCOVER/TYPE: E-PAYMENT ID: 2510020270CO: DISCOVEREntry Class Code: WEB","75","","Posted","1642.65"
"9/15/2021","","Withdrawal ACH PAYPAL/TYPE: INST XFER ID: PAYPALSI77CO: PAYPALEntry Class Code: WEB","9.99","","Posted","1717.65"
"9/14/2021","","Withdrawal POS #000000102669/GATE 1445 506 NW 1 GAINESVILLE FLCard 2801","18.54","","Posted","1727.64"
"9/14/2021","","Withdrawal ATM Transaction","180","","Posted","1746.18"
"9/14/2021","","Withdrawal Debit Card MC Debit/WALGREENS #5024 800-289-2273 FLDate 09/13/21 0 1256616160 1 5912Card 2801","22.08","","Posted","1926.18"
"9/14/2021","","Withdrawal Debit Card MC Debit/GRU/EZ-PAY WEB PYMT 352-334-3434 FLDate 09/13/21 0 1256503123 0 4900Card 2801","274.86","","Posted","1948.26"
"9/14/2021","","Deposit Home Banking Transfer - From Share 0000/Funds Transfer via Online","","1000","Posted","2223.12"
"9/14/2021","","Withdrawal ACH PAYPAL/TYPE: INST XFER ID: PAYPALSI77CO: PAYPALEntry Class Code: WEB","39.99","","Posted","1223.12"
"9/14/2021","","Withdrawal ACH PAYPAL/TYPE: INST XFER ID: PAYPALSI77CO: PAYPALEntry Class Code: WEB","24.99","","Posted","1263.11"
"9/13/2021","","Withdrawal POS #000000865446/WAWA 5325 2373 SW ARCHER ROA GAINESVILLEFLCard 2801","13.38","","Posted","1288.1"
"9/13/2021","","Deposit Home Banking Transfer trf/From CHAPLINSKI,LEON 3496297 Share 0000","","200","Posted","1301.48"
"9/13/2021","","Withdrawal Debit Card MC Debit/NETFLIX.COM LOS GATOS CADate 09/13/21 0 1256468518 1 4899Card 2801","9.88","","Posted","1101.48"
"9/13/2021","","Recurring Withdrawal Debit Card Fee/MASTERCARD ISSUER CROSS-BORDER FEEDate 09/11/21 0 1254870514 0 5817Card 2801","0.05","","Posted","1111.36"
"9/13/2021","","Recurring Withdrawal Debit Card MC Debit/PAYPAL *LINKTREE 4029357733 AUDate 09/11/21 0 1254870514 0 5817Card 2801","6","","Posted","1111.41"
"9/13/2021","","Deposit Home Banking Transfer trf/From CHAPLINSKI,LEON 3496297 Share 0090","","200","Posted","1117.41"
"9/13/2021","","Withdrawal Bill Payment #000012373398/GRU EZ PAY WEB PYMT GAINESVILLE FLCard 2801","209.53","","Posted","917.41"
"9/13/2021","","Withdrawal ACH PAYPAL/TYPE: INST XFER ID: PAYPALSI77CO: PAYPALEntry Class Code: WEB","14.99","","Posted","1126.94"
"9/13/2021","","Withdrawal ACH PAYPAL/TYPE: INST XFER ID: PAYPALSI77CO: PAYPALEntry Class Code: WEB","9.18","","Posted","1141.93"
"9/12/2021","","Withdrawal Debit Card MC Debit/PUBLIX #435 GAINESVILLE FLDate 09/10/21 0 1253910743 1 5411Card 2801","80.03","","Posted","1151.11"
"9/11/2021","","Deposit ACH STEVEN CHAPLINSK/TYPE: MOBILE DEP CO: STEVEN CHAPLINSKACH Trace Number: 263178470000009","","163.77","Posted","1231.14"
"9/10/2021","","Deposit POS #000000941872/PAYPAL*chaplinski San Jose CACard 2801","","34.47","Posted","1067.37"
"9/10/2021","","Withdrawal POS #000000613712/FAST TRACK #200 3960 SW ARCHER RDGAINESVILLE FLCard 2801","18.43","","Posted","1032.9"
"9/10/2021","","Withdrawal ATM Transaction","40","","Posted","1051.33"
"9/10/2021","","Withdrawal Debit Card MC Debit/ELDERSCROLLSONLINE. 855-296-3170 MDDate 09/10/21 0 1253698432 1 7994Card 2801","14.99","","Posted","1091.33"
"9/10/2021","","Withdrawal ACH TARGET CARD SRVC/TYPE: BILL PAY ID: T510215170CO: TARGET CARD SRVCEntry Class Code: WEB","25","","Posted","1106.32"
"9/9/2021","","Withdrawal Debit Card MC Debit/WALGREENS #5024 800-289-2273 FLDate 09/08/21 0 1251607416 1 5912Card 2801","15","","Posted","1131.32"
"9/9/2021","","Withdrawal ACH PAYPAL/TYPE: INST XFER ID: PAYPALSI77CO: PAYPALEntry Class Code: WEB","19.99","","Posted","1146.32"
"9/8/2021","","Withdrawal POS #000000033932/PUBLIX 3930 SW ARCHER ROA GAINESVILLE FLCard 2801","25.7","","Posted","1166.31"
"9/8/2021","","Withdrawal POS #000000014786/CIRCLE K # 06782 5 GAINESVILLE FLCard 2801","17.31","","Posted","1192.01"
"9/8/2021","","Withdrawal POS #000018544628/WALGREENS 2415 SW GAINESVILLE FLCard 2801","21.01","","Posted","1209.32"
"9/8/2021","","Withdrawal Bill Payment #000009103856/PAYPAL *VIDIQ San Jose CACard 2801","10","","Posted","1230.33"
"9/7/2021","","Withdrawal ACH PAYPAL/TYPE: INST XFER ID: PAYPALSI77CO: PAYPALEntry Class Code: WEB","27.94","","Posted","1240.33"
"9/7/2021","","Withdrawal ACH PAYPAL/TYPE: INST XFER ID: PAYPALSI77CO: PAYPALEntry Class Code: WEB","5.99","","Posted","1268.27"
"9/7/2021","","Withdrawal ACH PAYPAL/TYPE: INST XFER ID: PAYPALSI77CO: PAYPALEntry Class Code: WEB","2.99","","Posted","1274.26"
"9/6/2021","","Withdrawal Debit Card MC Debit/PUBLIX #1560 GAINESVILLE FLDate 09/04/21 0 1247836114 5 5411Card 2801","21.39","","Posted","1277.25"
"9/6/2021","","Recurring Withdrawal Debit Card MC Debit/AMAZON PRIME*253Y95IJ0 AMZN.COM/BIL WADate 09/05/21 0 1248819282 5 5968Card 2801","13.08","","Posted","1298.64"
"9/6/2021","","Withdrawal Debit Card MC Debit/COX GAINESVILLE COMM 800-234-3993 FLDate 09/04/21 0 1247814189 5 4899Card 2801","94.32","","Posted","1311.72"
"9/5/2021","","Withdrawal POS #000000634877/AMAZON.COM*251J42IJ0 SEATTLE WACard 2801","32.06","","Posted","1406.04"
"9/4/2021","","Withdrawal at ATM #000000000082/Columbia Gainesville 1 1250 W UniversityGainesville FLCard 2801","23.5","","Posted","1438.1"
"9/4/2021","","Withdrawal POS #000000105125/WAWA 5325 2373 SW ARCHER ROA GAINESVILLEFLCard 2801","19.55","","Posted","1461.6"
"9/4/2021","","Withdrawal/Cash Disbursed 200.00","200","","Posted","1481.15"
"9/3/2021","","Withdrawal Debit Card MC Debit/PUBLIX #1312 GAINESVILLE FLDate 09/02/21 0 1245874546 1 5411Card 2801","36.37","","Posted","1681.15"
"9/2/2021","","Withdrawal ACH PAYPAL/TYPE: INST XFER ID: PAYPALSI77CO: PAYPALEntry Class Code: WEB","60.07","","Posted","1717.52"
"9/1/2021","","Withdrawal POS #000000008021/CIRCLE K # 06782 5 GAINESVILLE FLCard 2801","21.08","","Posted","1777.59"
"9/1/2021","","Withdrawal ACH PAYMENT FOR AMZ/TYPE: STORECARD ID: 9069872103CO: PAYMENT FOR AMZEntry Class Code: WEB","50","","Posted","1798.67"
"8/31/2021","","Withdrawal ACH BARCLAYCARD US/TYPE: CREDITCARD ID: 2510407970CO: BARCLAYCARD USEntry Class Code: WEB","50","","Posted","1848.67"
"8/31/2021","","Withdrawal ACH CAPITAL ONE/TYPE: MOBILE PMT ID: 9279744980CO: CAPITAL ONEEntry Class Code: WEB","25","","Posted","1898.67"
"8/31/2021","","Withdrawal ACH TARGET CARD SRVC/TYPE: BILL PAY ID: 5411721813CO: TARGET CARD SRVCEntry Class Code: WEB","50","","Posted","1923.67"
"8/31/2021","","Withdrawal ACH DISCOVER/TYPE: E-PAYMENT ID: 2510020270CO: DISCOVEREntry Class Code: WEB","33.78","","Posted","1973.67"
"8/30/2021","","Deposit Home Banking Transfer trf/From CHAPLINSKI,LEON 3496297 Share 0090","","2000","Posted","2007.45"
"8/30/2021","","Deposit Home Banking Transfer - From Share 0000/Funds Transfer via Mobile","","2.75","Posted","7.45"
"8/30/2021","","Withdrawal ACH PAYPAL/TYPE: INST XFER ID: PAYPALSI77CO: PAYPALEntry Class Code: WEB","11.48","","Posted","4.7"
"8/30/2021","","Withdrawal ACH PAYPAL/TYPE: INST XFER ID: PAYPALSI77CO: PAYPALEntry Class Code: WEB","2.99","","Posted","16.18"
"8/30/2021","","Withdrawal POS #000000731362/PUBLIX 9200 NW 39TH AVE GAINESVILLE FLCard 2801","18.71","","Posted","19.17"
"8/29/2021","","Withdrawal POS #000000601141/WAWA 5325 2373 SW ARCHER ROA GAINESVILLEFLCard 2801","18.3","","Posted","37.88"
"8/29/2021","","Deposit POS #000000130258/PAYPAL*chaplinski San Jose CACard 2801","","7","Posted","56.18"
"8/27/2021","","Recurring Withdrawal Debit Card MC Debit/HELP.HBOMAX.COM NEW YORK NYDate 08/27/21 0 1239858259 1 5815Card 2801","17.23","","Posted","49.18"
"8/27/2021","","Withdrawal ACH PAYPAL/TYPE: INST XFER ID: PAYPALSI77CO: PAYPALEntry Class Code: WEB","2.99","","Posted","66.41"
"8/26/2021","","Deposit Adjustment/FUNDS TRAN RET-INVALID ACCT #","30","","Posted","69.4"
"8/26/2021","","Withdrawal ACH PAYPAL/TYPE: INST XFER ID: PAYPALSI77CO: PAYPALEntry Class Code: WEB","4.5","","Posted","99.4"
"8/24/2021","","Withdrawal ATM Fee/ASAI 318 Suite 8C NW 13 Gainesville FLCard 2801","2","","Posted","103.9"
"8/24/2021","","Withdrawal at ATM #000000000902/ASAI 318 Suite 8C NW 13 Gainesville FLCard 2801","38.5","","Posted","105.9"
"8/24/2021","","Withdrawal POS #000000086864/GATE 1445 506 NW 1 GAINESVILLE FLCard 2801","22.62","","Posted","144.4"
"8/24/2021","","Withdrawal ACH PAYPAL/TYPE: INST XFER ID: PAYPALSI77CO: PAYPALEntry Class Code: WEB","57.41","","Posted","167.02"
"8/24/2021","","Deposit ACH EVEN CHAPLINSKI/TYPE: Funds Tran ID: 9007587542CO: EVEN CHAPLINSKIEntry Class Code: WEB","","30","Posted","224.43"
"8/23/2021","","Withdrawal Debit Card MC Debit/WALGREENS #5024 800-289-2273 FLDate 08/22/21 0 1234711756 1 5912Card 2801","4.65","","Posted","194.43"
"8/23/2021","","Deposit Home Banking Transfer trf/From CHAPLINSKI,LEON 3496297 Share 0090","","100","Posted","199.08"
"8/23/2021","","Withdrawal ATM Transaction","20","","Posted","99.08"
"8/23/2021","","Withdrawal ACH PAYPAL/TYPE: INST XFER ID: PAYPALSI77CO: PAYPALEntry Class Code: WEB","6.99","","Posted","119.08"
"8/23/2021","","Deposit Home Banking Transfer - From Share 0000/Funds Transfer via Mobile","","5","Posted","126.07"
"8/22/2021","","Withdrawal Debit Card MC Debit/PUBLIX #1312 GAINESVILLE FLDate 08/20/21 0 1232749566 1 5411Card 2801","71.42","","Posted","121.07"
"8/22/2021","","Withdrawal POS #000000035657/PUBLIX 5200 S W 34TH STRE GAINESVILLE FLCard 2801","30.96","","Posted","192.49"
"8/22/2021","","Withdrawal POS #000000010085/CIRCLE K # 06782 5 GAINESVILLE FLCard 2801","22.1","","Posted","223.45"
"8/21/2021","","Deposit Home Banking Transfer trf/From CHAPLINSKI,LEON 3496297 Share 0090","","100","Posted","245.55"
"8/20/2021","","Withdrawal POS #000000825743/FAST TRACK #200 3960 SW ARCHER RDGAINESVILLE FLCard 2801","9.21","","Posted","145.55"
"8/19/2021","100","Draft 100","850","","Posted","154.76"
"8/19/2021","","Withdrawal ACH PAYPAL/TYPE: INST XFER ID: PAYPALSI77CO: PAYPALEntry Class Code: WEB","29","","Posted","1004.76"
"8/17/2021","","Withdrawal ACH PAYPAL/TYPE: INST XFER ID: PAYPALSI77CO: PAYPALEntry Class Code: WEB","31.27","","Posted","1033.76"
"8/16/2021","","Withdrawal Debit Card MC Debit/PIZZA HUT 27918 3523739402 FLDate 08/15/21 0 1227170071 4 5812Card 2801","30.79","","Posted","1065.03"
"8/16/2021","","Withdrawal Debit Card MC Debit/NETFLIX.COM CADate 08/14/21 0 1226476915 2 4899Card 2801","9.88","","Posted","1095.82"
"8/16/2021","","Withdrawal POS #000000084920/GATE 1445 506 NW 1 GAINESVILLE FLCard 2801","13.57","","Posted","1105.7"
"8/16/2021","","Withdrawal POS #000000023411/PUBLIX 203 NW 13TH STREET GAINESVILLE FLCard 2801","40.11","","Posted","1119.27"
"8/16/2021","","Withdrawal ATM Transaction","80","","Posted","1159.38"
"8/16/2021","","Deposit Home Banking Transfer trf/From CHAPLINSKI,LEON 3496297 Share 0090","","100","Posted","1239.38"
"8/16/2021","","Deposit POS #000000290388/PAYPAL*chaplinski San Jose CACard 2801","","24.62","Posted","1139.38"
"8/16/2021","","Deposit Home Banking Transfer - From Share 0000/Funds Transfer via Online","","15","Posted","1114.76"
"8/16/2021","","Withdrawal ACH PAYPAL/TYPE: INST XFER ID: PAYPALSI77CO: PAYPALEntry Class Code: WEB","5.99","","Posted","1099.76"
"8/14/2021","","Withdrawal POS #000011050060/WALGREENS 2415 SW GAINESVILLE FLCard 2801","7.56","","Posted","1105.75"
"8/14/2021","","Withdrawal POS #000000084418/GATE 1445 506 NW 1 GAINESVILLE FLCard 2801","13.57","","Posted","1113.31"
"8/13/2021","","Withdrawal Adjustment POS #000000000004/AMAZON.COM SEATTLE WACard 2801","","7.09","Posted","1126.88"
"8/12/2021","","Recurring Withdrawal Debit Card Fee/MASTERCARD ISSUER CROSS-BORDER FEEDate 08/11/21 0 1223212559 1 5817Card 2801","0.05","","Posted","1119.79"
"8/12/2021","","Recurring Withdrawal Debit Card MC Debit/PAYPAL *LINKTREE 4029357733 AUDate 08/11/21 0 1223212559 1 5817Card 2801","6","","Posted","1119.84"
"8/11/2021","","Withdrawal ACH TURTLEBAYS MARKE/CO: TURTLEBAYS MARKETINGTYPE: IAT PAYPAL ID: 770510487CEntry Class Code: IAT","5","","Posted","1125.84"
"8/11/2021","","Withdrawal ACH PAYMENT FOR AMZ/TYPE: STORECARD ID: 9069872103CO: PAYMENT FOR AMZEntry Class Code: WEB","25","","Posted","1130.84"
"8/11/2021","","Withdrawal ACH PAYPAL/TYPE: INST XFER ID: PAYPALSI77CO: PAYPALEntry Class Code: WEB","0.99","","Posted","1155.84"
"8/10/2021","","Withdrawal ACH PAYPAL/TYPE: INST XFER ID: PAYPALSI77CO: PAYPALEntry Class Code: WEB","3.69","","Posted","1156.83"
"8/9/2021","","Withdrawal POS #000000002523/CIRCLE K # 06782 5 GAINESVILLE FLCard 2801","23.67","","Posted","1160.52"
"8/9/2021","","Withdrawal POS #000013221697/WALGREENS 2415 SW GAINESVILLE FLCard 2801","16.85","","Posted","1184.19"
"8/9/2021","","Withdrawal Debit Card MC Debit/WALGREENS #5024 800-289-2273 FLDate 08/08/21 0 1220489139 1 5912Card 2801","39.99","","Posted","1201.04"
"8/8/2021","","Withdrawal at ATM #000000009758/CAMPUS 1900 SW 34TH ST GAINESVILLE FLCard 2801","120","","Posted","1241.03"
"8/8/2021","","Withdrawal POS #000000054358/FAST TRACK #200 3960 SW ARCHER RDGAINESVILLE FLCard 2801","23.24","","Posted","1361.03"
"8/8/2021","","Withdrawal POS #000000086361/PUBLIX 3930 SW ARCHER ROA GAINESVILLE FLCard 2801","40.21","","Posted","1384.27"
"8/8/2021","","Withdrawal Bill Payment #000008044715/PAYPAL *VIDIQ San Jose CACard 2801","10","","Posted","1424.48"
"8/6/2021","","Withdrawal ACH CAPITAL ONE/TYPE: MOBILE PMT ID: 9279744980CO: CAPITAL ONEEntry Class Code: WEB","25","","Posted","1434.48"
"8/5/2021","","Withdrawal Debit Card MC Debit/PUBLIX #1312 GAINESVILLE FLDate 08/04/21 0 1216616412 1 5411Card 2801","52.11","","Posted","1459.48"
"8/5/2021","","Withdrawal ACH COX COMM GAN/TYPE: BANK DRAFT ID: 1581620085CO: COX COMM GANEntry Class Code: WEB","116.58","","Posted","1511.59"
"8/5/2021","","Withdrawal ACH APPLECARD GSBANK/TYPE: PAYMENT ID: 9999999999CO: APPLECARD GSBANKEntry Class Code: WEB","49.41","","Posted","1628.17"
"8/5/2021","","Withdrawal ACH PAYMENT FOR AMZ/TYPE: STORECARD ID: 9069872103CO: PAYMENT FOR AMZEntry Class Code: WEB","35","","Posted","1677.58"
"8/4/2021","","Withdrawal POS #000000706259/FAST TRACK #200 3960 SW ARCHER RDGAINESVILLE FLCard 2801","21.98","","Posted","1712.58"
"8/4/2021","","Withdrawal Bill Payment #000000712500/PHR*SIMEDHEALTHLLC GAINESVILLE FLCard 2801","45","","Posted","1734.56"
"8/4/2021","","Withdrawal ACH PAYPAL/TYPE: INST XFER ID: PAYPALSI77CO: PAYPALEntry Class Code: WEB","2.99","","Posted","1779.56"
"8/4/2021","","Withdrawal POS #000000591903/KANGAROO EXPRESS 3913 3424 SW WILLISTONGAINESVILLE FLCard 2801","21.86","","Posted","1782.55"
"7/30/2021","","Withdrawal ACH BARCLAYCARD US/TYPE: CREDITCARD ID: 2510407970CO: BARCLAYCARD USEntry Class Code: WEB","36.02","","Posted","1804.41"
"7/30/2021","","Withdrawal ACH CAPITAL ONE/TYPE: MOBILE PMT ID: 9279744980CO: CAPITAL ONEEntry Class Code: WEB","25","","Posted","1840.43"
"7/30/2021","","Withdrawal ACH DISCOVER/TYPE: E-PAYMENT ID: 2510020270CO: DISCOVEREntry Class Code: WEB","31","","Posted","1865.43"
"7/29/2021","","Withdrawal Adjustment POS #000000293028/AMAZON.COM SEATTLE WACard 2801","","27.81","Posted","1896.43"
"7/29/2021","","Withdrawal ATM Fee/COLUMBIA CAR-428486 318 NW 13TH STGAINESVILLE FLCard 2801","2","","Posted","1868.62"
"7/29/2021","","Withdrawal at ATM #000000003731/COLUMBIA CAR-428486 318 NW 13TH STGAINESVILLE FLCard 2801","23","","Posted","1870.62"
"7/29/2021","","Withdrawal ATM Fee/COLUMBIA CAR-428486 318 NW 13TH STGAINESVILLE FLCard 2801","2","","Posted","1893.62"
"7/29/2021","","Withdrawal at ATM #000000003730/COLUMBIA CAR-428486 318 NW 13TH STGAINESVILLE FLCard 2801","23","","Posted","1895.62"
"7/29/2021","","Withdrawal/Transactor: STEVEN J CHAPLINSKICash Disbursed 120.00","120","","Posted","1918.62"
"7/29/2021","","Withdrawal POS #000000084284/PUBLIX 3930 SW ARCHER ROA GAINESVILLE FLCard 2801","56.69","","Posted","2038.62"
"7/29/2021","","Withdrawal POS #000000166784/FAST TRACK #200 3960 SW ARCHER RDGAINESVILLE FLCard 2801","20.52","","Posted","2095.31"
"7/29/2021","","Recurring Withdrawal Adjustment - Debit Card Credit Voucher/AMAZON PRIME AMZN.COM/BIL WADate 07/29/21 0 1210603391 1 5968Card 2801","","13.08","Posted","2115.83"
"7/29/2021","","Deposit Home Banking Transfer trf/From CHAPLINSKI,LEON 3496297 Share 0090","","2000","Posted","2102.75"
"7/29/2021","","Withdrawal ACH PAYPAL/TYPE: INST XFER ID: PAYPALSI77CO: PAYPALEntry Class Code: WEB","5.66","","Posted","102.75"
"7/29/2021","","Withdrawal ACH PAYPAL/TYPE: INST XFER ID: PAYPALSI77CO: PAYPALEntry Class Code: WEB","2.99","","Posted","108.41"
"7/28/2021","","Recurring Withdrawal Debit Card MC Debit/AMAZON PRIME*2E90R5DC2 AMZN.COM/BIL WADate 07/27/21 0 1208211269 1 5968Card 2801","13.08","","Posted","111.4"
"7/27/2021","","Deposit Home Banking Transfer trf/From CHAPLINSKI,LEON 3496297 Share 0090","","300","Posted","124.48"
"7/27/2021","","Withdrawal Fee/Deposited Check Returned Fee","35","","Posted","-175.52"
"7/27/2021","","Deposit Adjustment/FUNDS TRAN RET-ACCT CLOSED","350","","Posted","-140.52"
"7/27/2021","","Recurring Withdrawal Debit Card MC Debit/HELP.HBOMAX.COM NEW YORK NYDate 07/27/21 0 1208512117 1 5815Card 2801","17.23","","Posted","209.48"
"7/27/2021","","Withdrawal ACH CAPITAL ONE/TYPE: MOBILE PMT ID: 9279744980CO: CAPITAL ONEEntry Class Code: WEB","25","","Posted","226.71"
"7/27/2021","","Withdrawal ACH eBay IncFXYBKQSU/TYPE: PAYMENTS ID: 8194689000CO: eBay IncFXYBKQSUEntry Class Code: WEB","180.01","","Posted","251.71"
"7/26/2021","","Withdrawal Debit Card MC Debit/PUBLIX #1312 GAINESVILLE FLDate 07/25/21 0 1206839939 1 5411Card 2801","45.59","","Posted","431.72"
"7/26/2021","","Withdrawal ACH BEST BUY/TYPE: PAYMENT ID: CITIGPUFDRCO: BEST BUYEntry Class Code: PPD","54","","Posted","477.31"
"7/26/2021","","Withdrawal ACH APPLECARD GSBANK/TYPE: PAYMENT ID: 9999999999CO: APPLECARD GSBANKEntry Class Code: WEB","45.41","","Posted","531.31"
"7/26/2021","","Withdrawal ACH CREATIVE FABRICA/CO: CREATIVE FABRICA BVTYPE: IAT PAYPAL ID: 770510487CEntry Class Code: IAT","1","","Posted","576.72"
"7/26/2021","","Withdrawal ACH PAYPAL/TYPE: INST XFER ID: PAYPALSI77CO: PAYPALEntry Class Code: WEB","39.98","","Posted","577.72"
"7/26/2021","","Withdrawal ACH PAYPAL/TYPE: INST XFER ID: PAYPALSI77CO: PAYPALEntry Class Code: WEB","4.5","","Posted","617.7"
"7/26/2021","","Deposit ACH EBAY/TYPE: EDI PYMNTS ID: 3263863381 CO: EBAYEntry Class Code: CCD","","108.05","Posted","622.2"
"7/25/2021","","Withdrawal POS #000000418393/FAST TRACK #200 3960 SW ARCHER RDGAINESVILLE FLCard 2801","20.52","","Posted","514.15"
"7/25/2021","","Withdrawal POS #000013064597/WALGREENS 2415 SW GAINESVILLE FLCard 2801","6.06","","Posted","534.67"
"7/24/2021","","Withdrawal Home Banking Transfer - To Share 0000/Funds Transfer via Mobile","25","","Posted","540.73"
"7/23/2021","","Withdrawal Adjustment POS #000000554165/AMAZON.COM SEATTLE WACard 2801","","49.65","Posted","565.73"
"7/23/2021","","Deposit ACH EVEN CHAPLINSKI/TYPE: Funds Tran ID: 9007418628CO: EVEN CHAPLINSKIEntry Class Code: WEB","","350","Posted","516.08"
"7/22/2021","","Withdrawal POS #000000392386/AMAZON.COM*2E7IK9G82 SEATTLE WACard 2801","49.65","","Posted","166.08"
"7/22/2021","","Withdrawal Debit Card MC Debit/PUBLIX #680 GAINESVILLE FLDate 07/21/21 0 1202694515 1 5411Card 2801","21.23","","Posted","215.73"
"7/22/2021","","Withdrawal POS #000012308138/WALGREENS 2415 SW GAINESVILLE FLCard 2801","7.53","","Posted","236.96"
"7/22/2021","","Deposit Home Banking Transfer trf/From CHAPLINSKI,LEON 3496297 Share 0090","","400","Posted","244.49"
"7/22/2021","","Withdrawal Courtesy Pay Fee/Entry Class Code: IAT","35","","Posted","-155.51"
"7/22/2021","","Withdrawal ACH PHOTOPEA/CO: PHOTOPEATYPE: IAT PAYPAL ID: 770510487C","10","","Posted","-120.51"
"7/22/2021","","Deposit POS #000000315712/PAYPAL*chaplinski San Jose CACard 2801","","81.18","Posted","-110.51"
"7/21/2021","","Withdrawal Courtesy Pay fee","35","","Posted","-191.69"
"7/21/2021","150","Draft 150","230","","Posted","-156.69"
"7/21/2021","","Deposit Transfer From Share 0000","","11.7","Posted","73.31"
"7/21/2021","","Withdrawal Debit Card MC Debit/PUBLIX #1038 GAINESVILLE FLDate 07/20/21 0 1201696951 1 5411Card 2801","40.58","","Posted","61.61"
"7/21/2021","","Withdrawal POS #000000171121/TARGET T-0687 3970 SW Archer RdGainesville FLCard 2801","33.93","","Posted","102.19"
"7/21/2021","","Deposit Home Banking Transfer - From Share 0000/Funds Transfer via Mobile","","25","Posted","136.12"
"7/21/2021","","Withdrawal ACH BARCLAYCARD US/TYPE: CREDITCARD ID: 2510407970CO: BARCLAYCARD USEntry Class Code: WEB","31.54","","Posted","111.12"
"7/21/2021","","Withdrawal ACH MARIMURICASE/CO: MARIMURICASETYPE: IAT PAYPAL ID: 770510487CEntry Class Code: IAT","25.02","","Posted","142.66"
"7/21/2021","","Withdrawal ACH PAYPAL/TYPE: INST XFER ID: PAYPALSI77CO: PAYPALEntry Class Code: WEB","33.71","","Posted","167.68"
"7/21/2021","","Withdrawal ACH PAYPAL/TYPE: INST XFER ID: PAYPALSI77CO: PAYPALEntry Class Code: WEB","6.99","","Posted","201.39"
"7/21/2021","","Withdrawal ACH PAYPAL/TYPE: INST XFER ID: PAYPALSI77CO: PAYPALEntry Class Code: WEB","5.65","","Posted","208.38"
"7/21/2021","","Withdrawal ACH PAYPAL/TYPE: INST XFER ID: PAYPALSI77CO: PAYPALEntry Class Code: WEB","1","","Posted","214.03"
"7/21/2021","","Deposit ACH PAYPAL/TYPE: TRANSFER ID: PAYPALSD11 CO: PAYPALEntry Class Code: PPD","","1","Posted","215.03"
"7/20/2021","","Deposit at ATM #000000008196/CAMPUS 1900 SW 34TH ST GAINESVILLE FLCard 2801","","120","Posted","214.03"
"7/20/2021","","Withdrawal POS #000000089604/GATE 1445 506 NW 1 GAINESVILLE FLCard 2801","18.33","","Posted","94.03"
"7/20/2021","","Withdrawal/Cash Disbursed 200.00","200","","Posted","112.36"
"7/20/2021","","Withdrawal Transfer/To CHAPLINSKI,LEON 3496297 Share 0000","3000","","Posted","312.36"
"7/20/2021","","Withdrawal Bill Payment #000009336628/GRU EZ PAY WEB PYMT GAINESVILLE FLCard 2801","248.06","","Posted","3312.36"
"7/20/2021","","Withdrawal POS #000000000019/AMAZON.COM*2E2N822T1 SEATTLE WACard 2801","34.9","","Posted","3560.42"
"7/19/2021","","Withdrawal POS #000018233501/WALGREENS 2415 SW GAINESVILLE FLCard 2801","4.28","","Posted","3595.32"
"7/19/2021","","Withdrawal POS #000000958582/WAWA 5325 2373 SW ARCHER ROA GAINESVILLEFLCard 2801","26.47","","Posted","3599.6"
"7/19/2021","","Withdrawal Debit Card MC Debit/CLKBANK*COM 63TKALGP 800-390-6035 IDDate 07/18/21 0 1199110294 5 5734Card 2801","1","","Posted","3626.07"
"7/19/2021","","Withdrawal ACH BARCLAYCARD US/TYPE: CREDITCARD ID: 2510407970CO: BARCLAYCARD USEntry Class Code: WEB","40","","Posted","3627.07"
"7/19/2021","","Withdrawal ACH PADDLE.COM MARKE/CO: PADDLE.COM MARKET LIMITEDTYPE: IAT PAYPAL ID: 770510487CEntry Class Code: IAT","10","","Posted","3667.07"
"7/17/2021","","Withdrawal POS #000000793554/WAWA 5325 2373 SW ARCHER ROA GAINESVILLEFLCard 2801","15.51","","Posted","3677.07"
"7/17/2021","","Deposit Home Banking Transfer trf/From CHAPLINSKI,LEON 3496297 Share 0000","","3166.13","Posted","3692.58"
"7/17/2021","","Deposit Home Banking Transfer trf/From CHAPLINSKI,LEON 3496297 Share 0090","","220","Posted","526.45"
"7/16/2021","","Withdrawal Debit Card MC Debit/PUBLIX #1312 GAINESVILLE FLDate 07/15/21 0 1196703565 1 5411Card 2801","60.63","","Posted","306.45"
"7/15/2021","","Withdrawal POS #000000565069/FAST TRACK #200 3960 SW ARCHER RDGAINESVILLE FLCard 2801","10.68","","Posted","367.08"
"7/15/2021","","Deposit POS #000000562160/PAYPAL*chaplinski San Jose CACard 2801","","39.6","Posted","377.76"
"7/15/2021","237","Draft 237","850","","Posted","338.16"
"7/15/2021","","Withdrawal Debit Card MC Debit/WALGREENS #5024 800-289-2273 FLDate 07/14/21 0 1195641363 1 5912Card 2801","8.28","","Posted","1188.16"
"7/15/2021","","Withdrawal ACH PADDLE.COM MARKE/CO: PADDLE.COM MARKET LIMITEDTYPE: IAT PAYPAL ID: 770510487CEntry Class Code: IAT","5.99","","Posted","1196.44"
"7/14/2021","","Withdrawal POS #000000032105/CIRCLE K # 06782 5 GAINESVILLE FLCard 2801","13.5","","Posted","1202.43"
"7/13/2021","","Withdrawal POS #000000000020/AMAZON.COM*2E7J71TR1 SEATTLE WACard 2801","26.42","","Posted","1215.93"
"7/12/2021","","Recurring Withdrawal Debit Card Fee/MASTERCARD ISSUER CROSS-BORDER FEEDate 07/11/21 0 1192439235 2 5817Card 2801","0.05","","Posted","1242.35"
"7/12/2021","","Recurring Withdrawal Debit Card MC Debit/PAYPAL *LINKTREE 4029357733 AUDate 07/11/21 0 1192439235 2 5817Card 2801","6","","Posted","1242.4"
"7/12/2021","","Withdrawal POS #000011047312/WALGREENS 2415 SW GAINESVILLE FLCard 2801","4.28","","Posted","1248.4"
"7/12/2021","","Withdrawal ACH TECHLAIM SIA/CO: TECHLAIM SIATYPE: IAT PAYPAL ID: 770510487CEntry Class Code: IAT","1.49","","Posted","1252.68"
"7/11/2021","","Withdrawal Debit Card MC Debit/PAYPAL *MUIREY03 4029357733 CADate 07/09/21 0 1190400088 1 7372Card 2801","0.99","","Posted","1254.17"
"7/9/2021","","Withdrawal POS #000000030309/CIRCLE K # 06782 5 GAINESVILLE FLCard 2801","13.5","","Posted","1255.16"
"7/9/2021","","Deposit POS #000000752560/PAYPAL*chaplinski San Jose CACard 2801","","193.05","Posted","1268.66"
"7/9/2021","","Withdrawal Debit Card MC Debit/PIZZA HUT 27918 3523739402 FLDate 07/07/21 0 1188191773 1 5812Card 2801","35.53","","Posted","1075.61"
"7/9/2021","","Withdrawal Debit Card MC Debit/CANNAMD 855-4209170 FLDate 07/08/21 0 1189609701 1 8011Card 2801","195","","Posted","1111.14"
"7/9/2021","","Withdrawal Debit Card MC Debit/WALGREENS #5024 800-289-2273 FLDate 07/08/21 0 1189597740 1 5912Card 2801","15","","Posted","1306.14"
"7/9/2021","","Withdrawal Debit Card MC Debit/PRIME VIDEO*2920418O0 888-802-3080 WADate 07/08/21 0 1189605384 1 5818Card 2801","13.18","","Posted","1321.14"
"7/9/2021","","Withdrawal/Cash Disbursed 200.00","200","","Posted","1334.32"
"7/9/2021","","Withdrawal ACH PAYPAL/TYPE: INST XFER ID: PAYPALSI77CO: PAYPALEntry Class Code: WEB","2.99","","Posted","1534.32"
"7/9/2021","","Recurring Withdrawal Bill Payment - #000011827861/PAYPAL *VIDIQ 2211 North First S SanCACard 2801","10","","Posted","1537.31"
"7/8/2021","","Deposit POS #000000714446/PAYPAL*chaplinski San Jose CACard 2801","","257.4","Posted","1547.31"
"7/8/2021","","Withdrawal POS #000000040622/FAST TRACK #200 3960 SW ARCHER RDGAINESVILLE FLCard 2801","17.75","","Posted","1289.91"
"7/8/2021","","Withdrawal POS #000000074419/PUBLIX 3930 SW ARCHER ROA GAINESVILLE FLCard 2801","18.43","","Posted","1307.66"
"7/8/2021","","Withdrawal POS #000012253616/WALGREENS 2415 SW GAINESVILLE FLCard 2801","8.56","","Posted","1326.09"
"7/8/2021","","Withdrawal ACH LAST.FM LTD/CO: LAST.FM LTDTYPE: IAT PAYPAL ID: 770510487CEntry Class Code: IAT","3","","Posted","1334.65"
"7/4/2021","","Recurring Withdrawal Debit Card MC Debit/VIACOMCBS STREAMING 8882745343 CADate 07/02/21 0 1183474018 1 4899Card 2801","52.43","","Posted","1337.65"
"7/4/2021","","Recurring Withdrawal Debit Card MC Debit/VIACOMCBS STREAMING 8882745343 CADate 07/02/21 0 1183474013 1 4899Card 2801","43.08","","Posted","1390.08"
"7/4/2021","","Withdrawal Debit Card MC Debit/VIACOMCBS STREAMING 8882745343 CADate 07/02/21 0 1183474012 1 4899Card 2801","10.5","","Posted","1433.16"
"7/4/2021","","Withdrawal POS #000000175298/FAST TRACK #200 3960 SW ARCHER RDGAINESVILLE FLCard 2801","22.57","","Posted","1443.66"
"7/2/2021","","Withdrawal ACH BARCLAYCARD US/TYPE: CREDITCARD ID: 2510407970CO: BARCLAYCARD USEntry Class Code: WEB","75","","Posted","1466.23"
"7/2/2021","","Withdrawal ACH BEST BUY/TYPE: PAYMENT ID: CITIGPUFDRCO: BEST BUYEntry Class Code: PPD","75","","Posted","1541.23"
"7/2/2021","","Withdrawal ACH BEST BUY/TYPE: PAYMENT ID: CITIGPUFDRCO: BEST BUYEntry Class Code: PPD","75","","Posted","1616.23"
"7/2/2021","","Withdrawal ACH DISCOVER/TYPE: E-PAYMENT ID: 2510020270CO: DISCOVEREntry Class Code: WEB","75","","Posted","1691.23"
"7/2/2021","","Withdrawal ACH TARGET CARD SRVC/TYPE: BILL PAY ID: T510215170CO: TARGET CARD SRVCEntry Class Code: WEB","75","","Posted","1766.23"
"7/2/2021","","Withdrawal ACH PAYMENT FOR AMZ/TYPE: STORECARD ID: 9069872103CO: PAYMENT FOR AMZEntry Class Code: WEB","75","","Posted","1841.23"
"7/1/2021","","Withdrawal Debit Card MC Debit/PUBLIX #1038 GAINESVILLE FLDate 06/30/21 0 1181753574 1 5411Card 2801","41.29","","Posted","1916.23"
"7/1/2021","","Withdrawal ACH APPLECARD GSBANK/TYPE: PAYMENT ID: 9999999999CO: APPLECARD GSBANKEntry Class Code: WEB","75","","Posted","1957.52"
"7/1/2021","","Withdrawal ACH CAPITAL ONE/TYPE: MOBILE PMT ID: 9279744980CO: CAPITAL ONEEntry Class Code: WEB","75","","Posted","2032.52"
"7/1/2021","","Withdrawal ACH PAYPAL/TYPE: INST XFER ID: PAYPALSI77CO: PAYPALEntry Class Code: WEB","49.98","","Posted","2107.52"
"6/30/2021","","Withdrawal POS #000000019103/CIRCLE K # 26146 3 GAINESVILLE FLCard 2801","16.98","","Posted","2157.5"
"6/30/2021","","Withdrawal Debit Card MC Debit/PUBLIX #1312 GAINESVILLE FLDate 06/29/21 0 1180625032 1 5411Card 2801","40.3","","Posted","2174.48"
"6/30/2021","","Withdrawal ACH COX COMM GAN/TYPE: BANK DRAFT ID: 1581620085CO: COX COMM GANEntry Class Code: WEB","5.03","","Posted","2214.78"
"6/30/2021","","Deposit Home Banking Transfer trf/From CHAPLINSKI,LEON 3496297 Share 0090","","2000","Posted","2219.81"
"6/30/2021","","Withdrawal ACH PAYPAL/TYPE: INST XFER ID: PAYPALSI77CO: PAYPALEntry Class Code: WEB","33.45","","Posted","219.81"
"6/29/2021","","Withdrawal Debit Card MC Debit/PUBLIX #1312 GAINESVILLE FLDate 06/28/21 0 1179522814 1 5411Card 2801","78.49","","Posted","253.26"
"6/29/2021","","Withdrawal Debit Card MC Debit/WALGREENS #5024 800-289-2273 FLDate 06/28/21 0 1179519487 1 5912Card 2801","4.65","","Posted","331.75"
"6/29/2021","","Withdrawal ACH PADDLE.COM MARKE/CO: PADDLE.COM MARKET LIMITEDTYPE: IAT PAYPAL ID: 770510487CEntry Class Code: IAT","5.99","","Posted","336.4"
"6/29/2021","","Withdrawal ACH PAYPAL/TYPE: INST XFER ID: PAYPALSI77CO: PAYPALEntry Class Code: WEB","5.66","","Posted","342.39"
"6/29/2021","","Withdrawal POS #000000000000/AMAZON PAYMENTS SEATTLE WACard 2801","5.74","","Posted","348.05"
"6/28/2021","","Recurring Withdrawal Debit Card MC Debit/HELP.HBOMAX.COM NEW YORK NYDate 06/27/21 0 1178683424 5 5815Card 2801","17.23","","Posted","353.79"
"6/28/2021","","Recurring Withdrawal Debit Card MC Debit/AMAZON PRIME*217157D82 AMZN.COM/BIL WADate 06/27/21 0 1178669271 5 5968Card 2801","13.09","","Posted","371.02"
"6/28/2021","","Withdrawal POS #000000066157/GATE 1445 506 NW 1 GAINESVILLE FLCard 2801","8.76","","Posted","384.11"
"6/28/2021","","Withdrawal/Transactor: STEVEN J CHAPLINSKICash Disbursed 120.00","120","","Posted","392.87"
"6/28/2021","","Deposit Home Banking Transfer - Online Banking/From CHAPLINSKI,LEON 3496297 Share 0090","","150","Posted","512.87"
"6/28/2021","","Deposit Home Banking Transfer - From Share 0000/Funds Transfer via Online","","100","Posted","362.87"
"6/28/2021","","Withdrawal ACH PAYPAL/TYPE: INST XFER ID: PAYPALSI77CO: PAYPALEntry Class Code: WEB","39.99","","Posted","262.87"
"6/27/2021","","Withdrawal POS #000000000000/AMAZON PAYMENTS SEATTLE WACard 2801","5.74","","Posted","302.86"
"6/25/2021","","Withdrawal POS #000000073587/GATE 1445 506 NW 1 GAINESVILLE FLCard 2801","22.33","","Posted","308.6"
"6/25/2021","","Withdrawal at ATM #000000006161/CAMPUS 1900 SW 34TH ST GAINESVILLE FLCard 2801","60","","Posted","330.93"
"6/24/2021","","Withdrawal Adjustment POS #000000000086/AMAZON.COM SEATTLE WACard 2801","","45.93","Posted","390.93"
"6/23/2021","","Withdrawal ACH APPLECARD GSBANK/TYPE: PAYMENT ID: 9999999999CO: APPLECARD GSBANKEntry Class Code: WEB","25","","Posted","345"
"6/22/2021","","Withdrawal ACH Vertiec Solution/TYPE: B2P*FLDOH ID: 0000486349CO: Vertiec SolutionEntry Class Code: WEB","77.75","","Posted","370"
"6/22/2021","","Deposit POS #000000242632/PAYPAL*chaplinski San Jose CACard 2801","","178.2","Posted","447.75"
"6/22/2021","","Deposit Home Banking Transfer - From Share 0000/Funds Transfer via Online","","175","Posted","269.55"
"6/21/2021","","Withdrawal ACH PAYMENT FOR AMZ/TYPE: STORECARD ID: 9069872103CO: PAYMENT FOR AMZEntry Class Code: WEB","100","","Posted","94.55"
"6/21/2021","","Withdrawal Transfer fee","8","","Posted","194.55"
"6/21/2021","","Deposit Transfer From Share 0000","","200","Posted","202.55"
"6/21/2021","","Withdrawal ACH PAYPAL/TYPE: INST XFER ID: PAYPALSI77CO: PAYPALEntry Class Code: WEB","6.99","","Posted","2.55"
"6/21/2021","","Withdrawal ACH PAYPAL/TYPE: INST XFER ID: PAYPALSI77CO: PAYPALEntry Class Code: WEB","1.99","","Posted","9.54"
"6/21/2021","","Withdrawal POS #000000990788/AMAZON.COM*215VY1SG1 SEATTLE WACard 2801","45.93","","Posted","11.53"
"6/20/2021","","Withdrawal POS #000000880685/FAST TRACK #200 3960 SW ARCHER RDGAINESVILLE FLCard 2801","22.57","","Posted","57.46"
"6/20/2021","","Withdrawal POS #000000029500/PUBLIX 3930 SW ARCHER ROA GAINESVILLE FLCard 2801","44.46","","Posted","80.03"
"6/20/2021","","Withdrawal Debit Card MC Debit/PUBLIX #1312 GAINESVILLE FLDate 06/18/21 0 1169764423 1 5411Card 2801","41.91","","Posted","124.49"
"6/20/2021","","Withdrawal Debit Card MC Debit/AMZN DIGITAL*213334Z60 888-802-3080 WADate 06/18/21 0 1169422634 1 5818Card 2801","100","","Posted","166.4"
"6/20/2021","","Withdrawal Debit Card MC Debit/PAYPAL *EBAY US 4029357733 CADate 06/17/21 0 1168417789 1 5311Card 2801","839.99","","Posted","266.4"
"6/20/2021","","Withdrawal POS #000000350216/AMAZON.COM*210N16AL0 SEATTLE WACard 2801","12.81","","Posted","1106.39"
"6/20/2021","","Recurring Withdrawal Bill Payment - #000097791799/PAYPAL *TUBEBUDDY TUBEBUD 2211 NorthS San Jose CACard 2801","4.5","","Posted","1119.2"
"6/20/2021","","Withdrawal Bill Payment #000011160011/PAYPAL *GUMROAD EXOARTIC 2211 NorthS San Jose CACard 2801","1","","Posted","1123.7"
"6/18/2021","","Withdrawal ACH APPLECARD GSBANK/TYPE: PAYMENT ID: 9999999999CO: APPLECARD GSBANKEntry Class Code: WEB","125","","Posted","1124.7"
"6/18/2021","","Withdrawal ACH CAPITAL ONE/TYPE: MOBILE PMT ID: 9279744980CO: CAPITAL ONEEntry Class Code: WEB","100","","Posted","1249.7"
"6/18/2021","","Withdrawal ACH BARCLAYCARD US/TYPE: CREDITCARD ID: 2510407970CO: BARCLAYCARD USEntry Class Code: WEB","100","","Posted","1349.7"
"6/18/2021","","Withdrawal POS #000000712796/WAWA 5325 2373 SW ARCHER ROA GAINESVILLEFLCard 2801","27.34","","Posted","1449.7"
"6/18/2021","","Withdrawal Bill Payment #000011116970/PAYPAL *STRLABSITES PRIME 2211 NorthS San Jose CACard 2801","19","","Posted","1477.04"
"6/18/2021","","Withdrawal ACH DISCOVER/TYPE: E-PAYMENT ID: 2510020270CO: DISCOVEREntry Class Code: WEB","100","","Posted","1496.04"
"6/18/2021","","Withdrawal ACH TARGET CARD SRVC/TYPE: BILL PAY ID: T510215170CO: TARGET CARD SRVCEntry Class Code: WEB","100","","Posted","1596.04"
"6/17/2021","236","Draft 236","850","","Posted","1696.04"
"6/17/2021","","Withdrawal Adjustment Debit Card - Credit Voucher/PAYPAL *EBAY US 4029357733 CADate 06/15/21 0 1166371994 1 5311Card 2801","","765.1","Posted","2546.04"
"6/16/2021","","Withdrawal Debit Card MC Debit/PAYPAL *EBAY US 4029357733 CADate 06/15/21 0 1166635234 1 5311Card 2801","765.1","","Posted","1780.94"
"6/16/2021","","Withdrawal POS #000000415870/CK 2726162 7302 SW ARCHER RD GAINESVILLEFLCard 2801","23.35","","Posted","2546.04"
"6/16/2021","","Deposit Home Banking Transfer - From Share 0000/bills","","650","Posted","2569.39"
"6/15/2021","","Deposit POS #000000517304/PAYPAL*chaplinski San Jose CACard 2801","","732.6","Posted","1919.39"
"6/15/2021","","Withdrawal Debit Card MC Debit/WALGREENS #5024 800-289-2273 FLDate 06/14/21 0 1165512347 1 5912Card 2801","4","","Posted","1186.79"
"6/15/2021","","Withdrawal ACH TARGET CARD SRVC/TYPE: BILL PAY ID: T510215170CO: TARGET CARD SRVCEntry Class Code: WEB","75","","Posted","1190.79"
"6/15/2021","","Withdrawal Bill Payment #000007279958/PAYPAL *ZENIMAX ONL San Jose CACard 2801","14.99","","Posted","1265.79"
"6/15/2021","","Deposit POS #000000314330/PAYPAL*chaplinski San Jose CACard 2801","","19.8","Posted","1280.78"
"6/15/2021","","Withdrawal POS #000012283703/GOOGLE *Domains Mountain View CACard 2801","6","","Posted","1260.98"
"6/14/2021","","Recurring Withdrawal Adjustment - Debit Card Credit Voucher/SOUNDCLOUD INC SAN FRANCISC CADate 06/14/21 0 1165400928 1 4899Card 2801","","1.5","Posted","1266.98"
"6/14/2021","","Withdrawal Debit Card MC Debit/PUBLIX #1312 GAINESVILLE FLDate 06/12/21 0 1163798447 2 5411Card 2801","25.51","","Posted","1265.48"
"6/14/2021","","Withdrawal Debit Card MC Debit/PRIME VIDEO*215X323P1 888-802-3080 WADate 06/13/21 0 1164704725 1 5818Card 2801","5.67","","Posted","1290.99"
"6/14/2021","","Recurring Withdrawal Debit Card MC Debit/VZWRLSS*BILL PAY V FOLSOM CADate 06/12/21 0 1163011733 4 4814Card 2801","113.49","","Posted","1296.66"
"6/14/2021","","Withdrawal POS #000000081607/GATE 1445 506 NW 1 GAINESVILLE FLCard 2801","22.33","","Posted","1410.15"
"6/14/2021","","Withdrawal ACH PAYPAL/TYPE: INST XFER ID: PAYPALSI77CO: PAYPALEntry Class Code: WEB","27.95","","Posted","1432.48"
"6/14/2021","","Withdrawal Bill Payment #000001265801/PAYPAL *PACKIX San Jose CACard 2801","0.99","","Posted","1460.43"
"6/14/2021","","Withdrawal Bill Payment #000012264962/PAYPAL *PACKIX San Jose CACard 2801","1.99","","Posted","1461.42"
"6/13/2021","","Recurring Withdrawal Debit Card Fee/MASTERCARD ISSUER CROSS-BORDER FEEDate 06/11/21 0 1162482595 1 7372Card 2801","0.05","","Posted","1463.41"
"6/13/2021","","Recurring Withdrawal Debit Card MC Debit/PAYPAL *LINKTREE 4029357733 AUDate 06/11/21 0 1162482595 1 7372Card 2801","6","","Posted","1463.46"
"6/12/2021","","Deposit Home Banking Transfer - From Share 0000/Funds Transfer via Online","","350","Posted","1469.46"
"6/10/2021","","Withdrawal Debit Card MC Debit/WALGREENS #5024 800-289-2273 FLDate 06/09/21 0 1160510538 1 5912Card 2801","19.28","","Posted","1119.46"
"6/10/2021","","Withdrawal Bill Payment #000027794161/PAYPAL *LH TRADING 2211 North First SJose CACard 2801","62.48","","Posted","1138.74"
"6/9/2021","","Withdrawal POS #000000009559/CIRCLE K # 06782 5 GAINESVILLE FLCard 2801","15.98","","Posted","1201.22"
"6/9/2021","","Withdrawal Debit Card MC Debit/PUBLIX #680 GAINESVILLE FLDate 06/08/21 0 1159576254 1 5411Card 2801","34.23","","Posted","1217.2"
"6/9/2021","","Withdrawal Debit Card MC Debit/PUBLIX #1312 GAINESVILLE FLDate 06/08/21 0 1159576147 1 5411Card 2801","31.78","","Posted","1251.43"
"6/9/2021","","Withdrawal ACH APPLECARD GSBANK/TYPE: PAYMENT ID: 9999999999CO: APPLECARD GSBANKEntry Class Code: WEB","75","","Posted","1283.21"
"6/9/2021","","Withdrawal ACH BEST BUY/TYPE: PAYMENT ID: CITIGPUFDRCO: BEST BUYEntry Class Code: PPD","75","","Posted","1358.21"
"6/9/2021","","Withdrawal ACH TARGET CARD SRVC/TYPE: BILL PAY ID: T510215170CO: TARGET CARD SRVCEntry Class Code: WEB","75","","Posted","1433.21"
"6/9/2021","","Withdrawal ACH BEST BUY/TYPE: PAYMENT ID: CITIGPUFDRCO: BEST BUYEntry Class Code: PPD","75","","Posted","1508.21"
"6/9/2021","","Withdrawal ACH PAYPAL/TYPE: INST XFER ID: PAYPALSI77CO: PAYPALEntry Class Code: WEB","2.99","","Posted","1583.21"
"6/8/2021","","Withdrawal Debit Card MC Debit/PUBLIX #1038 GAINESVILLE FLDate 06/07/21 0 1158510821 1 5411Card 2801","41.48","","Posted","1586.2"
"6/8/2021","","Withdrawal POS #000000518006/AMAZON.COM*2X3C172M1 SEATTLE WACard 2801","35.98","","Posted","1627.68"
"6/8/2021","","Withdrawal POS #000000000004/AMAZON.COM*2X0BQ00N0 SEATTLE WACard 2801","26.42","","Posted","1663.66"
"6/8/2021","","Withdrawal POS #000000010537/CIRCLE K # 26146 3 GAINESVILLE FLCard 2801","15.98","","Posted","1690.08"
"6/7/2021","","Withdrawal Debit Card MC Debit/PUBLIX #1312 GAINESVILLE FLDate 06/05/21 0 1156594073 2 5411Card 2801","42.87","","Posted","1706.06"
"6/7/2021","","Withdrawal ACH BEST BUY/TYPE: PAYMENT ID: CITIGPUFDRCO: BEST BUYEntry Class Code: PPD","75","","Posted","1748.93"
"6/7/2021","","Withdrawal ACH LAST.FM LTD/CO: LAST.FM LTDTYPE: IAT PAYPAL ID: 770510487CEntry Class Code: IAT","3","","Posted","1823.93"
"6/7/2021","","Withdrawal ACH BEST BUY/TYPE: PAYMENT ID: CITIGPUFDRCO: BEST BUYEntry Class Code: PPD","75","","Posted","1826.93"
"6/5/2021","","Withdrawal POS #000000044185/FAST TRACK #200 3960 SW ARCHER RDGAINESVILLE FLCard 2801","22.56","","Posted","1901.93"
"6/3/2021","","Withdrawal ACH CAPITAL ONE/TYPE: MOBILE PMT ID: 9279744980CO: CAPITAL ONEEntry Class Code: WEB","75","","Posted","1924.49"
"6/3/2021","","Withdrawal POS #000000480551/AMAZON.COM*2R8QH9Y70 SEATTLE WACard 2801","16.04","","Posted","1999.49"
"6/2/2021","","Withdrawal ACH BARCLAYCARD US/TYPE: CREDITCARD ID: 2510407970CO: BARCLAYCARD USEntry Class Code: WEB","75","","Posted","2015.53"
"6/2/2021","","Withdrawal ACH DISCOVER/TYPE: E-PAYMENT ID: 2510020270CO: DISCOVEREntry Class Code: WEB","75","","Posted","2090.53"
"6/2/2021","","Withdrawal ACH TARGET CARD SRVC/TYPE: BILL PAY ID: T510215170CO: TARGET CARD SRVCEntry Class Code: WEB","75","","Posted","2165.53"
"6/1/2021","","Withdrawal POS #000000063975/PUBLIX 3930 SW ARCHER ROA GAINESVILLE FLCard 2801","32.08","","Posted","2240.53"
"6/1/2021","","Withdrawal ACH CITY OF GAINESVI/TYPE: 2000-6637- ID: 5330903620CO: CITY OF GAINESVIEntry Class Code: WEB","178.73","","Posted","2272.61"
"6/1/2021","","Withdrawal ACH APPLECARD GSBANK/TYPE: PAYMENT ID: 9999999999CO: APPLECARD GSBANKEntry Class Code: WEB","75","","Posted","2451.34"
"6/1/2021","","Withdrawal ACH CAPITAL ONE/TYPE: MOBILE PMT ID: 9279744980CO: CAPITAL ONEEntry Class Code: WEB","75","","Posted","2526.34"
"6/1/2021","","Withdrawal POS #000000061707/GATE 1445 506 NW 1 GAINESVILLE FLCard 2801","13.57","","Posted","2601.34"
"6/1/2021","","Withdrawal ACH PAYPAL/TYPE: INST XFER ID: PAYPALSI77CO: PAYPALEntry Class Code: WEB","5.66","","Posted","2614.91"
"5/30/2021","","Withdrawal Debit Card MC Debit/PUBLIX #1312 GAINESVILLE FLDate 05/28/21 0 1148028662 2 5411Card 2801","42.32","","Posted","2620.57"
"5/30/2021","","Deposit Home Banking Transfer trf/From CHAPLINSKI,LEON 3496297 Share 0090","","2000","Posted","2662.89"
"5/29/2021","","Withdrawal POS #000000000009/AMAZON PAYMENTS SEATTLE WACard 2801","5.74","","Posted","662.89"
"5/28/2021","","Withdrawal POS #000000000005/AMAZON.COM*2X1HX9OW1 SEATTLE WACard 2801","17.11","","Posted","668.63"
"5/28/2021","","Recurring Withdrawal Debit Card MC Debit/AMAZON PRIME*2R8PP9GG2 AMZN.COM/BIL WADate 05/27/21 0 1147410671 1 5968Card 2801","13.09","","Posted","685.74"
"5/28/2021","","Withdrawal ACH BEST BUY/TYPE: PAYMENT ID: CITIGPUFDRCO: BEST BUYEntry Class Code: PPD","100","","Posted","698.83"
"5/28/2021","","Withdrawal ACH BEST BUY/TYPE: PAYMENT ID: CITIGPUFDRCO: BEST BUYEntry Class Code: PPD","75","","Posted","798.83"
"5/28/2021","","Withdrawal ACH BEST BUY/TYPE: PAYMENT ID: CITIGPUFDRCO: BEST BUYEntry Class Code: PPD","100","","Posted","873.83"
"5/28/2021","","Recurring Withdrawal Bill Payment - #000027450528/PAYPAL *PPLUS 2211 North First S SanCACard 2801","10.5","","Posted","973.83"
"5/28/2021","","Withdrawal POS #000000200940/WAWA 5325 2373 SW ARCHER ROA GAINESVILLEFLCard 2801","20.74","","Posted","984.33"
"5/27/2021","","Recurring Withdrawal Debit Card MC Debit/HELP.HBOMAX.COM NEW YORK NYDate 05/27/21 0 1147530392 1 5815Card 2801","17.23","","Posted","1005.07"
"5/27/2021","","Withdrawal ACH COX COMM GAN/TYPE: BANK DRAFT ID: 1581620085CO: COX COMM GANEntry Class Code: WEB","105.03","","Posted","1022.3"
"5/27/2021","","Withdrawal POS #000000000009/AMAZON PAYMENTS SEATTLE WACard 2801","5.74","","Posted","1127.33"
"5/27/2021","","Withdrawal ACH PAYMENT FOR AMZ/TYPE: STORECARD ID: 9069872103CO: PAYMENT FOR AMZEntry Class Code: WEB","150","","Posted","1133.07"
"5/26/2021","","Withdrawal POS #000000510071/CK 2726162 7302 SW ARCHER RD GAINESVILLEFLCard 2801","6.83","","Posted","1283.07"
"5/26/2021","","Withdrawal POS #000018316544/WALGREENS 2415 SW GAINESVILLE FLCard 2801","25.87","","Posted","1289.9"
"5/26/2021","","Withdrawal Debit Card MC Debit/COUNTRY CRITTERS - 4 OCALA FLDate 05/25/21 0 1145668660 1 0742Card 2801","30","","Posted","1315.77"
"5/26/2021","","Withdrawal Debit Card MC Debit/VZWRLSS*MY VZ VE P 800-922-0204 FLDate 05/26/21 0 1146663586 1 4814Card 2801","473.28","","Posted","1345.77"
"5/26/2021","","Withdrawal POS #000000481097/CK 2726162 7302 SW ARCHER RD GAINESVILLEFLCard 2801","30.62","","Posted","1819.05"
"5/26/2021","","Withdrawal ACH CAPITAL ONE/TYPE: MOBILE PMT ID: 9279744980CO: CAPITAL ONEEntry Class Code: WEB","250","","Posted","1849.67"
"5/26/2021","","Withdrawal ACH BARCLAYCARD US/TYPE: CREDITCARD ID: 2510407970CO: BARCLAYCARD USEntry Class Code: WEB","150","","Posted","2099.67"
"5/26/2021","","Withdrawal ACH APPLECARD GSBANK/TYPE: PAYMENT ID: 9999999999CO: APPLECARD GSBANKEntry Class Code: WEB","125","","Posted","2249.67"
"5/26/2021","","Withdrawal ACH DISCOVER/TYPE: E-PAYMENT ID: 2510020270CO: DISCOVEREntry Class Code: WEB","175","","Posted","2374.67"
"5/26/2021","","Withdrawal ACH TARGET CARD SRVC/TYPE: BILL PAY ID: T510215170CO: TARGET CARD SRVCEntry Class Code: WEB","150","","Posted","2549.67"
"5/26/2021","","Withdrawal ACH EXXONMOBIL/TYPE: ONLINE PMT ID: CITICTPCO: EXXONMOBILEntry Class Code: WEB","13.31","","Posted","2699.67"
"5/25/2021","","Deposit Home Banking Transfer - From Share 0000/Funds Transfer via Online","","475","Posted","2712.98"
"5/25/2021","","Deposit Home Banking Transfer - From Share 0000/bills","","750","Posted","2237.98"
"5/25/2021","","Deposit Home Banking Transfer - From Share 0000/Funds Transfer via Online","","750","Posted","1487.98"
"5/25/2021","","Deposit Home Banking Transfer - From Share 0000/Funds Transfer via Mobile","","500","Posted","737.98"
"5/24/2021","","Withdrawal Debit Card MC Debit/PUBLIX #1312 GAINESVILLE FLDate 05/23/21 0 1143498988 1 5411Card 2801","77.88","","Posted","237.98"
"5/24/2021","","Recurring Withdrawal Debit Card MC Debit/SOUNDCLOUD INC SAN FRANCISC CADate 05/24/21 0 1144498667 1 4899Card 2801","4.99","","Posted","315.86"
"5/24/2021","","Withdrawal Debit Card MC Debit/ONLYFANS 8886880458 FLDate 05/20/21 0 1140808102 5 5967Card 2801","10.49","","Posted","320.85"
"5/24/2021","","Withdrawal Debit Card MC Debit/AMZN DIGITAL*2R8ES6LA2 888-802-3080 WADate 05/23/21 0 1143736262 1 5818Card 2801","0.99","","Posted","331.34"
"5/24/2021","","Withdrawal ACH PAYMENT FOR AMZ/TYPE: STORECARD ID: 9069872103CO: PAYMENT FOR AMZEntry Class Code: WEB","65","","Posted","332.33"
"5/24/2021","","Withdrawal ACH EXXONMOBIL/TYPE: ONLINE PMT ID: CITICTPCO: EXXONMOBILEntry Class Code: WEB","7.78","","Posted","397.33"
"5/23/2021","","Deposit POS #000000478197/PAYPAL*chaplinski San Jose CACard 2801","","118.8","Posted","405.11"
"5/23/2021","","Withdrawal Bill Payment #000010440934/PAYPAL *PACKIX 2211 North First S SanCACard 2801","3","","Posted","286.31"
"5/22/2021","","Withdrawal ATM Fee/COLUMBIA CAR-428486 318 NW 13TH STGAINESVILLE FLCard 2801","2","","Posted","289.31"
"5/22/2021","","Withdrawal at ATM #000000003405/COLUMBIA CAR-428486 318 NW 13TH STGAINESVILLE FLCard 2801","23","","Posted","291.31"
"5/22/2021","","Withdrawal POS #000000059894/GATE 1445 506 NW 1 GAINESVILLE FLCard 2801","23.31","","Posted","314.31"
"5/22/2021","","Withdrawal at ATM #000000001544/CAMPUS 1900 SW 34TH ST GAINESVILLE FLCard 2801","200","","Posted","337.62"
"5/21/2021","","Withdrawal Debit Card MC Debit/PUBLIX #1312 GAINESVILLE FLDate 05/20/21 0 1140623440 1 5411Card 2801","27.92","","Posted","537.62"
"5/21/2021","","Withdrawal ACH BARCLAYCARD US/TYPE: CREDITCARD ID: 2510407970CO: BARCLAYCARD USEntry Class Code: WEB","65","","Posted","565.54"
"5/21/2021","","Withdrawal ACH CAPITAL ONE/TYPE: MOBILE PMT ID: 9279744980CO: CAPITAL ONEEntry Class Code: WEB","65","","Posted","630.54"
"5/21/2021","","Withdrawal ACH APPLECARD GSBANK/TYPE: PAYMENT ID: 9999999999CO: APPLECARD GSBANKEntry Class Code: WEB","50","","Posted","695.54"
"5/21/2021","","Withdrawal ACH APPLECARD GSBANK/TYPE: PAYMENT ID: 9999999999CO: APPLECARD GSBANKEntry Class Code: WEB","27","","Posted","745.54"
"5/21/2021","","Withdrawal ACH DISCOVER/TYPE: E-PAYMENT ID: 2510020270CO: DISCOVEREntry Class Code: WEB","65","","Posted","772.54"
"5/21/2021","","Withdrawal ACH TARGET CARD SRVC/TYPE: BILL PAY ID: T510215170CO: TARGET CARD SRVCEntry Class Code: WEB","65","","Posted","837.54"
"5/20/2021","","Withdrawal Adjustment POS #000000505150/AMAZON.COM SEATTLE WACard 2801","","46.99","Posted","902.54"
"5/20/2021","","Withdrawal Debit Card MC Debit/PIZZA HUT 27918 3523739402 FLDate 05/18/21 0 1138211165 1 5812Card 2801","21.67","","Posted","855.55"
"5/20/2021","","Withdrawal Bill Payment #000097602382/PAYPAL *ANDREACABIB EBAY 2211 NorthS San Jose CACard 2801","33.45","","Posted","877.22"
"5/20/2021","","Withdrawal ACH PAYPAL/TYPE: INST XFER ID: PAYPALSI77CO: PAYPALEntry Class Code: WEB","4.96","","Posted","910.67"
"5/19/2021","","Withdrawal POS #000000000009/AMAZON PAYMENTS SEATTLE WACard 2801","15.48","","Posted","915.63"
"5/19/2021","","Deposit Home Banking Transfer trf/From CHAPLINSKI,LEON 3496297 Share 0090","","701","Posted","931.11"
"5/18/2021","235","Draft 235","850","","Posted","230.11"
"5/18/2021","","Withdrawal Bill Payment #000027209306/PAYPAL *STRLABSITES PRIME 2211 NorthS San Jose CACard 2801","19","","Posted","1080.11"
"5/18/2021","","Withdrawal Debit Card MC Debit/PUBLIX #1312 GAINESVILLE FLDate 05/17/21 0 1137551809 1 5411Card 2801","33.94","","Posted","1099.11"
"5/18/2021","","Withdrawal Debit Card MC Debit/252PEPSIVEN9147678600 GAINESVILLE FLDate 05/17/21 0 1137547304 1 5814Card 2801","3","","Posted","1133.05"
"5/18/2021","","Withdrawal Debit Card MC Debit/CHEVRON 0042059 GAINESVILLE FLDate 05/17/21 0 1137621286 0 5541Card 2801","23.07","","Posted","1136.05"
"5/18/2021","","Withdrawal/Cash Disbursed 100.00","100","","Posted","1159.12"
"5/18/2021","","Deposit Home Banking Transfer trf/From CHAPLINSKI,LEON 3496297 Share 0090","","55","Posted","1259.12"
"5/18/2021","","Deposit Home Banking Transfer - From Share 0000/Funds Transfer via Mobile","","15","Posted","1204.12"
"5/18/2021","","Withdrawal POS #000000273457/AMAZON.COM*2L8JS8IK0 SEATTLE WACard 2801","46.99","","Posted","1189.12"
"5/18/2021","","Deposit POS #000000624794/PAYPAL*chaplinski San Jose CACard 2801","","34.65","Posted","1236.11"
"5/17/2021","","Withdrawal ACH PAYPAL/TYPE: INST XFER ID: PAYPALSI77CO: PAYPALEntry Class Code: WEB","14.99","","Posted","1201.46"
"5/16/2021","","Withdrawal Debit Card MC Debit/PAYPAL *KINBUNDOLIM 4029357733 CADate 05/13/21 0 1133245705 1 5945Card 2801","3","","Posted","1216.45"
"5/15/2021","","Withdrawal POS #000007249569/GOOGLE *Domains Mountain View CACard 2801","12","","Posted","1219.45"
"5/13/2021","","Withdrawal Debit Card MC Debit/PIZZA HUT 27918 3523739402 FLDate 05/11/21 0 1131193007 1 5812Card 2801","35.53","","Posted","1231.45"
"5/13/2021","","Withdrawal Debit Card MC Debit/PUBLIX #1312 GAINESVILLE FLDate 05/12/21 0 1132606317 1 5411Card 2801","149.68","","Posted","1266.98"
"5/13/2021","","Recurring Withdrawal Debit Card Fee/MASTERCARD ISSUER CROSS-BORDER FEEDate 05/12/21 0 1132191600 1 7372Card 2801","0.05","","Posted","1416.66"
"5/13/2021","","Recurring Withdrawal Debit Card MC Debit/PAYPAL *LINKTREE 4029357733 AUDate 05/12/21 0 1132191600 1 7372Card 2801","6","","Posted","1416.71"
"5/13/2021","","Withdrawal Debit Card MC Debit/PAYPAL *ETSY.COM 4029357733 NYDate 05/12/21 0 1132187934 1 5699Card 2801","10.15","","Posted","1422.71"
"5/13/2021","","Withdrawal Debit Card MC Debit/PAYPAL *ETSY.COM 4029357733 NYDate 05/12/21 0 1132187933 1 5699Card 2801","5.31","","Posted","1432.86"
"5/13/2021","","Withdrawal ACH PAYPAL/TYPE: INST XFER ID: PAYPALSI77CO: PAYPALEntry Class Code: WEB","4.99","","Posted","1438.17"
"5/12/2021","","Deposit at ATM #000000000671/CAMPUS 1900 SW 34TH ST GAINESVILLE FLCard 2801","","153","Posted","1443.16"
"5/12/2021","","Withdrawal/Cash Disbursed 225.00","225","","Posted","1290.16"
"5/12/2021","","Withdrawal Debit Card MC Debit/WALGREENS #5024 800-289-2273 FLDate 05/11/21 0 1131607093 1 5912Card 2801","18.17","","Posted","1515.16"
"5/12/2021","","Deposit Home Banking Transfer trf/From CHAPLINSKI,LEON 3496297 Share 0090","","350","Posted","1533.33"
"5/12/2021","","Withdrawal ACH PAYPAL/TYPE: INST XFER ID: PAYPALSI77CO: PAYPALEntry Class Code: WEB","6.99","","Posted","1183.33"
"5/12/2021","","Withdrawal Bill Payment #000057401651/PAYPAL *ETSY.COM 2211 North First S SanJose CACard 2801","3.97","","Posted","1190.32"
"5/11/2021","","Deposit POS #000000108793/PAYPAL*chaplinski San Jose CACard 2801","","118.8","Posted","1194.29"
"5/10/2021","","Withdrawal Debit Card MC Debit/PUBLIX #1312 GAINESVILLE FLDate 05/09/21 0 1129440869 1 5411Card 2801","18.96","","Posted","1075.49"
"5/10/2021","","Withdrawal ACH PAYPAL/TYPE: INST XFER ID: PAYPALSI77CO: PAYPALEntry Class Code: WEB","2.99","","Posted","1094.45"
"5/7/2021","","Withdrawal Debit Card MC Debit/PIZZA HUT 27918 GAINESVILLE FLDate 05/05/21 0 1125274587 1 5812Card 2801","27.53","","Posted","1097.44"
"5/7/2021","","Withdrawal ACH LAST.FM LTD/CO: LAST.FM LTDTYPE: IAT PAYPAL ID: 770510487CEntry Class Code: IAT","3","","Posted","1124.97"
"5/6/2021","","Withdrawal Debit Card MC Debit/PUBLIX #1312 GAINESVILLE FLDate 05/05/21 0 1125577276 1 5411Card 2801","13.07","","Posted","1127.97"
"5/6/2021","","Withdrawal Debit Card MC Debit/AMZN DIGITAL*2K12D5QG3 888-802-3080 WADate 05/05/21 0 1125320932 1 5818Card 2801","1.99","","Posted","1141.04"
"5/6/2021","","Withdrawal ACH COX COMM GAN/TYPE: BANK DRAFT ID: 1581620085CO: COX COMM GANEntry Class Code: WEB","127.52","","Posted","1143.03"
"5/6/2021","","Withdrawal ACH PAYMENT FOR AMZ/TYPE: STORECARD ID: 9069872103CO: PAYMENT FOR AMZEntry Class Code: WEB","65","","Posted","1270.55"
"5/5/2021","","Withdrawal Debit Card MC Debit/PAYPAL *DARKSHAMASH 4029357733 CADate 05/04/21 0 1124714581 1 8999Card 2801","18.5","","Posted","1335.55"
"5/5/2021","","Withdrawal ACH CITY OF GAINESVI/TYPE: 2000-6637- ID: 5330903620CO: CITY OF GAINESVIEntry Class Code: WEB","171.4","","Posted","1354.05"
"5/5/2021","","Withdrawal ACH BARCLAYCARD US/TYPE: CREDITCARD ID: 2510407970CO: BARCLAYCARD USEntry Class Code: WEB","65","","Posted","1525.45"
"5/5/2021","","Withdrawal ACH CAPITAL ONE/TYPE: MOBILE PMT ID: 9279744980CO: CAPITAL ONEEntry Class Code: WEB","65","","Posted","1590.45"
"5/5/2021","","Withdrawal ACH BEST BUY/TYPE: PAYMENT ID: CITIGPUFDRCO: BEST BUYEntry Class Code: PPD","65","","Posted","1655.45"
"5/5/2021","","Withdrawal ACH APPLECARD GSBANK/TYPE: PAYMENT ID: 9999999999CO: APPLECARD GSBANKEntry Class Code: WEB","55","","Posted","1720.45"
"5/5/2021","","Withdrawal ACH TARGET CARD SRVC/TYPE: BILL PAY ID: T510215170CO: TARGET CARD SRVCEntry Class Code: WEB","65","","Posted","1775.45"
"5/5/2021","","Withdrawal ACH BEST BUY/TYPE: PAYMENT ID: CITIGPUFDRCO: BEST BUYEntry Class Code: PPD","65","","Posted","1840.45"
"5/5/2021","","Withdrawal ACH DISCOVER/TYPE: E-PAYMENT ID: 2510020270CO: DISCOVEREntry Class Code: WEB","55","","Posted","1905.45"
"5/4/2021","","Withdrawal POS #000000073420/GATE 1445 506 NW 1 GAINESVILLE FLCard 2801","30.57","","Posted","1960.45"
"5/4/2021","","Withdrawal/Cash Disbursed 225.00","225","","Posted","1991.02"
"5/4/2021","","Withdrawal POS #000000069797/PUBLIX 5200 S W 34TH STRE GAINESVILLE FLCard 2801","29.95","","Posted","2216.02"
"5/4/2021","","Withdrawal POS #000000228165/USPS PO 11322705 4600 SW 34TH STGAINESVILLE FLCard 2801","11","","Posted","2245.97"
"5/4/2021","","Withdrawal ACH PAYPAL/TYPE: INST XFER ID: PAYPALSI77CO: PAYPALEntry Class Code: WEB","2.99","","Posted","2256.97"
"5/3/2021","","Withdrawal POS #000000000023/AMAZON.COM*AU8ER6ZT3 SEATTLE WACard 2801","10.67","","Posted","2259.96"
"5/3/2021","","Withdrawal ACH PAYPAL/TYPE: INST XFER ID: PAYPALSI77CO: PAYPALEntry Class Code: WEB","4.99","","Posted","2270.63"
"4/30/2021","","Withdrawal Debit Card MC Debit/COUNTRY CRITTERS - 4 OCALA FLDate 04/29/21 0 1119660197 1 0742Card 2801","30","","Posted","2275.62"
"4/30/2021","","Deposit Home Banking Transfer trf/From CHAPLINSKI,LEON 3496297 Share 0090","","2000","Posted","2305.62"
"4/29/2021","","Withdrawal Debit Card MC Debit/PAYPAL *ETSY.COM 4029357733 CADate 04/28/21 0 1118146596 1 5699Card 2801","21.03","","Posted","305.62"
"4/29/2021","","Withdrawal ACH PAYPAL/TYPE: INST XFER ID: PAYPALSI77CO: PAYPALEntry Class Code: WEB","5.66","","Posted","326.65"
"4/29/2021","","Deposit POS #000000247495/PAYPAL*chaplinski San Jose CACard 2801","","94.05","Posted","332.31"
"4/28/2021","","Recurring Withdrawal Debit Card MC Debit/AMAZON PRIME*2E7QP6VV3 AMZN.COM/BIL WADate 04/27/21 0 1117994890 0 5968Card 2801","13.09","","Posted","238.26"
"4/28/2021","","Withdrawal Debit Card MC Debit/PAYPAL *TWITCHOVRLY 4029357733 CADate 04/27/21 0 1117666694 1 7372Card 2801","11.25","","Posted","251.35"
"4/28/2021","","Withdrawal ACH PAYPAL/TYPE: INST XFER ID: PAYPALSI77CO: PAYPALEntry Class Code: WEB","24.98","","Posted","262.6"
"4/28/2021","","Deposit Home Banking Transfer - From Share 0000/Vet Appt","","125","Posted","287.58"
"4/27/2021","","Withdrawal/Cash Disbursed 300.00","300","","Posted","162.58"
"4/27/2021","","Withdrawal Debit Card MC Debit/PUBLIX #1312 GAINESVILLE FLDate 04/26/21 0 1116509094 1 5411Card 2801","88.25","","Posted","462.58"
"4/27/2021","","Recurring Withdrawal Debit Card MC Debit/HELP.HBOMAX.COM NEW YORK NYDate 04/27/21 0 1117509004 1 5815Card 2801","17.23","","Posted","550.83"
"4/26/2021","","Withdrawal POS #000000494673/FAST TRACK #200 3960 SW ARCHER RDGAINESVILLE FLCard 2801","13.94","","Posted","568.06"
"4/26/2021","","Withdrawal Bill Payment #000009548880/PAYPAL *DISNEY PLUS 2211 North First SJose CACard 2801","9.18","","Posted","582"
"4/25/2021","","Recurring Withdrawal Debit Card MC Debit/SOUNDCLOUD INC SAN FRANCISC CADate 04/24/21 0 1114766563 1 4899Card 2801","4.99","","Posted","591.18"
"4/21/2021","","Withdrawal Debit Card MC Debit/WORDPRESS 0XFKTN2K1Z SAN FRANCISC CADate 04/20/21 0 1110163691 1 7372Card 2801","48","","Posted","596.17"
"4/21/2021","","Withdrawal Debit Card MC Debit/PAYPAL *BLVCKLNGS 4029357733 CADate 04/20/21 0 1110159483 1 7372Card 2801","1.49","","Posted","644.17"
"4/20/2021","","Withdrawal Debit Card Fee/MASTERCARD ISSUER CROSS-BORDER FEEDate 04/19/21 0 1109184122 1 7311Card 2801","0.06","","Posted","645.66"
"4/20/2021","","Withdrawal Debit Card MC Debit/MIXCLOUD PREM LONDON LNDate 04/19/21 0 1109184122 1 7311Card 2801","7.99","","Posted","645.72"
"4/19/2021","202","Draft 202","850","","Posted","653.71"
"4/19/2021","","Withdrawal POS #000000094697/PUBLIX 3930 SW ARCHER ROA GAINESVILLE FLCard 2801","108.31","","Posted","1503.71"
"4/19/2021","","Withdrawal/Cash Disbursed 260.00","260","","Posted","1612.02"
"4/19/2021","","Withdrawal Debit Card MC Debit/PIZZA HUT 27918 3523739402 FLDate 04/16/21 0 1106310415 3 5812Card 2801","42.88","","Posted","1872.02"
"4/19/2021","","Withdrawal Debit Card Fee/MASTERCARD ISSUER CROSS-BORDER FEEDate 04/18/21 0 1108306909 3 5734Card 2801","0.03","","Posted","1914.9"
"4/19/2021","","Withdrawal Debit Card MC Debit/PAYPAL *CHARIZ JOHN ZA 4029357733 AUDate 04/18/21 0 1108306909 3 5734Card 2801","3.99","","Posted","1914.93"
"4/19/2021","","Withdrawal ACH APPLECARD GSBANK/TYPE: PAYMENT ID: 9999999999CO: APPLECARD GSBANKEntry Class Code: WEB","100","","Posted","1918.92"
"4/19/2021","","Withdrawal ACH PAYPAL/TYPE: INST XFER ID: PAYPALSI77CO: PAYPALEntry Class Code: WEB","39.98","","Posted","2018.92"
"4/19/2021","","Withdrawal ACH PAYPAL/TYPE: INST XFER ID: PAYPALSI77CO: PAYPALEntry Class Code: WEB","14.99","","Posted","2058.9"
"4/16/2021","","Withdrawal POS #000016554225/WALGREENS 2415 SW GAINESVILLE FLCard 2801","22.24","","Posted","2073.89"
"4/16/2021","","Withdrawal POS #000000053120/GATE 1445 506 NW 1 GAINESVILLE FLCard 2801","21.57","","Posted","2096.13"
"4/16/2021","","Withdrawal POS #000000205538/AMAZON.COM*QN3DZ9HU3 SEATTLE WACard 2801","12.29","","Posted","2117.7"
"4/16/2021","","Withdrawal POS #000000205514/AMAZON.COM*401V98BH3 SEATTLE WACard 2801","34.23","","Posted","2129.99"
"4/15/2021","","Withdrawal Debit Card MC Debit/COUNTRY CRITTERS - 4 OCALA FLDate 04/14/21 0 1104613761 1 0742Card 2801","30","","Posted","2164.22"
"4/15/2021","","Withdrawal Debit Card Fee/MASTERCARD ISSUER CROSS-BORDER FEEDate 04/14/21 0 1104120823 1 5999Card 2801","0.16","","Posted","2194.22"
"4/15/2021","","Withdrawal Debit Card MC Debit/PAYPAL *PADDLE.COM 35314369001 GBDate 04/14/21 0 1104120823 1 5999Card 2801","19.99","","Posted","2194.38"
"4/15/2021","","Withdrawal Debit Card MC Debit/PAYPAL *BLVCKLNGS 4029357733 CADate 04/14/21 0 1104117516 1 7372Card 2801","1.5","","Posted","2214.37"
"4/14/2021","","Withdrawal Debit Card MC Debit/TUMBLR, INC. 5120800053 CADate 04/13/21 0 1103571649 1 5045Card 2801","19","","Posted","2215.87"
"4/14/2021","","Deposit ACH E*TRADE/TYPE: ACH TRNSFR ID: 1391321258CO: E*TRADEEntry Class Code: PPD","","50","Posted","2234.87"
"4/14/2021","","Withdrawal Bill Payment #000026034417/PAYPAL *BULLETHOUND 2211 North First SJose CACard 2801","5","","Posted","2184.87"
"4/14/2021","","Withdrawal POS #000000035070/PUBLIX 3930 SW ARCHER ROA GAINESVILLE FLCard 2801","90.53","","Posted","2189.87"
"4/13/2021","","Withdrawal Debit Card MC Debit/PIZZA HUT 27918 3523739402 FLDate 04/12/21 0 1102132047 1 5812Card 2801","35.46","","Posted","2280.4"
"4/13/2021","","Withdrawal Debit Card MC Debit/WALGREENS #5024 800-289-2273 FLDate 04/12/21 0 1102547509 1 5912Card 2801","28.86","","Posted","2315.86"
"4/13/2021","","Withdrawal Debit Card MC Debit/PAYPAL *BLVCKLNGS 4029357733 CADate 04/12/21 0 1102539061 1 7372Card 2801","1.79","","Posted","2344.72"
"4/13/2021","","Withdrawal ACH APPLECARD GSBANK/TYPE: PAYMENT ID: 9999999999CO: APPLECARD GSBANKEntry Class Code: WEB","100","","Posted","2346.51"
"4/13/2021","","Withdrawal Bill Payment #000026002088/PAYPAL *ETSY 2211 North First S San JoseCACard 2801","11.6","","Posted","2446.51"
"4/13/2021","","Withdrawal Bill Payment #000056898461/PAYPAL *ETSY.COM 2211 North First S SanJose CACard 2801","14.95","","Posted","2458.11"
"4/12/2021","","Withdrawal/Cash Disbursed 150.00","150","","Posted","2473.06"
"4/12/2021","","Withdrawal POS #000010324719/WALGREENS 2415 SW GAINESVILLE FLCard 2801","5.35","","Posted","2623.06"
"4/11/2021","","Withdrawal Debit Card MC Debit/PIZZA HUT 27918 3523739402 FLDate 04/08/21 0 1098358049 1 5812Card 2801","30.18","","Posted","2628.41"
"4/9/2021","","Withdrawal ACH PAYPAL/TYPE: INST XFER ID: PAYPALSI77CO: PAYPALEntry Class Code: WEB","2.99","","Posted","2658.59"
"4/7/2021","","Withdrawal ACH E*TRADE BANK/TYPE: TRANSFER ID: 9658390001CO: E*TRADE BANKEntry Class Code: CCD","0.57","","Posted","2661.58"
"4/7/2021","","Deposit ACH E*TRADE BANK/TYPE: TRANSFER ID: 9658390001CO: E*TRADE BANKEntry Class Code: CCD","","0.32","Posted","2662.15"
"4/7/2021","","Deposit ACH E*TRADE BANK/TYPE: TRANSFER ID: 9658390001CO: E*TRADE BANKEntry Class Code: CCD","","0.25","Posted","2661.83"
"4/6/2021","","Deposit ACH STEVEN CHAPLINSK/TYPE: MOBILE DEP CO: STEVEN CHAPLINSKACH Trace Number: 263178470000017","","1400","Posted","2661.58"
"4/6/2021","","Deposit Home Banking Transfer - From Share 0000/Funds Transfer via Online","","350","Posted","1261.58"
"4/6/2021","","Withdrawal ACH BEST BUY/TYPE: PAYMENT ID: CITIGPUFDRCO: BEST BUYEntry Class Code: PPD","55","","Posted","911.58"
"4/6/2021","","Withdrawal ACH LAST.FM LTD/CO: LAST.FM LTDTYPE: IAT PAYPAL ID: 770510487CEntry Class Code: IAT","3","","Posted","966.58"
"4/6/2021","","Withdrawal ACH BEST BUY/TYPE: PAYMENT ID: CITIGPUFDRCO: BEST BUYEntry Class Code: PPD","55","","Posted","969.58"
"4/5/2021","","Withdrawal Bill Payment #000000563201/Microsoft Corporation Eve MICROSOFT*XBOXREDMOND WACard 2801","4.98","","Posted","1024.58"
"4/5/2021","","Withdrawal Bill Payment #000008850166/PAYPAL *ZENIMAX ONL 2211 North First SJose CACard 2801","27.99","","Posted","1029.56"
"4/5/2021","","Withdrawal/Cash Disbursed 150.00","150","","Posted","1057.55"
"4/5/2021","","Withdrawal POS #000000416024/AMAZON.COM*DI1C22RF3 SEATTLE WACard 2801","12.29","","Posted","1207.55"
"4/5/2021","","Withdrawal ACH PAYMENT FOR AMZ/TYPE: STORECARD ID: 9069872103CO: PAYMENT FOR AMZEntry Class Code: WEB","65","","Posted","1219.84"
"4/2/2021","","Withdrawal Debit Card MC Debit/AMZN DIGITAL*IT6ER04C3 888-802-3080 WADate 04/01/21 0 1091315345 1 5818Card 2801","9.99","","Posted","1284.84"
"4/2/2021","","Withdrawal ACH CITY OF GAINESVI/TYPE: 2000-6637- ID: 5330903620CO: CITY OF GAINESVIEntry Class Code: WEB","169.52","","Posted","1294.83"
"4/2/2021","","Withdrawal ACH COX COMM GAN/TYPE: BANK DRAFT ID: 1581620085CO: COX COMM GANEntry Class Code: WEB","127.52","","Posted","1464.35"
"4/2/2021","","Withdrawal ACH CAPITAL ONE/TYPE: MOBILE PMT ID: 9279744980CO: CAPITAL ONEEntry Class Code: WEB","55","","Posted","1591.87"
"4/2/2021","","Withdrawal ACH BARCLAYCARD US/TYPE: CREDITCARD ID: 2510407970CO: BARCLAYCARD USEntry Class Code: WEB","55","","Posted","1646.87"
"4/2/2021","","Withdrawal ACH TARGET CARD SRVC/TYPE: BILL PAY ID: T510215170CO: TARGET CARD SRVCEntry Class Code: WEB","55","","Posted","1701.87"
"4/2/2021","","Withdrawal ACH ROBINHOOD/TYPE: Funds ID: 1464364776 CO: ROBINHOODEntry Class Code: WEB","55","","Posted","1756.87"
"4/2/2021","","Withdrawal ACH DISCOVER/TYPE: E-PAYMENT ID: 2510020270CO: DISCOVEREntry Class Code: WEB","53","","Posted","1811.87"
"4/2/2021","","Withdrawal ACH E*TRADE/TYPE: ACH TRNSFR ID: 1391321258CO: E*TRADEEntry Class Code: PPD","50","","Posted","1864.87"
"4/1/2021","","Withdrawal POS #000000912507/AMAZON.COM*489RL5UZ3 SEATTLE WACard 2801","23.11","","Posted","1914.87"
"4/1/2021","","Withdrawal Debit Card MC Debit/PAYPAL *IPMOSKINAEL 4029357733 CADate 03/31/21 0 1090624209 1 7395Card 2801","21.5","","Posted","1937.98"
"4/1/2021","","Withdrawal POS #000000598647/AMAZON.COM*F565U8HW3 SEATTLE WACard 2801","16.47","","Posted","1959.48"
"4/1/2021","","Withdrawal ACH PAYPAL/TYPE: INST XFER ID: PAYPALSI77CO: PAYPALEntry Class Code: WEB","89.99","","Posted","1975.95"
"4/1/2021","","Withdrawal ACH PAYPAL/TYPE: INST XFER ID: PAYPALSI77CO: PAYPALEntry Class Code: WEB","14.99","","Posted","2065.94"
"4/1/2021","","Withdrawal Bill Payment #000008689195/PAYPAL *PACKIX 2211 North First S SanCACard 2801","1.99","","Posted","2080.93"
"4/1/2021","","Deposit ACH Skrill Inc./TYPE: SETTL ID: 0300508113CO: Skrill Inc.Entry Class Code: PPD","","0.3","Posted","2082.92"
"4/1/2021","","Deposit ACH Skrill Inc./TYPE: SETTL ID: 0300508113CO: Skrill Inc.Entry Class Code: PPD","","0.11","Posted","2082.62"
"3/31/2021","","Withdrawal ACH APPLECARD GSBANK/TYPE: PAYMENT ID: 9999999999CO: APPLECARD GSBANKEntry Class Code: WEB","50","","Posted","2082.51"
"3/31/2021","","Withdrawal ACH PAYPAL/TYPE: INST XFER ID: PAYPALSI77CO: PAYPALEntry Class Code: WEB","3","","Posted","2132.51"
"3/31/2021","","Withdrawal ACH PAYPAL/TYPE: INST XFER ID: PAYPALSI77CO: PAYPALEntry Class Code: WEB","1.99","","Posted","2135.51"
"3/30/2021","","Withdrawal ACH BARCLAYCARD US/TYPE: CREDITCARD ID: 2510407970CO: BARCLAYCARD USEntry Class Code: WEB","45","","Posted","2137.5"
"3/30/2021","","Deposit Home Banking Transfer - Online Banking/From CHAPLINSKI,LEON 3496297 Share 0090","","2000","Posted","2182.5"
"3/30/2021","","Withdrawal ACH PAYPAL/TYPE: INST XFER ID: PAYPALSI77CO: PAYPALEntry Class Code: WEB","39.99","","Posted","182.5"
"3/30/2021","","Withdrawal ACH PAYPAL/TYPE: INST XFER ID: PAYPALSI77CO: PAYPALEntry Class Code: WEB","39.99","","Posted","222.49"
"3/30/2021","","Withdrawal ACH PAYPAL/TYPE: INST XFER ID: PAYPALSI77CO: PAYPALEntry Class Code: WEB","39.99","","Posted","262.48"
"3/30/2021","","Deposit POS #000000959977/PAYPAL*chaplinski San Jose CACard 2801","","79.2","Posted","302.47"
"3/30/2021","","Deposit Home Banking Transfer - From Share 0000/Funds Transfer via Mobile","","125","Posted","223.27"
"3/29/2021","","Withdrawal ATM Fee/COLUMBIA CAR-428486 318 NW 13TH STGAINESVILLE FLCard 2801","2","","Posted","98.27"
"3/29/2021","","Withdrawal at ATM #000000003096/COLUMBIA CAR-428486 318 NW 13TH STGAINESVILLE FLCard 2801","23","","Posted","100.27"
"3/29/2021","","Withdrawal at ATM #000000006380/CAMPUS 1900 SW 34TH ST GAINESVILLE FLCard 2801","180","","Posted","123.27"
"3/29/2021","","Withdrawal Debit Card MC Debit/SCRUBS CARWASH - GAINE GAINESVILLE FLDate 03/28/21 0 1087445829 1 7542Card 2801","4","","Posted","303.27"
"3/29/2021","","Deposit POS #000000343770/PAYPAL*chaplinski San Jose CACard 2801","","118.8","Posted","307.27"
"3/29/2021","","Withdrawal ACH PAYPAL/TYPE: INST XFER ID: PAYPALSI77CO: PAYPALEntry Class Code: WEB","39.99","","Posted","188.47"
"3/29/2021","","Withdrawal ACH PAYPAL/TYPE: INST XFER ID: PAYPALSI77CO: PAYPALEntry Class Code: WEB","39.99","","Posted","228.46"
"3/29/2021","","Withdrawal ACH PAYPAL/TYPE: INST XFER ID: PAYPALSI77CO: PAYPALEntry Class Code: WEB","10.5","","Posted","268.45"
"3/29/2021","","Withdrawal ACH PAYPAL/TYPE: INST XFER ID: PAYPALSI77CO: PAYPALEntry Class Code: WEB","5.66","","Posted","278.95"
"3/29/2021","","Withdrawal Bill Payment #000000050750/Microsoft Corporation Eve MICROSOFT*XBOXREDMOND WACard 2801","0.46","","Posted","284.61"
"3/28/2021","","Withdrawal POS #000000032515/PUBLIX 3930 SW ARCHER ROA GAINESVILLE FLCard 2801","26.81","","Posted","285.07"
"3/28/2021","","Recurring Withdrawal Debit Card MC Debit/HELP.HBOMAX.COM NEW YORK NYDate 03/27/21 0 1086822896 1 5815Card 2801","17.23","","Posted","311.88"
"3/28/2021","","Withdrawal Debit Card MC Debit/KINDLE UNLTD*R11JK1VA3 866-321-8851 WADate 03/26/21 0 1085800614 1 5818Card 2801","9.99","","Posted","329.11"
"3/26/2021","","Withdrawal Bill Payment #000008479811/PAYPAL *DISNEY PLUS 2211 North First SJose CACard 2801","9.18","","Posted","339.1"
"3/25/2021","","Recurring Withdrawal Debit Card MC Debit/SOUNDCLOUD INC SAN FRANCISC CADate 03/25/21 0 1084556042 1 4899Card 2801","4.99","","Posted","348.28"
"3/25/2021","","Withdrawal Bill Payment #000025333228/PAYPAL *LH TRADING 2211 North First SJose CACard 2801","44.94","","Posted","353.27"
"3/22/2021","","Withdrawal POS #000000859166/AMAZON.COM*2V8XI38S3 SEATTLE WACard 2801","2.24","","Posted","398.21"
"3/22/2021","","Withdrawal at ATM #000000005674/CAMPUS 1900 SW 34TH ST GAINESVILLE FLCard 2801","120","","Posted","400.45"
"3/22/2021","","Withdrawal POS #000000212218/USPS PO 11322705 4600 SW 34TH STGAINESVILLE FLCard 2801","8.5","","Posted","520.45"
"3/22/2021","","Deposit Home Banking Transfer - From Share 0000/Funds Transfer via Mobile","","250","Posted","528.95"
"3/19/2021","","Withdrawal Debit Card MC Debit/PAYPAL *SJCHAPLINSKI 4029357733 CADate 03/18/21 0 1077230483 1 4829Card 2801","0.02","","Posted","278.95"
"3/18/2021","","Withdrawal Adjustment POS #000000756195/AMAZON.COM SEATTLE WACard 2801","","17.09","Posted","278.97"
"3/18/2021","","Withdrawal Debit Card MC Debit/GNV CITY CENTER LLC-GA GAINESVILLE FLDate 03/16/21 0 1075510897 0 7523Card 2801","6","","Posted","261.88"
"3/18/2021","","Withdrawal at ATM #000000008720/CAMPUS 1900 SW 34TH ST GAINESVILLE FLCard 2801","80","","Posted","267.88"
"3/18/2021","","Withdrawal ACH PAYPAL/TYPE: INST XFER ID: PAYPALSI77CO: PAYPALEntry Class Code: WEB","14.99","","Posted","347.88"
"3/18/2021","","Deposit POS #000000779130/PAYPAL*chaplinski San Jose CACard 2801","","118.8","Posted","362.87"
"3/17/2021","","Withdrawal/Cash Disbursed 30.00","30","","Posted","244.07"
"3/17/2021","","Withdrawal POS #000000000005/AMAZON.COM*G25PN8NF3 SEATTLE WACard 2801","12.29","","Posted","274.07"
"3/17/2021","","Withdrawal Debit Card MC Debit/COUNTRY CRITTERS - 4 OCALA FLDate 03/16/21 0 1075495944 1 0742Card 2801","75","","Posted","286.36"
"3/17/2021","","Withdrawal Debit Card Fee/MASTERCARD ISSUER CROSS-BORDER FEEDate 03/15/21 0 1074114177 1 5734Card 2801","0.02","","Posted","361.36"
"3/17/2021","","Withdrawal Debit Card MC Debit/PAYPAL *CHARIZ 4029357733 AUDate 03/15/21 0 1074114177 1 5734Card 2801","2.99","","Posted","361.38"
"3/17/2021","","Withdrawal ACH PAYPAL/TYPE: INST XFER ID: PAYPALSI77CO: PAYPALEntry Class Code: WEB","39.99","","Posted","364.37"
"3/16/2021","","Withdrawal Adjustment POS #000000163227/AMAZON.COM SEATTLE WACard 2801","","12.29","Posted","404.36"
"3/16/2021","","Deposit Home Banking Transfer - From Share 0000/Funds Transfer via Mobile","","175","Posted","392.07"
"3/16/2021","","Withdrawal Debit Card MC Debit/PAYPAL *IPMOSKINAEL 4029357733 CADate 03/14/21 0 1073119936 1 7395Card 2801","45.5","","Posted","217.07"
"3/16/2021","","Withdrawal Debit Card MC Debit/PAYPAL *ETSY.COM 4029357733 CADate 03/14/21 0 1073119864 1 5699Card 2801","9.88","","Posted","262.57"
"3/16/2021","","Withdrawal Debit Card MC Debit/PAYPAL *ETSY.COM 4029357733 CADate 03/14/21 0 1073119863 1 5699Card 2801","13.34","","Posted","272.45"
"3/16/2021","","Withdrawal ACH CAPITAL ONE/TYPE: MOBILE PMT ID: 9279744980CO: CAPITAL ONEEntry Class Code: WEB","50","","Posted","285.79"
"3/16/2021","","Withdrawal POS #000000418543/WAWA 5325 2373 SW ARCHER ROA GAINESVILLEFLCard 2801","13.01","","Posted","335.79"
"3/16/2021","","Withdrawal ACH PAYMENT FOR AMZ/TYPE: STORECARD ID: 9069872103CO: PAYMENT FOR AMZEntry Class Code: WEB","125","","Posted","348.8"
"3/16/2021","","Withdrawal ACH TARGET CARD SRVC/TYPE: BILL PAY ID: T510215170CO: TARGET CARD SRVCEntry Class Code: WEB","75","","Posted","473.8"
"3/15/2021","","Withdrawal POS #000000000008/AMAZON.COM*6Q23J5RT3 SEATTLE WACard 2801","12.29","","Posted","548.8"
"3/15/2021","","Withdrawal Bill Payment #000008081950/PAYPAL *liuwentj 2211 North First S SanJose CACard 2801","874.95","","Posted","561.09"
"3/15/2021","","Withdrawal Debit Card MC Debit/SCRUBS CARWASH - GAINE GAINESVILLE FLDate 03/13/21 0 1072703495 5 7542Card 2801","5","","Posted","1436.04"
"3/15/2021","","Withdrawal Debit Card MC Debit/WALGREENS #5024 800-289-2273 FLDate 03/13/21 0 1072695425 5 5912Card 2801","18.17","","Posted","1441.04"
"3/15/2021","","Withdrawal Debit Card MC Debit/PAYPAL *IPKAMENALEX 4029357733 CADate 03/14/21 0 1073417945 1 5099Card 2801","19.99","","Posted","1459.21"
"3/15/2021","","Withdrawal Bill Payment #000024967779/PAYPAL *PACKIX 2211 North First S SanCACard 2801","1.99","","Posted","1479.2"
"3/15/2021","","Withdrawal ACH BARCLAYCARD US/TYPE: CREDITCARD ID: 2510407970CO: BARCLAYCARD USEntry Class Code: WEB","55","","Posted","1481.19"
"3/15/2021","","Withdrawal ACH APPLECARD GSBANK/TYPE: PAYMENT ID: 9999999999CO: APPLECARD GSBANKEntry Class Code: WEB","55","","Posted","1536.19"
"3/15/2021","","Withdrawal ACH TARGET CARD SRVC/TYPE: BILL PAY ID: T510215170CO: TARGET CARD SRVCEntry Class Code: WEB","55","","Posted","1591.19"
"3/15/2021","","Withdrawal ACH DISCOVER/TYPE: E-PAYMENT ID: 2510020270CO: DISCOVEREntry Class Code: WEB","50","","Posted","1646.19"
"3/15/2021","","Withdrawal ACH PAYPAL/TYPE: INST XFER ID: PAYPALSI77CO: PAYPALEntry Class Code: WEB","39.99","","Posted","1696.19"
"3/15/2021","","Withdrawal ACH PAYPAL/TYPE: INST XFER ID: PAYPALSI77CO: PAYPALEntry Class Code: WEB","37.95","","Posted","1736.18"
"3/15/2021","","Withdrawal ACH PAYPAL/TYPE: INST XFER ID: PAYPALSI77CO: PAYPALEntry Class Code: WEB","10","","Posted","1774.13"
"3/14/2021","","Withdrawal Debit Card MC Debit/FIT2RUN GAINESVILLE GAINESVILLE FLDate 03/12/21 0 1071790100 1 5655Card 2801","53.45","","Posted","1784.13"
"3/14/2021","","Deposit Home Banking Transfer - From Share 0000/Funds Transfer via Mobile","","450","Posted","1837.58"
"3/13/2021","","Withdrawal ATM Fee/COLUMBIA CAR-428486 318 NW 13TH STGAINESVILLE FLCard 2801","2","","Posted","1387.58"
"3/13/2021","","Withdrawal at ATM #000000003023/COLUMBIA CAR-428486 318 NW 13TH STGAINESVILLE FLCard 2801","23","","Posted","1389.58"
"3/13/2021","","Withdrawal ATM Fee/COLUMBIA CAR-428486 318 NW 13TH STGAINESVILLE FLCard 2801","2","","Posted","1412.58"
"3/13/2021","","Withdrawal at ATM #000000003022/COLUMBIA CAR-428486 318 NW 13TH STGAINESVILLE FLCard 2801","63","","Posted","1414.58"
"3/12/2021","","Withdrawal POS #000021000016/FIT2RUN GAINESVILLE 6419 NEWBERRY RDGAINESVILLE FLCard 2801","53.45","","Posted","1477.58"
"3/12/2021","","Deposit Home Banking Transfer trf/From CHAPLINSKI,LEON 3496297 Share 0090","","100","Posted","1531.03"
"3/12/2021","","Deposit Home Banking Transfer trf/From CHAPLINSKI,LEON 3496297 Share 0090","","425","Posted","1431.03"
"3/12/2021","","Withdrawal at ATM #000000004681/CAMPUS 1900 SW 34TH ST GAINESVILLE FLCard 2801","40","","Posted","1006.03"
"3/12/2021","","Withdrawal Debit Card MC Debit/PUBLIX #1312 GAINESVILLE FLDate 03/11/21 0 1070536058 1 5411Card 2801","28.89","","Posted","1046.03"
"3/12/2021","","Withdrawal Debit Card MC Debit/COUNTRY CRITTERS - 3 GAINESVILLE FLDate 03/11/21 0 1070535457 1 0742Card 2801","366.22","","Posted","1074.92"
"3/11/2021","","Withdrawal POS #000053110997/SHELL SERVICE S GAINESVILLE FLCard 2801","27.49","","Posted","1441.14"
"3/9/2021","","Withdrawal Debit Card MC Debit/WALGREENS #5024 GAINESVILLE FLDate 03/08/21 0 1067438890 1 5912Card 2801","12.88","","Posted","1468.63"
"3/9/2021","","Withdrawal ACH PAYPAL/TYPE: INST XFER ID: PAYPALSI77CO: PAYPALEntry Class Code: WEB","2.99","","Posted","1481.51"
"3/8/2021","","Withdrawal POS #000000060760/GATE 1445 506 NW 1 GAINESVILLE FLCard 2801","4.82","","Posted","1484.5"
"3/8/2021","","Withdrawal ACH LAST.FM LTD/CO: LAST.FM LTDTYPE: IAT PAYPAL ID: 770510487CEntry Class Code: IAT","3","","Posted","1489.32"
"3/3/2021","","Recurring Withdrawal Debit Card MC Debit/HELP.HBOMAX.COM NEW YORK NYDate 03/03/21 0 1062476710 1 5815Card 2801","17.23","","Posted","1492.32"
"3/3/2021","","Deposit Home Banking Transfer - From Share 0000/Funds Transfer via Mobile","","850","Posted","1509.55"
"3/2/2021","","Withdrawal ACH CITY OF GAINESVI/TYPE: 2000-6637- ID: 5330903620CO: CITY OF GAINESVIEntry Class Code: WEB","179.72","","Posted","659.55"
"3/2/2021","","Withdrawal ACH COX COMM GAN/TYPE: BANK DRAFT ID: 1581620085CO: COX COMM GANEntry Class Code: WEB","127.52","","Posted","839.27"
"3/2/2021","","Withdrawal ACH BEST BUY/TYPE: PAYMENT ID: CITIGPUFDRCO: BEST BUYEntry Class Code: PPD","55","","Posted","966.79"
"3/2/2021","","Withdrawal ACH CAPITAL ONE/TYPE: MOBILE PMT ID: 9279744980CO: CAPITAL ONEEntry Class Code: WEB","50","","Posted","1021.79"
"3/2/2021","","Withdrawal ACH BARCLAYCARD US/TYPE: CREDITCARD ID: 2510407970CO: BARCLAYCARD USEntry Class Code: WEB","50","","Posted","1071.79"
"3/2/2021","","Withdrawal ACH APPLECARD GSBANK/TYPE: PAYMENT ID: 9999999999CO: APPLECARD GSBANKEntry Class Code: WEB","25","","Posted","1121.79"
"3/2/2021","","Withdrawal ACH SANTA FE COLLEGE/TYPE: SCHOOLFEES ID: 5591207627CO: SANTA FE COLLEGEEntry Class Code: WEB","350.31","","Posted","1146.79"
"3/2/2021","","Withdrawal ACH WAWA CREDIT CARD/TYPE: ONLINE PMT ID: CITICTPCO: WAWA CREDIT CARDEntry Class Code: WEB","105.14","","Posted","1497.1"
"3/2/2021","","Withdrawal ACH PAYMENT FOR AMZ/TYPE: STORECARD ID: 9069872103CO: PAYMENT FOR AMZEntry Class Code: WEB","75","","Posted","1602.24"
"3/2/2021","","Withdrawal ACH DISCOVER/TYPE: E-PAYMENT ID: 2510020270CO: DISCOVEREntry Class Code: WEB","50","","Posted","1677.24"
"3/2/2021","","Withdrawal ACH TARGET CARD SRVC/TYPE: BILL PAY ID: T510215170CO: TARGET CARD SRVCEntry Class Code: WEB","50","","Posted","1727.24"
"3/2/2021","","Withdrawal ACH PAYPAL/TYPE: INST XFER ID: PAYPALSI77CO: PAYPALEntry Class Code: WEB","5.66","","Posted","1777.24"
"3/1/2021","","Recurring Withdrawal Debit Card MC Debit/SOUNDCLOUD INC SAN FRANCISC CADate 03/01/21 0 1060311701 1 4899Card 2801","4.99","","Posted","1782.9"
"3/1/2021","","Withdrawal Debit Card MC Debit/ELDERSCROLLSONLINE. 855-296-3170 MDDate 03/01/21 0 1060309446 1 7994Card 2801","49.99","","Posted","1787.89"
"3/1/2021","","Withdrawal Debit Card MC Debit/ELDERSCROLLSONLINE. 855-296-3170 MDDate 03/01/21 0 1060309445 1 7994Card 2801","39.99","","Posted","1837.88"
"3/1/2021","","Withdrawal ACH PAYPAL/TYPE: INST XFER ID: PAYPALSI77CO: PAYPALEntry Class Code: WEB","99.99","","Posted","1877.87"
"3/1/2021","","Withdrawal ACH PAYPAL/TYPE: INST XFER ID: PAYPALSI77CO: PAYPALEntry Class Code: WEB","39","","Posted","1977.86"
"3/1/2021","","Withdrawal ACH PAYPAL/TYPE: INST XFER ID: PAYPALSI77CO: PAYPALEntry Class Code: WEB","39","","Posted","2016.86"
"3/1/2021","","Withdrawal ACH PAYPAL/TYPE: INST XFER ID: PAYPALSI77CO: PAYPALEntry Class Code: WEB","10.5","","Posted","2055.86"
"3/1/2021","","Withdrawal ACH PAYPAL/TYPE: INST XFER ID: PAYPALSI77CO: PAYPALEntry Class Code: WEB","8.03","","Posted","2066.36"
"3/1/2021","","Withdrawal POS #000000702758/AMAZON.COM*6V06K3643 SEATTLE WACard 2801","17.09","","Posted","2074.39"
"2/28/2021","","Withdrawal POS #000000018130/PUBLIX 3930 SW ARCHER ROA GAINESVILLE FLCard 2801","15.63","","Posted","2091.48"
"2/26/2021","","Withdrawal Bill Payment #000007470833/PAYPAL *ASKNET INC 2211 North First SJose CACard 2801","19.99","","Posted","2107.11"
"2/26/2021","","Deposit Home Banking Transfer trf/From CHAPLINSKI,LEON 3496297 Share 0090","","2000","Posted","2127.1"
"2/24/2021","","Withdrawal ACH PAYPAL/TYPE: INST XFER ID: PAYPALSI77CO: PAYPALEntry Class Code: WEB","44.99","","Posted","127.1"
"2/23/2021","","Withdrawal ACH BEST BUY/TYPE: PAYMENT ID: CITIGPUFDRCO: BEST BUYEntry Class Code: PPD","55","","Posted","172.09"
"2/23/2021","","Withdrawal ACH PAYPAL/TYPE: INST XFER ID: PAYPALSI77CO: PAYPALEntry Class Code: WEB","100","","Posted","227.09"
"2/23/2021","","Withdrawal ACH PAYPAL/TYPE: INST XFER ID: PAYPALSI77CO: PAYPALEntry Class Code: WEB","50","","Posted","327.09"
"2/23/2021","","Withdrawal ACH KLARNA INC/TYPE: KLARNA ID: 0009259410CO: KLARNA INCEntry Class Code: WEB","34.7","","Posted","377.09"
"2/23/2021","","Withdrawal ACH PAYPAL/TYPE: INST XFER ID: PAYPALSI77CO: PAYPALEntry Class Code: WEB","24.99","","Posted","411.79"
"2/23/2021","","Withdrawal ACH PAYPAL/TYPE: INST XFER ID: PAYPALSI77CO: PAYPALEntry Class Code: WEB","2.99","","Posted","436.78"
"2/22/2021","","Withdrawal ACH BEST BUY/TYPE: PAYMENT ID: CITIGPUFDRCO: BEST BUYEntry Class Code: PPD","125","","Posted","439.77"
"2/22/2021","","Withdrawal ACH BARCLAYCARD US/TYPE: CREDITCARD ID: 2510407970CO: BARCLAYCARD USEntry Class Code: WEB","100","","Posted","564.77"
"2/22/2021","","Withdrawal ACH CAPITAL ONE/TYPE: MOBILE PMT ID: 9279744980CO: CAPITAL ONEEntry Class Code: WEB","65","","Posted","664.77"
"2/22/2021","","Withdrawal ACH APPLECARD GSBANK/TYPE: PAYMENT ID: 9999999999CO: APPLECARD GSBANKEntry Class Code: WEB","25","","Posted","729.77"
"2/22/2021","","Withdrawal ACH DISCOVER/TYPE: E-PAYMENT ID: 2510020270CO: DISCOVEREntry Class Code: WEB","100","","Posted","754.77"
"2/22/2021","","Withdrawal ACH TARGET DEBIT CRD/Location - TARGET -0687GAINESVILLE FL / Terminal ID: 174TYPE: ACH TRAN ID: 1410215170CO: TARGET DEBIT CRDEntry Class C","75.44","","Posted","854.77"
"2/22/2021","","Withdrawal ACH KLARNA INC/TYPE: KLARNA ID: 0009259410CO: KLARNA INCEntry Class Code: WEB","50.24","","Posted","930.21"
"2/22/2021","","Withdrawal ACH PAYPAL/TYPE: INST XFER ID: PAYPALSI77CO: PAYPALEntry Class Code: WEB","36","","Posted","980.45"
"2/22/2021","","Withdrawal ACH PAYPAL/TYPE: INST XFER ID: PAYPALSI77CO: PAYPALEntry Class Code: WEB","30.5","","Posted","1016.45"
"2/22/2021","","Withdrawal ACH PAYPAL/TYPE: INST XFER ID: PAYPALSI77CO: PAYPALEntry Class Code: WEB","10","","Posted","1046.95"
"2/22/2021","","Withdrawal ACH PAYPAL/TYPE: INST XFER ID: PAYPALSI77CO: PAYPALEntry Class Code: WEB","9.99","","Posted","1056.95"
"2/22/2021","","Withdrawal POS #000000002120/AMAZON.COM*PU23M49W3 SEATTLE WACard 2801","16.99","","Posted","1066.94"
"2/22/2021","","Withdrawal POS #000000000073/AMAZON.COM*FJ68I73A3 SEATTLE WACard 2801","27.53","","Posted","1083.93"
"2/21/2021","","Withdrawal Debit Card MC Debit/PUBLIX #125 GAINESVILLE FLDate 02/19/21 0 1050582715 1 5411Card 2801","89.25","","Posted","1111.46"
"2/21/2021","","Withdrawal Debit Card Fee/VISA INTERNATIONAL SERVICE ASSESSMENTDate 02/18/21Card 1140","0.04","","Posted","1200.71"
"2/21/2021","","Withdrawal Debit Card Signature Debit/PAYPAL *BLVCKLNGS 0635308003 FRDate 02/18/21 0 1049951415 4 7372Card 1140","4.99","","Posted","1200.75"
"2/19/2021","","Withdrawal ATM Fee/COLUMBIA CAR-428486 318 NW 13TH STGAINESVILLE FLCard 2801","2","","Posted","1205.74"
"2/19/2021","","Withdrawal at ATM #000000002930/COLUMBIA CAR-428486 318 NW 13TH STGAINESVILLE FLCard 2801","63","","Posted","1207.74"
"2/19/2021","","Withdrawal at ATM #000000002923/CAMPUS 1900 SW 34TH ST GAINESVILLE FLCard 1140","180","","Posted","1270.74"
"2/19/2021","","Recurring Withdrawal Debit Card - Signature Debit/Netflix.com netflix.com CADate 02/18/21 0 1049010069 2 4899Card 1140","9.88","","Posted","1450.74"
"2/19/2021","","Withdrawal Debit Card Signature Debit/PP*GOOGLE GOOGLE STORA 402-935-7733 CADate 02/17/21 0 1048851676 3 5815Card 1140","1.99","","Posted","1460.62"
"2/19/2021","","Deposit Home Banking Transfer - From Share 0000/Funds Transfer via Mobile","","950","Posted","1462.61"
"2/18/2021","","Withdrawal Debit Card Signature Debit/Amazon.com*IP4NA1P03 Amzn.com/bill WADate 02/17/21 0 1048699217 3 5942Card 1140","5.62","","Posted","512.61"
"2/18/2021","","Withdrawal Debit Card Signature Debit/PAYPAL *COCOATECH 402-935-7733 CADate 02/17/21 0 1048441651 0 5734Card 1140","18","","Posted","518.23"
"2/18/2021","","Withdrawal Debit Card Signature Debit/PUBLIX #680 863-688-1188 FLDate 02/17/21 0 1048047561 0 5411Card 1140","68.08","","Posted","536.23"
"2/17/2021","232","Draft 232","850","","Posted","604.31"
"2/17/2021","","Withdrawal/Cash Disbursed 160.00","160","","Posted","1454.31"
"2/17/2021","","Withdrawal Debit Card Signature Debit/SP * NOMNOMNOW INC. NOMNOMNOW.MYS CADate 02/16/21 0 1047900235 3 5995Card 1140","30","","Posted","1614.31"
"2/17/2021","","Withdrawal Debit Card Signature Debit/THEFARMERSDOG.COM THEFARMERSDOG NYDate 02/16/21 0 1047900234 3 5995Card 1140","37.24","","Posted","1644.31"
"2/17/2021","","Withdrawal Debit Card Signature Debit/PAYPAL *UBER 402-935-7733 CADate 02/16/21 0 1047729063 2 4121Card 1140","10","","Posted","1681.55"
"2/17/2021","","Withdrawal Debit Card Signature Debit/HONDA OF GAINESVILLE GAINESVILLE FLDate 02/16/21 0 1047363243 0 5511Card 1140","261.31","","Posted","1691.55"
"2/17/2021","","Recurring Withdrawal Debit Card Fee/VISA INTERNATIONAL SERVICE ASSESSMENTDate 02/17/21Card 1140","0.06","","Posted","1952.86"
"2/17/2021","","Recurring Withdrawal Debit Card - Signature Debit/MIXCLOUD PREM LONDON GBDate 02/17/21 0 1048115255 0 7311Card 1140","7.99","","Posted","1952.92"
"2/17/2021","","Recurring Withdrawal Debit Card Fee/VISA INTERNATIONAL SERVICE ASSESSMENTDate 02/16/21Card 1140","0.08","","Posted","1960.91"
"2/17/2021","","Recurring Withdrawal Debit Card - Signature Debit/PAYPAL *PADDLE.COM 35314369001 GBDate 02/16/21 0 1047089045 0 5999Card 1140","9.99","","Posted","1960.99"
"2/16/2021","","Withdrawal Debit Card Signature Debit/PAYPAL *UBER 402-935-7733 CADate 02/15/21 0 1046547924 2 4121Card 1140","10","","Posted","1970.98"
"2/16/2021","","Withdrawal Debit Card Signature Debit/PAYPAL *UBER 402-935-7733 CADate 02/15/21 0 1046547923 2 4121Card 1140","15.18","","Posted","1980.98"
"2/16/2021","","Deposit Home Banking Transfer trf/From CHAPLINSKI,LEON 3496297 Share 0090","","262","Posted","1996.16"
"2/16/2021","","Deposit Home Banking Transfer - From Share 0000/Funds Transfer via Mobile","","275","Posted","1734.16"
"2/16/2021","","Withdrawal ACH PAYPAL/TYPE: INST XFER ID: PAYPALSI77CO: PAYPALEntry Class Code: WEB","14.99","","Posted","1459.16"
"2/14/2021","","Withdrawal Debit Card Signature Debit/PLAYSTATION NETWORK 800-345-7669 CADate 02/13/21 0 1044014505 4 5816Card 1140","29.98","","Posted","1474.15"
"2/14/2021","","Withdrawal Debit Card Signature Debit/PAYPAL *PACKIX 402-935-7733 NJDate 02/12/21 0 1043242483 4 5816Card 1140","0.49","","Posted","1504.13"
"2/14/2021","","Withdrawal Debit Card Signature Debit/PAYPAL *BANDCAMP 402-935-7733 CADate 02/12/21 0 1043019773 8 5735Card 1140","5","","Posted","1504.62"
"2/13/2021","","Withdrawal POS #000000032127/PUBLIX 3930 SW ARCHER ROA GAINESVILLE FLCard 1140","83.99","","Posted","1509.62"
"2/12/2021","","Withdrawal POS #000000472169/AMAZON.COM*UY7Z21W73 SEATTLE WACard 1140","34.99","","Posted","1593.61"
"2/12/2021","","Withdrawal POS #000000015702/WALGREENS STORE 2415 SW 7 GAINESVILLE FLCard 1140","18.17","","Posted","1628.6"
"2/12/2021","","Withdrawal POS #000000426947/WALGREENS STORE 2415 SW 7 GAINESVILLE FLCard 1140","19.03","","Posted","1646.77"
"2/12/2021","","Withdrawal Debit Card Signature Debit/WALGREENS #5024 800-289-2273 FLDate 02/11/21 0 1042872537 0 5912Card 1140","22.76","","Posted","1665.8"
"2/9/2021","","Withdrawal Debit Card Signature Debit/KLARNA *PAYMENTS 844-5527621 NYDate 02/08/21 0 1039629075 2 5999Card 1140","17.35","","Posted","1688.56"
"2/9/2021","","Withdrawal Debit Card Signature Debit/KLARNA *PAYMENTS 844-5527621 NYDate 02/08/21 0 1039586381 2 5999Card 1140","25.12","","Posted","1705.91"
"2/8/2021","","Withdrawal ACH BARCLAYCARD US/TYPE: CREDITCARD ID: 2510407970CO: BARCLAYCARD USEntry Class Code: WEB","100","","Posted","1731.03"
"2/8/2021","","Withdrawal ACH APPLECARD GSBANK/TYPE: PAYMENT ID: 9999999999CO: APPLECARD GSBANKEntry Class Code: WEB","94.06","","Posted","1831.03"
"2/8/2021","","Withdrawal ACH CAPITAL ONE/TYPE: MOBILE PMT ID: 9279744980CO: CAPITAL ONEEntry Class Code: WEB","65","","Posted","1925.09"
"2/8/2021","","Withdrawal ACH PAYMENT FOR AMZ/TYPE: STORECARD ID: 9069872103CO: PAYMENT FOR AMZEntry Class Code: WEB","158.84","","Posted","1990.09"
"2/8/2021","","Withdrawal ACH DISCOVER/TYPE: E-PAYMENT ID: 2510020270CO: DISCOVEREntry Class Code: WEB","55","","Posted","2148.93"
"2/8/2021","","Withdrawal ACH ZIPLINE NPCA/TYPE: PREAUTHPMT ID: 1263732506CO: ZIPLINE NPCAEntry Class Code: PPD","0.04","","Posted","2203.93"
"2/8/2021","","Deposit ACH ZIPLINE NPCA/TYPE: PAYMENT ID: 1263732506CO: ZIPLINE NPCAEntry Class Code: CCD","","0.06","Posted","2203.97"
"2/8/2021","","Withdrawal Adjustment POS #000000407782/AMAZON.COM SEATTLE WACard 1140","","7.95","Posted","2203.91"
"2/7/2021","","Withdrawal Debit Card Signature Debit/PP*APPLE.COM/BILL 402-935-7733 CADate 02/05/21 0 1036909336 5 5735Card 1140","14.99","","Posted","2195.96"
"2/5/2021","","Withdrawal ATM Fee/COLUMBIA CAR-428486 318 NW 13TH STGAINESVILLE FLCard 1140","2","","Posted","2210.95"
"2/5/2021","","Withdrawal at ATM #000000002889/COLUMBIA CAR-428486 318 NW 13TH STGAINESVILLE FLCard 1140","63","","Posted","2212.95"
"2/5/2021","","Withdrawal POS #000000737724/GATE 1445 GAINESVILLE FLCard 1140","13.57","","Posted","2275.95"
"2/5/2021","","Withdrawal/Cash Disbursed 240.00","240","","Posted","2289.52"
"2/5/2021","","Withdrawal Adjustment Debit Card - Credit Voucher/PAYPAL *ETSY 402-935-7733 NYDate 02/04/21 0 1035677881 0 5970Card 1140","","35.99","Posted","2529.52"
"2/5/2021","","Deposit Home Banking Transfer - From Share 0000/Funds Transfer via Mobile","","500","Posted","2493.53"
"2/4/2021","","Withdrawal Debit Card Signature Debit/PP*APPLE.COM/BILL 402-935-7733 CADate 02/02/21 0 1033536402 4 5735Card 1140","2.99","","Posted","1993.53"
"2/4/2021","","Withdrawal Debit Card Signature Debit/VALENCIA COL TUITION 407-582-1200 FLDate 02/03/21 0 1034400793 1 8220Card 1140","3","","Posted","1996.52"
"2/4/2021","","Withdrawal ACH CITY OF GAINESVI/TYPE: 2000-6637- ID: 5330903620CO: CITY OF GAINESVIEntry Class Code: WEB","212.01","","Posted","1999.52"
"2/4/2021","","Withdrawal ACH WAWA CREDIT CARD/TYPE: ONLINE PMT ID: CITICTPCO: WAWA CREDIT CARDEntry Class Code: WEB","55","","Posted","2211.53"
"2/3/2021","","Withdrawal Debit Card Signature Debit/Amazon.com*6Y0NL43T3 Amzn.com/bill WADate 02/02/21 0 1033833008 2 5942Card 1140","11.51","","Posted","2266.53"
"2/3/2021","","Withdrawal Debit Card Signature Debit/PLAYSTATION NETWORK 800-345-7669 CADate 02/02/21 0 1033829432 1 5816Card 1140","49.99","","Posted","2278.04"
"2/3/2021","","Withdrawal Debit Card Signature Debit/PAYPAL *CDKEYS.COM 402-935-7733 CADate 02/02/21 0 1033152790 2 5816Card 1140","39.98","","Posted","2328.03"
"2/3/2021","","Withdrawal ACH APPLECARD GSBANK/TYPE: PAYMENT ID: 9999999999CO: APPLECARD GSBANKEntry Class Code: WEB","100","","Posted","2368.01"
"2/3/2021","","Withdrawal POS #000000305411/WALGREENS STORE 3455 SW A GAINESVILLE FLCard 1140","31","","Posted","2468.01"
"2/3/2021","","Withdrawal POS #000000000008/AMAZON.COM*6172X07C3 SEATTLE WACard 1140","17.3","","Posted","2499.01"
"2/3/2021","","Deposit ACH PAYPAL/TYPE: TRANSFER ID: PAYPALSD11 CO: PAYPALEntry Class Code: PPD","","97","Posted","2516.31"
"2/3/2021","","Withdrawal POS #000000784817/Microsoft 1 Microsoft Way Redmond WACard 1140","44.99","","Posted","2419.31"
"2/2/2021","","Withdrawal POS #000000092568/PUBLIX 3930 SW ARCHER ROA GAINESVILLE FLCard 1140","118.4","","Posted","2464.3"
"2/2/2021","","Withdrawal POS #000000716344/KANGAROO EXPRESS 3913 3424 SW WILLISTONGAINESVILLE FLCard 1140","21.96","","Posted","2582.7"
"2/2/2021","","Withdrawal POS #000000088866/AMAZON.COM*JY31Z2TN3 SEATTLE WACard 1140","47.95","","Posted","2604.66"
"2/1/2021","","Recurring Withdrawal Debit Card Fee/VISA INTERNATIONAL SERVICE ASSESSMENTDate 02/01/21Card 1140","0.06","","Posted","2652.61"
"2/1/2021","","Recurring Withdrawal Debit Card - Signature Debit/MIXCLOUD PREM LONDON GBDate 02/01/21 0 1032208242 0 7311Card 1140","7.99","","Posted","2652.67"
"2/1/2021","","Deposit ACH PAYPAL/TYPE: TRANSFER ID: PAYPALSD11 CO: PAYPALEntry Class Code: PPD","","207.41","Posted","2660.66"
"2/1/2021","","Deposit Home Banking Transfer trf/From CHAPLINSKI,LEON 3496297 Share 0090","","2000","Posted","2453.25"
"1/31/2021","","Withdrawal Debit Card Signature Debit/PP*APPLE.COM/BILL 402-935-7733 CADate 01/28/21 0 1028007161 9 5735Card 1140","2.99","","Posted","453.25"
"1/31/2021","","Withdrawal Debit Card Signature Debit/PP*APPLE.COM/BILL 402-935-7733 CADate 01/28/21 0 1028007160 9 5735Card 1140","5.99","","Posted","456.24"
"1/31/2021","","Withdrawal Debit Card Fee/VISA INTERNATIONAL SERVICE ASSESSMENTDate 01/29/21Card 1140","0.03","","Posted","462.23"
"1/31/2021","","Withdrawal Debit Card Signature Debit/PAYPAL *NEXUSMODS 35314369001 GBDate 01/29/21 0 1029525776 4 5999Card 1140","4.28","","Posted","462.26"
"1/29/2021","","Withdrawal Debit Card Signature Debit/PP*APPLE.COM/BILL 402-935-7733 CADate 01/27/21 0 1027398929 4 5735Card 1140","2.99","","Posted","466.54"
"1/29/2021","","Withdrawal Debit Card Signature Debit/PAYPAL *CDKEYS.COM 402-935-7733 CADate 01/27/21 0 1027000963 4 5816Card 1140","32.99","","Posted","469.53"
"1/29/2021","","Withdrawal ACH PAYPAL/TYPE: INST XFER ID: PAYPALSI77CO: PAYPALEntry Class Code: WEB","5.47","","Posted","502.52"
"1/28/2021","","Withdrawal Debit Card Signature Debit/AMZN Mktp US*BX8429043 Amzn.com/bill WADate 01/27/21 0 1027477510 4 5942Card 1140","11.19","","Posted","507.99"
"1/28/2021","","Recurring Withdrawal Debit Card - Signature Debit/HELP.HBOMAX.COM HTTPSHBOMAX.C NYDate 01/27/21 0 1027769244 4 5815Card 1140","17.23","","Posted","519.18"
"1/27/2021","","Withdrawal POS #000000037988/PUBLIX 3930 SW ARCHER ROA GAINESVILLE FLCard 1140","74.05","","Posted","536.41"
"1/27/2021","","Deposit Home Banking Transfer - From Share 0000/Funds Transfer via Online","","350","Posted","610.46"
"1/27/2021","","Withdrawal Adjustment Debit Card - Credit Voucher/PAYPAL *GEARBEST 402-935-7733 CADate 01/26/21 0 1026537000 2 5331Card 1140","","257.76","Posted","260.46"
"1/27/2021","","Withdrawal Debit Card Signature Debit/KLARNA *PAYMENTS 844-5527621 NYDate 01/25/21 0 1025084452 3 5999Card 1140","17.34","","Posted","2.7"
"1/27/2021","","Withdrawal Debit Card Signature Debit/KLARNA *PAYMENTS 844-5527621 NYDate 01/25/21 0 1025053210 3 5999Card 1140","25.12","","Posted","20.04"
"1/27/2021","","Withdrawal Debit Card Fee/VISA INTERNATIONAL SERVICE ASSESSMENTDate 01/26/21Card 1140","0.18","","Posted","45.16"
"1/27/2021","","Withdrawal Debit Card Signature Debit/CDKEYS.COM CDK2156 NLDate 01/26/21 0 1026148347 0 5816Card 1140","22.99","","Posted","45.34"
"1/27/2021","","Withdrawal Debit Card Signature Debit/Kindle Unltd*F70ZQ4XE3 866-321-8851 WADate 01/26/21 0 1026566593 2 5818Card 1140","9.99","","Posted","68.33"
"1/27/2021","","Withdrawal Debit Card Signature Debit/PARCHMENT-UNIV DOCS 480-719-1646 AZDate 01/26/21 0 1026065594 2 7372Card 1140","3.15","","Posted","78.32"
"1/27/2021","","Withdrawal Debit Card Signature Debit/PARCHMENT-UNIV DOCS 480-719-1646 AZDate 01/26/21 0 1026065575 2 7372Card 1140","3.15","","Posted","81.47"
"1/27/2021","","Withdrawal Debit Card Signature Debit/PAYPAL *JUSTANSWER 402-935-7733 CADate 01/25/21 0 1025892931 3 7311Card 1140","1","","Posted","84.62"
"1/27/2021","","Withdrawal Debit Card Signature Debit/PAYPAL *GEARBEST 402-935-7733 CADate 01/25/21 0 1025892930 3 5331Card 1140","257.76","","Posted","85.62"
"1/27/2021","","Withdrawal Transfer fee","8","","Posted","343.38"
"1/27/2021","","Deposit Transfer From Share 0000","","300","Posted","351.38"
"1/27/2021","","Withdrawal Debit Card Signature Debit/CU DENVER ONLINE 303-315-1800 CODate 01/26/21 0 1026820220 2 8220Card 1140","50","","Posted","51.38"
"1/27/2021","","Withdrawal Transfer fee","8","","Posted","101.38"
"1/27/2021","","Deposit Transfer From Share 0000","","100","Posted","109.38"
"1/27/2021","","Recurring Withdrawal Debit Card - Signature Debit/SoundCloud Inc 347-9866607 CADate 01/27/21 0 1027695366 0 4899Card 1140","4.99","","Posted","9.38"
"1/27/2021","","Withdrawal ACH COX COMM GAN/TYPE: BANK DRAFT ID: 1581620085CO: COX COMM GANEntry Class Code: WEB","127.52","","Posted","14.37"
"1/27/2021","","Withdrawal ACH GEARBEST/CO: GEARBESTTYPE: IAT PAYPAL ID: 770510487CEntry Class Code: IAT","207.41","","Posted","141.89"
"1/27/2021","","Withdrawal POS #000000705676/AMAZON.COM*4J55D8I53 SEATTLE WACard 1140","42.62","","Posted","349.3"
"1/27/2021","","Withdrawal ACH PAYMENT FOR AMZ/TYPE: STORECARD ID: 9069872103CO: PAYMENT FOR AMZEntry Class Code: WEB","211.68","","Posted","391.92"
"1/27/2021","","Withdrawal ACH PAYPAL/TYPE: INST XFER ID: PAYPALSI77CO: PAYPALEntry Class Code: WEB","8.03","","Posted","603.6"
"1/27/2021","","Withdrawal ACH PAYPAL/TYPE: INST XFER ID: PAYPALSI77CO: PAYPALEntry Class Code: WEB","5.24","","Posted","611.63"
"1/26/2021","","Withdrawal POS #000000804619/Microsoft 1 Microsoft Way Redmond WACard 1140","2.99","","Posted","616.87"
"1/26/2021","","Withdrawal Debit Card Signature Debit/PLAYSTATION NETWORK 800-345-7669 CADate 01/25/21 0 1025060429 2 5816Card 1140","39.99","","Posted","619.86"
"1/26/2021","","Withdrawal Debit Card Signature Debit/PP*APPLE.COM/BILL 402-935-7733 CADate 01/24/21 0 1024118718 4 5735Card 1140","4.99","","Posted","659.85"
"1/26/2021","","Withdrawal Debit Card Signature Debit/PIZZA HUT 27918 GAINESVILLE FLDate 01/24/21 0 1024669920 4 5812Card 1140","12.13","","Posted","664.84"
"1/26/2021","","Withdrawal Debit Card Signature Debit/BESTBUYCOM806417860706 RICHFIELD MNDate 01/25/21 0 1025000124 0 5732Card 1140","103.77","","Posted","676.97"
"1/26/2021","","Withdrawal Debit Card Signature Debit/CANNAMD 855-4209170 FLDate 01/25/21 0 1025978219 1 8011Card 1140","195","","Posted","780.74"
"1/26/2021","","Withdrawal ACH BARCLAYCARD US/TYPE: CREDITCARD ID: 2510407970CO: BARCLAYCARD USEntry Class Code: WEB","97.51","","Posted","975.74"
"1/26/2021","","Withdrawal ACH CAPITAL ONE/TYPE: MOBILE PMT ID: 9279744980CO: CAPITAL ONEEntry Class Code: WEB","65","","Posted","1073.25"
"1/26/2021","","Withdrawal ACH BEST BUY/TYPE: PAYMENT ID: CITIGPUFDRCO: BEST BUYEntry Class Code: PPD","55","","Posted","1138.25"
"1/26/2021","","Withdrawal ACH APPLECARD GSBANK/TYPE: PAYMENT ID: 9999999999CO: APPLECARD GSBANKEntry Class Code: WEB","48.41","","Posted","1193.25"
"1/26/2021","","Withdrawal ACH OMNYEX ECOMMERCE/CO: OMNYEX ECOMMERCE DMCCTYPE: IAT PAYPAL ID: 770510487CEntry Class Code: IAT","49.67","","Posted","1241.66"
"1/26/2021","","Withdrawal ACH PAYPAL/TYPE: INST XFER ID: PAYPALSI77CO: PAYPALEntry Class Code: WEB","69.98","","Posted","1291.33"
"1/26/2021","","Withdrawal ACH DISCOVER/TYPE: E-PAYMENT ID: 2510020270CO: DISCOVEREntry Class Code: WEB","55","","Posted","1361.31"
"1/26/2021","","Withdrawal ACH WAWA CREDIT CARD/TYPE: ONLINE PMT ID: CITICTPCO: WAWA CREDIT CARDEntry Class Code: WEB","45","","Posted","1416.31"
"1/26/2021","","Withdrawal ACH PAYPAL/TYPE: INST XFER ID: PAYPALSI77CO: PAYPALEntry Class Code: WEB","10.66","","Posted","1461.31"
"1/25/2021","","Withdrawal at ATM #000000000882/CAMPUS 1900 SW 34TH ST GAINESVILLE FLCard 1140","120","","Posted","1471.97"
"1/25/2021","","Deposit Home Banking Transfer - From Share 0000/Funds Transfer via Mobile","","1500","Posted","1591.97"
"1/25/2021","","Withdrawal Debit Card Signature Debit/PRIVATEINTERNETACCESS WWW.PRIVATEIN CODate 01/24/21 0 1024716002 0 5734Card 1140","9.95","","Posted","91.97"
"1/24/2021","","Withdrawal POS #000000060308/PUBLIX 3930 SW ARCHER ROA GAINESVILLE FLCard 1140","33.72","","Posted","101.92"
"1/21/2021","","Recurring Withdrawal Debit Card - Signature Debit/DisneyPLUS 888-9057888 CADate 01/20/21 0 1020042692 3 5815Card 1140","8.03","","Posted","135.64"
"1/21/2021","","Withdrawal Debit Card Signature Debit/PIZZA HUT 27918 https://ipcha FLDate 01/20/21 0 1020658789 3 5812Card 1140","28.18","","Posted","143.67"
"1/21/2021","","Withdrawal Debit Card Signature Debit/VALENCIA COL TUITION 407-582-1200 FLDate 01/20/21 0 1020526264 1 8220Card 1140","3","","Posted","171.85"
"1/21/2021","","Withdrawal Debit Card Fee/VISA INTERNATIONAL SERVICE ASSESSMENTDate 01/19/21Card 1140","0.02","","Posted","174.85"
"1/21/2021","","Withdrawal Debit Card Signature Debit/PAYPAL *CHARIZ 4029357733 AUDate 01/19/21 0 1019815671 3 5734Card 1140","1.99","","Posted","174.87"
"1/21/2021","","Deposit ACH PAYPAL/TYPE: TRANSFER ID: PAYPALSD11 CO: PAYPALEntry Class Code: PPD","","99","Posted","176.86"
"1/20/2021","","Withdrawal POS #000000055460/PUBLIX 125 SW 34TH ST GAINESVILLE FLCard 1140","29.37","","Posted","77.86"
"1/20/2021","","Withdrawal at ATM #000000005364/CAMPUS 5725 SW 75TH ST GAINESVILLE FLCard 1140","120","","Posted","107.23"
"1/20/2021","","Deposit Home Banking Transfer trf/From CHAPLINSKI,LEON 3496297 Share 0090","","150","Posted","227.23"
"1/20/2021","","Deposit at ATM #000000005115/CAMPUS 1900 SW 34TH ST GAINESVILLE FLCard 1140","","18","Posted","77.23"
"1/20/2021","","Deposit Home Banking Transfer - From Share 0000/Funds Transfer via Online","","5","Posted","59.23"
"1/19/2021","","Withdrawal POS #000000848961/SHELL SERVICE STATION GAINESVILLE FLCard 1140","13.47","","Posted","54.23"
"1/19/2021","","Withdrawal ACH PAYPAL/TYPE: INST XFER ID: PAYPALSI77CO: PAYPALEntry Class Code: WEB","78.21","","Posted","67.7"
"1/19/2021","","Withdrawal ACH TARGET DEBIT CRD/Location - TARGET -0687GAINESVILLE FL / Terminal ID: 173TYPE: ACH TRAN ID: 1410215170CO: TARGET DEBIT CRDEntry Class C","30.68","","Posted","145.91"
"1/19/2021","","Withdrawal ACH PAYPAL/TYPE: INST XFER ID: PAYPALSI77CO: PAYPALEntry Class Code: WEB","14.99","","Posted","176.59"
"1/17/2021","","Withdrawal Debit Card Signature Debit/PAYPAL *ETSY 402-935-7733 NYDate 01/15/21 0 1015973311 7 5970Card 1140","35.99","","Posted","191.58"
"1/16/2021","","Withdrawal POS #000000076634/PUBLIX 3930 SW ARCHER ROA GAINESVILLE FLCard 1140","76.4","","Posted","227.57"
"1/15/2021","231","Draft 231","850","","Posted","303.97"
"1/15/2021","","Withdrawal Debit Card Signature Debit/PLAYSTATION NETWORK 800-345-7669 CADate 01/14/21 0 1014956750 4 5816Card 1140","39.99","","Posted","1153.97"
"1/15/2021","","Withdrawal Debit Card Signature Debit/AMZN Mktp US*445QJ1OQ3 Amzn.com/bill WADate 01/14/21 0 1014794191 2 5942Card 1140","3.24","","Posted","1193.96"
"1/15/2021","","Withdrawal Debit Card Signature Debit/COUNTRY CRITTERS - 3 GAINESVILLE FLDate 01/13/21 0 1013755966 4 0742Card 1140","284.94","","Posted","1197.2"
"1/14/2021","","Deposit Home Banking Transfer trf/From CHAPLINSKI,LEON 3496297 Share 0090","","413","Posted","1482.14"
"1/14/2021","","Withdrawal POS #000000785293/GATE 1445 GAINESVILLE FLCard 1140","15.53","","Posted","1069.14"
"1/14/2021","","Withdrawal at ATM #000000000023/CAMPUS 1900 SW 34TH ST GAINESVILLE FLCard 1140","160","","Posted","1084.67"
"1/14/2021","","Withdrawal Debit Card Signature Debit/COUNTRY CRITTERS - 4 OCALA FLDate 01/12/21 0 1012710902 4 0742Card 1140","30","","Posted","1244.67"
"1/14/2021","","Withdrawal ACH VERIZON WIRELESS/TYPE: PAYMENTS ID: 1223344794CO: VERIZON WIRELESSEntry Class Code: PPD","117.38","","Posted","1274.67"
"1/13/2021","","Withdrawal POS #000000034006/PUBLIX 3930 SW ARCHER ROA GAINESVILLE FLCard 1140","6.87","","Posted","1392.05"
"1/13/2021","","Withdrawal POS #000000882351/CIRCLE K # 06782 GAINESVILLE FLCard 1140","18.77","","Posted","1398.92"
"1/13/2021","","Withdrawal POS #000000146905/WALGREENS STORE 2415 SW 7 GAINESVILLE FLCard 1140","18.17","","Posted","1417.69"
"1/13/2021","","Withdrawal POS #000000037324/WALGREENS STORE 2415 SW 7 GAINESVILLE FLCard 1140","2.13","","Posted","1435.86"
"1/12/2021","","Withdrawal POS #000000075022/PUBLIX 3930 SW ARCHER ROA GAINESVILLE FLCard 1140","38.68","","Posted","1437.99"
"1/11/2021","","Withdrawal POS #000000060900/WALGREENS STORE 2415 SW 7 GAINESVILLE FLCard 1140","6.41","","Posted","1476.67"
"1/11/2021","","Withdrawal POS #000000597575/GATE 1445 GAINESVILLE FLCard 1140","11.4","","Posted","1483.08"
"1/11/2021","","Withdrawal/Cash Disbursed 40.00","40","","Posted","1494.48"
"1/11/2021","","Withdrawal ACH PAYMENT FOR AMZ/TYPE: STORECARD ID: 9069872103CO: PAYMENT FOR AMZEntry Class Code: WEB","25","","Posted","1534.48"
"1/10/2021","","Withdrawal POS #000000432658/WALGREENS STORE 2415 SW 7 GAINESVILLE FLCard 1140","33.26","","Posted","1559.48"
"1/10/2021","","Withdrawal at ATM #000000009730/CAMPUS 1900 SW 34TH ST GAINESVILLE FLCard 1140","60","","Posted","1592.74"
"1/10/2021","","Withdrawal Debit Card Signature Debit/PP*APPLE.COM/BILL 402-935-7733 CADate 01/08/21 0 1008510062 7 5735Card 1140","2.99","","Posted","1652.74"
"1/8/2021","","Withdrawal POS #000000072582/PUBLIX 3930 SW ARCHER ROA GAINESVILLE FLCard 1140","32.05","","Posted","1655.73"
"1/8/2021","","Withdrawal at ATM #000000004249/CAMPUS 1900 SW 34TH ST GAINESVILLE FLCard 1140","100","","Posted","1687.78"
"1/8/2021","","Deposit at ATM #000000004248/CAMPUS 1900 SW 34TH ST GAINESVILLE FLCard 1140Check hold release 01/12/21 375.00","","600","Posted","1787.78"
"1/7/2021","","Withdrawal POS #000000859266/CIRCLE K # 26146 GAINESVILLE FLCard 1140","19.18","","Posted","1187.78"
"1/7/2021","","Withdrawal at ATM #000000009454/CAMPUS 1900 SW 34TH ST GAINESVILLE FLCard 1140","40","","Posted","1206.96"
"1/7/2021","","Withdrawal POS #000000114747/WALGREENS STORE 2415 SW 7 GAINESVILLE FLCard 1140","5.12","","Posted","1246.96"
"1/5/2021","","Withdrawal Debit Card Signature Debit/PIZZA HUT 27918 https://ipcha FLDate 01/03/21 0 1003886326 4 5812Card 1140","35.53","","Posted","1252.08"
"1/5/2021","","Withdrawal ACH BEST BUY/TYPE: PAYMENT ID: CITIGPUFDRCO: BEST BUYEntry Class Code: PPD","44.96","","Posted","1287.61"
"1/4/2021","","Withdrawal ACH CITY OF GAINESVI/TYPE: 2000-6637- ID: 5330903620CO: CITY OF GAINESVIEntry Class Code: WEB","188.56","","Posted","1332.57"
"1/4/2021","","Withdrawal ACH COX COMM GAN/TYPE: BANK DRAFT ID: 1581620085CO: COX COMM GANEntry Class Code: WEB","127.52","","Posted","1521.13"
"1/4/2021","","Withdrawal ACH CAPITAL ONE/TYPE: MOBILE PMT ID: 9279744980CO: CAPITAL ONEEntry Class Code: WEB","25","","Posted","1648.65"
"1/4/2021","","Withdrawal ACH BARCLAYCARD US/TYPE: CREDITCARD ID: 2510407970CO: BARCLAYCARD USEntry Class Code: WEB","25","","Posted","1673.65"
"1/4/2021","","Withdrawal ACH LAST.FM LTD./CO: LAST.FM LTD.TYPE: IAT PAYPAL ID: 770510487CEntry Class Code: IAT","3","","Posted","1698.65"
"1/4/2021","","Withdrawal Debit Card Signature Debit/PP*APPLE.COM/BILL 402-935-7733 CADate 01/02/21 0 1002730349 4 5735Card 1140","2.99","","Posted","1701.65"
"1/4/2021","","Withdrawal Debit Card Signature Debit/PAYPAL *PLAYSTATION 402-935-7733 CADate 01/02/21 0 1002730348 4 7994Card 1140","27.99","","Posted","1704.64"
"1/4/2021","","Withdrawal ACH DISCOVER/TYPE: E-PAYMENT ID: 2510020270CO: DISCOVEREntry Class Code: WEB","58","","Posted","1732.63"
"1/4/2021","","Withdrawal ACH PAYMENT FOR AMZ/TYPE: STORECARD ID: 9069872103CO: PAYMENT FOR AMZEntry Class Code: WEB","25","","Posted","1790.63"
"1/4/2021","","Withdrawal ACH WAWA CREDIT CARD/TYPE: ONLINE PMT ID: CITICTPCO: WAWA CREDIT CARDEntry Class Code: WEB","25","","Posted","1815.63"
"1/3/2021","","Withdrawal Debit Card Signature Debit/AMZN Digital*Z91A589A3 888-802-3080 WADate 01/02/21 0 1002482689 3 5818Card 1140","50","","Posted","1840.63"
"1/3/2021","","Withdrawal Debit Card Signature Debit/PAYPAL *PLAYSTATION 402-935-7733 CADate 01/02/21 0 1002296098 3 7994Card 1140","5.83","","Posted","1890.63"
"1/3/2021","","Withdrawal Debit Card Signature Debit/PAYPAL *DAMIENGEMIN 402-935-7733 CADate 01/02/21 0 1002416949 2 7333Card 1140","3.49","","Posted","1896.46"
"1/2/2021","","Withdrawal Bill Payment #000015518667/Dave Inc 1265 South Cochran Los AngelesCard 1140","1","","Posted","1899.95"
"1/2/2021","","Withdrawal POS #000000092202/PUBLIX 3930 SW ARCHER ROA GAINESVILLE FLCard 1140","58.09","","Posted","1900.95"
"1/2/2021","","Withdrawal POS #000000067357/WAWA 5325 2373 SW ARCHER ROA GAINESVILLEFLCard 1140","13.01","","Posted","1959.04"
"1/2/2021","","Withdrawal at ATM #000000008957/CAMPUS 1900 SW 34TH ST GAINESVILLE FLCard 1140","100","","Posted","1972.05"
"1/2/2021","","Withdrawal Home Banking Transfer - To Share 0000/Funds Transfer via Online","10","","Posted","2072.05"
"12/30/2020","","Withdrawal Adjustment Debit Card - Credit Voucher/PP*APPLE.COM/BILL 402-935-7733 CADate 12/29/20 0 0364761940 0 5735Card 1140","","9.99","Posted","2082.05"
"12/30/2020","","Withdrawal Debit Card Signature Debit/Amazon Prime*TX05X6Z43 Amzn.com/bill WADate 12/29/20 0 0364465851 2 5968Card 1140","13.11","","Posted","2072.06"
"12/30/2020","","Deposit Home Banking Transfer trf/From CHAPLINSKI,LEON 3496297 Share 0090","","2000","Posted","2085.17"
"12/29/2020","","Withdrawal Debit Card Signature Debit/PP*APPLE.COM/BILL 402-935-7733 CADate 12/28/20 0 0363032762 3 5735Card 1140","2.99","","Posted","85.17"
"12/29/2020","","Withdrawal Debit Card Signature Debit/PP*APPLE.COM/BILL 402-935-7733 CADate 12/28/20 0 0363706923 0 5735Card 1140","9.99","","Posted","88.16"
"12/29/2020","","Withdrawal ACH BARCLAYCARD US/TYPE: CREDITCARD ID: 2510407970CO: BARCLAYCARD USEntry Class Code: WEB","20","","Posted","98.15"
"12/29/2020","","Withdrawal ACH NOSSKIRNEH/CO: NOSSKIRNEHTYPE: IAT PAYPAL ID: 770510487CEntry Class Code: IAT","2.75","","Posted","118.15"
"12/29/2020","","Withdrawal ACH PAYPAL/TYPE: INST XFER ID: PAYPALSI77CO: PAYPALEntry Class Code: WEB","5.47","","Posted","120.9"
"12/28/2020","","Withdrawal ACH APPLECARD GSBANK/TYPE: PAYMENT ID: 9999999999CO: APPLECARD GSBANKEntry Class Code: WEB","46.93","","Posted","126.37"
"12/28/2020","","Withdrawal ACH BARCLAYCARD US/TYPE: CREDITCARD ID: 2510407970CO: BARCLAYCARD USEntry Class Code: WEB","30","","Posted","173.3"
"12/28/2020","","Withdrawal ACH CAPITAL ONE/TYPE: MOBILE PMT ID: 9279744980CO: CAPITAL ONEEntry Class Code: WEB","30","","Posted","203.3"
"12/28/2020","","Withdrawal ACH DISCOVER/TYPE: E-PAYMENT ID: 2510020270CO: DISCOVEREntry Class Code: WEB","25","","Posted","233.3"
"12/28/2020","","Withdrawal ACH TIGI SOFTWARE/CO: TIGI SOFTWARETYPE: IAT PAYPAL ID: 770510487CEntry Class Code: IAT","5.99","","Posted","258.3"
"12/28/2020","","Withdrawal ACH PAYPAL/TYPE: INST XFER ID: PAYPALSI77CO: PAYPALEntry Class Code: WEB","8.03","","Posted","264.29"
"12/28/2020","","Withdrawal ACH PAYPAL/TYPE: INST XFER ID: PAYPALSI77CO: PAYPALEntry Class Code: WEB","5.24","","Posted","272.32"
"12/27/2020","","Withdrawal Debit Card Signature Debit/Kindle Unltd*J96LZ7343 866-321-8851 WADate 12/26/20 0 0361073141 2 5818Card 1140","9.99","","Posted","277.56"
"12/27/2020","","Recurring Withdrawal Debit Card - Signature Debit/HELP.HBOMAX.COM HTTPSHBOMAX.C NYDate 12/27/20 0 0362847245 0 5815Card 1140","17.23","","Posted","287.55"
"12/26/2020","","Withdrawal POS #000018946300/WAWA 5325 2373 SW ARCHER ROA GAINESVILLEFLCard 1140","8.32","","Posted","304.78"
"12/26/2020","","Withdrawal POS #000000012006/PUBLIX 3930 SW ARCHER ROA GAINESVILLE FLCard 1140","20.72","","Posted","313.1"
"12/26/2020","","Withdrawal at ATM #000000003580/CAMPUS 5725 SW 75TH ST GAINESVILLE FLCard 1140","60","","Posted","333.82"
"12/26/2020","","Deposit Debit Card/PAYPAL*chaplinski steven San Jose CADate 12/26/20 0 0000254752 0 4829Card 1140","","271.35","Posted","393.82"
"12/26/2020","","Withdrawal POS #000000036214/CVS/PHARMACY #03 03255--3404 SW ArcGainesville FLCard 1140","10.14","","Posted","122.47"
"12/26/2020","","Deposit at ATM #000000008324/CAMPUS 1900 SW 34TH ST GAINESVILLE FLCard 1140","","92","Posted","132.61"
"12/25/2020","","Withdrawal POS #000000194488/FAST TRACK #200 3960 SW ARCHER RDGAINESVILLE FLCard 1140","6.72","","Posted","40.61"
"12/25/2020","","Withdrawal Adjustment Debit Card - Credit Voucher/NCX*D UNLOCK LTD USD DROITWICH GBDate 12/24/20 0 0359122894 0 7372Card 1140","","28","Posted","47.33"
"12/25/2020","","Withdrawal Debit Card Signature Debit/PRIVATEINTERNETACCESS WWW.PRIVATEIN CODate 12/24/20 0 0359965689 0 5734Card 1140","9.95","","Posted","19.33"
"12/22/2020","","Withdrawal POS #000077034486/PETSMART # 0303 3736 SW ARCHER ROAGAINESVILLE FLCard 1140","5.22","","Posted","29.28"
"12/22/2020","","Withdrawal POS #000079034482/PETSMART # 0303 3736 SW ARCHER ROAGAINESVILLE FLCard 1140","27.43","","Posted","34.5"
"12/22/2020","","Deposit Home Banking Transfer trf/From CHAPLINSKI,LEON 3496297 Share 0090","","50","Posted","61.93"
"12/22/2020","","Withdrawal POS #000000098960/PUBLIX 3930 SW ARCHER ROA GAINESVILLE FLCard 1140","16.04","","Posted","11.93"
"12/21/2020","","Recurring Withdrawal Debit Card - Signature Debit/DisneyPLUS 888-9057888 CADate 12/20/20 0 0355628518 3 5815Card 1140","8.03","","Posted","27.97"
"12/21/2020","","Withdrawal Debit Card Signature Debit/PP*APPLE.COM/BILL 402-935-7733 CADate 12/20/20 0 0355571920 4 5735Card 1140","9.99","","Posted","36"
"12/20/2020","","Deposit Home Banking Transfer trf/From CHAPLINSKI,LEON 3496297 Share 0090","","100","Posted","45.99"
"12/20/2020","","Withdrawal Courtesy Pay fee","35","","Posted","-54.01"
"12/20/2020","","Withdrawal Debit Card Signature Debit/PIZZA HUT 27918 https://ipcha FLDate 12/17/20 1 0352063781 1 5812Card 1140","25.03","","Posted","-19.01"
"12/20/2020","","Withdrawal Debit Card Fee/VISA INTERNATIONAL SERVICE ASSESSMENTDate 12/17/20Card 1140","0.02","","Posted","6.02"
"12/20/2020","","Withdrawal Debit Card Signature Debit/PAYPAL *BLVCKLNGS 0635308003 FRDate 12/17/20 0 0352264903 6 7372Card 1140","2","","Posted","6.04"
"12/19/2020","","Withdrawal POS #000000011100/PUBLIX 3930 SW ARCHER ROA GAINESVILLE FLCard 1140","8.87","","Posted","8.04"
"12/19/2020","","Withdrawal POS #000041017673/PETSMART # 0303 3736 SW ARCHER ROAGAINESVILLE FLCard 1140","25.24","","Posted","16.91"
"12/19/2020","","Withdrawal POS #000000891192/CIRCLE K # 26146 GAINESVILLE FLCard 1140","13.3","","Posted","42.15"
"12/19/2020","","Withdrawal at ATM #000000007770/CAMPUS 1900 SW 34TH ST GAINESVILLE FLCard 1140","20","","Posted","55.45"
"12/19/2020","","Deposit Debit Card/PAYPAL*chaplinski steven San Jose CADate 12/19/20 0 0000313301 6 4829Card 1140","","13.6","Posted","75.45"
"12/18/2020","","Withdrawal ACH PAYPAL/TYPE: INST XFER ID: PAYPALSI77CO: PAYPALEntry Class Code: WEB","14.99","","Posted","61.85"
"12/17/2020","","Deposit Home Banking Transfer trf/From CHAPLINSKI,LEON 3496297 Share 0090","","100","Posted","76.84"
"12/17/2020","","Withdrawal Adjustment COURTESY PAY FEE","","35","Posted","-23.16"
"12/17/2020","","Withdrawal Adjustment COURTESY PAY FEE","","35","Posted","-58.16"
"12/17/2020","","Withdrawal Adjustment COURTESY PAY FEE","","35","Posted","-93.16"
"12/17/2020","","Withdrawal Courtesy Pay fee","35","","Posted","-128.16"
"12/17/2020","","Withdrawal Debit Card Signature Debit/PAYPAL *USPOSTALSER 402-935-7733 CADate 12/16/20 0 0351885402 4 9399Card 1140","13.6","","Posted","-93.16"
"12/17/2020","","Withdrawal Courtesy Pay fee","35","","Posted","-79.56"
"12/17/2020","","Withdrawal Debit Card Signature Debit/PAYPAL *PACKIX 402-935-7733 NJDate 12/15/20 0 0350885401 4 5816Card 1140","1.8","","Posted","-44.56"
"12/17/2020","","Withdrawal Debit Card Fee/VISA INTERNATIONAL SERVICE ASSESSMENTDate 12/16/20Card 1140","0.01","","Posted","-42.76"
"12/17/2020","","Withdrawal Courtesy Pay fee","35","","Posted","-42.75"
"12/17/2020","","Withdrawal Debit Card Signature Debit/PAYPAL *BLVCKLNGS 0635308003 FRDate 12/16/20 0 0351083434 0 7372Card 1140","1.49","","Posted","-7.75"
"12/17/2020","","Withdrawal ACH TARGET DEBIT CRD/Location - TARGET -0687GAINESVILLE FL / Terminal ID: 073TYPE: ACH TRAN ID: 1410215170CO: TARGET DEBIT CRDEntry Class C","28.24","","Posted","-6.26"
"12/17/2020","","Withdrawal Transfer fee","8","","Posted","21.98"
"12/17/2020","","Deposit Transfer From Share 0000","","5","Posted","29.98"
"12/17/2020","","Withdrawal ACH WAWA CREDIT CARD/TYPE: ONLINE PMT ID: CITICTPCO: WAWA CREDIT CARDEntry Class Code: WEB","15","","Posted","24.98"
"12/16/2020","","Withdrawal POS #000000361072/WAWA 5325 2373 SW ARCHER ROA GAINESVILLEFLCard 1140","19.99","","Posted","39.98"
"12/16/2020","","Withdrawal Debit Card Signature Debit/WALGREENS #5024 800-289-2273 FLDate 12/15/20 0 0350645392 0 5912Card 1140","18.17","","Posted","59.97"
"12/14/2020","","Withdrawal POS #000000079889/PUBLIX 3930 SW ARCHER ROA GAINESVILLE FLCard 1140","50.39","","Posted","78.14"
"12/13/2020","","Withdrawal POS #000000437349/AMAZON.COM*CV3OL7443 SEATTLE WACard 1140","27.99","","Posted","128.53"
"12/13/2020","","Withdrawal POS #000000160265/FAST TRACK #200 3960 SW ARCHER RDGAINESVILLE FLCard 1140","14.49","","Posted","156.52"
"12/13/2020","","Withdrawal at ATM #000000007208/CAMPUS 1900 SW 34TH ST GAINESVILLE FLCard 1140","40","","Posted","171.01"
"12/13/2020","","Withdrawal Debit Card Signature Debit/PIZZA HUT 27918 https://ipcha FLDate 12/11/20 0 0346936172 4 5812Card 1140","34.53","","Posted","211.01"
"12/11/2020","230","Draft 230","850","","Posted","245.54"
"12/10/2020","","Withdrawal at ATM #000000006937/CAMPUS 1900 SW 34TH ST GAINESVILLE FLCard 1140","60","","Posted","1095.54"
"12/10/2020","","Withdrawal Debit Card Fee/VISA INTERNATIONAL SERVICE ASSESSMENTDate 12/09/20Card 1140","0.22","","Posted","1155.54"
"12/10/2020","","Withdrawal Debit Card Signature Debit/NCX*D UNLOCK LTD USD DROITWICH GBDate 12/09/20 0 0344098255 0 7372Card 1140","28","","Posted","1155.76"
"12/9/2020","","Withdrawal Debit Card Signature Debit/PP*APPLE.COM/BILL 402-935-7733 CADate 12/08/20 0 0343653547 0 5735Card 1140","2.99","","Posted","1183.76"
"12/8/2020","","Withdrawal POS #000000508145/USPS PO 11322705 4600 SW GAINESVILLE FLCard 1140","46.2","","Posted","1186.75"
"12/8/2020","","Withdrawal at ATM #000000006744/CAMPUS 1900 SW 34TH ST GAINESVILLE FLCard 1140","60","","Posted","1232.95"
"12/8/2020","","Deposit Home Banking Transfer trf/From CHAPLINSKI,LEON 3496297 Share 0090","","400","Posted","1292.95"
"12/7/2020","","Withdrawal ACH BLVCKLNGS/CO: BLVCKLNGSTYPE: IAT PAYPAL ID: 770510487CEntry Class Code: IAT","1","","Posted","892.95"
"12/7/2020","","Withdrawal ACH PAYPAL/TYPE: VERIFYBANK ID: PAYPALRD33CO: PAYPALEntry Class Code: PPD","0.24","","Posted","893.95"
"12/7/2020","","Deposit ACH PAYPAL/TYPE: VERIFYBANK ID: PAYPALRD33CO: PAYPALEntry Class Code: PPD","","0.13","Posted","894.19"
"12/7/2020","","Deposit ACH PAYPAL/TYPE: VERIFYBANK ID: PAYPALRD33CO: PAYPALEntry Class Code: PPD","","0.11","Posted","894.06"
"12/5/2020","","Withdrawal POS #000000067282/PUBLIX 3930 SW ARCHER ROA GAINESVILLE FLCard 1140","9.44","","Posted","893.95"
"12/5/2020","","Deposit Home Banking Transfer - From Share 0000/Funds Transfer via Mobile","","20","Posted","903.39"
"12/5/2020","","Withdrawal at ATM #000000006569/CAMPUS 1900 SW 34TH ST GAINESVILLE FLCard 1140","100","","Posted","883.39"
"12/3/2020","","Withdrawal Debit Card Signature Debit/PIZZA HUT 27918 https://ipcha FLDate 12/01/20 0 0336616109 5 5812Card 1140","28.69","","Posted","983.39"
"12/3/2020","","Withdrawal ACH INSPIREGOODIES/CO: INSPIREGOODIESTYPE: IAT PAYPAL ID: 770510487CEntry Class Code: IAT","45.9","","Posted","1012.08"
"12/3/2020","","Withdrawal ACH Dave, Inc/TYPE: DEBIT ID: 1465396710 CO: Dave, IncEntry Class Code: WEB","1","","Posted","1057.98"
"12/2/2020","","Withdrawal ACH CITY OF GAINESVI/TYPE: 2000-6637- ID: 5330903620CO: CITY OF GAINESVIEntry Class Code: WEB","190.49","","Posted","1058.98"
"12/2/2020","","Withdrawal ACH LAST.FM LTD./CO: LAST.FM LTD.TYPE: IAT PAYPAL ID: 770510487CEntry Class Code: IAT","3","","Posted","1249.47"
"12/1/2020","","Withdrawal ACH CAPITAL ONE/TYPE: ONLINE PMT ID: 9279744991CO: CAPITAL ONEEntry Class Code: WEB","25","","Posted","1252.47"
"12/1/2020","","Deposit ACH Dave, Inc/TYPE: CREDIT ID: 1465396710CO: Dave, IncEntry Class Code: WEB","","0.07","Posted","1277.47"
"12/1/2020","","Deposit ACH Dave, Inc/TYPE: CREDIT ID: 1465396710CO: Dave, IncEntry Class Code: WEB","","0.02","Posted","1277.4"
"11/30/2020","","Withdrawal Debit Card Signature Debit/PAYPAL *PLAYSTATION 402-935-7733 CADate 11/28/20 0 0333327342 4 7994Card 1140","4.97","","Posted","1277.38"
"11/30/2020","","Withdrawal Debit Card Signature Debit/BESTBUYCOM806382028639 RICHFIELD MNDate 11/29/20 0 0334909097 3 5732Card 1140","32.09","","Posted","1282.35"
"11/30/2020","","Withdrawal Debit Card Signature Debit/SCRUBS CARWASH - GAINE GAINESVILLE FLDate 11/28/20 0 0333771640 3 7542Card 1140","6.25","","Posted","1314.44"
"11/30/2020","","Withdrawal ACH COX COMM GAN/TYPE: BANK DRAFT ID: 1581620085CO: COX COMM GANEntry Class Code: WEB","127.16","","Posted","1320.69"
"11/30/2020","","Withdrawal ACH BEST BUY/TYPE: PAYMENT ID: CITIGPUFDRCO: BEST BUYEntry Class Code: PPD","45","","Posted","1447.85"
"11/30/2020","","Withdrawal ACH APPLECARD GSBANK/TYPE: PAYMENT ID: 9999999999CO: APPLECARD GSBANKEntry Class Code: WEB","22.61","","Posted","1492.85"
"11/29/2020","","Withdrawal POS #000000501613/LOWE'S #3278 GAINESVILLE FLCard 1140","42.32","","Posted","1515.46"
"11/29/2020","","Withdrawal POS #000000043153/PUBLIX 3930 SW ARCHER ROA GAINESVILLE FLCard 1140","144.31","","Posted","1557.78"
"11/28/2020","","Withdrawal POS #000020284741/SQ *VC GAINESVILLE SQUARE PURCHASEGAINESVILLE FLCard 1140","48.15","","Posted","1702.09"
"11/28/2020","","Withdrawal POS #000016040840/BEST BUY #424 3750 SE ARCHER ROAGAINSVILLE FLCard 1140","117.67","","Posted","1750.24"
"11/28/2020","","Withdrawal at ATM #000000005987/CAMPUS 1900 SW 34TH ST GAINESVILLE FLCard 1140","180","","Posted","1867.91"
"11/28/2020","","Deposit Home Banking Transfer trf/From CHAPLINSKI,LEON 3496297 Share 0090","","2000","Posted","2047.91"
"11/27/2020","","Withdrawal ACH PAYPAL/TYPE: INST XFER ID: PAYPALSI77CO: PAYPALEntry Class Code: WEB","9.99","","Posted","47.91"
"11/25/2020","","Withdrawal Debit Card Signature Debit/PRIVATEINTERNETACCESS WWW.PRIVATEIN CODate 11/24/20 0 0329683764 0 5734Card 1140","9.95","","Posted","57.9"
"11/22/2020","","Withdrawal POS #000000057608/PUBLIX 3930 SW ARCHER ROA GAINESVILLE FLCard 1140","74.8","","Posted","67.85"
"11/22/2020","","Withdrawal at ATM #000000005597/CAMPUS 1900 SW 34TH ST GAINESVILLE FLCard 1140","80","","Posted","142.65"
"11/22/2020","","Deposit Home Banking Transfer trf/From CHAPLINSKI,LEON 3496297 Share 0090","","100","Posted","222.65"
"11/22/2020","","Recurring Withdrawal Debit Card - Signature Debit/DisneyPLUS 888-9057888 CADate 11/20/20 0 0325477906 9 5815Card 1140","8.03","","Posted","122.65"
"11/22/2020","","Withdrawal Debit Card Signature Debit/EXXONMOBIL 96724869 GAINESVILLE FLDate 11/19/20 0 0324879059 4 5541Card 1140","22.11","","Posted","130.68"
"11/20/2020","","Deposit at ATM #000000005445/CAMPUS 1900 SW 34TH ST GAINESVILLE FLCard 1140","","69","Posted","152.79"
"11/20/2020","","Withdrawal at ATM #000000005443/CAMPUS 1900 SW 34TH ST GAINESVILLE FLCard 1140","120","","Posted","83.79"
"11/20/2020","","Deposit Home Banking Transfer - From Share 0000/Funds Transfer via Mobile","","50","Posted","203.79"
"11/20/2020","","Withdrawal ACH PAYPAL/TYPE: INST XFER ID: PAYPALSI77CO: PAYPALEntry Class Code: WEB","0.74","","Posted","153.79"
"11/19/2020","","Withdrawal POS #000000080373/PUBLIX 5200 S W 34TH STRE GAINESVILLE FLCard 1140","10.54","","Posted","154.53"
"11/19/2020","","Withdrawal at ATM #000000005316/CAMPUS 1900 SW 34TH ST GAINESVILLE FLCard 1140","80","","Posted","165.07"
"11/19/2020","","Deposit Home Banking Transfer - From Share 0000/Funds Transfer via Mobile","","65","Posted","245.07"
"11/19/2020","","Deposit Home Banking Transfer - From Share 0000/Funds Transfer via Mobile","","65","Posted","180.07"
"11/18/2020","","Withdrawal POS #000000310184/WALGREENS STORE 2415 SW 7 GAINESVILLE FLCard 1140","4.61","","Posted","115.07"
"11/18/2020","","Withdrawal POS #000000364576/WALGREENS STORE 2415 SW 7 GAINESVILLE FLCard 1140","60.5","","Posted","119.68"
"11/18/2020","","Withdrawal Debit Card Signature Debit/CHIPOTLE 0793 GAINESVILLE FLDate 11/17/20 0 0322184035 0 5814Card 1140","7.49","","Posted","180.18"
"11/18/2020","","Withdrawal ACH APPLECARD GSBANK/TYPE: PAYMENT ID: 9999999999CO: APPLECARD GSBANKEntry Class Code: WEB","50","","Posted","187.67"
"11/18/2020","","Withdrawal ACH DISCOVER/TYPE: E-PAYMENT ID: 2510020270CO: DISCOVEREntry Class Code: WEB","26","","Posted","237.67"
"11/18/2020","","Withdrawal ACH CAPITAL ONE/TYPE: MOBILE PMT ID: 9279744980CO: CAPITAL ONEEntry Class Code: WEB","25","","Posted","263.67"
"11/18/2020","","Withdrawal ACH PAYMENT FOR AMZ/TYPE: STORECARD ID: 9069872103CO: PAYMENT FOR AMZEntry Class Code: WEB","112.84","","Posted","288.67"
"11/17/2020","","Withdrawal POS #000070022099/PETSMART # 0303 3736 SW ARCHER ROAGAINESVILLE FLCard 1140","77","","Posted","401.51"
"11/17/2020","","Withdrawal POS #000000975560/FAST TRACK #200 3960 SW ARCHER RDGAINESVILLE FLCard 1140","22.23","","Posted","478.51"
"11/17/2020","","Deposit Home Banking Transfer - From Share 0000/Funds Transfer via Mobile","","200","Posted","500.74"
"11/17/2020","","Deposit Home Banking Transfer - From Share 0000/Funds Transfer via Mobile","","250","Posted","300.74"
"11/16/2020","229","Draft 229","850","","Posted","50.74"
"11/16/2020","","Withdrawal POS #000000232872/WALGREENS STORE 2415 SW 7 GAINESVILLE FLCard 1140","20.4","","Posted","900.74"
"11/16/2020","","Withdrawal ACH CAPITAL ONE/TYPE: ONLINE PMT ID: 9279744991CO: CAPITAL ONEEntry Class Code: WEB","25","","Posted","921.14"
"11/15/2020","","Withdrawal POS #000000030367/PUBLIX 3930 SW ARCHER ROA GAINESVILLE FLCard 1140","82.73","","Posted","946.14"
"11/15/2020","","Withdrawal Debit Card Signature Debit/WALGREENS #5024 800-289-2273 FLDate 11/13/20 0 0318366262 6 5912Card 1140","13.28","","Posted","1028.87"
"11/12/2020","","Withdrawal ACH BARCLAYCARD US/TYPE: CREDITCARD ID: 2510407970CO: BARCLAYCARD USEntry Class Code: WEB","27","","Posted","1042.15"
"11/11/2020","","Withdrawal POS #000000347509/WALGREENS STORE 2415 SW 7 GAINESVILLE FLCard 1140","17.19","","Posted","1069.15"
"11/11/2020","","Withdrawal at ATM #000000000429/CAMPUS 1900 SW 34TH ST GAINESVILLE FLCard 1140","140","","Posted","1086.34"
"11/10/2020","","Withdrawal POS #000000072181/PUBLIX 3930 SW ARCHER ROA GAINESVILLE FLCard 1140","50.27","","Posted","1226.34"
"11/10/2020","","Withdrawal ACH COX COMM GAN/TYPE: BANK DRAFT ID: 1581620085CO: COX COMM GANEntry Class Code: WEB","125.94","","Posted","1276.61"
"11/10/2020","","Withdrawal ACH APPLECARD GSBANK/TYPE: PAYMENT ID: 9999999999CO: APPLECARD GSBANKEntry Class Code: WEB","50","","Posted","1402.55"
"11/10/2020","","Withdrawal ACH VZ WIRELESS VE/TYPE: VZW WEBPAY ID: 0000751800CO: VZ WIRELESS VEEntry Class Code: WEB","55.55","","Posted","1452.55"
"11/9/2020","","Withdrawal ACH WAWA CREDIT CARD/TYPE: ONLINE PMT ID: CITICTPCO: WAWA CREDIT CARDEntry Class Code: WEB","25","","Posted","1508.1"
"11/8/2020","","Withdrawal POS #000000013173/CVS/PHARMACY #03 03255--3404 SW ArcGainesville FLCard 1140","19.37","","Posted","1533.1"
"11/8/2020","","Withdrawal POS #000000226085/WAWA 5325 2373 SW ARCHER ROA GAINESVILLEFLCard 1140","15.18","","Posted","1552.47"
"11/6/2020","","Withdrawal Debit Card Signature Debit/COUNTRY CRITTERS - 4 OCALA FLDate 11/04/20 0 0309046964 5 0742Card 1140","35","","Posted","1567.65"
"11/6/2020","","Withdrawal ACH WAWA CREDIT CARD/TYPE: ONLINE PMT ID: CITICTPCO: WAWA CREDIT CARDEntry Class Code: WEB","29","","Posted","1602.65"
"11/4/2020","","Withdrawal POS #000000254082/WALGREENS STORE 2415 SW 7 GAINESVILLE FLCard 1140","43.28","","Posted","1631.65"
"11/4/2020","","Withdrawal POS #000000000007/AMAZON.COM*2864R4HI1 SEATTLE WACard 1140","63.76","","Posted","1674.93"
"11/4/2020","","Withdrawal POS #000000081495/PUBLIX 3930 SW ARCHER ROA GAINESVILLE FLCard 1140","33.79","","Posted","1738.69"
"11/3/2020","","Withdrawal ACH CITY OF GAINESVI/TYPE: 2000-6637- ID: 5330903620CO: CITY OF GAINESVIEntry Class Code: WEB","187.69","","Posted","1772.48"
"11/1/2020","","Withdrawal POS #000000077534/PUBLIX 3930 SW ARCHER ROA GAINESVILLE FLCard 1140","64.86","","Posted","1960.17"
"10/31/2020","","Deposit Home Banking Transfer trf/From CHAPLINSKI,LEON 3496297 Share 0090","","2000","Posted","2025.03"
"10/27/2020","","Withdrawal POS #000000059255/PUBLIX 3930 SW ARCHER ROA GAINESVILLE FLCard 1140","23","","Posted","25.03"
"10/25/2020","","Withdrawal Debit Card Signature Debit/PRIVATEINTERNETACCESS WWW.PRIVATEIN CODate 10/24/20 0 0298109598 1 5734Card 1140","9.95","","Posted","48.03"
"10/25/2020","","Withdrawal Debit Card Signature Debit/CHIPOTLE 0793 GAINESVILLE FLDate 10/24/20 0 0298193830 0 5814Card 1140","1.98","","Posted","57.98"
"10/25/2020","","Withdrawal POS #000000058653/PUBLIX 5200 S W 34TH STRE GAINESVILLE FLCard 1140","10.7","","Posted","59.96"
"10/24/2020","","Withdrawal at ATM #000000002048/PAI ISO 3401 SW 34TH ST., GAINESVILLE FLCard 1140","187.75","","Posted","70.66"
"10/24/2020","","Deposit Home Banking Transfer - From Share 0000/Funds Transfer via Mobile","","100","Posted","258.41"
"10/24/2020","","Withdrawal POS #000000072174/PUBLIX 3930 SW ARCHER ROA GAINESVILLE FLCard 1140","87.92","","Posted","158.41"
"10/23/2020","","Deposit ACH Steven  Chaplin/TYPE: TRANSFER ID: 6192912998CO: Steven ChaplinEntry Class Code: WEB","","16.5","Posted","246.33"
"10/21/2020","","Withdrawal at ATM #000000000718/PAI ISO 3401 SW 34TH ST., GAINESVILLE FLCard 1140","132.75","","Posted","229.83"
"10/21/2020","","Recurring Withdrawal Debit Card - Signature Debit/DisneyPLUS 888-9057888 CADate 10/20/20 0 0294801035 3 5815Card 1140","8.03","","Posted","362.58"
"10/19/2020","","Withdrawal Debit Card Signature Debit/PAYPAL *TAMRIELTRAD 402-935-7733 CADate 10/18/20 0 0292162909 4 5945Card 1140","2","","Posted","370.61"
"10/19/2020","","Withdrawal ACH TARGET DEBIT CRD/Location - TARGET -0687GAINESVILLE FL / Terminal ID: 172TYPE: ACH TRAN ID: 1410215170CO: TARGET DEBIT CRDEntry Class C","107.44","","Posted","372.61"
"10/19/2020","","Withdrawal ACH PAYMENT FOR AMZ/TYPE: STORECARD ID: 9069872103CO: PAYMENT FOR AMZEntry Class Code: WEB","55","","Posted","480.05"
"10/18/2020","","Withdrawal Debit Card Signature Debit/WALGREENS #5024 800-289-2273 FLDate 10/17/20 0 0291406395 1 5912Card 1140","15","","Posted","535.05"
"10/18/2020","","Withdrawal Debit Card Signature Debit/WALGREENS #5024 800-289-2273 FLDate 10/16/20 0 0290778380 6 5912Card 1140","3.17","","Posted","550.05"
"10/17/2020","","Withdrawal at ATM #000000008812/CAMPUS 1900 SW 34TH ST GAINESVILLE FLCard 1140","140","","Posted","553.22"
"10/17/2020","","Deposit Home Banking Transfer - From Share 0000/Funds Transfer via Online","","500","Posted","693.22"
"10/16/2020","","Withdrawal POS #000000361865/WALGREENS STORE 2415 SW 7 GAINESVILLE FLCard 1140","12.83","","Posted","193.22"
"10/15/2020","","Withdrawal at ATM #000000000637/PAI ISO 3401 SW 34TH ST., GAINESVILLE FLCard 1140","117.75","","Posted","206.05"
"10/15/2020","","Withdrawal POS #000000106065/PUBLIX 3930 SW ARCHER ROA GAINESVILLE FLCard 1140","55.67","","Posted","323.8"
"10/11/2020","","Withdrawal POS #000000054244/PUBLIX 3930 SW ARCHER ROA GAINESVILLE FLCard 1140","64.02","","Posted","379.47"
"10/9/2020","228","Draft 228","850","","Posted","443.49"
"10/7/2020","","Withdrawal ACH DISCOVER/TYPE: E-PAYMENT ID: 2510020270CO: DISCOVEREntry Class Code: WEB","55","","Posted","1293.49"
"10/7/2020","","Withdrawal ACH PAYMENT FOR AMZ/TYPE: STORECARD ID: 9069872103CO: PAYMENT FOR AMZEntry Class Code: WEB","115","","Posted","1348.49"
"10/6/2020","","Withdrawal ACH APPLECARD GSBANK/TYPE: PAYMENT ID: 9999999999CO: APPLECARD GSBANKEntry Class Code: WEB","100","","Posted","1463.49"
"10/6/2020","","Withdrawal ACH DISCOVER/TYPE: E-PAYMENT ID: 2510020270CO: DISCOVEREntry Class Code: WEB","55","","Posted","1563.49"
"10/6/2020","","Withdrawal ACH CAPITAL ONE/TYPE: MOBILE PMT ID: 9279744980CO: CAPITAL ONEEntry Class Code: WEB","55","","Posted","1618.49"
"10/6/2020","","Withdrawal ACH BEST BUY/TYPE: PAYMENT ID: CITIGPUFDRCO: BEST BUYEntry Class Code: PPD","55","","Posted","1673.49"
"10/6/2020","","Withdrawal ACH BARCLAYCARD US/TYPE: CREDITCARD ID: 2510407970CO: BARCLAYCARD USEntry Class Code: WEB","55","","Posted","1728.49"
"10/6/2020","","Withdrawal ACH CAPITAL ONE/TYPE: MOBILE PMT ID: 9279744980CO: CAPITAL ONEEntry Class Code: WEB","45","","Posted","1783.49"
"10/6/2020","","Withdrawal ACH VZ WIRELESS VE/TYPE: VZW WEBPAY ID: 0000751800CO: VZ WIRELESS VEEntry Class Code: WEB","265.96","","Posted","1828.49"
"10/6/2020","","Withdrawal ACH WAWA CREDIT CARD/TYPE: ONLINE PMT ID: CITICTPCO: WAWA CREDIT CARDEntry Class Code: WEB","55","","Posted","2094.45"
"10/5/2020","","Withdrawal POS #000000031030/PUBLIX 3930 SW ARCHER ROA GAINESVILLE FLCard 1140","27.32","","Posted","2149.45"
"10/5/2020","","Withdrawal at ATM #000000001919/PAI ISO 3401 SW 34TH ST., GAINESVILLE FLCard 1140","62.75","","Posted","2176.77"
"10/5/2020","","Withdrawal/Cash Disbursed 100.00","100","","Posted","2239.52"
"10/5/2020","","Withdrawal POS #000000079405/PUBLIX 3930 SW ARCHER ROA GAINESVILLE FLCard 1140","16.04","","Posted","2339.52"
"10/1/2020","","Withdrawal at ATM #000000001877/PAI ISO 3401 SW 34TH ST., GAINESVILLE FLCard 1140","77.75","","Posted","2355.56"
"10/1/2020","","Deposit Home Banking Transfer trf/From CHAPLINSKI,LEON 3496297 Share 0090","","2000","Posted","2433.31"
"9/29/2020","","Withdrawal at ATM #000000001850/PAI ISO 3401 SW 34TH ST., GAINESVILLE FLCard 1140","42.75","","Posted","433.31"
"9/28/2020","","Withdrawal ACH CITY OF GAINESVI/TYPE: 2000-6637- ID: 5330903620CO: CITY OF GAINESVIEntry Class Code: WEB","227.08","","Posted","476.06"
"9/28/2020","","Deposit Home Banking Transfer - From Share 0000/Funds Transfer via Mobile","","250","Posted","703.14"
"9/28/2020","","Deposit Home Banking Transfer - From Share 0000/Funds Transfer via Mobile","","175","Posted","453.14"
"9/26/2020","","Withdrawal at ATM #000000000401/PAI ISO 3401 SW 34TH ST., GAINESVILLE FLCard 1140","192.75","","Posted","278.14"
"9/26/2020","","Deposit Home Banking Transfer - From Share 0000/Funds Transfer via Online","","230","Posted","470.89"
"9/25/2020","","Withdrawal POS #000000016427/PUBLIX 5200 S W 34TH STRE GAINESVILLE FLCard 1140","35.57","","Posted","240.89"
"9/25/2020","","Withdrawal Debit Card Signature Debit/PRIVATEINTERNETACCESS WWW.PRIVATEIN CODate 09/24/20 0 0268436352 0 5734Card 1140","9.95","","Posted","276.46"
"9/25/2020","","Withdrawal Adjustment POS #000000314106/AMAZON.COM SEATTLE WACard 1140","","85.07","Posted","286.41"
"9/24/2020","","Withdrawal at ATM #000000001010/CAMPUS 1900 SW 34TH ST GAINESVILLE FLCard 1140","60","","Posted","201.34"
"9/21/2020","","Withdrawal at ATM #000000001776/PAI ISO 3401 SW 34TH ST., GAINESVILLE FLCard 1140","42.75","","Posted","261.34"
"9/21/2020","","Deposit Home Banking Transfer - From Share 0000/Funds Transfer via Mobile","","250","Posted","304.09"
"9/21/2020","","Recurring Withdrawal Debit Card - Signature Debit/DisneyPLUS 888-9057888 CADate 09/20/20 0 0264389714 3 5815Card 1140","8.03","","Posted","54.09"
"9/21/2020","","Withdrawal Debit Card Fee/VISA INTERNATIONAL SERVICE ASSESSMENTDate 09/20/20Card 1140","0.04","","Posted","62.12"
"9/21/2020","","Withdrawal Debit Card Signature Debit/PAYPAL *GOG 35314369001 PLDate 09/20/20 0 0264165259 0 5816Card 1140","5","","Posted","62.16"
"9/21/2020","","Withdrawal ACH CAPITAL ONE/TYPE: MOBILE PMT ID: 9279744980CO: CAPITAL ONEEntry Class Code: WEB","544.43","","Posted","67.16"
"9/21/2020","","Withdrawal ACH DISCOVER/TYPE: E-PAYMENT ID: 2510020270CO: DISCOVEREntry Class Code: WEB","455.55","","Posted","611.59"
"9/21/2020","","Withdrawal ACH APPLECARD GSBANK/TYPE: PAYMENT ID: 9999999999CO: APPLECARD GSBANKEntry Class Code: WEB","150","","Posted","1067.14"
"9/21/2020","","Withdrawal ACH BEST BUY/TYPE: PAYMENT ID: CITIGPUFDRCO: BEST BUYEntry Class Code: PPD","33.04","","Posted","1217.14"
"9/21/2020","","Withdrawal ACH PAYMENT FOR AMZ/TYPE: STORECARD ID: 9069872103CO: PAYMENT FOR AMZEntry Class Code: WEB","500","","Posted","1250.18"
"9/21/2020","","Withdrawal ACH WAWA CREDIT CARD/TYPE: ONLINE PMT ID: CITICTPCO: WAWA CREDIT CARDEntry Class Code: WEB","29","","Posted","1750.18"
"9/21/2020","","Withdrawal POS #000000060204/AMAZON.COM*M49XR9GP2 SEATTLE WACard 1140","102.55","","Posted","1779.18"
"9/20/2020","","Withdrawal POS #000000058434/PUBLIX 3930 SW ARCHER ROA GAINESVILLE FLCard 1140","148.36","","Posted","1881.73"
"9/20/2020","","Withdrawal Debit Card Signature Debit/PLAYSTATION NETWORK 800-345-7669 CADate 09/19/20 0 0263332251 4 5816Card 1140","159.98","","Posted","2030.09"
"9/20/2020","","Withdrawal Debit Card Signature Debit/BESTBUYCOM806322187145 888-BESTBUY MNDate 09/18/20 0 0262415497 6 5732Card 1140","25","","Posted","2190.07"
"9/20/2020","","Withdrawal Debit Card Signature Debit/BESTBUYCOM806322189231 888-BESTBUY MNDate 09/18/20 0 0262415494 6 5732Card 1140","25","","Posted","2215.07"
"9/19/2020","","Withdrawal POS #000000058085/PUBLIX 3930 SW ARCHER ROA GAINESVILLE FLCard 1140","94.17","","Posted","2240.07"
"9/19/2020","","Withdrawal POS #000000492083/CHEVRON/CARY OIL CO., I MICANOPY FLCard 1140","29.82","","Posted","2334.24"
"9/19/2020","","Withdrawal at ATM #000000001760/PAI ISO 3401 SW 34TH ST., GAINESVILLE FLCard 1140","272.75","","Posted","2364.06"
"9/19/2020","","Deposit Home Banking Transfer - From Share 0000/Funds Transfer via Mobile","","1500","Posted","2636.81"
"9/18/2020","","Withdrawal POS #000000039667/WALGREENS STORE 2415 SW 7 GAINESVILLE FLCard 1140","45.42","","Posted","1136.81"
"9/18/2020","","Withdrawal POS #000000018871/PUBLIX 3930 SW ARCHER ROA GAINESVILLE FLCard 1140","59.31","","Posted","1182.23"
"9/18/2020","","Withdrawal Debit Card Signature Debit/PIZZA HUT 27918 https://ipcha FLDate 09/17/20 0 0261985303 3 5812Card 1140","35.04","","Posted","1241.54"
"9/17/2020","","Withdrawal ACH APPLECARD GSBANK/TYPE: PAYMENT ID: 9999999999CO: APPLECARD GSBANKEntry Class Code: WEB","707.86","","Posted","1276.58"
"9/17/2020","","Withdrawal ACH BARCLAYCARD US/TYPE: CREDITCARD ID: 2510407970CO: BARCLAYCARD USEntry Class Code: WEB","650","","Posted","1984.44"
"9/17/2020","","Deposit Home Banking Transfer - From Share 0000/Funds Transfer via Mobile","","1000","Posted","2634.44"
"9/16/2020","","Deposit Home Banking Transfer - From Share 0000/Funds Transfer via Mobile","","1500","Posted","1634.44"
"9/14/2020","227","Draft 227","850","","Posted","134.44"
"9/14/2020","","Withdrawal POS #000000439034/WALGREENS STORE 2415 SW 7 GAINESVILLE FLCard 1140","18.18","","Posted","984.44"
"9/14/2020","","Withdrawal POS #000000413514/CIRCLE K # 21311 GAINESVILLE FLCard 1140","10.77","","Posted","1002.62"
"9/12/2020","","Deposit at ATM #000000000173/CAMPUS 1900 SW 34TH ST GAINESVILLE FLCard 1140","","38","Posted","1013.39"
"9/12/2020","","Withdrawal POS #000000094429/PUBLIX 5200 S W 34TH STRE GAINESVILLE FLCard 1140","35.4","","Posted","975.39"
"9/12/2020","","Withdrawal at ATM #000000000192/PAI ISO 3401 SW 34TH ST., GAINESVILLE FLCard 1140","82.75","","Posted","1010.79"
"9/12/2020","","Withdrawal at ATM #000000000145/CAMPUS 1900 SW 34TH ST GAINESVILLE FLCard 1140","80","","Posted","1093.54"
"9/8/2020","","Withdrawal POS #000000040807/PUBLIX 3930 SW ARCHER ROA GAINESVILLE FLCard 1140","64.87","","Posted","1173.54"
"9/8/2020","","Withdrawal at ATM #000000006268/CAMPUS 1900 SW 34TH ST GAINESVILLE FLCard 1140","40","","Posted","1238.41"
"9/8/2020","","Withdrawal ACH APPLECARD GSBANK/TYPE: PAYMENT ID: 9999999999CO: APPLECARD GSBANKEntry Class Code: WEB","42","","Posted","1278.41"
"9/8/2020","","Withdrawal ACH WAWA CREDIT CARD/TYPE: ONLINE PMT ID: CITICTPCO: WAWA CREDIT CARDEntry Class Code: WEB","28.67","","Posted","1320.41"
"9/8/2020","","Withdrawal POS #000000074347/PUBLIX 3930 SW ARCHER ROA GAINESVILLE FLCard 1140","41.34","","Posted","1349.08"
"9/6/2020","","Deposit ACH STEVEN CHAPLINSK/TYPE: MOBILE DEP CO: STEVEN CHAPLINSKACH Trace Number: 263178470000004","","34.84","Posted","1390.42"
"9/6/2020","","Withdrawal at ATM #000000009659/CAMPUS 1900 SW 34TH ST GAINESVILLE FLCard 1140","80","","Posted","1355.58"
"9/6/2020","","Withdrawal Debit Card Signature Debit/PIZZA HUT 27918 https://ipcha FLDate 09/03/20 0 0247623950 9 5812Card 1140","35.04","","Posted","1435.58"
"9/4/2020","","Withdrawal POS #000000116993/PUBLIX 3930 SW ARCHER ROA GAINESVILLE FLCard 1140","35.68","","Posted","1470.62"
"9/4/2020","","Withdrawal at ATM #000000009522/CAMPUS 1900 SW 34TH ST GAINESVILLE FLCard 1140","40","","Posted","1506.3"
"9/3/2020","","Withdrawal ACH COX COMM GAN/TYPE: BANK DRAFT ID: 1581620085CO: COX COMM GANEntry Class Code: WEB","131.54","","Posted","1546.3"
"9/3/2020","","Withdrawal ACH PAYMENT FOR AMZ/TYPE: STORECARD ID: 9069872103CO: PAYMENT FOR AMZEntry Class Code: WEB","35.09","","Posted","1677.84"
"9/2/2020","","Withdrawal ACH CAPITAL ONE","35","","Posted","1712.93"
"9/2/2020","","Withdrawal ACH CITY OF GAINESVI/TYPE: 2000-6637- ID: 5330903620CO: CITY OF GAINESVIEntry Class Code: WEB","240.83","","Posted","1747.93"
"9/2/2020","","Withdrawal ACH DISCOVER/TYPE: E-PAYMENT ID: 2510020270CO: DISCOVEREntry Class Code: WEB","35","","Posted","1988.76"
"9/2/2020","","Withdrawal ACH BARCLAYCARD US/TYPE: CREDITCARD ID: 2510407970CO: BARCLAYCARD USEntry Class Code: WEB","35","","Posted","2023.76"
"9/1/2020","","Withdrawal at ATM #000000009263/CAMPUS 1900 SW 34TH ST GAINESVILLE FLCard 1140","60","","Posted","2058.76"
"8/31/2020","","Withdrawal ACH APPLECARD GSBANK/TYPE: PAYMENT ID: 9999999999CO: APPLECARD GSBANKEntry Class Code: WEB","25","","Posted","2118.76"
"8/31/2020","","Withdrawal ACH DISCOVER/TYPE: E-PAYMENT ID: 2510020270CO: DISCOVEREntry Class Code: WEB","15","","Posted","2143.76"
"8/31/2020","","Deposit Home Banking Transfer trf/From CHAPLINSKI,LEON 3496297 Share 0090","","1000","Posted","2158.76"
"8/30/2020","","Withdrawal Debit Card Signature Debit/PAYPAL *PLAYSTATION 402-935-7733 CADate 08/28/20 0 0241765429 5 7994Card 1140","14.98","","Posted","1158.76"
"8/30/2020","","Deposit Home Banking Transfer trf/From CHAPLINSKI,LEON 3496297 Share 0090","","1000","Posted","1173.74"
"8/28/2020","","Deposit at ATM #000000008961/CAMPUS 1900 SW 34TH ST GAINESVILLE FLCard 1140","","164.91","Posted","173.74"
"8/27/2020","","Withdrawal ACH PAYMENT FOR AMZ/TYPE: STORECARD ID: 9069872103CO: PAYMENT FOR AMZEntry Class Code: WEB","15","","Posted","8.83"
"8/26/2020","","Withdrawal ATM Fee/ARCHER ROAD GAINESVILLE FLCard 1140","2","","Posted","23.83"
"8/26/2020","","Withdrawal at ATM #000000725615/ARCHER ROAD GAINESVILLE FLCard 1140","24","","Posted","25.83"
"8/26/2020","","Withdrawal Adjustment Debit Card - Credit Voucher/VERIZON WRLS 14349-01 TAMPA FLDate 08/24/20 0 0237025617 4 4814Card 1140","","28","Posted","49.83"
"8/25/2020","","Withdrawal Debit Card Signature Debit/PRIVATEINTERNETACCESS WWW.PRIVATEIN CODate 08/24/20 0 0237693675 0 5734Card 1140","9.95","","Posted","21.83"
"8/25/2020","","Withdrawal Debit Card Signature Debit/CELLULAR SALES EF-GV GAINESVILLE FLDate 08/24/20 0 0237708660 0 4812Card 1140","49.7","","Posted","31.78"
"8/25/2020","","Withdrawal POS #000000730226/TARGET T-0687 3970 SW Arc Gainesville FLCard 1140","75.17","","Posted","81.48"
"8/25/2020","","Withdrawal POS #000000015410/PUBLIX 3930 SW ARCHER ROA GAINESVILLE FLCard 1140","46.35","","Posted","156.65"
"8/23/2020","","Withdrawal Debit Card Signature Debit/VZWRLSS*ETM SFL1434901 800-922-0204 FLDate 08/23/20 0 0236412185 0 4812Card 1140","28","","Posted","203"
"8/22/2020","","Deposit Home Banking Transfer trf/From CHAPLINSKI,LEON 3496297 Share 0000","","200","Posted","231"
"8/22/2020","","Withdrawal at ATM #000000008644/CAMPUS 1900 SW 34TH ST GAINESVILLE FLCard 1140","20","","Posted","31"
"8/21/2020","","Recurring Withdrawal Debit Card - Signature Debit/DisneyPLUS 888-9057888 CADate 08/20/20 0 0233830273 3 5815Card 1140","8.03","","Posted","51"
"8/21/2020","","Withdrawal Debit Card Signature Debit/PAYPAL *TIGISOFTWAR 402-935-7733 CADate 08/20/20 0 0233425010 4 7372Card 1140","5.99","","Posted","59.03"
"8/21/2020","","Withdrawal Debit Card Fee/VISA INTERNATIONAL SERVICE ASSESSMENTDate 08/20/20Card 1140","0.02","","Posted","65.02"
"8/21/2020","","Withdrawal Debit Card Signature Debit/PAYPAL *CHARIZ 4029357733 AUDate 08/20/20 0 0233001840 3 5734Card 1140","2.99","","Posted","65.04"
"8/21/2020","","Withdrawal Debit Card Fee/VISA INTERNATIONAL SERVICE ASSESSMENTDate 08/20/20Card 1140","0.01","","Posted","68.03"
"8/21/2020","","Withdrawal Debit Card Signature Debit/PAYPAL *BLVCKLNGS 0635308003 FRDate 08/20/20 0 0233101255 0 7372Card 1140","1.25","","Posted","68.04"
"8/21/2020","","Withdrawal POS #000000090559/PUBLIX 3930 SW ARCHER ROA GAINESVILLE FLCard 1140","92.68","","Posted","69.29"
"8/20/2020","","Withdrawal Debit Card Signature Debit/PAYPAL *USPS 402-935-7733 DCDate 08/19/20 0 0232867544 0 9399Card 1140","7.5","","Posted","161.97"
"8/20/2020","","Withdrawal Debit Card Signature Debit/WALGREENS #5024 800-289-2273 FLDate 08/19/20 0 0232227438 1 5912Card 1140","44.9","","Posted","169.47"
"8/19/2020","","Withdrawal/Cash Disbursed 70.00","70","","Posted","214.37"
"8/19/2020","","Deposit Debit Card/PAYPAL*chaplinski steven San Jose CADate 08/19/20 0 0000567962 3 4829Card 1140","","254.7","Posted","284.37"
"8/16/2020","","Withdrawal POS #000000071511/PUBLIX 3930 SW ARCHER ROA GAINESVILLE FLCard 1140","27.19","","Posted","29.67"
"8/14/2020","226","Draft 226","850","","Posted","56.86"
"8/13/2020","","Withdrawal at ATM #000000004280/CAMPUS 1900 SW 34TH ST GAINESVILLE FLCard 1140","40","","Posted","906.86"
"8/13/2020","","Withdrawal POS #000000079244/PUBLIX 3930 SW ARCHER ROA GAINESVILLE FLCard 1140","23.22","","Posted","946.86"
"8/13/2020","","Withdrawal POS #000000462634/WALGREENS STORE 2415 SW 7 GAINESVILLE FLCard 1140","17.82","","Posted","970.08"
"8/13/2020","","Withdrawal POS #000000304636/WALGREENS STORE 2415 SW 7 GAINESVILLE FLCard 1140","8.56","","Posted","987.9"
"8/9/2020","","Withdrawal Debit Card Signature Debit/PlaystationNetwork 800-3457669 CADate 08/08/20 0 0221483677 4 5816Card 1140","24.93","","Posted","996.46"
"8/7/2020","","Withdrawal POS #000000076393/PUBLIX 3930 SW ARCHER ROA GAINESVILLE FLCard 1140","43.25","","Posted","1021.39"
"8/6/2020","","Withdrawal ACH COX COMM GAN/TYPE: BANK DRAFT ID: 1581620085CO: COX COMM GANEntry Class Code: WEB","65.39","","Posted","1064.64"
"8/6/2020","","Withdrawal ACH PAYMENT FOR AMZ/TYPE: STORECARD ID: 9069872103CO: PAYMENT FOR AMZEntry Class Code: WEB","55","","Posted","1130.03"
"8/5/2020","","Withdrawal POS #000000075127/PUBLIX 3930 SW ARCHER ROA GAINESVILLE FLCard 1140","2","","Posted","1185.03"
"8/5/2020","","Withdrawal POS #000000075104/PUBLIX 3930 SW ARCHER ROA GAINESVILLE FLCard 1140","2","","Posted","1187.03"
"8/5/2020","","Withdrawal Debit Card Signature Debit/PAYPAL *EBAYINCSHIP 402-935-7733 CADate 08/04/20 0 0217477989 2 7399Card 1140","8.76","","Posted","1189.03"
"8/5/2020","","Withdrawal Debit Card Signature Debit/PAYPAL *EBAYINCSHIP 402-935-7733 CADate 08/04/20 0 0217477988 2 7399Card 1140","2.78","","Posted","1197.79"
"8/5/2020","","Withdrawal Debit Card Signature Debit/PAYPAL *ZENIMAX ONL 855-296-3170 MDDate 08/04/20 0 0217738198 0 5816Card 1140","27.99","","Posted","1200.57"
"8/5/2020","","Withdrawal POS #000073015896/PETSMART # 0303 3736 SW ARCHER ROAGAINESVILLE FLCard 1140","44.58","","Posted","1228.56"
"8/5/2020","","Withdrawal ACH CITY OF GAINESVI/TYPE: 2000-6637- ID: 5330903620CO: CITY OF GAINESVIEntry Class Code: WEB","258.61","","Posted","1273.14"
"8/5/2020","","Withdrawal ACH APPLECARD GSBANK/TYPE: PAYMENT ID: 9999999999CO: APPLECARD GSBANKEntry Class Code: WEB","75","","Posted","1531.75"
"8/5/2020","","Withdrawal ACH CAPITAL ONE/TYPE: MOBILE PMT ID: 9279744980CO: CAPITAL ONEEntry Class Code: WEB","55","","Posted","1606.75"
"8/5/2020","","Withdrawal ACH DISCOVER/TYPE: E-PAYMENT ID: 2510020270CO: DISCOVEREntry Class Code: WEB","55","","Posted","1661.75"
"8/5/2020","","Withdrawal ACH BEST BUY/TYPE: PAYMENT ID: CITICTP CO: BEST BUYEntry Class Code: WEB","55","","Posted","1716.75"
"8/5/2020","","Withdrawal ACH BARCLAYCARD US/TYPE: CREDITCARD ID: 2510407970CO: BARCLAYCARD USEntry Class Code: WEB","50","","Posted","1771.75"
"8/5/2020","","Withdrawal ACH WAWA CREDIT CARD/TYPE: ONLINE PMT ID: CITICTPCO: WAWA CREDIT CARDEntry Class Code: WEB","28.02","","Posted","1821.75"
"8/4/2020","","Deposit Debit Card/PAYPAL*chaplinski steven San Jose CADate 08/04/20 1 0000199619 3 4829Card 1140","","7.3","Posted","1849.77"
"8/4/2020","","Withdrawal POS #000000055158/PUBLIX 3930 SW ARCHER ROA GAINESVILLE FLCard 1140","89.53","","Posted","1842.47"
"8/4/2020","","Withdrawal POS #000015015644/PETSMART # 0303 3736 SW ARCHER ROAGAINESVILLE FLCard 1140","92.69","","Posted","1932"
"8/4/2020","","Withdrawal POS #000000095240/PUBLIX 3930 SW ARCHER ROA GAINESVILLE FLCard 1140","8.22","","Posted","2024.69"
"7/31/2020","","Withdrawal Debit Card Signature Debit/PAYPAL *EBAYINCSHIP 408-376-7400 CADate 07/30/20 0 0212878255 2 7399Card 1140","2.84","","Posted","2032.91"
"7/31/2020","","Deposit Home Banking Transfer trf/From CHAPLINSKI,LEON 3496297 Share 0090","","2000","Posted","2035.75"
"7/30/2020","","Withdrawal POS #000000011847/PUBLIX 5200 S W 34TH STRE GAINESVILLE FLCard 1140","30.03","","Posted","35.75"
"7/30/2020","","Deposit Debit Card/PAYPAL*chaplinski steven San Jose CADate 07/30/20 1 0000434614 2 4829Card 1140","","22.65","Posted","65.78"
"7/30/2020","","Withdrawal POS #000000037315/PUBLIX 3930 SW ARCHER ROA GAINESVILLE FLCard 1140","23.97","","Posted","43.13"
"7/29/2020","","Withdrawal POS #000000071101/PUBLIX 3930 SW ARCHER ROA GAINESVILLE FLCard 1140","34.26","","Posted","67.1"
"7/29/2020","","Withdrawal Adjustment POS #000048013643/PETSMART # 0303 3736 SW ARCHER ROAGAINESVILLE FLCard 1140","","68.59","Posted","101.36"
"7/29/2020","","Withdrawal POS #000048013643/PETSMART # 0303 3736 SW ARCHER ROAGAINESVILLE FLCard 1140","68.59","","Posted","32.77"
"7/29/2020","","Withdrawal POS #000048013643/PETSMART # 0303 3736 SW ARCHER ROAGAINESVILLE FLCard 1140","68.59","","Posted","101.36"
"7/28/2020","","Deposit ACH Steven  Chaplin/TYPE: TRANSFER ID: 6192912998CO: Steven ChaplinEntry Class Code: WEB","","3","Posted","169.95"
"7/27/2020","","Deposit Home Banking Transfer trf/From CHAPLINSKI,LEON 3496297 Share 0090","","200","Posted","166.95"
"7/27/2020","","Withdrawal Adjustment COURTESY PAY FEE","","35","Posted","-33.05"
"7/27/2020","","Withdrawal Courtesy Pay Fee/Entry Class Code: POS","35","","Posted","-68.05"
"7/27/2020","","Withdrawal ACH TARGET DEBIT CRD/Location - TARGET -0687GAINESVILLE FL / Terminal ID: 071TYPE: ACH TRAN ID: 1410215170CO: TARGET DEBIT CRD","59.57","","Posted","-33.05"
"7/27/2020","","Deposit Transfer From Share 0000","","0.93","Posted","26.52"
"7/26/2020","","Withdrawal Debit Card Signature Debit/PRIVATEINTERNETACCESS HTTPSWWW.PRIV CODate 07/24/20 0 0206170454 5 5734Card 1140","9.95","","Posted","25.59"
"7/26/2020","","Withdrawal Debit Card Signature Debit/PIZZA HUT 27921 https://ipcha FLDate 07/23/20 0 0205916161 8 5812Card 1140","40.62","","Posted","35.54"
"7/24/2020","","Withdrawal POS #000000878396/CK 2726162 7302 SW ARCHER RD GAINESVILLE FL Card 1140","23.44","","Posted","76.16"
"7/24/2020","","Withdrawal Debit Card Signature Debit/PAYPAL *KHANACADEMY 402-935-7733 CA Date 07/22/20 0 0204544073 4 8641 Card 1140","5","","Posted","99.6"
"7/24/2020","","Withdrawal POS #000000806824/WAWA 5325 2373 SW ARCHER ROA GAINESVILLE FL Card 1140","22.69","","Posted","104.6"
"7/23/2020","","Deposit Home Banking Transfer - From Share 0000/Funds Transfer via Online","","30","Posted","127.29"
"7/22/2020","","Withdrawal Debit Card Signature Debit/PAYPAL *ZENIMAX ONL 855-296-3170 MD Date 07/21/20 0 0203684968 0 5816 Card 1140","39.99","","Posted","97.29"
"7/22/2020","","Withdrawal Debit Card Signature Debit/WALGREENS #5024 GAINESVILLE FL Date 07/21/20 0 0203163833 1 5912 Card 1140","41.38","","Posted","137.28"
"7/22/2020","","Withdrawal POS #000000091710/PUBLIX 3930 SW ARCHER ROA GAINESVILLE FL Card 1140","209.54","","Posted","178.66"
"7/21/2020","","Recurring Withdrawal Debit Card - Signature Debit/DisneyPLUS 888-9057888 CA Date 07/20/20 0 0202385035 3 5815 Card 1140","8.03","","Posted","388.2"
"7/21/2020","","Withdrawal ACH CAPITAL ONE/TYPE: MOBILE PMT ID: 9279744980 CO: CAPITAL ONE Entry Class Code: WEB","25","","Posted","396.23"
"7/20/2020","","Withdrawal ACH BEST BUY/TYPE: PAYMENT ID: CITICTP CO: BEST BUY Entry Class Code: WEB","50","","Posted","421.23"
"7/17/2020","","Withdrawal Debit Card Signature Debit/WALGREENS #5024 GAINESVILLE FL Date 07/16/20 0 0198227931 1 5912 Card 1140","8.31","","Posted","471.23"
"7/16/2020","","Withdrawal POS #000000050234/PUBLIX 3930 SW ARCHER ROA GAINESVILLE FL Card 1140","26.58","","Posted","479.54"
"7/16/2020","","Deposit Debit Card/PAYPAL*chaplinski steven San Jose CA Date 07/16/20 0 0000423034 7 4829 Card 1140","","172.19","Posted","506.12"
"7/16/2020","","Withdrawal POS #000000218861/WALGREENS STORE 2415 SW 7 GAINESVILLE FL Card 1140","18.17","","Posted","333.93"
"7/16/2020","","Withdrawal POS #000000141777/WALGREENS STORE 2415 SW 7 GAINESVILLE FL Card 1140","8.34","","Posted","352.1"
"7/14/2020","225","Draft 225","850","","Posted","360.44"
"7/13/2020","","Withdrawal Debit Card Signature Debit/ELDERSCROLLSONLINE. 855-296-3170 MD Date 07/13/20 0 0195400748 0 7994 Card 1140","14.99","","Posted","1210.44"
"7/12/2020","","Recurring Withdrawal Debit Card - Signature Debit/PlaystationNetwork 800-3457669 CA Date 07/10/20 0 0192717875 8 5816 Card 1140","9.99","","Posted","1225.43"
"7/9/2020","","Withdrawal at ATM #000000001619/CAMPUS 1900 SW 34TH ST GAINESVILLE FL Card 1140","60","","Posted","1235.42"
"7/8/2020","","Withdrawal ACH APPLECARD GSBANK/TYPE: PAYMENT ID: 9999999999 CO: APPLECARD GSBANK Entry Class Code: WEB","50","","Posted","1295.42"
"7/8/2020","","Withdrawal POS #000000097350/PUBLIX 3930 SW ARCHER ROA GAINESVILLE FL Card 1140","30.55","","Posted","1345.42"
"7/7/2020","","Withdrawal POS #000000097226/PUBLIX 3930 SW ARCHER ROA GAINESVILLE FL Card 1140","81.82","","Posted","1375.97"
"7/7/2020","","Withdrawal POS #000000465552/WAWA 5325 2373 SW ARCHER ROA GAINESVILLE FL Card 1140","25.43","","Posted","1457.79"
"7/7/2020","","Withdrawal ACH APPLECARD GSBANK/TYPE: PAYMENT ID: 9999999999 CO: APPLECARD GSBANK Entry Class Code: WEB","125","","Posted","1483.22"
"7/7/2020","","Withdrawal ACH BARCLAYCARD US/TYPE: CREDITCARD ID: 2510407970 CO: BARCLAYCARD US Entry Class Code: WEB","50","","Posted","1608.22"
"7/7/2020","","Withdrawal ACH DISCOVER/TYPE: E-PAYMENT ID: 2510020270 CO: DISCOVER Entry Class Code: WEB","50","","Posted","1658.22"
"7/6/2020","","Withdrawal ACH B2P*FLDOH-OMMU/TYPE: B2P*FLDOH ID: BILL2PAYVS CO: B2P*FLDOH-OMMU Entry Class Code: WEB","77.75","","Posted","1708.22"
"7/3/2020","","Withdrawal Debit Card Signature Debit/PAYPAL *EBAYINCSHIP 408-376-7400 CA Date 07/02/20 0 0184148024 3 7399 Card 1140","11.19","","Posted","1785.97"
"7/2/2020","","Withdrawal ACH CITY OF GAINESVI/TYPE: 2000-6637- ID: 5330903620 CO: CITY OF GAINESVI Entry Class Code: WEB","196.5","","Posted","1797.16"
"7/2/2020","","Withdrawal ACH APPLECARD GSBANK/TYPE: PAYMENT ID: 9999999999 CO: APPLECARD GSBANK Entry Class Code: WEB","125","","Posted","1993.66"
"6/30/2020","","Deposit Home Banking Transfer trf/From CHAPLINSKI,LEON 3496297 Share 0090","","1000","Posted","2118.66"
"6/30/2020","","Withdrawal ACH APPLECARD GSBANK/TYPE: PAYMENT ID: 9999999999 CO: APPLECARD GSBANK Entry Class Code: WEB","95","","Posted","1118.66"
"6/30/2020","","Deposit ACH Steven  Chaplin/TYPE: TRANSFER ID: 6192912998 CO: Steven Chaplin Entry Class Code: WEB","","10.16","Posted","1213.66"
"6/29/2020","","Withdrawal POS #000000030357/PUBLIX 3930 SW ARCHER ROA GAINESVILLE FL Card 1140","47.17","","Posted","1203.5"
"6/29/2020","","Deposit Home Banking Transfer - Online Banking/From CHAPLINSKI,LEON 3496297 Share 0090","","1000","Posted","1250.67"
"6/29/2020","","Withdrawal ACH BARCLAYCARD US/TYPE: CREDITCARD ID: 2510407970 CO: BARCLAYCARD US Entry Class Code: WEB","39","","Posted","250.67"
"6/29/2020","","Withdrawal ACH PAYMENT FOR AMZ/TYPE: STORECARD ID: 9069872103 CO: PAYMENT FOR AMZ Entry Class Code: WEB","25","","Posted","289.67"
"6/28/2020","","Withdrawal POS #000000429760/WALGREENS STORE 2415 SW 7 GAINESVILLE FL Card 1140","25.18","","Posted","314.67"
"6/25/2020","","Withdrawal POS #000000072679/PUBLIX 3930 SW ARCHER ROA GAINESVILLE FL Card 1140","53.65","","Posted","339.85"
"6/25/2020","","Deposit Home Banking Transfer trf/From CHAPLINSKI,LEON 3496297 Share 0090","","200","Posted","393.5"
"6/25/2020","","Withdrawal Debit Card Signature Debit/PRIVATEINTERNETACCESS HTTPSWWW.PRIV CO Date 06/24/20 0 0176491301 0 5734 Card 1140","9.95","","Posted","193.5"
"6/25/2020","","Withdrawal ACH TARGET DEBIT CRD/Location - TARGET -0687 GAINESVILLE FL / Terminal ID: 173 TYPE: ACH TRAN ID: 1410215170CO: TARGET DEBIT CRDEntry Class","77.97","","Posted","203.45"
"6/24/2020","","Withdrawal Debit Card Signature Debit/CCVC-OCALA OCALA FL Date 06/23/20 0 0175551245 0 0742 Card 1140","448.94","","Posted","281.42"
"6/23/2020","","Withdrawal POS #000000224049/FAST TRACK #200 3960 SW ARCHER RD GAINESVILLE FL Card 1140","25.61","","Posted","730.36"
"6/23/2020","","Deposit Home Banking Transfer trf/From CHAPLINSKI,LEON 3496297 Share 0090","","200","Posted","755.97"
"6/23/2020","","Deposit Home Banking Transfer trf/From CHAPLINSKI,LEON 3496297 Share 0090","","200","Posted","555.97"
"6/23/2020","","Withdrawal Debit Card Signature Debit/WALGREENS #5024 GAINESVILLE FL Date 06/22/20 0 0174219688 1 5912 Card 1140","37.51","","Posted","355.97"
"6/23/2020","","Deposit Home Banking Transfer - From Share 0000/Funds Transfer via Online","","225","Posted","393.48"
"6/23/2020","","Withdrawal POS #000000039481/PUBLIX 3930 SW ARCHER ROA GAINESVILLE FL Card 1140","60.93","","Posted","168.48"
"6/22/2020","","Withdrawal at ATM #000000000203/CAMPUS 1900 SW 34TH ST GAINESVILLE FL Card 1140","20","","Posted","229.41"
"6/21/2020","","Withdrawal POS #000000065183/FAST TRACK #200 3960 SW ARCHER RD GAINESVILLE FL Card 1140","21.11","","Posted","249.41"
"6/21/2020","","Withdrawal POS #000000070392/PUBLIX 3930 SW ARCHER ROA GAINESVILLE FL Card 1140","37.74","","Posted","270.52"
"6/20/2020","","Withdrawal POS #000000079791/PUBLIX 3930 SW ARCHER ROA GAINESVILLE FL Card 1140","24.99","","Posted","308.26"
"6/19/2020","","Deposit Home Banking Transfer - From Share 0000/Funds Transfer via Online","","300","Posted","333.25"
"6/19/2020","","Withdrawal POS #000000331803/WALGREENS STORE 2415 SW 7 GAINESVILLE FL Card 1140","4.82","","Posted","33.25"
"6/19/2020","","Withdrawal POS #000000788644/FAST TRACK #200 3960 SW ARCHER RD GAINESVILLE FL Card 1140","16.74","","Posted","38.07"
"6/18/2020","","Withdrawal POS #000000016208/PUBLIX 3930 SW ARCHER ROA GAINESVILLE FL Card 1140","33.17","","Posted","54.81"
"6/16/2020","","Withdrawal Debit Card Signature Debit/PIZZA HUT 27918 https://ipcha FL Date 06/14/20 0 0166692117 3 5812 Card 1140","36.04","","Posted","87.98"
"6/15/2020","","Withdrawal POS #000000038067/PUBLIX 3930 SW ARCHER ROA GAINESVILLE FL Card 1140","71.91","","Posted","124.02"
"6/12/2020","","Withdrawal Debit Card Signature Debit/WALGREENS #5024 GAINESVILLE FL Date 06/11/20 0 0163086764 1 5912 Card 1140","12.85","","Posted","195.93"
"6/11/2020","","Withdrawal Debit Card Signature Debit/PIZZA HUT 27918 https://ipcha FL Date 06/09/20 0 0161727653 4 5812 Card 1140","29.69","","Posted","208.78"
"6/11/2020","","Withdrawal ACH COX COMM GAN/TYPE: BANK DRAFT ID: 1581620085 CO: COX COMM GAN Entry Class Code: WEB","104.75","","Posted","238.47"
"6/10/2020","204","Draft 204","850","","Posted","343.22"
"6/10/2020","","Withdrawal POS #000000074057/PUBLIX 3930 SW ARCHER ROA GAINESVILLE FL Card 1140","52.42","","Posted","1193.22"
"6/9/2020","","Withdrawal POS #000000160819/WALGREENS STORE 2415 SW 7 GAINESVILLE FL Card 1140","7.16","","Posted","1245.64"
"6/8/2020","","Withdrawal ACH CAPITAL ONE/TYPE: MOBILE PMT ID: 9279744980 CO: CAPITAL ONE Entry Class Code: WEB","156.43","","Posted","1252.8"
"6/8/2020","","Withdrawal ACH BEST BUY/TYPE: PAYMENT ID: CITICTP CO: BEST BUY Entry Class Code: WEB","125","","Posted","1409.23"
"6/8/2020","","Withdrawal ACH DISCOVER/TYPE: E-PAYMENT ID: 2510020270 CO: DISCOVER Entry Class Code: WEB","100","","Posted","1534.23"
"6/8/2020","","Withdrawal ACH BARCLAYCARD US/TYPE: CREDITCARD ID: 2510407970 CO: BARCLAYCARD US Entry Class Code: WEB","100","","Posted","1634.23"
"6/8/2020","","Withdrawal ACH APPLECARD GSBANK/TYPE: PAYMENT ID: 9999999999 CO: APPLECARD GSBANK Entry Class Code: WEB","100","","Posted","1734.23"
"6/6/2020","","Deposit Home Banking Transfer - From Share 0000/Funds Transfer via Online","","500","Posted","1834.23"
"6/5/2020","","Withdrawal ACH APPLECARD GSBANK/TYPE: PAYMENT ID: 9999999999 CO: APPLECARD GSBANK Entry Class Code: WEB","50","","Posted","1334.23"
"6/3/2020","","Withdrawal ACH APPLECARD GSBANK/TYPE: PAYMENT ID: 9999999999 CO: APPLECARD GSBANK Entry Class Code: WEB","75","","Posted","1384.23"
"6/3/2020","","Withdrawal POS #000000056254/PUBLIX 5200 S W 34TH STRE GAINESVILLE FL Card 1140","19.03","","Posted","1459.23"
"6/2/2020","","Withdrawal ACH APPLECARD GSBANK/TYPE: PAYMENT ID: 9999999999 CO: APPLECARD GSBANK Entry Class Code: WEB","75","","Posted","1478.26"
"6/1/2020","","Withdrawal POS #000000784393/FAST TRACK #200 3960 SW ARCHER RD GAINESVILLE FL Card 1140","8.37","","Posted","1553.26"
"6/1/2020","","Withdrawal POS #000000097798/PUBLIX 3930 SW ARCHER ROA GAINESVILLE FL Card 1140","105.77","","Posted","1561.63"
"6/1/2020","","Withdrawal Adjustment Debit Card - Credit Voucher/PAYPAL *WALMART COM 402-935-7733 CA Date 05/31/20 0 0152066778 2 5310 Card 1140","","8.39","Posted","1667.4"
"6/1/2020","","Withdrawal Debit Card Signature Debit/PAYPAL *DPORTAL 402-935-7733 CA Date 05/31/20 0 0152066777 2 5732 Card 1140","19.99","","Posted","1659.01"
"6/1/2020","","Withdrawal ACH CITY OF GAINESVI/TYPE: 2000-6637- ID: 5330903620 CO: CITY OF GAINESVI Entry Class Code: WEB","182.85","","Posted","1679"
"6/1/2020","","Withdrawal ACH CAPITAL ONE/TYPE: ONLINE PMT ID: 9279744991 CO: CAPITAL ONE Entry Class Code: WEB","50","","Posted","1861.85"
"6/1/2020","","Withdrawal ACH DISCOVER/TYPE: E-PAYMENT ID: 2510020270 CO: DISCOVER Entry Class Code: WEB","50","","Posted","1911.85"
"6/1/2020","","Withdrawal ACH BEST BUY/TYPE: PAYMENT ID: CITICTP CO: BEST BUY Entry Class Code: WEB","35","","Posted","1961.85"
"5/31/2020","","Withdrawal POS #000000661036/WAWA 5291 3312 W SILVER SPRI OCALA FL Card 1140","35.6","","Posted","1996.85"
"5/29/2020","","Deposit Home Banking Transfer trf/From CHAPLINSKI,LEON 3496297 Share 0090","","2000","Posted","2032.45"
"5/27/2020","","Withdrawal at ATM #000000008280/CAMPUS 1900 SW 34TH ST GAINESVILLE FL Card 1140","40","","Posted","32.45"
"5/27/2020","","Withdrawal ACH DISCOVER/TYPE: E-PAYMENT ID: 2510020270 CO: DISCOVER Entry Class Code: WEB","48.51","","Posted","72.45"
"5/26/2020","","Deposit","","100","Posted","120.96"
"5/26/2020","","Withdrawal Debit Card Signature Debit/STEAMGAMES.COM 4259522 425-8899642 WA Date 05/26/20 0 0147820747 1 5816 Card 1140","29.99","","Posted","20.96"
"5/26/2020","","Recurring Withdrawal Debit Card - Signature Debit/STEAMGAMES.COM 425-889-9642 WA Date 05/24/20 0 0145207548 1 5816 Card 1140","14.99","","Posted","50.95"
"5/26/2020","","Withdrawal ACH CAPITAL ONE/TYPE: ONLINE PMT ID: 9279744991 CO: CAPITAL ONE Entry Class Code: WEB","45","","Posted","65.94"
"5/26/2020","","Withdrawal ACH BARCLAYCARD US/TYPE: CREDITCARD ID: 2510407970 CO: BARCLAYCARD US Entry Class Code: WEB","35","","Posted","110.94"
"5/26/2020","","Withdrawal ACH APPLECARD GSBANK/TYPE: PAYMENT ID: 9999999999 CO: APPLECARD GSBANK Entry Class Code: WEB","25","","Posted","145.94"
"5/25/2020","","Withdrawal Debit Card Signature Debit/PRIVATEINTERNETACCESS HTTPSWWW.PRIV CO Date 05/24/20 0 0145163402 2 5734 Card 1140","9.95","","Posted","170.94"
"5/25/2020","","Withdrawal Debit Card Signature Debit/WALGREENS #5024 GAINESVILLE FL Date 05/24/20 0 0145357402 1 5912 Card 1140","25.11","","Posted","180.89"
"5/23/2020","","Withdrawal POS #000000209403/WALGREENS STORE 2415 SW 7 GAINESVILLE FL Card 1140","9.48","","Posted","206"
"5/22/2020","","Withdrawal POS #000000823051/FAST TRACK #200 3960 SW ARCHER RD GAINESVILLE FL Card 1140","16.74","","Posted","215.48"
"5/22/2020","","Withdrawal POS #000000032628/PUBLIX 3930 SW ARCHER ROA GAINESVILLE FL Card 1140","28.46","","Posted","232.22"
"5/22/2020","","Withdrawal ACH APPLECARD GSBANK/TYPE: PAYMENT ID: 9999999999 CO: APPLECARD GSBANK Entry Class Code: WEB","25","","Posted","260.68"
"5/20/2020","","Withdrawal POS #000000055188/PUBLIX 3930 SW ARCHER ROA GAINESVILLE FL Card 1140","33.59","","Posted","285.68"
"5/20/2020","","Deposit Home Banking Transfer trf/From CHAPLINSKI,LEON 3496297 Share 0090","","200","Posted","319.27"
"5/19/2020","","Withdrawal POS #000000054642/WALGREENS STORE 2415 SW 7 GAINESVILLE FL Card 1140","8.13","","Posted","119.27"
"5/19/2020","","Withdrawal Debit Card Signature Debit/PIZZA HUT 27918 https://ipcha FL Date 05/17/20 0 0138366750 3 5812 Card 1140","24.34","","Posted","127.4"
"5/15/2020","","Withdrawal Debit Card Signature Debit/PIZZA HUT 27918 https://ipcha FL Date 05/13/20 0 0134239366 3 5812 Card 1140","29.69","","Posted","151.74"
"5/15/2020","","Withdrawal ACH BEST BUY/TYPE: PAYMENT ID: CITICTP CO: BEST BUY Entry Class Code: WEB","30","","Posted","181.43"
"5/15/2020","","Withdrawal POS #000000093462/PUBLIX 3930 SW ARCHER ROA GAINESVILLE FL Card 1140","22.01","","Posted","211.43"
"5/13/2020","201","Draft 201","850","","Posted","233.44"
"5/13/2020","","Withdrawal Debit Card Signature Debit/WALGREENS #5024 GAINESVILLE FL Date 05/12/20 0 0133000668 1 5912 Card 1140","20.17","","Posted","1083.44"
"5/12/2020","","Withdrawal POS #000000052923/PUBLIX 3930 SW ARCHER ROA GAINESVILLE FL Card 1140","9.35","","Posted","1103.61"
"5/11/2020","","Withdrawal ACH APPLECARD GSBANK/TYPE: PAYMENT ID: 9999999999 CO: APPLECARD GSBANK Entry Class Code: WEB","50","","Posted","1112.96"
"5/8/2020","","Withdrawal Adjustment Debit Card - Credit Voucher/SANTAFECCOLBKSTOR #341 GAINESVILLE FL Date 05/05/20 0 0126316501 4 5942 Card 1140","","39.99","Posted","1162.96"
"5/8/2020","","Withdrawal Adjustment Debit Card - Credit Voucher/SANTAFECCOLBKSTOR #341 GAINESVILLE FL Date 05/05/20 0 0126316500 4 5942 Card 1140","","29.99","Posted","1122.97"
"5/8/2020","","Withdrawal Debit Card Signature Debit/ATWIIKS REPO.PACKIX.C NJ Date 05/07/20 0 0128470400 3 5734 Card 1140","0.99","","Posted","1092.98"
"5/8/2020","","Withdrawal Debit Card Signature Debit/ATWIIKS REPO.PACKIX.C NJ Date 05/07/20 0 0128470399 3 5734 Card 1140","0.99","","Posted","1093.97"
"5/8/2020","","Withdrawal Debit Card Signature Debit/ATWIIKS REPO.PACKIX.C NJ Date 05/07/20 0 0128470398 3 5734 Card 1140","0.99","","Posted","1094.96"
"5/7/2020","","Withdrawal at ATM #000000007007/CAMPUS 1900 SW 34TH ST GAINESVILLE FL Card 1140","100","","Posted","1095.95"
"5/7/2020","","Withdrawal POS #000000377629/FAST TRACK #200 3960 SW ARCHER RD GAINESVILLE FL Card 1140","23.37","","Posted","1195.95"
"5/7/2020","","Deposit ACH APPLECARD GSBANK/TYPE: REFUND ID: 9999999999 CO: APPLECARD GSBANK Entry Class Code: PPD","","50","Posted","1219.32"
"5/7/2020","","Withdrawal POS #000000076600/PUBLIX 3930 SW ARCHER ROA GAINESVILLE FL Card 1140","61.97","","Posted","1169.32"
"5/6/2020","","Withdrawal Debit Card Signature Debit/UDEMY ONLINE COURSES HTTPSWWW.UDEM CA Date 05/05/20 0 0126837579 0 8299 Card 1140","39.96","","Posted","1231.29"
"5/6/2020","","Withdrawal Debit Card Signature Debit/SANTAFECCOLBKSTOR #341 GAINESVILLE FL Date 05/04/20 0 0125445575 4 5942 Card 1140","39.99","","Posted","1271.25"
"5/6/2020","","Withdrawal Debit Card Signature Debit/SANTAFECCOLBKSTOR #341 GAINESVILLE FL Date 05/05/20 0 0126055676 3 5942 Card 1140","29.99","","Posted","1311.24"
"5/6/2020","","Withdrawal ACH APPLECARD GSBANK/TYPE: PAYMENT ID: 9999999999 CO: APPLECARD GSBANK Entry Class Code: WEB","50","","Posted","1341.23"
"5/6/2020","","Withdrawal ACH BEST BUY/TYPE: PAYMENT ID: CITICTP CO: BEST BUY Entry Class Code: WEB","50","","Posted","1391.23"
"5/6/2020","","Withdrawal ACH CAPITAL ONE/TYPE: MOBILE PMT ID: 9279744980 CO: CAPITAL ONE Entry Class Code: WEB","25","","Posted","1441.23"
"5/6/2020","","Withdrawal ACH DISCOVER/TYPE: E-PAYMENT ID: 2510020270 CO: DISCOVER Entry Class Code: WEB","25","","Posted","1466.23"
"5/5/2020","","Withdrawal Debit Card Signature Debit/PAYPAL *BLVCKLNGS 402-935-7733 CA Date 05/04/20 0 0125395625 3 7372 Card 1140","1.5","","Posted","1491.23"
"5/5/2020","","Withdrawal POS #000000050600/PUBLIX 3930 SW ARCHER ROA GAINESVILLE FL Card 1140","87.3","","Posted","1492.73"
"5/5/2020","","Withdrawal POS #000000950863/CIRCLE K # 26146 GAINESVILLE FL Card 1140","15.46","","Posted","1580.03"
"5/3/2020","","Withdrawal POS #000000090611/PUBLIX 3930 SW ARCHER ROA GAINESVILLE FL Card 1140","44.37","","Posted","1595.49"
"5/1/2020","","Withdrawal POS #000000991864/CIRCLE K # 21142 GAINESVILLE FL Card 1140","13.33","","Posted","1639.86"
"5/1/2020","","Withdrawal POS #000077341402/THE HOME DEPOT #0270 7107 NW 4TH BLVD GAINESVILLE FL Card 1140","138.22","","Posted","1653.19"
"5/1/2020","","Withdrawal Debit Card Signature Debit/PAYPAL *WALMART COM 402-935-7733 CA Date 04/30/20 0 0121193564 0 5310 Card 1140","40.46","","Posted","1791.41"
"5/1/2020","","Withdrawal ACH APPLECARD GSBANK/TYPE: PAYMENT ID: 9999999999 CO: APPLECARD GSBANK Entry Class Code: WEB","120.01","","Posted","1831.87"
"5/1/2020","","Withdrawal ACH APPLECARD GSBANK/TYPE: PAYMENT ID: 9999999999 CO: APPLECARD GSBANK Entry Class Code: WEB","75","","Posted","1951.88"
"5/1/2020","","Withdrawal ACH BEST BUY/TYPE: PAYMENT ID: CITICTP CO: BEST BUY Entry Class Code: WEB","70","","Posted","2026.88"
"5/1/2020","","Deposit ACH Steven  Chaplin/TYPE: TRANSFER ID: 6192912998 CO: Steven Chaplin Entry Class Code: WEB","","24.19","Posted","2096.88"
"4/30/2020","","Withdrawal POS #000000745678/CK 2726162 7302 SW ARCHER RD GAINESVILLE FL Card 1140","21.42","","Posted","2072.69"
"4/29/2020","","Deposit Home Banking Transfer - living expenses/From CHAPLINSKI,LEON 3496297 Share 0090","","2000","Posted","2094.11"
"4/28/2020","","Withdrawal POS #000000037400/PUBLIX 3930 SW ARCHER ROA GAINESVILLE FL Card 1140","118.3","","Posted","94.11"
"4/28/2020","","Withdrawal Debit Card Signature Debit/PIZZA HUT 27918 https://ipcha FL Date 04/27/20 0 0118821220 3 5812 Card 1140","24.34","","Posted","212.41"
"4/28/2020","","Withdrawal ACH CAPITAL ONE/TYPE: MOBILE PMT ID: 9279744980 CO: CAPITAL ONE Entry Class Code: WEB","50","","Posted","236.75"
"4/27/2020","","Withdrawal ACH CITY OF GAINESVI/TYPE: 2000-6637- ID: 5330903620 CO: CITY OF GAINESVI Entry Class Code: PPD","172.5","","Posted","286.75"
"4/27/2020","","Withdrawal ACH APPLECARD GSBANK/TYPE: PAYMENT ID: 9999999999 CO: APPLECARD GSBANK Entry Class Code: WEB","125","","Posted","459.25"
"4/27/2020","","Withdrawal ACH COX COMM GAN/TYPE: BANK DRAFT ID: 1581620085 CO: COX COMM GAN Entry Class Code: WEB","104.75","","Posted","584.25"
"4/27/2020","","Withdrawal ACH BARCLAYCARD US/TYPE: CREDITCARD ID: 2510407970 CO: BARCLAYCARD US Entry Class Code: WEB","100","","Posted","689"
"4/27/2020","","Withdrawal ACH BARCLAYCARD US/TYPE: CREDITCARD ID: 2510407970 CO: BARCLAYCARD US Entry Class Code: WEB","50","","Posted","789"
"4/27/2020","","Withdrawal ACH CAPITAL ONE/TYPE: ONLINE PMT ID: 9279744991 CO: CAPITAL ONE Entry Class Code: WEB","50","","Posted","839"
"4/27/2020","","Withdrawal ACH APPLECARD GSBANK/TYPE: PAYMENT ID: 9999999999 CO: APPLECARD GSBANK Entry Class Code: WEB","50","","Posted","889"
"4/26/2020","","Withdrawal POS #000000437977/LOWE'S #3278 GAINESVILLE FL Card 1140","37.41","","Posted","939"
"4/26/2020","","Withdrawal POS #000000469967/FAST TRACK #200 3960 SW ARCHER RD GAINESVILLE FL Card 1140","28.55","","Posted","976.41"
"4/26/2020","","Withdrawal POS #000000058031/PUBLIX 3930 SW ARCHER ROA GAINESVILLE FL Card 1140","78.61","","Posted","1004.96"
"4/26/2020","","Withdrawal POS #000000259790/LOWE'S #3278 GAINESVILLE FL Card 1140","45.09","","Posted","1083.57"
"4/26/2020","","Withdrawal POS #000000310156/WALGREENS STORE 2415 SW 7 GAINESVILLE FL Card 1140","23.51","","Posted","1128.66"
"4/26/2020","","Withdrawal at ATM #000000006206/CAMPUS 1900 SW 34TH ST GAINESVILLE FL Card 1140","60","","Posted","1152.17"
"4/24/2020","","Deposit ACH STEVEN CHAPLINSK/TYPE: MOBILE DEP CO: STEVEN CHAPLINSK ACH Trace Number: 263178470000023","","1200","Posted","1212.17"
"4/24/2020","","Deposit ACH STEVEN CHAPLINSK/TYPE: MOBILE DEP CO: STEVEN CHAPLINSK ACH Trace Number: 263178470000024","","4.98","Posted","12.17"
"4/22/2020","","Withdrawal POS #000000458124/WALGREENS STORE 2415 SW 7 GAINESVILLE FL Card 1140","7.16","","Posted","7.19"
"4/20/2020","","Withdrawal Debit Card Signature Debit/SANTA FE COLLEGE 352-395-5228 FL Date 04/19/20 0 0110242139 0 8220 Card 1140","23.77","","Posted","14.35"
"4/19/2020","","Withdrawal POS #000000077627/PUBLIX 3930 SW ARCHER ROA GAINESVILLE FL Card 1140","42.44","","Posted","38.12"
"4/19/2020","","Withdrawal at ATM #000000005892/CAMPUS 1900 SW 34TH ST GAINESVILLE FL Card 1140","60","","Posted","80.56"
"4/14/2020","","Withdrawal POS #000000145275/WALGREENS STORE 2415 SW 7 GAINESVILLE FL Card 1140","8.41","","Posted","140.56"
"4/14/2020","","Withdrawal ACH CAPITAL ONE/TYPE: MOBILE PMT ID: 9279744980 CO: CAPITAL ONE Entry Class Code: WEB","25","","Posted","148.97"
"4/14/2020","","Withdrawal ACH BARCLAYCARD US/TYPE: CREDITCARD ID: 2510407970 CO: BARCLAYCARD US Entry Class Code: WEB","25","","Posted","173.97"
"4/13/2020","200","Draft 200","850","","Posted","198.97"
"4/10/2020","","Withdrawal POS #000000053693/PUBLIX 3930 SW ARCHER ROA GAINESVILLE FL Card 1140","112.41","","Posted","1048.97"
"4/10/2020","","Withdrawal ACH COX COMM GAN/TYPE: BANK DRAFT ID: 1581620085 CO: COX COMM GAN Entry Class Code: PPD","220.62","","Posted","1161.38"
"4/8/2020","","Withdrawal Home Banking Transfer/To CAMPUS Q2 PREFUN 3440431 Share 0090 External Transfer Tracking ID:5092308","25","","Posted","1382"
"4/6/2020","","Withdrawal POS #000000072049/PUBLIX 3930 SW ARCHER ROA GAINESVILLE FL Card 1140","37.18","","Posted","1407"
"3/31/2020","","Withdrawal POS #000000889937/CIRCLE K # 26146 GAINESVILLE FL Card 1140","20","","Posted","1444.18"
"3/30/2020","","Withdrawal ACH CITY OF GAINESVI/TYPE: 2000-6637- ID: 5330903620 CO: CITY OF GAINESVI Entry Class Code: PPD","179.59","","Posted","1464.18"
"3/30/2020","","Withdrawal ACH CAPITAL ONE/TYPE: ONLINE PMT ID: 9279744991 CO: CAPITAL ONE Entry Class Code: WEB","75","","Posted","1643.77"
"3/30/2020","","Withdrawal ACH BARCLAYCARD US/TYPE: CREDITCARD ID: 2510407970 CO: BARCLAYCARD US Entry Class Code: WEB","75","","Posted","1718.77"
"3/30/2020","","Withdrawal ACH APPLECARD GSBANK/TYPE: PAYMENT ID: 9999999999 CO: APPLECARD GSBANK Entry Class Code: WEB","70","","Posted","1793.77"
"3/29/2020","","Withdrawal POS #000000104100/PUBLIX 3930 SW ARCHER ROA GAINESVILLE FL Card 1140","165.82","","Posted","1863.77"
"3/28/2020","","Deposit Home Banking Transfer - monthly expenses/From CHAPLINSKI,LEON 3496297 Share 0090","","2000","Posted","2029.59"
"3/27/2020","","Withdrawal at ATM #000000004105/CAMPUS 1900 SW 34TH ST GAINESVILLE FL Card 1140","40","","Posted","29.59"
"3/27/2020","","Deposit Home Banking Transfer trf/From CHAPLINSKI,LEON 3496297 Share 0090","","50","Posted","69.59"
"3/23/2020","","Deposit Home Banking Transfer - From Share 0000/Funds Transfer via Online","","10","Posted","19.59"
"3/21/2020","","Withdrawal POS #000000068262/PUBLIX 3930 SW ARCHER ROA GAINESVILLE FL Card 1140","21.98","","Posted","9.59"
"3/20/2020","","Deposit ACH STEVEN CHAPLINSK/TYPE: MOBILE DEP CO: STEVEN CHAPLINSK ACH Trace Number: 263178470000022","","13.6","Posted","31.57"
"3/20/2020","","Withdrawal POS #000000102982/PUBLIX 3930 SW ARCHER ROA GAINESVILLE FL Card 1140","43","","Posted","17.97"
"3/20/2020","","Withdrawal POS #000000443789/SHELL SERVICE STATION 3901 SW ARCHER RD GAINESVILLE FL Card 1140","2.96","","Posted","60.97"
"3/19/2020","","Withdrawal POS #000000067778/PUBLIX 3930 SW ARCHER ROA GAINESVILLE FL Card 1140","8.56","","Posted","63.93"
"3/18/2020","","Withdrawal POS #000000067229/PUBLIX 3930 SW ARCHER ROA GAINESVILLE FL Card 1140","38.84","","Posted","72.49"
"3/18/2020","","Withdrawal ACH APPLECARD GSBANK/TYPE: PAYMENT ID: 9999999999 CO: APPLECARD GSBANK Entry Class Code: WEB","145.01","","Posted","111.33"
"3/18/2020","","Withdrawal ACH BARCLAYCARD US/TYPE: CREDITCARD ID: 2510407970 CO: BARCLAYCARD US Entry Class Code: WEB","75","","Posted","256.34"
"3/18/2020","","Deposit Home Banking Transfer checking/From CHAPLINSKI,LEON 3496297 Share 0090","","50","Posted","331.34"
"3/18/2020","","Withdrawal Home Banking Transfer - To Share 0000/Funds Transfer via Online","15","","Posted","281.34"
"3/17/2020","","Withdrawal POS #000000014434/PUBLIX 3930 SW ARCHER ROA GAINESVILLE FL Card 1140","50.07","","Posted","296.34"
"3/17/2020","","Withdrawal Debit Card Signature Debit/QUINN EYE CENTER GAINESVILLE FL Date 03/16/20 0 0076666354 1 8042 Card 1140","46.2","","Posted","346.41"
"3/17/2020","","Withdrawal POS #000000305060/WALGREENS STORE 2415 SW 7 GAINESVILLE FL Card 1140","8.2","","Posted","392.61"
"3/16/2020","","Withdrawal POS #000000042897/FAST TRACK #200 3960 SW ARCHER RD GAINESVILLE FL Card 1140","9.63","","Posted","400.81"
"3/16/2020","","Withdrawal POS #000000074536/PUBLIX 3930 SW ARCHER ROA GAINESVILLE FL Card 1140","11.14","","Posted","410.44"
"3/15/2020","","Withdrawal POS #000000086755/PUBLIX 3930 SW ARCHER ROA GAINESVILLE FL Card 1140","42.57","","Posted","421.58"
"3/10/2020","9002","Draft 9002","850","","Posted","464.15"
"3/10/2020","","Withdrawal ACH BARCLAYCARD US/TYPE: CREDITCARD ID: 2510407970 CO: BARCLAYCARD US Entry Class Code: WEB","55","","Posted","1314.15"
"3/10/2020","","Withdrawal POS #000000047058/PUBLIX 3930 SW ARCHER ROA GAINESVILLE FL Card 1140","35.58","","Posted","1369.15"
"3/9/2020","","Withdrawal POS #000000849438/CIRCLE K # 21424 GAINESVILLE FL Card 1140","12.83","","Posted","1404.73"
"3/9/2020","","Withdrawal POS #000000675592/CIRCLE K # 21416 GAINESVILLE FL Card 1140","12.55","","Posted","1417.56"
"3/9/2020","","Deposit","","201","Posted","1430.11"
"3/6/2020","","Withdrawal POS #000000049935/PUBLIX 3100 SW 35TH BLVD GAINESVILLE FL Card 1140","23.12","","Posted","1229.11"
"3/6/2020","","Withdrawal at ATM #000000001048/PUBLIX 3100 S W 35TH BLV GAINESVILLE FL Card 1140","40","","Posted","1252.23"
"3/6/2020","","Withdrawal Debit Card Signature Debit/NINTENDO *AMERICAUS 800-255-3700 WA Date 03/05/20 0 0065438354 5 5816 Card 1140","4.99","","Posted","1292.23"
"3/5/2020","","Withdrawal Debit Card Signature Debit/NINTENDO *AMERICAUS 800-255-3700 WA Date 03/04/20 0 0064424011 5 5816 Card 1140","0.2","","Posted","1297.22"
"3/5/2020","","Withdrawal Debit Card Signature Debit/NINTENDO *AMERICAUS 800-255-3700 WA Date 03/04/20 0 0064421006 5 5816 Card 1140","0.1","","Posted","1297.42"
"3/5/2020","","Withdrawal Debit Card Signature Debit/NINTENDO *AMERICAUS 800-255-3700 WA Date 03/04/20 0 0064420629 5 5816 Card 1140","0.99","","Posted","1297.52"
"3/5/2020","","Withdrawal Debit Card Signature Debit/NINTENDO *AMERICAUS 800-255-3700 WA Date 03/04/20 0 0064420412 5 5816 Card 1140","3.99","","Posted","1298.51"
"3/5/2020","","Withdrawal Debit Card Signature Debit/NINTENDO *AMERICAUS 800-255-3700 WA Date 03/04/20 0 0064419245 5 5816 Card 1140","0.05","","Posted","1302.5"
"3/4/2020","","Withdrawal ACH APPLECARD GSBANK/TYPE: PAYMENT ID: 9999999999 CO: APPLECARD GSBANK Entry Class Code: WEB","70","","Posted","1302.55"
"3/4/2020","","Withdrawal POS #000000606847/WM SUPERCENTER # Wal-Mart Super Cen GAINESVILLE FL Card 1140","13.84","","Posted","1372.55"
"3/4/2020","","Withdrawal POS #000045757032/Wal-Mart Super Center 0538 WAL-SAMS GAINESVILLE FL Card 1140","7.37","","Posted","1386.39"
"3/2/2020","","Withdrawal ACH CITY OF GAINESVI/TYPE: 2000-6637- ID: 5330903620 CO: CITY OF GAINESVI Entry Class Code: PPD","166.52","","Posted","1393.76"
"3/2/2020","","Withdrawal ACH BARCLAYCARD US/TYPE: CREDITCARD ID: 2510407970 CO: BARCLAYCARD US Entry Class Code: WEB","100","","Posted","1560.28"
"3/2/2020","","Withdrawal ACH COX COMM GAN/TYPE: BANK DRAFT ID: 1581620085 CO: COX COMM GAN Entry Class Code: WEB","70.75","","Posted","1660.28"
"3/2/2020","","Withdrawal ATM Fee/GAINESVILLE OFFICE GAINESVILLE FL Card 1140","2","","Posted","1731.03"
"3/2/2020","","Withdrawal at ATM #000000048468/GAINESVILLE OFFICE GAINESVILLE FL Card 1140","83.5","","Posted","1733.03"
"2/29/2020","","Withdrawal Paper Statement","3","","Posted","1816.53"
"2/29/2020","","Withdrawal POS #000000062005/PUBLIX 3930 SW ARCHER ROA GAINESVILLE FL Card 1140","54.53","","Posted","1819.53"
"2/29/2020","","Deposit","","1875","Posted","1874.06"
"2/29/2020","","Withdrawal POS #000000464148/WALGREENS STORE 2415 SW 7 GAINESVILLE FL Card 1140","24.42","","Posted","-0.94"
"2/29/2020","","Withdrawal Transfer fee","8","","Posted","23.48"
"2/29/2020","","Deposit Transfer From Share 0000","","15","Posted","31.48"
"2/26/2020","","Withdrawal POS #000000061033/PUBLIX 3930 SW ARCHER ROA GAINESVILLE FL Card 1140","9.72","","Posted","16.48"
"2/25/2020","","Withdrawal POS #000000060748/WALGREENS STORE 2415 SW 7 GAINESVILLE FL Card 1140","7.16","","Posted","26.2"
"2/24/2020","","Withdrawal POS #000000035648/PUBLIX 3930 SW ARCHER ROA GAINESVILLE FL Card 1140","35.82","","Posted","33.36"
"2/21/2020","","Withdrawal POS #000000044670/PUBLIX 3930 SW ARCHER ROA GAINESVILLE FL Card 1140","23.04","","Posted","69.18"
"2/20/2020","","Withdrawal POS #000000035137/PUBLIX 3930 SW ARCHER ROA GAINESVILLE FL Card 1140","32.89","","Posted","92.22"
"2/18/2020","","Withdrawal POS #000000136480/WALGREENS STORE 2415 SW 7 GAINESVILLE FL Card 1140","10.49","","Posted","125.11"
"2/18/2020","","Withdrawal POS #000000025042/PUBLIX 3930 SW ARCHER ROA GAINESVILLE FL Card 1140","45.39","","Posted","135.6"
"2/13/2020","","Withdrawal POS #000000073698/PUBLIX 3930 SW ARCHER ROA GAINESVILLE FL Card 1140","45.01","","Posted","180.99"
"2/11/2020","","Withdrawal Home Banking Transfer - To Share 0000/Funds Transfer via Online","15","","Posted","226"
"2/10/2020","","Withdrawal Starter Checks","3","","Posted","241"
"2/10/2020","","Deposit by Check/Check Received 200.00","","200","Posted","244"
"1/31/2020","","Withdrawal Paper Statement","3","","Posted","44"
"12/31/2019","","Withdrawal Paper Statement","3","","Posted","47"
"12/11/2019","","Deposit ACH CAMPUS USA CREDI/TYPE: ONLINEACCT ID: 590637646 CO: CAMPUS USA CREDI Entry Class Code: PPD","","50","Posted","50"