Post Date,Check,Description,Debit,Credit,Status,Balance,date,amount,vendor_group,amount_grouped
6/6/2025,,"Recurring Withdrawal Debit Card - MC Debit Gator/SUPERPOWER CHATGPT MIDDLETOWN DE

Date 06/05/25 0 5156229550 1 5734

Card 1247",15.0,,Posted,847.61,2025-06-06,15.0,"Recurring Withdrawal Debit Card - MC Debit Gator/SUPERPOWER CHATGPT MIDDLETOWN DE

Date 06/05/25 0 5156229550 1 5734

Card 1247",15.0
6/6/2025,,"Recurring Withdrawal Debit Card - MC Debit Gator/SUPERPOWER CHATGPT MIDDLETOWN DE

Date 06/05/25 0 5156229549 1 5734

Card 1247",15.0,,Posted,862.61,2025-06-06,15.0,"Recurring Withdrawal Debit Card - MC Debit Gator/SUPERPOWER CHATGPT MIDDLETOWN DE

Date 06/05/25 0 5156229550 1 5734

Card 1247",15.0
6/6/2025,,"Withdrawal Debit Card MC Debit Gator/IONOS INC. CHESTERBROOK PA

Date 06/05/25 0 5156041339 1 4816

Card 1247",60.0,,Posted,877.61,2025-06-06,60.0,"Withdrawal Debit Card MC Debit Gator/IONOS INC. CHESTERBROOK PA

Date 06/05/25 0 5156041339 1 4816

Card 1247",60.0
6/5/2025,,"Recurring Withdrawal Debit Card - MC Debit Gator/OPENAI *CHATGPT SUBSCR SAN FRANCISC CA

Date 06/04/25 0 5155335474 0 5734

Card 1247",20.0,,Posted,937.61,2025-06-05,20.0,"Recurring Withdrawal Debit Card - MC Debit Gator/OPENAI *CHATGPT SUBSCR SAN FRANCISC CA

Date 06/04/25 0 5155335474 0 5734

Card 1247",20.0
6/4/2025,,"Recurring Withdrawal Debit Card - MC Debit Gator/APPLE.COM/BILL 866-712-7753 CA

Date 06/03/25 0 5154093226 1 5818

Card 1247",6.98,,Posted,957.61,2025-06-04,6.98,"Recurring Withdrawal Debit Card - MC Debit Gator/APPLE.COM/BILL 866-712-7753 CA

Date 06/03/25 0 5154093226 1 5818

Card 1247",6.98
6/4/2025,,"Withdrawal Bill Payment #000000229775/ADOBE INC ADOBE ADOBE.COM SAN JOSE CA

Card 1247",19.99,,Posted,964.59,2025-06-04,19.99,"Withdrawal Bill Payment #000000229775/ADOBE INC ADOBE ADOBE.COM SAN JOSE CA

Card 1247",19.99
6/4/2025,,"Withdrawal POS #000000580851/SUNOCO 8002212501 4234 SW 20TH AVE

GAINESVILLE FL

Card 1247",26.86,,Posted,984.58,2025-06-04,26.86,"Withdrawal POS #000000580851/SUNOCO 8002212501 4234 SW 20TH AVE

GAINESVILLE FL

Card 1247",26.86
6/3/2025,,"Recurring Withdrawal Debit Card - MC Debit Gator/OPENAI SAN FRANCISC CA

Date 06/02/25 0 5153238318 1 5734

Card 1247",6.06,,Posted,1011.44,2025-06-03,6.06,Recurring Withdrawal Debit Card - MC Debit Gator/OPENAI SAN FRANCISC CADate 03/08/25 0 5067339145 0 5734Card 1247,6.29875
6/3/2025,,"Recurring Withdrawal Debit Card - MC Debit Gator/NOTION LABS, INC. SAN FRANCISC CA

Date 06/02/25 0 5153210973 1 7372

Card 1247",22.0,,Posted,1017.5,2025-06-03,22.0,"Recurring Withdrawal Debit Card - MC Debit Gator/NOTION LABS, INC. SAN FRANCISC CA

Date 06/02/25 0 5153210973 1 7372

Card 1247",22.0
6/3/2025,,"Recurring Withdrawal Debit Card - MC Debit Gator/OPENAI SAN FRANCISC CA

Date 06/02/25 0 5153210920 1 5734

Card 1247",6.06,,Posted,1039.5,2025-06-03,6.06,"Recurring Withdrawal Debit Card - MC Debit Gator/OPENAI SAN FRANCISC CA

Date 05/31/25 0 5151282040 2 5734

Card 1247",6.346666666666667
6/3/2025,,"Recurring Withdrawal Debit Card - MC Debit Gator/APPLE.COM/BILL 866-712-7753 CA

Date 06/03/25 0 5154230337 1 5818

Card 1247",2.99,,Posted,1045.56,2025-06-03,2.99,"Recurring Withdrawal Debit Card - MC Debit Gator/APPLE.COM/BILL 866-712-7753 CA

Date 06/03/25 0 5154093226 1 5818

Card 1247",2.99
6/3/2025,,"Withdrawal Bill Payment #000000197457/ADOBE INC ADOBE ADOBE.COM SAN JOSE CA

Card 1247",19.99,,Posted,1048.55,2025-06-03,19.99,"Withdrawal Bill Payment #000000229775/ADOBE INC ADOBE ADOBE.COM SAN JOSE CA

Card 1247",19.99
6/3/2025,,"Recurring Withdrawal Bill Payment - #000000000059/ADOBE INC CS ADDTL STORAG ADOBE.COM SAN

JOSE CA

Card 1247",9.99,,Posted,1068.54,2025-06-03,9.99,"Recurring Withdrawal Bill Payment - #000000000059/ADOBE INC CS ADDTL STORAG ADOBE.COM SAN

JOSE CA

Card 1247",9.99
6/3/2025,,"Recurring Withdrawal Bill Payment - #000000362823/ADOBE INC ADOBE ADOBE.COM SAN JOSE CA

Card 1247",19.99,,Posted,1078.53,2025-06-03,19.99,"Recurring Withdrawal Bill Payment - #000000000059/ADOBE INC CS ADDTL STORAG ADOBE.COM SAN

JOSE CA

Card 1247",19.99
6/2/2025,,"Withdrawal POS #000000572320/SUNOCO 8002212501 4234 SW 20TH AVE

GAINESVILLE FL

Card 1247",22.17,,Posted,1098.52,2025-06-02,22.17,"Withdrawal POS #000000666979/SUNOCO 8002212501 4234 SW 20TH AVE

GAINESVILLE FL

Card 1247",22.005000000000003
6/2/2025,,"Recurring Withdrawal Debit Card - MC Debit Gator/MYDESIGNS - PRO - MON LAS VEGAS NV

Date 06/01/25 0 5152146505 1 5734

Card 1247",49.99,,Posted,1120.69,2025-06-02,49.99,"Recurring Withdrawal Debit Card - MC Debit Gator/MYDESIGNS - PRO - MON LAS VEGAS NV

Date 06/01/25 0 5152146505 1 5734

Card 1247",49.99
6/2/2025,,"Recurring Withdrawal Debit Card - MC Debit Gator/OPENAI SAN FRANCISC CA

Date 06/02/25 0 5153117531 1 5734

Card 1247",6.04,,Posted,1170.68,2025-06-02,6.04,Recurring Withdrawal Debit Card - MC Debit Gator/OPENAI SAN FRANCISC CADate 03/08/25 0 5067339145 0 5734Card 1247,6.29875
6/2/2025,,"Recurring Withdrawal Debit Card - MC Debit Gator/OPENAI SAN FRANCISC CA

Date 05/31/25 0 5151282040 2 5734

Card 1247",6.27,,Posted,1176.72,2025-06-02,6.27,"Recurring Withdrawal Debit Card - MC Debit Gator/OPENAI SAN FRANCISC CA

Date 05/31/25 0 5151282040 2 5734

Card 1247",6.346666666666667
6/2/2025,,"Recurring Withdrawal Debit Card - MC Debit Gator/OPENAI SAN FRANCISC CA

Date 06/01/25 0 5152295185 0 5734

Card 1247",6.24,,Posted,1182.99,2025-06-02,6.24,Recurring Withdrawal Debit Card - MC Debit Gator/OPENAI SAN FRANCISC CADate 03/08/25 0 5067339145 0 5734Card 1247,6.29875
6/2/2025,,"Recurring Withdrawal Debit Card - MC Debit Gator/OPENAI SAN FRANCISC CA

Date 05/31/25 0 5151556312 2 5734

Card 1247",6.22,,Posted,1189.23,2025-06-02,6.22,"Withdrawal Debit Card MC Debit Gator/VIDIQ SAN FRANCISC CA

Date 05/31/25 0 5151573162 0 5734

Card 1247",6.22
6/2/2025,,"Recurring Withdrawal Debit Card - MC Debit Gator/PARAMOUNT+ WEST HOLLYWO CA

Date 06/01/25 0 5152328615 1 4899

Card 1247",14.96,,Posted,1195.45,2025-06-02,14.96,"Recurring Withdrawal Debit Card - MC Debit Gator/PARAMOUNT+ WEST HOLLYWO CA

Date 06/01/25 0 5152328615 1 4899

Card 1247",14.96
6/2/2025,,"Recurring Withdrawal Debit Card - MC Debit Gator/PADDLE.NET* SETAPP NEW YORK NY

Date 05/31/25 0 5151555568 2 5817

Card 1247",9.99,,Posted,1210.41,2025-06-02,9.99,"Recurring Withdrawal Debit Card - MC Debit Gator/PADDLE.NET* SETAPP NEW YORK NY

Date 05/31/25 0 5151555568 2 5817

Card 1247",9.99
6/2/2025,,"Withdrawal Debit Card MC Debit Gator/INVIDEO INC COUNTRY OF S DE

Date 06/01/25 0 5152143829 1 5734

Card 1247",33.04,,Posted,1220.4,2025-06-02,33.04,"Withdrawal Debit Card MC Debit Gator/INVIDEO INC COUNTRY OF S DE

Date 06/01/25 0 5152143829 1 5734

Card 1247",33.04
6/2/2025,,"Withdrawal Debit Card MC Debit Gator/VIDIQ SAN FRANCISC CA

Date 05/31/25 0 5151573162 0 5734

Card 1247",19.0,,Posted,1253.44,2025-06-02,19.0,"Withdrawal Debit Card MC Debit Gator/VIDIQ SAN FRANCISC CA

Date 05/31/25 0 5151573162 0 5734

Card 1247",19.0
6/2/2025,,"Withdrawal Debit Card MC Debit Gator/INVIDEO INC COUNTRY OF S DE

Date 05/31/25 0 5151554623 2 5734

Card 1247",25.0,,Posted,1272.44,2025-06-02,25.0,"Withdrawal Debit Card MC Debit Gator/INVIDEO INC COUNTRY OF S DE

Date 06/01/25 0 5152143829 1 5734

Card 1247",25.0
6/2/2025,,"Withdrawal Debit Card MC Debit Gator/INSTACART*159 SAN FRANCISC CA

Date 05/31/25 0 5151554560 2 5411

Card 1247",3.0,,Posted,1297.44,2025-06-02,3.0,"Withdrawal Debit Card MC Debit Gator/INSTACART*159 SAN FRANCISC CA

Date 05/31/25 0 5151554560 2 5411

Card 1247",3.0
6/2/2025,,"Withdrawal Debit Card MC Debit Gator/INSTACART*159 SAN FRANCISC CA

Date 05/31/25 0 5151554551 2 5411

Card 1247",39.76,,Posted,1300.44,2025-06-02,39.76,"Withdrawal Debit Card MC Debit Gator/INSTACART*159 SAN FRANCISC CA

Date 05/31/25 0 5151554560 2 5411

Card 1247",39.76
6/2/2025,,"Recurring Withdrawal Debit Card Fee/MASTERCARD ISSUER CROSS-BORDER FEE

Date 06/01/25 0 5152326251 1 5734

Card 1247",0.1,,Posted,1340.2,2025-06-02,0.1,"Recurring Withdrawal Debit Card Fee/MASTERCARD ISSUER CROSS-BORDER FEE

Date 06/01/25 0 5152326251 1 5734

Card 1247",0.065
6/2/2025,,"Recurring Withdrawal Debit Card - MC Debit Gator/LEONARDO.AI NORTH SYDNEY NS

Date 06/01/25 0 5152326251 1 5734

Card 1247",12.0,,Posted,1340.3,2025-06-02,12.0,"Recurring Withdrawal Debit Card - MC Debit Gator/LEONARDO.AI NORTH SYDNEY NS

Date 06/01/25 0 5152326251 1 5734

Card 1247",12.0
6/2/2025,,"Recurring Withdrawal Debit Card Fee/MASTERCARD ISSUER CROSS-BORDER FEE

Date 05/31/25 0 5151375863 2 5817

Card 1247",0.08,,Posted,1352.3,2025-06-02,0.08,"Withdrawal Debit Card Fee/MASTERCARD ISSUER CROSS-BORDER FEE

Date 03/31/25 0 5090929332 0 5817

Card 1247",0.11399999999999999
6/2/2025,,"Recurring Withdrawal Debit Card - MC Debit Gator/OBSIDIAN.MD OAKVILLE ON

Date 05/31/25 0 5151375863 2 5817

Card 1247",10.0,,Posted,1352.38,2025-06-02,10.0,"Recurring Withdrawal Debit Card - MC Debit Gator/OBSIDIAN.MD OAKVILLE ON

Date 05/31/25 0 5151375863 2 5817

Card 1247",10.0
6/2/2025,,"Withdrawal Debit Card Fee/MASTERCARD ISSUER CROSS-BORDER FEE

Date 05/31/25 0 5151554310 2 5734

Card 1247",0.16,,Posted,1362.38,2025-06-02,0.16,"Withdrawal Debit Card Fee/MASTERCARD ISSUER CROSS-BORDER FEE

Date 03/31/25 0 5090929332 0 5817

Card 1247",0.11399999999999999
6/2/2025,,"Withdrawal Debit Card MC Debit Gator/IDEOGRAM AI TORONTO ON

Date 05/31/25 0 5151554310 2 5734

Card 1247",20.0,,Posted,1362.54,2025-06-02,20.0,"Withdrawal Debit Card MC Debit Gator/IDEOGRAM AI TORONTO ON

Date 05/31/25 0 5151554310 2 5734

Card 1247",20.0
6/2/2025,,"Recurring Withdrawal Debit Card Fee/MASTERCARD ISSUER CROSS-BORDER FEE

Date 05/31/25 0 5151554309 2 5734

Card 1247",0.03,,Posted,1382.54,2025-06-02,0.03,"Recurring Withdrawal Debit Card Fee/MASTERCARD ISSUER CROSS-BORDER FEE

Date 06/01/25 0 5152326251 1 5734

Card 1247",0.065
6/2/2025,,"Recurring Withdrawal Debit Card - MC Debit Gator/IDEOGRAM AI TORONTO ON

Date 05/31/25 0 5151554309 2 5734

Card 1247",3.2,,Posted,1382.57,2025-06-02,3.2,"Recurring Withdrawal Debit Card - MC Debit Gator/IDEOGRAM AI TORONTO ON

Date 04/08/25 0 5098321266 0 5734

Card 1247",3.2
6/2/2025,,"Withdrawal ACH Watson Realty Co/TYPE: WEB PMTS ID: 9000321157

CO: Watson Realty Co

NAME: Steven chaplinskiEntry Class Code: WEB",1179.0,,Posted,1385.77,2025-06-02,1179.0,"Withdrawal ACH Watson Realty Co/TYPE: WEB PMTS ID: 9000321157

CO: Watson Realty Co

NAME: Steven chaplinskiEntry Class Code: WEB",1179.0
6/2/2025,,"Withdrawal ACH AppFolio, Inc. F/TYPE: WEB PMTS ID: 9001406550

CO: AppFolio, Inc. F

NAME: Steven chaplinskiEntry Class Code: WEB",2.49,,Posted,2564.77,2025-06-02,2.49,"Withdrawal ACH AppFolio, Inc. F/TYPE: WEB PMTS ID: 9001406550

CO: AppFolio, Inc. F

NAME: Steven chaplinskiEntry Class Code: WEB",2.49
6/1/2025,,"Withdrawal POS #000000000002/ETSY.COM*US ETSY.COM*AIAV WWW.ETSY.COM/

BROOKLYN NY

Card 1247",0.6,,Posted,2567.26,2025-06-01,0.6,"Withdrawal POS #000000000002/ETSY.COM*US ETSY.COM*AIAV WWW.ETSY.COM/

BROOKLYN NY

Card 1247",0.6
6/1/2025,,"Withdrawal POS #000020312090/GOOGLE *YouTubePremium 1600 Amphitheatre

Parkw Mountain View CA

Card 1247",15.92,,Posted,2567.86,2025-06-01,15.92,"Withdrawal POS #000020312090/GOOGLE *YouTubePremium 1600 Amphitheatre

Parkw Mountain View CA

Card 1247",15.92
5/31/2025,,"Recurring Withdrawal Debit Card - MC Debit Gator/OPENAI SAN FRANCISC CA

Date 05/31/25 0 5151240922 1 5734

Card 1247",6.71,,Posted,2583.78,2025-05-31,6.71,"Recurring Withdrawal Debit Card - MC Debit Gator/OPENAI SAN FRANCISC CA

Date 05/31/25 0 5151282040 2 5734

Card 1247",6.346666666666667
5/31/2025,,"Recurring Withdrawal Debit Card - MC Debit Gator/OPENAI SAN FRANCISC CA

Date 05/30/25 0 5150240921 1 5734

Card 1247",6.63,,Posted,2590.49,2025-05-31,6.63,Recurring Withdrawal Debit Card - MC Debit Gator/OPENAI SAN FRANCISC CADate 03/08/25 0 5067339145 0 5734Card 1247,6.29875
5/31/2025,,"Recurring Withdrawal Debit Card - MC Debit Gator/OPENAI SAN FRANCISC CA

Date 05/30/25 0 5150059225 1 5734

Card 1247",6.24,,Posted,2597.12,2025-05-31,6.24,Recurring Withdrawal Debit Card - MC Debit Gator/OPENAI SAN FRANCISC CADate 03/08/25 0 5067339145 0 5734Card 1247,6.29875
5/31/2025,,"Withdrawal Debit Card MC Debit Gator/WALGREENS #9304 GAINESVILLE FL

Date 05/30/25 0 5150232309 1 5912

Card 1247",23.78,,Posted,2603.36,2025-05-31,23.78,"Withdrawal Debit Card MC Debit Gator/WALGREENS #9304 GAINESVILLE FL

Date 05/30/25 0 5150232309 1 5912

Card 1247",23.78
5/31/2025,,"Withdrawal Debit Card MC Debit Gator/WALGREENS #5024 GAINESVILLE FL

Date 05/30/25 0 5150232278 1 5912

Card 1247",15.0,,Posted,2627.14,2025-05-31,15.0,"Withdrawal Debit Card MC Debit Gator/WALGREENS #9304 GAINESVILLE FL

Date 05/30/25 0 5150232309 1 5912

Card 1247",15.0
5/31/2025,,"Withdrawal POS #000000256943/AMAZON.COM*NN6201DU0 SEATTLE WA

Card 1247",30.34,,Posted,2642.14,2025-05-31,30.34,"Withdrawal POS #000000256943/AMAZON.COM*NN6201DU0 SEATTLE WA

Card 1247",30.34
5/30/2025,,"Withdrawal POS #000000347331/SUNOCO 8002212501 4234 SW 20TH AVE

GAINESVILLE FL

Card 1247",39.5,,Posted,2672.48,2025-05-30,39.5,"Withdrawal POS #000000666979/SUNOCO 8002212501 4234 SW 20TH AVE

GAINESVILLE FL

Card 1247",39.5
5/30/2025,,"Withdrawal ATM Fee/EFT 6419 W Newberry Rd Gainesville FL

Card 1247",2.0,,Posted,2711.98,2025-05-30,2.0,"Withdrawal ATM Fee/EFT 6419 W Newberry Rd Gainesville FL

Card 1247",2.0
5/30/2025,,"Withdrawal at ATM #000000785755/EFT 6419 W Newberry Rd Gainesville FL

Card 1247",128.0,,Posted,2713.98,2025-05-30,128.0,"Withdrawal at ATM #000000785755/EFT 6419 W Newberry Rd Gainesville FL

Card 1247",128.0
5/30/2025,,Withdrawal CourtesyFeeDebit,35.0,,Posted,-158.02,2025-05-30,35.0,Withdrawal CourtesyFeeDebit,35.0
5/30/2025,,"Recurring Withdrawal Debit Card - MC Debit Gator/SUPERPOWER CHATGPT MIDDLETOWN DE

Date 05/29/25 0 5149990977 0 5734

Card 1247",15.0,,Posted,-123.02,2025-05-30,15.0,"Recurring Withdrawal Debit Card - MC Debit Gator/SUPERPOWER CHATGPT MIDDLETOWN DE

Date 06/05/25 0 5156229550 1 5734

Card 1247",15.0
5/28/2025,,Withdrawal CourtesyFeeDebit,35.0,,Posted,-108.02,2025-05-28,35.0,Withdrawal CourtesyFeeDebit,35.0
5/28/2025,,"Recurring Withdrawal Debit Card - MC Debit Gator/IC* INSTACART*SUBSCRIP SAN FRANCISC CA

Date 05/27/25 0 5147989663 0 5411

Card 1247",9.99,,Posted,-73.02,2025-05-28,9.99,"Recurring Withdrawal Debit Card - MC Debit Gator/IC* INSTACART*SUBSCRIP SAN FRANCISC CA

Date 05/27/25 0 5147989663 0 5411

Card 1247",9.99
5/26/2025,,Withdrawal CourtesyFeeDebit,35.0,,Posted,-63.03,2025-05-26,35.0,Withdrawal CourtesyFeeDebit,35.0
5/26/2025,,"Withdrawal POS #000000216148/SUNOCO 8002212501 4234 SW 20TH AVE

GAINESVILLE FL

Card 1247",20.76,,Posted,-28.03,2025-05-26,20.76,"Withdrawal POS #000000666979/SUNOCO 8002212501 4234 SW 20TH AVE

GAINESVILLE FL

Card 1247",20.76
5/26/2025,,"Withdrawal Debit Card MC Debit Gator/CIRCLE K # 26146 GAINESVILLE FL

Date 05/24/25 0 5144137268 1 5499

Card 1247",7.72,,Posted,-7.27,2025-05-26,7.72,"Withdrawal Debit Card MC Debit Gator/CIRCLE K # 26146 GAINESVILLE FL

Date 05/24/25 0 5144137268 1 5499

Card 1247",7.72
5/26/2025,,"Withdrawal Debit Card MC Debit Gator/CIRCLE K # 06782 GAINESVILLE FL

Date 05/24/25 0 5144137005 1 5499

Card 1247",19.54,,Posted,0.45,2025-05-26,19.54,Withdrawal Debit Card MC Debit Gator/CIRCLE K # 06782 GAINESVILLE FLDate 01/31/25 0 5031331003 1 5499Card 1247,19.54
5/25/2025,,"Recurring Withdrawal Debit Card - MC Debit Gator/NETFLIX.COM LOS GATOS CA

Date 05/23/25 0 5143471019 2 4899

Card 1247",20.71,,Posted,19.99,2025-05-25,20.71,"Recurring Withdrawal Debit Card - MC Debit Gator/NETFLIX.COM LOS GATOS CA

Date 05/23/25 0 5143471019 2 4899

Card 1247",20.71
5/25/2025,,"Withdrawal POS #000000133422/SUNOCO 8002212501 4234 SW 20TH AVE

GAINESVILLE FL

Card 1247",20.76,,Posted,40.7,2025-05-25,20.76,"Withdrawal POS #000000216148/SUNOCO 8002212501 4234 SW 20TH AVE

GAINESVILLE FL

Card 1247",20.33
5/24/2025,,"Withdrawal ATM Fee/EFT 6419 W Newberry Rd Gainesville FL

Card 1247",2.0,,Posted,61.46,2025-05-24,2.0,"Withdrawal ATM Fee/EFT 6419 W Newberry Rd Gainesville FL

Card 1247",2.0
5/24/2025,,"Withdrawal at ATM #000000478783/EFT 6419 W Newberry Rd Gainesville FL

Card 1247",63.0,,Posted,63.46,2025-05-24,63.0,"Withdrawal at ATM #000000785755/EFT 6419 W Newberry Rd Gainesville FL

Card 1247",63.0
5/21/2025,,"Withdrawal POS #000000059286/SUNOCO 8002212501 4234 SW 20TH AVE

GAINESVILLE FL

Card 1247",16.79,,Posted,1.46,2025-05-21,16.79,"Withdrawal POS #000000666979/SUNOCO 8002212501 4234 SW 20TH AVE

GAINESVILLE FL

Card 1247",16.79
5/21/2025,,"Withdrawal Debit Card MC Debit Gator/INSTACART*159 SAN FRANCISC CA

Date 05/20/25 0 5140325944 0 5411

Card 1247",62.0,,Posted,-81.75,2025-05-21,62.0,"Withdrawal Debit Card MC Debit Gator/INSTACART*159 SAN FRANCISC CA

Date 03/22/25 0 5081791779 0 5411

Card 1247",62.0
5/21/2025,,"Recurring Withdrawal Debit Card - MC Debit Gator/CANVA* I04522-50593645 CAMDEN DE

Date 05/20/25 0 5140963894 0 7333

Card 1247",12.99,,Posted,-19.75,2025-05-21,12.99,"Recurring Withdrawal Debit Card - MC Debit Gator/CANVA* I04522-50593645 CAMDEN DE

Date 05/20/25 0 5140963894 0 7333

Card 1247",12.99
5/21/2025,,"Withdrawal Debit Card MC Debit Gator/CIRCLE K # 06782 GAINESVILLE FL

Date 05/19/25 0 5139975993 0 5499

Card 1247",19.54,,Posted,-6.76,2025-05-21,19.54,Withdrawal Debit Card MC Debit Gator/CIRCLE K # 06782 GAINESVILLE FLDate 01/31/25 0 5031331003 1 5499Card 1247,19.54
5/20/2025,,Withdrawal ATM Transaction,20.0,,Posted,12.78,2025-05-20,20.0,Withdrawal ATM Transaction,20.0
5/20/2025,,"Withdrawal Debit Card MC Debit Gator/SUNOCO 8002212501 QPS GAINESVILLE FL

Date 05/19/25 0 5139082313 1 5541

Card 1247",22.17,,Posted,32.78,2025-05-20,22.17,"Withdrawal Debit Card MC Debit Gator/SUNOCO 8002212501 QPS GAINESVILLE FL

Date 05/19/25 0 5139082313 1 5541

Card 1247",22.005000000000003
5/19/2025,,"Withdrawal Debit Card MC Debit Gator/INSTACART*159 SAN FRANCISC CA

Date 05/18/25 0 5138957555 0 5411

Card 1247",45.67,,Posted,54.95,2025-05-19,45.67,"Withdrawal Debit Card MC Debit Gator/INSTACART*159 SAN FRANCISC CA

Date 03/22/25 0 5081791779 0 5411

Card 1247",45.67
5/19/2025,,"Withdrawal Debit Card MC Debit Gator/SUNOCO 8002212501 QPS GAINESVILLE FL

Date 05/18/25 0 5138961883 0 5541

Card 1247",20.76,,Posted,100.62,2025-05-19,20.76,"Withdrawal Debit Card MC Debit Gator/SUNOCO 8002212501 QPS GAINESVILLE FL

Date 05/19/25 0 5139082313 1 5541

Card 1247",20.545
5/19/2025,,"Withdrawal ACH FLUENT-Gainesvil/TYPE: PAYMENT ID: 1371804719

CO: FLUENT-Gainesvil

NAME: steven chaplinskiEntry Class Code: WEB",55.0,,Posted,121.38,2025-05-19,55.0,"Withdrawal ACH FLUENT-Gainesvil/TYPE: PAYMENT ID: 1371804719

CO: FLUENT-Gainesvil

NAME: steven chaplinskiEntry Class Code: WEB",55.0
5/18/2025,,"Withdrawal Debit Card MC Debit Gator/UBER *TRIP 8005928996 CA

Date 05/17/25 0 5137425800 0 4121

Card 1247",12.93,,Posted,176.38,2025-05-18,12.93,"Withdrawal Debit Card MC Debit Gator/UBER *TRIP 8005928996 CA

Date 05/17/25 0 5137425800 0 4121

Card 1247",12.93
5/18/2025,,"Withdrawal Debit Card MC Debit Gator/UBER TRIP* TRIP SAN FRANCISC CA

Date 05/17/25 0 5137032195 1 4121

Card 1247",7.84,,Posted,189.31,2025-05-18,7.84,"Withdrawal Debit Card MC Debit Gator/UBER TRIP* TRIP SAN FRANCISC CA

Date 05/17/25 0 5137032195 1 4121

Card 1247",7.84
5/18/2025,,"Withdrawal Debit Card MC Debit Gator/SUNOCO 8002212501 QPS GAINESVILLE FL

Date 05/17/25 0 5137923930 0 5541

Card 1247",20.33,,Posted,197.15,2025-05-18,20.33,"Withdrawal Debit Card MC Debit Gator/SUNOCO 8002212501 QPS GAINESVILLE FL

Date 05/19/25 0 5139082313 1 5541

Card 1247",20.545
5/18/2025,,"Withdrawal Debit Card MC Debit Gator/SUNOCO 8002212501 QPS GAINESVILLE FL

Date 05/17/25 0 5137923929 0 5541

Card 1247",17.28,,Posted,217.48,2025-05-18,17.28,"Withdrawal Debit Card MC Debit Gator/SUNOCO 8002212501 QPS GAINESVILLE FL

Date 05/19/25 0 5139082313 1 5541

Card 1247",17.28
5/18/2025,,"Recurring Withdrawal Debit Card - MC Debit Gator/CHIPOTLE ONLINE CHIPOTLE.COM CA

Date 05/17/25 0 5137923085 0 5814

Card 1247",20.0,,Posted,234.76,2025-05-18,20.0,"Recurring Withdrawal Debit Card - MC Debit Gator/CHIPOTLE ONLINE CHIPOTLE.COM CA

Date 05/17/25 0 5137923085 0 5814

Card 1247",20.0
5/18/2025,,"Recurring Withdrawal Debit Card - MC Debit Gator/AMAZON PRIME*NZ72M6V92 AMZN.COM/BIL WA

Date 05/17/25 0 5137026065 1 5968

Card 1247",15.13,,Posted,254.76,2025-05-18,15.13,"Recurring Withdrawal Debit Card - MC Debit Gator/AMAZON PRIME*NZ72M6V92 AMZN.COM/BIL WA

Date 05/17/25 0 5137026065 1 5968

Card 1247",15.13
5/16/2025,,"Withdrawal Debit Card MC Debit Gator/UBER *TRIP 8005928996 CA

Date 05/15/25 0 5135067572 1 4121

Card 1247",18.97,,Posted,269.89,2025-05-16,18.97,"Withdrawal Debit Card MC Debit Gator/UBER *TRIP 8005928996 CA

Date 05/17/25 0 5137425800 0 4121

Card 1247",18.97
5/16/2025,,"Withdrawal Debit Card MC Debit Gator/SUNOCO 8002212501 QPS GAINESVILLE FL

Date 05/15/25 0 5135215071 1 5541

Card 1247",34.99,,Posted,288.86,2025-05-16,34.99,"Withdrawal Debit Card MC Debit Gator/SUNOCO 8002212501 QPS GAINESVILLE FL

Date 05/19/25 0 5139082313 1 5541

Card 1247",34.99
5/16/2025,,"Withdrawal ACH FLUENT-Gainesvil/TYPE: PAYMENT ID: 1371804719

CO: FLUENT-Gainesvil

NAME: steven chaplinskiEntry Class Code: WEB",25.0,,Posted,323.85,2025-05-16,25.0,"Withdrawal ACH FLUENT-Gainesvil/TYPE: PAYMENT ID: 1371804719

CO: FLUENT-Gainesvil

NAME: steven chaplinskiEntry Class Code: WEB",25.0
5/15/2025,,"Withdrawal Debit Card MC Debit Gator/INSTACART*159 SAN FRANCISC CA

Date 05/14/25 0 5134998729 0 5411

Card 1247",3.41,,Posted,348.85,2025-05-15,3.41,Withdrawal Debit Card MC Debit Gator/INSTACART*159 SAN FRANCISC CADate 03/13/25 0 5072883709 0 5411Card 1247,3.75
5/15/2025,,"Withdrawal Debit Card MC Debit Gator/INSTACART*159 SAN FRANCISC CA

Date 05/14/25 0 5134998723 0 5411

Card 1247",55.08,,Posted,352.26,2025-05-15,55.08,"Withdrawal Debit Card MC Debit Gator/INSTACART*159 SAN FRANCISC CA

Date 03/22/25 0 5081791779 0 5411

Card 1247",55.04
5/15/2025,,"Withdrawal Debit Card MC Debit Gator/SUNOCO 8002212501 QPS GAINESVILLE FL

Date 05/14/25 0 5134204005 1 5541

Card 1247",24.19,,Posted,407.34,2025-05-15,24.19,"Withdrawal Debit Card MC Debit Gator/SUNOCO 8002212501 QPS GAINESVILLE FL

Date 05/19/25 0 5139082313 1 5541

Card 1247",24.19
5/14/2025,,"Withdrawal Debit Card MC Debit Gator/SUNOCO 8002212501 QPS GAINESVILLE FL

Date 05/13/25 0 5133133164 1 5541

Card 1247",24.19,,Posted,431.53,2025-05-14,24.19,"Withdrawal Debit Card MC Debit Gator/SUNOCO 8002212501 QPS GAINESVILLE FL

Date 05/19/25 0 5139082313 1 5541

Card 1247",24.19
5/14/2025,,"Recurring Withdrawal Debit Card Fee/MASTERCARD ISSUER CROSS-BORDER FEE

Date 05/13/25 0 5133953606 0 5734

Card 1247",0.08,,Posted,455.72,2025-05-14,0.08,"Withdrawal Debit Card Fee/MASTERCARD ISSUER CROSS-BORDER FEE

Date 03/31/25 0 5090929332 0 5817

Card 1247",0.11399999999999999
5/14/2025,,"Recurring Withdrawal Debit Card - MC Debit Gator/RAYCAST.COM CHESHIRE LN

Date 05/13/25 0 5133953606 0 5734

Card 1247",10.0,,Posted,455.8,2025-05-14,10.0,"Recurring Withdrawal Debit Card - MC Debit Gator/RAYCAST.COM CHESHIRE LN

Date 05/13/25 0 5133953606 0 5734

Card 1247",10.0
5/14/2025,,"Recurring Withdrawal Debit Card Fee/MASTERCARD ISSUER CROSS-BORDER FEE

Date 05/13/25 0 5133953605 0 5734

Card 1247",0.08,,Posted,465.8,2025-05-14,0.08,"Withdrawal Debit Card Fee/MASTERCARD ISSUER CROSS-BORDER FEE

Date 03/31/25 0 5090929332 0 5817

Card 1247",0.11399999999999999
5/14/2025,,"Recurring Withdrawal Debit Card - MC Debit Gator/RAYCAST.COM CHESHIRE LN

Date 05/13/25 0 5133953605 0 5734

Card 1247",10.0,,Posted,465.88,2025-05-14,10.0,"Recurring Withdrawal Debit Card - MC Debit Gator/RAYCAST.COM CHESHIRE LN

Date 05/13/25 0 5133953606 0 5734

Card 1247",10.0
5/14/2025,,"Withdrawal Debit Card MC Debit Gator/CIRCLE K # 26146 GAINESVILLE FL

Date 05/12/25 0 5132947482 0 5499

Card 1247",19.75,,Posted,475.88,2025-05-14,19.75,"Withdrawal Debit Card MC Debit Gator/CIRCLE K # 06782 GAINESVILLE FL

Date 04/09/25 0 5099980889 0 5499

Card 1247",19.54
5/11/2025,,"Withdrawal POS #000000000047/CIRCLE K # 26146 3525 GAINESVILLE FL

Card 1247",19.75,,Posted,495.63,2025-05-11,19.75,Withdrawal POS #000000991864/CIRCLE K # 21142 GAINESVILLE FL Card 1140,19.643333333333334
5/11/2025,,"Withdrawal Debit Card MC Debit Gator/INSTACART*159 SAN FRANCISC CA

Date 05/09/25 0 5129018006 2 5411

Card 1247",38.0,,Posted,515.38,2025-05-11,38.0,"Withdrawal Debit Card MC Debit Gator/INSTACART*159 SAN FRANCISC CA

Date 03/22/25 0 5081791779 0 5411

Card 1247",38.010000000000005
5/11/2025,,"Withdrawal Debit Card MC Debit Gator/SUNOCO 8002212501 QPS GAINESVILLE FL

Date 05/09/25 0 5129469564 2 5541

Card 1247",23.01,,Posted,553.38,2025-05-11,23.01,"Withdrawal Debit Card MC Debit Gator/SUNOCO 8002212501 QPS GAINESVILLE FL

Date 05/19/25 0 5139082313 1 5541

Card 1247",23.01
5/11/2025,,"Withdrawal Debit Card MC Debit Gator/AMAZON PRIME*NI9490PZ1 AMZN.COM/BIL WA

Date 05/11/25 0 5131126852 1 5818

Card 1247",3.4,,Posted,576.39,2025-05-11,3.4,"Withdrawal Debit Card MC Debit Gator/AMAZON PRIME*NI9490PZ1 AMZN.COM/BIL WA

Date 05/11/25 0 5131126852 1 5818

Card 1247",3.4
5/10/2025,,"Withdrawal POS #000000000052/CIRCLE K # 26146 3525 GAINESVILLE FL

Card 1247",19.75,,Posted,579.79,2025-05-10,19.75,"Withdrawal POS #000000000047/CIRCLE K # 26146 3525 GAINESVILLE FL

Card 1247",19.75
5/9/2025,,"Recurring Withdrawal Debit Card Fee/MASTERCARD ISSUER CROSS-BORDER FEE

Date 05/08/25 0 5128330209 0 5734

Card 1247",0.06,,Posted,599.54,2025-05-09,0.06,"Withdrawal Debit Card Fee/MASTERCARD ISSUER CROSS-BORDER FEE

Date 03/31/25 0 5090929332 0 5817

Card 1247",0.11399999999999999
5/9/2025,,"Recurring Withdrawal Debit Card - MC Debit Gator/IDEOGRAM AI TORONTO ON

Date 05/08/25 0 5128330209 0 5734

Card 1247",8.0,,Posted,599.6,2025-05-09,8.0,"Recurring Withdrawal Debit Card - MC Debit Gator/IDEOGRAM AI TORONTO ON

Date 04/08/25 0 5098321266 0 5734

Card 1247",8.0
5/9/2025,,"Withdrawal Debit Card MC Debit Gator/IONOS INC. CHESTERBROOK PA

Date 05/08/25 0 5128032400 1 4816

Card 1247",23.0,,Posted,607.6,2025-05-09,23.0,"Withdrawal Debit Card MC Debit Gator/IONOS INC. CHESTERBROOK PA

Date 06/05/25 0 5156041339 1 4816

Card 1247",23.0
5/9/2025,,"Withdrawal ACH FLUENT-Gainesvil/TYPE: PAYMENT ID: 1371804719

CO: FLUENT-Gainesvil

NAME: steven chaplinskiEntry Class Code: WEB",20.0,,Posted,630.6,2025-05-09,20.0,"Withdrawal ACH FLUENT-Gainesvil/TYPE: PAYMENT ID: 1371804719

CO: FLUENT-Gainesvil

NAME: steven chaplinskiEntry Class Code: WEB",20.5
5/8/2025,,"Withdrawal ACH SUNO INC./TYPE: SUNO INC. ID: 1800948598

CO: SUNO INC. NAME: STEVEN J CHAPLINSKI

Entry Class Code: WEB",10.0,,Posted,650.6,2025-05-08,10.0,"Withdrawal ACH SUNO INC./TYPE: SUNO INC. ID: 1800948598

CO: SUNO INC. NAME: STEVEN J CHAPLINSKI

Entry Class Code: WEB",10.0
5/8/2025,,"Recurring Withdrawal Debit Card - MC Debit Gator/TUBEBUDDYCOM* 8668823239 CA

Date 05/07/25 0 5127999675 0 5734

Card 1247",7.5,,Posted,660.6,2025-05-08,7.5,"Recurring Withdrawal Debit Card - MC Debit Gator/TUBEBUDDYCOM* 8668823239 CA

Date 05/07/25 0 5127999675 0 5734

Card 1247",7.5
5/8/2025,,"Recurring Withdrawal Debit Card Fee/MASTERCARD ISSUER CROSS-BORDER FEE

Date 05/08/25 0 5128978432 0 5734

Card 1247",0.23,,Posted,668.1,2025-05-08,0.23,"Withdrawal Debit Card Fee/MASTERCARD ISSUER CROSS-BORDER FEE

Date 03/31/25 0 5090929332 0 5817

Card 1247",0.11399999999999999
5/8/2025,,"Recurring Withdrawal Debit Card - MC Debit Gator/NOTEGPT.IO ADMIRALTY KO

Date 05/08/25 0 5128978432 0 5734

Card 1247",29.0,,Posted,668.33,2025-05-08,29.0,"Recurring Withdrawal Debit Card - MC Debit Gator/NOTEGPT.IO ADMIRALTY KO

Date 05/08/25 0 5128978432 0 5734

Card 1247",29.0
5/8/2025,,"Withdrawal Debit Card MC Debit Gator/GRU/EZ-PAY WEB PYMT 352-334-3434 FL

Date 05/07/25 0 5127319905 0 4900

Card 1247",143.13,,Posted,697.33,2025-05-08,143.13,"Withdrawal Debit Card MC Debit Gator/GRU/EZ-PAY WEB PYMT 352-334-3434 FL

Date 05/07/25 0 5127319905 0 4900

Card 1247",143.13
5/8/2025,,"Withdrawal Debit Card MC Debit Gator/COX GAINESVILLE COMM 800-234-3993 FL

Date 05/07/25 0 5127973169 0 4899

Card 1247",156.13,,Posted,840.46,2025-05-08,156.13,"Withdrawal Debit Card MC Debit Gator/COX GAINESVILLE COMM 800-234-3993 FL

Date 05/07/25 0 5127973169 0 4899

Card 1247",156.13
5/8/2025,,"Withdrawal Bill Payment #000000176250/APPLE COM ONE APPLE PARK WAY ONE APPLE

CA

Card 1247",13.98,,Posted,996.59,2025-05-08,13.98,"Withdrawal Bill Payment #000000176250/APPLE COM ONE APPLE PARK WAY ONE APPLE

CA

Card 1247",13.98
5/8/2025,,"Withdrawal POS #000000752480/PUBLIX 3100 SW 35TH BLVD GAINESVILLE FL

Card 1247",37.56,,Posted,1010.57,2025-05-08,37.56,Withdrawal at ATM #000000001048/PUBLIX 3100 S W 35TH BLV GAINESVILLE FL Card 1140,37.56
5/7/2025,,"Withdrawal POS #000000000025/CIRCLE K # 26146 3525 GAINESVILLE FL

Card 1247",19.75,,Posted,1048.13,2025-05-07,19.75,"Withdrawal POS #000000000047/CIRCLE K # 26146 3525 GAINESVILLE FL

Card 1247",19.75
5/7/2025,,"Withdrawal Debit Card MC Debit Gator/SUNOCO 8002212501 QPS GAINESVILLE FL

Date 05/06/25 0 5126182193 1 5541

Card 1247",20.33,,Posted,1067.88,2025-05-07,20.33,"Withdrawal Debit Card MC Debit Gator/SUNOCO 8002212501 QPS GAINESVILLE FL

Date 05/19/25 0 5139082313 1 5541

Card 1247",20.545
5/7/2025,,"Withdrawal Debit Card MC Debit Gator/IONOS INC. CHESTERBROOK PA

Date 05/06/25 0 5126989315 0 4816

Card 1247",25.0,,Posted,1088.21,2025-05-07,25.0,"Withdrawal Debit Card MC Debit Gator/IONOS INC. CHESTERBROOK PA

Date 06/05/25 0 5156041339 1 4816

Card 1247",25.0
5/6/2025,,"Withdrawal POS #000000248532/AMAZON.COM*NI55D0DC2 SEATTLE WA

Card 1247",20.23,,Posted,1113.21,2025-05-06,20.23,"Withdrawal POS #000000134088/AMAZON.COM*N888H1072 SEATTLE WA

Card 1247",20.295
5/6/2025,,"Recurring Withdrawal Debit Card - MC Debit Gator/SUPERPOWER CHATGPT MIDDLETOWN DE

Date 05/05/25 0 5125205338 1 5734

Card 1247",15.0,,Posted,1133.44,2025-05-06,15.0,"Recurring Withdrawal Debit Card - MC Debit Gator/SUPERPOWER CHATGPT MIDDLETOWN DE

Date 06/05/25 0 5156229550 1 5734

Card 1247",15.0
5/6/2025,,"Recurring Withdrawal Debit Card - MC Debit Gator/SUPERPOWER CHATGPT MIDDLETOWN DE

Date 05/05/25 0 5125957245 0 5734

Card 1247",15.0,,Posted,1148.44,2025-05-06,15.0,"Recurring Withdrawal Debit Card - MC Debit Gator/SUPERPOWER CHATGPT MIDDLETOWN DE

Date 06/05/25 0 5156229550 1 5734

Card 1247",15.0
5/6/2025,,"Withdrawal Debit Card MC Debit Gator/SUNOCO 8002212501 QPS GAINESVILLE FL

Date 05/05/25 0 5125202951 1 5541

Card 1247",22.17,,Posted,1163.44,2025-05-06,22.17,"Withdrawal Debit Card MC Debit Gator/SUNOCO 8002212501 QPS GAINESVILLE FL

Date 05/19/25 0 5139082313 1 5541

Card 1247",22.005000000000003
5/6/2025,,"Withdrawal Debit Card MC Debit Gator/IONOS INC. CHESTERBROOK PA

Date 05/05/25 0 5125954539 0 4816

Card 1247",60.0,,Posted,1185.61,2025-05-06,60.0,"Withdrawal Debit Card MC Debit Gator/IONOS INC. CHESTERBROOK PA

Date 06/05/25 0 5156041339 1 4816

Card 1247",60.0
5/5/2025,,"Recurring Withdrawal Debit Card - MC Debit Gator/OPENAI *CHATGPT SUBSCR SAN FRANCISC CA

Date 05/04/25 0 5124280497 0 5734

Card 1247",20.0,,Posted,1245.61,2025-05-05,20.0,"Recurring Withdrawal Debit Card - MC Debit Gator/OPENAI SAN FRANCISC CA

Date 05/31/25 0 5151282040 2 5734

Card 1247",20.0
5/5/2025,,"Recurring Withdrawal Debit Card - MC Debit Gator/HOSTINGER* HOSTINGER.C WILMINGTON DE

Date 05/05/25 0 5125011239 1 7372

Card 1247",4.68,,Posted,1265.61,2025-05-05,4.68,"Recurring Withdrawal Debit Card - MC Debit Gator/HOSTINGER* HOSTINGER.C WILMINGTON DE

Date 05/05/25 0 5125011239 1 7372

Card 1247",4.68
5/5/2025,,"Recurring Withdrawal Debit Card - MC Debit Gator/HOSTINGER* HOSTINGER.C WILMINGTON DE

Date 05/04/25 0 5124144321 1 7372

Card 1247",9.99,,Posted,1270.29,2025-05-05,9.99,"Recurring Withdrawal Debit Card - MC Debit Gator/HOSTINGER* HOSTINGER.C WILMINGTON DE

Date 05/05/25 0 5125011239 1 7372

Card 1247",9.99
5/5/2025,,"Withdrawal ACH FLUENT-Gainesvil/TYPE: PAYMENT ID: 1371804719

CO: FLUENT-Gainesvil

NAME: steven chaplinskiEntry Class Code: WEB",65.0,,Posted,1280.28,2025-05-05,65.0,"Withdrawal ACH FLUENT-Gainesvil/TYPE: PAYMENT ID: 1371804719

CO: FLUENT-Gainesvil

NAME: steven chaplinskiEntry Class Code: WEB",65.0
5/4/2025,,"Withdrawal POS #000000330773/SUNOCO 8002212501 4234 SW 20TH AVE

GAINESVILLE FL

Card 1247",18.74,,Posted,1345.28,2025-05-04,18.74,"Withdrawal POS #000000666979/SUNOCO 8002212501 4234 SW 20TH AVE

GAINESVILLE FL

Card 1247",18.575
5/4/2025,,"Recurring Withdrawal Debit Card - MC Debit Gator/NOTION LABS, INC. SAN FRANCISC CA

Date 05/02/25 0 5122358621 2 7372

Card 1247",22.0,,Posted,1364.02,2025-05-04,22.0,"Recurring Withdrawal Debit Card - MC Debit Gator/OPENAI SAN FRANCISC CA

Date 05/31/25 0 5151282040 2 5734

Card 1247",22.0
5/4/2025,,"Withdrawal Debit Card MC Debit Gator/INSTACART*159 SAN FRANCISC CA

Date 05/02/25 0 5122356706 2 5411

Card 1247",3.01,,Posted,1386.02,2025-05-04,3.01,"Withdrawal Debit Card MC Debit Gator/INSTACART*159 SAN FRANCISC CA

Date 03/22/25 0 5081791779 0 5411

Card 1247",3.01
5/4/2025,,"Withdrawal Debit Card MC Debit Gator/INSTACART*159 SAN FRANCISC CA

Date 05/02/25 0 5122356703 2 5411

Card 1247",65.28,,Posted,1389.03,2025-05-04,65.28,"Withdrawal Debit Card MC Debit Gator/INSTACART*159 SAN FRANCISC CA

Date 05/31/25 0 5151554560 2 5411

Card 1247",65.28
5/4/2025,,"Recurring Withdrawal Debit Card - MC Debit Gator/CS ADDTL STORAGE SAN JOSE CA

Date 05/03/25 0 5123478481 2 5817

Card 1247",9.99,,Posted,1454.31,2025-05-04,9.99,"Recurring Withdrawal Debit Card - MC Debit Gator/CS ADDTL STORAGE SAN JOSE CA

Date 05/03/25 0 5123478481 2 5817

Card 1247",9.99
5/4/2025,,"Recurring Withdrawal Debit Card - MC Debit Gator/ADOBE SAN JOSE CA

Date 05/03/25 0 5123478479 2 5817

Card 1247",19.99,,Posted,1464.3,2025-05-04,19.99,"Recurring Withdrawal Debit Card - MC Debit Gator/CS ADDTL STORAGE SAN JOSE CA

Date 05/03/25 0 5123478481 2 5817

Card 1247",19.99
5/4/2025,,"Withdrawal Debit Card MC Debit Gator/WALGREENS #9304 GAINESVILLE FL

Date 05/02/25 0 5122473217 2 5912

Card 1247",10.81,,Posted,1484.29,2025-05-04,10.81,"Withdrawal Debit Card MC Debit Gator/WALGREENS #9304 GAINESVILLE FL

Date 05/30/25 0 5150232309 1 5912

Card 1247",10.81
5/4/2025,,"Recurring Withdrawal Debit Card - MC Debit Gator/APPLE.COM/BILL 866-712-7753 CA

Date 05/03/25 0 5123472314 2 5818

Card 1247",2.99,,Posted,1495.1,2025-05-04,2.99,"Recurring Withdrawal Debit Card - MC Debit Gator/APPLE.COM/BILL 866-712-7753 CA

Date 06/03/25 0 5154093226 1 5818

Card 1247",2.99
5/4/2025,,"Withdrawal Debit Card MC Debit Gator/CIRCLE K # 06782 GAINESVILLE FL

Date 05/01/25 0 5121349634 2 5499

Card 1247",27.2,,Posted,1498.09,2025-05-04,27.2,Withdrawal Debit Card MC Debit Gator/CIRCLE K # 06782 GAINESVILLE FLDate 01/31/25 0 5031331003 1 5499Card 1247,27.095
5/2/2025,,"Recurring Withdrawal Debit Card - MC Debit Gator/MYDESIGNS - PRO - MON LAS VEGAS NV

Date 05/01/25 0 5121260380 1 5734

Card 1247",49.99,,Posted,1525.29,2025-05-02,49.99,"Recurring Withdrawal Debit Card - MC Debit Gator/MYDESIGNS - PRO - MON LAS VEGAS NV

Date 06/01/25 0 5152146505 1 5734

Card 1247",49.99
5/2/2025,,"Recurring Withdrawal Debit Card - MC Debit Gator/PARAMOUNT+ WEST HOLLYWO CA

Date 05/01/25 0 5121277574 1 4899

Card 1247",14.96,,Posted,1575.28,2025-05-02,14.96,"Recurring Withdrawal Debit Card - MC Debit Gator/PARAMOUNT+ WEST HOLLYWO CA

Date 06/01/25 0 5152328615 1 4899

Card 1247",14.96
5/2/2025,,"Recurring Withdrawal Debit Card - MC Debit Gator/APPLE.COM/BILL 866-712-7753 CA

Date 05/01/25 0 5121270888 1 5818

Card 1247",27.98,,Posted,1590.24,2025-05-02,27.98,"Recurring Withdrawal Debit Card - MC Debit Gator/APPLE.COM/BILL 866-712-7753 CA

Date 06/03/25 0 5154093226 1 5818

Card 1247",27.98
5/2/2025,,"Withdrawal ACH Watson Realty Co/TYPE: WEB PMTS ID: 9000321157

CO: Watson Realty Co

NAME: Steven chaplinskiEntry Class Code: WEB",1179.0,,Posted,1618.22,2025-05-02,1179.0,"Withdrawal ACH Watson Realty Co/TYPE: WEB PMTS ID: 9000321157

CO: Watson Realty Co

NAME: Steven chaplinskiEntry Class Code: WEB",1179.0
5/2/2025,,"Withdrawal ACH FLUENT-Gainesvil/TYPE: PAYMENT ID: 1371804719

CO: FLUENT-Gainesvil

NAME: steven chaplinskiEntry Class Code: WEB",18.0,,Posted,2797.22,2025-05-02,18.0,"Withdrawal ACH FLUENT-Gainesvil/TYPE: PAYMENT ID: 1371804719

CO: FLUENT-Gainesvil

NAME: steven chaplinskiEntry Class Code: WEB",17.75
5/2/2025,,"Withdrawal ACH AppFolio, Inc. F/TYPE: WEB PMTS ID: 9001406550

CO: AppFolio, Inc. F

NAME: Steven chaplinskiEntry Class Code: WEB",2.49,,Posted,2815.22,2025-05-02,2.49,"Withdrawal ACH AppFolio, Inc. F/TYPE: WEB PMTS ID: 9001406550

CO: AppFolio, Inc. F

NAME: Steven chaplinskiEntry Class Code: WEB",2.49
5/1/2025,,"Recurring Withdrawal Debit Card - MC Debit Gator/OPENAI SAN FRANCISC CA

Date 04/30/25 0 5120971870 0 5734

Card 1247",7.39,,Posted,2817.71,2025-05-01,7.39,Recurring Withdrawal Debit Card - MC Debit Gator/OPENAI SAN FRANCISC CADate 03/08/25 0 5067339145 0 5734Card 1247,7.39
5/1/2025,,"Recurring Withdrawal Debit Card - MC Debit Gator/PADDLE.NET* SETAPP NEW YORK NY

Date 05/01/25 0 5121349771 0 5817

Card 1247",9.99,,Posted,2825.1,2025-05-01,9.99,"Recurring Withdrawal Debit Card - MC Debit Gator/PADDLE.NET* SETAPP NEW YORK NY

Date 05/31/25 0 5151555568 2 5817

Card 1247",9.99
5/1/2025,,"Withdrawal Debit Card MC Debit Gator/SUNOCO 8002212501 QPS GAINESVILLE FL

Date 04/30/25 0 5120175998 1 5541

Card 1247",21.84,,Posted,2835.09,2025-05-01,21.84,"Withdrawal Debit Card MC Debit Gator/SUNOCO 8002212501 QPS GAINESVILLE FL

Date 05/19/25 0 5139082313 1 5541

Card 1247",22.005000000000003
5/1/2025,,"Recurring Withdrawal Debit Card Fee/MASTERCARD ISSUER CROSS-BORDER FEE

Date 05/01/25 0 5121175942 1 5817

Card 1247",0.08,,Posted,2856.93,2025-05-01,0.08,"Withdrawal Debit Card Fee/MASTERCARD ISSUER CROSS-BORDER FEE

Date 03/31/25 0 5090929332 0 5817

Card 1247",0.11399999999999999
5/1/2025,,"Recurring Withdrawal Debit Card - MC Debit Gator/OBSIDIAN.MD OAKVILLE ON

Date 05/01/25 0 5121175942 1 5817

Card 1247",10.0,,Posted,2857.01,2025-05-01,10.0,"Recurring Withdrawal Debit Card - MC Debit Gator/OBSIDIAN.MD OAKVILLE ON

Date 05/31/25 0 5151375863 2 5817

Card 1247",10.0
5/1/2025,,"Recurring Withdrawal Debit Card - MC Debit Gator/FS *RAINDROP.IO SANTA BARBAR CA

Date 04/30/25 0 5120038015 1 5734

Card 1247",3.0,,Posted,2867.01,2025-05-01,3.0,"Recurring Withdrawal Debit Card - MC Debit Gator/FS *RAINDROP.IO SANTA BARBAR CA

Date 04/30/25 0 5120038015 1 5734

Card 1247",3.0
5/1/2025,,"Withdrawal POS #000000876017/AMAZON.COM*N26MU72P0 SEATTLE WA

Card 1247",32.0,,Posted,2870.01,2025-05-01,32.0,"Withdrawal POS #000000256943/AMAZON.COM*NN6201DU0 SEATTLE WA

Card 1247",32.0
5/1/2025,,"Withdrawal POS #000000684070/AMAZON.COM*NB6J799P2 SEATTLE WA

Card 1247",21.36,,Posted,2902.01,2025-05-01,21.36,"Withdrawal POS #000000134088/AMAZON.COM*N888H1072 SEATTLE WA

Card 1247",21.36
5/1/2025,,"Withdrawal POS #000000680759/AMAZON.COM*N26B91SP0 SEATTLE WA

Card 1247",13.1,,Posted,2923.37,2025-05-01,13.1,"Withdrawal POS #000000256943/AMAZON.COM*NN6201DU0 SEATTLE WA

Card 1247",13.1
5/1/2025,,"Withdrawal POS #000000194578/Etsy.com*US Etsy.com*AiAv ADAMS STREET

www.etsy.com/ NY

Card 1247",0.2,,Posted,2936.47,2025-05-01,0.2,"Withdrawal POS #000000194578/Etsy.com*US Etsy.com*AiAv ADAMS STREET

www.etsy.com/ NY

Card 1247",0.2
5/1/2025,,"Withdrawal POS #000020035046/GOOGLE *YouTubePremium 1600 Amphitheatre

Parkw Mountain View CA

Card 1247",15.92,,Posted,2936.67,2025-05-01,15.92,"Withdrawal POS #000020312090/GOOGLE *YouTubePremium 1600 Amphitheatre

Parkw Mountain View CA

Card 1247",15.92
4/30/2025,,"Recurring Withdrawal Debit Card - MC Debit Gator/SUPERPOWER CHATGPT MIDDLETOWN DE

Date 04/29/25 0 5119982716 0 5734

Card 1247",15.0,,Posted,2952.59,2025-04-30,15.0,"Recurring Withdrawal Debit Card - MC Debit Gator/SUPERPOWER CHATGPT MIDDLETOWN DE

Date 06/05/25 0 5156229550 1 5734

Card 1247",15.0
4/30/2025,,"Withdrawal Debit Card MC Debit Gator/IONOS INC. CHESTERBROOK PA

Date 04/29/25 0 5119979985 0 4816

Card 1247",2.5,,Posted,2967.59,2025-04-30,2.5,"Withdrawal Debit Card MC Debit Gator/IONOS INC. CHESTERBROOK PA

Date 06/05/25 0 5156041339 1 4816

Card 1247",3.0
4/29/2025,,"Withdrawal Debit Card MC Debit Gator/SUNOCO 8002212501 QPS GAINESVILLE FL

Date 04/28/25 0 5118116540 1 5541

Card 1247",28.44,,Posted,-29.91,2025-04-29,28.44,"Withdrawal Debit Card MC Debit Gator/SUNOCO 8002212501 QPS GAINESVILLE FL

Date 05/19/25 0 5139082313 1 5541

Card 1247",28.44
4/29/2025,,"Withdrawal Debit Card MC Debit Gator/WALGREENS #5024 GAINESVILLE FL

Date 04/28/25 0 5118112027 1 5912

Card 1247",15.0,,Posted,-1.47,2025-04-29,15.0,"Withdrawal Debit Card MC Debit Gator/WALGREENS #9304 GAINESVILLE FL

Date 05/30/25 0 5150232309 1 5912

Card 1247",15.0
4/29/2025,,"Withdrawal POS #000000085932/SUNOCO 8002212501 4234 SW 20TH AVE

GAINESVILLE FL

Card 1247",19.47,,Posted,13.53,2025-04-29,19.47,"Withdrawal POS #000000666979/SUNOCO 8002212501 4234 SW 20TH AVE

GAINESVILLE FL

Card 1247",19.685
4/28/2025,,"Withdrawal ATM Fee/EFT 6419 W Newberry Rd Gainesville FL

Card 1247",2.0,,Posted,3.0,2025-04-28,2.0,"Withdrawal ATM Fee/EFT 6419 W Newberry Rd Gainesville FL

Card 1247",2.0
4/28/2025,,"Withdrawal at ATM #000000105254/EFT 6419 W Newberry Rd Gainesville FL

Card 1247",13.0,,Posted,5.0,2025-04-28,13.0,"Withdrawal at ATM #000000785755/EFT 6419 W Newberry Rd Gainesville FL

Card 1247",13.0
4/28/2025,,"Withdrawal Debit Card MC Debit Gator/INSTACART*159 SAN FRANCISC CA

Date 04/27/25 0 5117311838 1 5411

Card 1247",58.0,,Posted,18.0,2025-04-28,58.0,"Withdrawal Debit Card MC Debit Gator/INSTACART*159 SAN FRANCISC CA

Date 03/22/25 0 5081791779 0 5411

Card 1247",58.0
4/28/2025,,Withdrawal Courtesy Pay Fee/Entry Class Code: WEB,35.0,,Posted,-59.0,2025-04-28,35.0,Withdrawal Courtesy Pay Fee/Entry Class Code: WEB,35.0
4/28/2025,,"Withdrawal ACH FLUENT-Gainesvil/TYPE: PAYMENT ID: 1371804719

CO: FLUENT-Gainesvil

NAME: steven chaplinski",18.0,,Posted,-24.0,2025-04-28,18.0,Withdrawal ACH FLUENT-Gainesvil/TYPE: PAYMENT ID: 1371804719CO: FLUENT-GainesvilNAME: steven chaplinski,18.0
4/27/2025,,"Withdrawal Debit Card MC Debit Gator/IC* INSTACART*SUBSCRIP SAN FRANCISC CA

Date 04/26/25 0 5116980985 0 5411

Card 1247",9.99,,Posted,-6.0,2025-04-27,9.99,"Recurring Withdrawal Debit Card - MC Debit Gator/IC* INSTACART*SUBSCRIP SAN FRANCISC CA

Date 05/27/25 0 5147989663 0 5411

Card 1247",9.99
4/27/2025,,"Withdrawal POS #000000045037/SUNOCO 8002212501 4234 SW 20TH AVE

GAINESVILLE FL

Card 1247",21.84,,Posted,3.99,2025-04-27,21.84,"Withdrawal POS #000000666979/SUNOCO 8002212501 4234 SW 20TH AVE

GAINESVILLE FL

Card 1247",22.005000000000003
4/26/2025,,"Withdrawal POS #000000977612/SUNOCO 8002212501 4234 SW 20TH AVE

GAINESVILLE FL

Card 1247",21.84,,Posted,25.83,2025-04-26,21.84,"Withdrawal POS #000000666979/SUNOCO 8002212501 4234 SW 20TH AVE

GAINESVILLE FL

Card 1247",22.005000000000003
4/25/2025,,"Withdrawal POS #000080196760/SMOKE CITY 2120 SW 34TH ST GAINESVILLE

Card 1247",6.34,,Posted,47.67,2025-04-25,6.34,"Withdrawal POS #000080196760/SMOKE CITY 2120 SW 34TH ST GAINESVILLE

Card 1247",6.34
4/25/2025,,"Withdrawal POS #000000940381/SUNOCO 8002212501 4234 SW 20TH AVE

GAINESVILLE FL

Card 1247",21.84,,Posted,54.01,2025-04-25,21.84,"Withdrawal POS #000000666979/SUNOCO 8002212501 4234 SW 20TH AVE

GAINESVILLE FL

Card 1247",22.005000000000003
4/25/2025,,"Withdrawal ACH FLUENT-Gainesvil/TYPE: PAYMENT ID: 1371804719

CO: FLUENT-Gainesvil

NAME: steven chaplinskiEntry Class Code: WEB",28.5,,Posted,75.85,2025-04-25,28.5,"Withdrawal ACH FLUENT-Gainesvil/TYPE: PAYMENT ID: 1371804719

CO: FLUENT-Gainesvil

NAME: steven chaplinskiEntry Class Code: WEB",28.5
4/24/2025,,"Withdrawal POS #000000912703/SUNOCO 8002212501 4234 SW 20TH AVE

GAINESVILLE FL

Card 1247",24.52,,Posted,104.35,2025-04-24,24.52,"Withdrawal POS #000000666979/SUNOCO 8002212501 4234 SW 20TH AVE

GAINESVILLE FL

Card 1247",24.52
4/24/2025,,"Withdrawal ACH FLUENT-Gainesvil/TYPE: PAYMENT ID: 1371804719

CO: FLUENT-Gainesvil

NAME: steven chaplinskiEntry Class Code: WEB",21.0,,Posted,128.87,2025-04-24,21.0,"Withdrawal ACH FLUENT-Gainesvil/TYPE: PAYMENT ID: 1371804719

CO: FLUENT-Gainesvil

NAME: steven chaplinskiEntry Class Code: WEB",20.5
4/23/2025,,"Withdrawal POS #000000767866/PUBLIX 3100 SW 35TH BLVD GAINESVILLE FL

Card 1247",18.35,,Posted,149.87,2025-04-23,18.35,"Withdrawal POS #000000752480/PUBLIX 3100 SW 35TH BLVD GAINESVILLE FL

Card 1247",18.405
4/23/2025,,"Withdrawal POS #000000880006/SUNOCO 8002212501 4234 SW 20TH AVE

GAINESVILLE FL

Card 1247",21.84,,Posted,168.22,2025-04-23,21.84,"Withdrawal POS #000000580851/SUNOCO 8002212501 4234 SW 20TH AVE

GAINESVILLE FL

Card 1247",21.84
4/23/2025,,"Recurring Withdrawal Debit Card - MC Debit Gator/NETFLIX.COM CA

Date 04/23/25 0 5113169724 1 4899

Card 1247",20.71,,Posted,190.06,2025-04-23,20.71,"Recurring Withdrawal Debit Card - MC Debit Gator/NETFLIX.COM LOS GATOS CA

Date 05/23/25 0 5143471019 2 4899

Card 1247",20.71
4/23/2025,,"Withdrawal ACH FLUENT-Gainesvil/TYPE: PAYMENT ID: 1371804719

CO: FLUENT-Gainesvil

NAME: steven chaplinskiEntry Class Code: WEB",15.0,,Posted,210.77,2025-04-23,15.0,"Withdrawal ACH FLUENT-Gainesvil/TYPE: PAYMENT ID: 1371804719

CO: FLUENT-Gainesvil

NAME: steven chaplinskiEntry Class Code: WEB",15.0
4/22/2025,,"Withdrawal POS #000000788429/SUNOCO 8002212501 4234 SW 20TH AVE

GAINESVILLE FL

Card 1247",21.84,,Posted,225.77,2025-04-22,21.84,"Withdrawal POS #000000666979/SUNOCO 8002212501 4234 SW 20TH AVE

GAINESVILLE FL

Card 1247",22.005000000000003
4/22/2025,,"Withdrawal Debit Card MC Debit Gator/INSTACART*159 SAN FRANCISC CA

Date 04/21/25 0 5111802992 0 5411

Card 1247",55.0,,Posted,247.61,2025-04-22,55.0,"Withdrawal Debit Card MC Debit Gator/INSTACART*159 SAN FRANCISC CA

Date 03/22/25 0 5081791779 0 5411

Card 1247",55.04
4/22/2025,,"Withdrawal ACH FLUENT-Gainesvil/TYPE: PAYMENT ID: 1371804719

CO: FLUENT-Gainesvil

NAME: steven chaplinskiEntry Class Code: WEB",17.5,,Posted,302.61,2025-04-22,17.5,"Withdrawal ACH FLUENT-Gainesvil/TYPE: PAYMENT ID: 1371804719

CO: FLUENT-Gainesvil

NAME: steven chaplinskiEntry Class Code: WEB",17.75
4/22/2025,,"Withdrawal POS #000000773256/SUNOCO 8002212501 4234 SW 20TH AVE

GAINESVILLE FL

Card 1247",21.84,,Posted,320.11,2025-04-22,21.84,"Withdrawal POS #000000216148/SUNOCO 8002212501 4234 SW 20TH AVE

GAINESVILLE FL

Card 1247",21.84
4/21/2025,,"Recurring Withdrawal Debit Card - MC Debit Gator/CANVA* I04492-37655487 CAMDEN DE

Date 04/20/25 0 5110064939 1 7333

Card 1247",12.99,,Posted,341.95,2025-04-21,12.99,"Recurring Withdrawal Debit Card - MC Debit Gator/CANVA* I04522-50593645 CAMDEN DE

Date 05/20/25 0 5140963894 0 7333

Card 1247",12.99
4/21/2025,,"Withdrawal POS #000028288185/WAWA 5325 GAINESVILLE GAINESVILLE FL

Card 1247",15.54,,Posted,354.94,2025-04-21,15.54,"Withdrawal POS #000028288185/WAWA 5325 GAINESVILLE GAINESVILLE FL

Card 1247",15.54
4/21/2025,,"Withdrawal ACH FLUENT-Gainesvil/TYPE: PAYMENT ID: 1371804719

CO: FLUENT-Gainesvil

NAME: steven chaplinskiEntry Class Code: WEB",42.0,,Posted,370.48,2025-04-21,42.0,"Withdrawal ACH FLUENT-Gainesvil/TYPE: PAYMENT ID: 1371804719

CO: FLUENT-Gainesvil

NAME: steven chaplinskiEntry Class Code: WEB",42.0
4/20/2025,,"Withdrawal POS #000000732586/SUNOCO 8002212501 4234 SW 20TH AVE

GAINESVILLE FL

Card 1247",18.41,,Posted,412.48,2025-04-20,18.41,"Withdrawal POS #000000216148/SUNOCO 8002212501 4234 SW 20TH AVE

GAINESVILLE FL

Card 1247",18.41
4/20/2025,,"Withdrawal Debit Card MC Debit Gator/INSTACART*159 SAN FRANCISC CA

Date 04/19/25 0 5109159889 1 5411

Card 1247",48.79,,Posted,430.89,2025-04-20,48.79,"Withdrawal Debit Card MC Debit Gator/INSTACART*159 SAN FRANCISC CA

Date 03/22/25 0 5081791779 0 5411

Card 1247",48.965
4/20/2025,,"Withdrawal POS #000000752843/SUNOCO 8002212501 4234 SW 20TH AVE

GAINESVILLE FL

Card 1247",18.41,,Posted,479.68,2025-04-20,18.41,"Withdrawal POS #000000216148/SUNOCO 8002212501 4234 SW 20TH AVE

GAINESVILLE FL

Card 1247",18.41
4/19/2025,,"Withdrawal POS #000000000007/CIRCLE K # 06782 5237 GAINESVILLE FL

Card 1247",16.99,,Posted,498.09,2025-04-19,16.99,Withdrawal POS #000000000343/CIRCLE K # 06782 5237 GAINESVILLE FLCard 1247,16.99
4/18/2025,,"Recurring Withdrawal Debit Card - MC Debit Gator/AMAZON PRIME*TG93S4M53 AMZN.COM/BIL WA

Date 04/17/25 0 5107336159 0 5968

Card 1247",15.13,,Posted,515.08,2025-04-18,15.13,"Recurring Withdrawal Debit Card - MC Debit Gator/AMAZON PRIME*NZ72M6V92 AMZN.COM/BIL WA

Date 05/17/25 0 5137026065 1 5968

Card 1247",15.13
4/18/2025,,"Withdrawal POS #000000736804/PUBLIX 3100 SW 35TH BLVD GAINESVILLE FL

Card 1247",25.01,,Posted,530.21,2025-04-18,25.01,Withdrawal at ATM #000000001048/PUBLIX 3100 S W 35TH BLV GAINESVILLE FL Card 1140,25.01
4/17/2025,,"Withdrawal POS #000000597264/SUNOCO 8002212501 4234 SW 20TH AVE

GAINESVILLE FL

Card 1247",23.65,,Posted,555.22,2025-04-17,23.65,"Withdrawal POS #000000666979/SUNOCO 8002212501 4234 SW 20TH AVE

GAINESVILLE FL

Card 1247",23.653333333333336
4/17/2025,,"Recurring Withdrawal Debit Card - MC Debit Gator/APPLE.COM/BILL 866-712-7753 CA

Date 04/16/25 0 5106955527 0 5818

Card 1247",36.98,,Posted,578.87,2025-04-17,36.98,Recurring Withdrawal Debit Card - MC Debit Gator/APPLE.COM/BILL 866-712-7753 CADate 01/05/25 0 5005839185 0 5818Card 1247,36.98
4/17/2025,,"Withdrawal ACH FLUENT-Gainesvil/TYPE: PAYMENT ID: 1371804719

CO: FLUENT-Gainesvil

NAME: steven chaplinskiEntry Class Code: WEB",42.0,,Posted,615.85,2025-04-17,42.0,"Withdrawal ACH FLUENT-Gainesvil/TYPE: PAYMENT ID: 1371804719

CO: FLUENT-Gainesvil

NAME: steven chaplinskiEntry Class Code: WEB",42.0
4/16/2025,,"Withdrawal POS #000000560579/SUNOCO 8002212501 4234 SW 20TH AVE

GAINESVILLE FL

Card 1247",18.41,,Posted,657.85,2025-04-16,18.41,"Withdrawal POS #000000666979/SUNOCO 8002212501 4234 SW 20TH AVE

GAINESVILLE FL

Card 1247",18.575
4/16/2025,,"Withdrawal Debit Card MC Debit Gator/INSTACART*159 SAN FRANCISC CA

Date 04/15/25 0 5105953159 0 5411

Card 1247",70.0,,Posted,676.26,2025-04-16,70.0,"Withdrawal Debit Card MC Debit Gator/INSTACART*159 SAN FRANCISC CA

Date 03/22/25 0 5081791779 0 5411

Card 1247",70.0
4/15/2025,,"Withdrawal POS #000000515552/SUNOCO 8002212501 4234 SW 20TH AVE

GAINESVILLE FL

Card 1247",21.84,,Posted,746.26,2025-04-15,21.84,"Withdrawal POS #000000580851/SUNOCO 8002212501 4234 SW 20TH AVE

GAINESVILLE FL

Card 1247",21.84
4/14/2025,,"Withdrawal POS #000000500473/SUNOCO 8002212501 4234 SW 20TH AVE

GAINESVILLE FL

Card 1247",21.84,,Posted,768.1,2025-04-14,21.84,"Withdrawal POS #000000347331/SUNOCO 8002212501 4234 SW 20TH AVE

GAINESVILLE FL

Card 1247",21.84
4/14/2025,,"Recurring Withdrawal Debit Card Fee/MASTERCARD ISSUER CROSS-BORDER FEE

Date 04/13/25 0 5103998380 0 5734

Card 1247",0.08,,Posted,789.94,2025-04-14,0.08,"Withdrawal Debit Card Fee/MASTERCARD ISSUER CROSS-BORDER FEE

Date 03/31/25 0 5090929332 0 5817

Card 1247",0.11399999999999999
4/14/2025,,"Recurring Withdrawal Debit Card - MC Debit Gator/RAYCAST.COM CHESHIRE LN

Date 04/13/25 0 5103998380 0 5734

Card 1247",10.0,,Posted,790.02,2025-04-14,10.0,"Recurring Withdrawal Debit Card - MC Debit Gator/RAYCAST.COM CHESHIRE LN

Date 05/13/25 0 5133953606 0 5734

Card 1247",10.0
4/14/2025,,"Recurring Withdrawal Debit Card Fee/MASTERCARD ISSUER CROSS-BORDER FEE

Date 04/13/25 0 5103998379 0 5734

Card 1247",0.08,,Posted,800.02,2025-04-14,0.08,"Withdrawal Debit Card Fee/MASTERCARD ISSUER CROSS-BORDER FEE

Date 03/31/25 0 5090929332 0 5817

Card 1247",0.11399999999999999
4/14/2025,,"Recurring Withdrawal Debit Card - MC Debit Gator/RAYCAST.COM CHESHIRE LN

Date 04/13/25 0 5103998379 0 5734

Card 1247",10.0,,Posted,800.1,2025-04-14,10.0,"Recurring Withdrawal Debit Card - MC Debit Gator/RAYCAST.COM CHESHIRE LN

Date 05/13/25 0 5133953606 0 5734

Card 1247",10.0
4/13/2025,,"Withdrawal POS #000000406174/SUNOCO 8002212501 4234 SW 20TH AVE

GAINESVILLE FL

Card 1247",23.44,,Posted,810.1,2025-04-13,23.44,"Withdrawal POS #000000666979/SUNOCO 8002212501 4234 SW 20TH AVE

GAINESVILLE FL

Card 1247",23.653333333333336
4/11/2025,,"Withdrawal Debit Card MC Debit Gator/IONOS INC. CHESTERBROOK PA

Date 04/10/25 0 5100985699 0 4816

Card 1247",7.0,,Posted,833.54,2025-04-11,7.0,"Withdrawal Debit Card MC Debit Gator/IONOS INC. CHESTERBROOK PA

Date 06/05/25 0 5156041339 1 4816

Card 1247",7.0
4/11/2025,,"Withdrawal Debit Card MC Debit Gator/AMAZON PRIME*GN80C1F53 AMZN.COM/BIL WA

Date 04/11/25 0 5101982298 0 5818

Card 1247",3.4,,Posted,840.54,2025-04-11,3.4,"Withdrawal Debit Card MC Debit Gator/AMAZON PRIME*NI9490PZ1 AMZN.COM/BIL WA

Date 05/11/25 0 5131126852 1 5818

Card 1247",3.4
4/11/2025,,"Withdrawal Debit Card MC Debit Gator/CIRCLE K # 06782 GAINESVILLE FL

Date 04/09/25 0 5099980889 0 5499

Card 1247",19.33,,Posted,843.94,2025-04-11,19.33,"Withdrawal Debit Card MC Debit Gator/CIRCLE K # 06782 GAINESVILLE FL

Date 04/09/25 0 5099980889 0 5499

Card 1247",19.54
4/11/2025,,"Withdrawal POS #000000375291/SUNOCO 8002212501 4234 SW 20TH AVE

GAINESVILLE FL

Card 1247",23.87,,Posted,863.27,2025-04-11,23.87,"Withdrawal POS #000000666979/SUNOCO 8002212501 4234 SW 20TH AVE

GAINESVILLE FL

Card 1247",23.653333333333336
4/10/2025,,"Withdrawal Debit Card MC Debit Gator/INSTACART*159 SAN FRANCISC CA

Date 04/09/25 0 5099942565 0 5411

Card 1247",49.14,,Posted,887.14,2025-04-10,49.14,"Withdrawal Debit Card MC Debit Gator/INSTACART*159 SAN FRANCISC CA

Date 03/22/25 0 5081791779 0 5411

Card 1247",48.965
4/9/2025,,"Recurring Withdrawal Debit Card Fee/MASTERCARD ISSUER CROSS-BORDER FEE

Date 04/08/25 0 5098321266 0 5734

Card 1247",0.06,,Posted,485.28,2025-04-09,0.06,"Withdrawal Debit Card Fee/MASTERCARD ISSUER CROSS-BORDER FEE

Date 03/31/25 0 5090929332 0 5817

Card 1247",0.11399999999999999
4/9/2025,,"Recurring Withdrawal Debit Card - MC Debit Gator/IDEOGRAM AI TORONTO ON

Date 04/08/25 0 5098321266 0 5734

Card 1247",8.0,,Posted,485.34,2025-04-09,8.0,"Recurring Withdrawal Debit Card - MC Debit Gator/IDEOGRAM AI TORONTO ON

Date 04/08/25 0 5098321266 0 5734

Card 1247",8.0
4/9/2025,,"Withdrawal Debit Card MC Debit Gator/IONOS INC. CHESTERBROOK PA

Date 04/08/25 0 5098011593 1 4816

Card 1247",23.0,,Posted,493.34,2025-04-09,23.0,"Withdrawal Debit Card MC Debit Gator/IONOS INC. CHESTERBROOK PA

Date 06/05/25 0 5156041339 1 4816

Card 1247",23.0
4/9/2025,,"Withdrawal Debit Card MC Debit Gator/COX GAINESVILLE COMM 800-234-3993 FL

Date 04/08/25 0 5098319723 0 4899

Card 1247",156.13,,Posted,516.34,2025-04-09,156.13,Withdrawal Debit Card MC Debit Gator/COX GAINESVILLE COMM 800-234-3993 FLDate 03/09/25 0 5068137922 1 4899Card 1247,156.13
4/8/2025,,"Withdrawal ACH SUNO INC./TYPE: SUNO INC. ID: 1800948598

CO: SUNO INC. NAME: STEVEN J CHAPLINSKI

Entry Class Code: WEB",10.0,,Posted,672.47,2025-04-08,10.0,"Withdrawal ACH SUNO INC./TYPE: SUNO INC. ID: 1800948598

CO: SUNO INC. NAME: STEVEN J CHAPLINSKI

Entry Class Code: WEB",10.0
4/8/2025,,"Recurring Withdrawal Debit Card - MC Debit Gator/OPENAI SAN FRANCISC CA

Date 04/07/25 0 5097912116 0 5734

Card 1247",6.87,,Posted,682.47,2025-04-08,6.87,Recurring Withdrawal Debit Card - MC Debit Gator/OPENAI SAN FRANCISC CADate 03/08/25 0 5067339145 0 5734Card 1247,6.29875
4/8/2025,,"Recurring Withdrawal Debit Card - MC Debit Gator/TUBEBUDDYCOM* 8668823239 CA

Date 04/07/25 0 5097928096 0 5734

Card 1247",7.5,,Posted,689.34,2025-04-08,7.5,"Recurring Withdrawal Debit Card - MC Debit Gator/TUBEBUDDYCOM* 8668823239 CA

Date 05/07/25 0 5127999675 0 5734

Card 1247",7.5
4/8/2025,,"Recurring Withdrawal Debit Card Fee/MASTERCARD ISSUER CROSS-BORDER FEE

Date 04/08/25 0 5098910705 0 5734

Card 1247",0.23,,Posted,696.84,2025-04-08,0.23,"Withdrawal Debit Card Fee/MASTERCARD ISSUER CROSS-BORDER FEE

Date 03/31/25 0 5090929332 0 5817

Card 1247",0.11399999999999999
4/8/2025,,"Recurring Withdrawal Debit Card - MC Debit Gator/NOTEGPT.IO ADMIRALTY KO

Date 04/08/25 0 5098910705 0 5734

Card 1247",29.0,,Posted,697.07,2025-04-08,29.0,Recurring Withdrawal Debit Card - MC Debit Gator/NOTEGPT.IO ADMIRALTY KODate 02/08/25 0 5039144067 2 5734Card 1247,29.0
4/8/2025,,"Withdrawal Debit Card MC Debit Gator/GRU/EZ-PAY WEB PYMT 352-334-3434 FL

Date 04/07/25 0 5097325360 0 4900

Card 1247",133.69,,Posted,726.07,2025-04-08,133.69,"Withdrawal Debit Card MC Debit Gator/GRU/EZ-PAY WEB PYMT 352-334-3434 FL

Date 05/07/25 0 5127319905 0 4900

Card 1247",133.69
4/8/2025,,"Withdrawal POS #000000112784/SUNOCO 8002212501 4234 SW 20TH AVE

GAINESVILLE FL

Card 1247",21.84,,Posted,859.76,2025-04-08,21.84,"Withdrawal POS #000000216148/SUNOCO 8002212501 4234 SW 20TH AVE

GAINESVILLE FL

Card 1247",21.84
4/7/2025,,"Withdrawal POS #000000134088/AMAZON.COM*N888H1072 SEATTLE WA

Card 1247",10.18,,Posted,881.6,2025-04-07,10.18,"Withdrawal POS #000000134088/AMAZON.COM*N888H1072 SEATTLE WA

Card 1247",10.46
4/7/2025,,"Withdrawal POS #000000000003/AMAZON.COM*1U8092W83 SEATTLE WA

Card 1247",44.65,,Posted,891.78,2025-04-07,44.65,"Withdrawal POS #000000000003/AMAZON.COM*1U8092W83 SEATTLE WA

Card 1247",44.65
4/7/2025,,"Withdrawal POS #000000000032/AMAZON.COM*EO01Y18N3 SEATTLE WA

Card 1247",20.36,,Posted,936.43,2025-04-07,20.36,"Withdrawal POS #000000000003/AMAZON.COM*1U8092W83 SEATTLE WA

Card 1247",20.36
4/7/2025,,"Recurring Withdrawal Debit Card - MC Debit Gator/SUPERPOWER CHATGPT MIDDLETOWN DE

Date 04/05/25 0 5095135373 1 5734

Card 1247",15.0,,Posted,956.79,2025-04-07,15.0,"Recurring Withdrawal Debit Card - MC Debit Gator/SUPERPOWER CHATGPT MIDDLETOWN DE

Date 06/05/25 0 5156229550 1 5734

Card 1247",15.0
4/7/2025,,"Recurring Withdrawal Debit Card - MC Debit Gator/SUPERPOWER CHATGPT MIDDLETOWN DE

Date 04/05/25 0 5095135372 1 5734

Card 1247",15.0,,Posted,971.79,2025-04-07,15.0,"Recurring Withdrawal Debit Card - MC Debit Gator/SUPERPOWER CHATGPT MIDDLETOWN DE

Date 06/05/25 0 5156229550 1 5734

Card 1247",15.0
4/7/2025,,"Withdrawal Debit Card MC Debit Gator/IONOS INC. CHESTERBROOK PA

Date 04/06/25 0 5096139388 1 4816

Card 1247",1.0,,Posted,986.79,2025-04-07,1.0,"Withdrawal Debit Card MC Debit Gator/IONOS INC. CHESTERBROOK PA

Date 06/05/25 0 5156041339 1 4816

Card 1247",1.0
4/7/2025,,"Withdrawal Debit Card MC Debit Gator/CIRCLE K # 06782 GAINESVILLE FL

Date 04/05/25 0 5095133634 1 5499

Card 1247",26.99,,Posted,987.79,2025-04-07,26.99,Withdrawal Debit Card MC Debit Gator/CIRCLE K # 06782 GAINESVILLE FLDate 01/31/25 0 5031331003 1 5499Card 1247,27.095
4/7/2025,,"Recurring Withdrawal Debit Card - MC Debit Gator/APPLE.COM/BILL 866-712-7753 CA

Date 04/06/25 0 5096127456 1 5818

Card 1247",2.99,,Posted,1014.78,2025-04-07,2.99,Recurring Withdrawal Debit Card - MC Debit Gator/APPLE.COM/BILL 866-712-7753 CADate 01/05/25 0 5005839185 0 5818Card 1247,2.99
4/7/2025,,"Withdrawal ACH FLUENT-Gainesvil/TYPE: PAYMENT ID: 1371804719

CO: FLUENT-Gainesvil

NAME: steven chaplinskiEntry Class Code: WEB",45.0,,Posted,1017.77,2025-04-07,45.0,"Withdrawal ACH FLUENT-Gainesvil/TYPE: PAYMENT ID: 1371804719

CO: FLUENT-Gainesvil

NAME: steven chaplinskiEntry Class Code: WEB",45.0
4/7/2025,,"Withdrawal ACH AIRTABLE.com/bil/TYPE: AIRTABLE.c ID: 4270465600

CO: AIRTABLE.com/bil

NAME: STEVEN CHAPLINSKIEntry Class Code: WEB",31.0,,Posted,1062.77,2025-04-07,31.0,"Withdrawal ACH AIRTABLE.com/bil/TYPE: AIRTABLE.c ID: 4270465600

CO: AIRTABLE.com/bil

NAME: STEVEN CHAPLINSKIEntry Class Code: WEB",31.0
4/7/2025,,"Withdrawal POS #000000204012/SUNOCO 8002212501 4234 SW 20TH AVE

GAINESVILLE FL

Card 1247",21.84,,Posted,1093.77,2025-04-07,21.84,"Withdrawal POS #000000216148/SUNOCO 8002212501 4234 SW 20TH AVE

GAINESVILLE FL

Card 1247",21.84
4/6/2025,,"Recurring Withdrawal Debit Card - MC Debit Gator/OPENAI *CHATGPT SUBSCR SAN FRANCISC CA

Date 04/04/25 0 5094561526 0 5734

Card 1247",20.0,,Posted,1115.61,2025-04-06,20.0,"Recurring Withdrawal Debit Card - MC Debit Gator/OPENAI *CHATGPT SUBSCR SAN FRANCISC CA

Date 06/04/25 0 5155335474 0 5734

Card 1247",20.0
4/6/2025,,"Recurring Withdrawal Debit Card - MC Debit Gator/OPENAI SAN FRANCISC CA

Date 04/04/25 0 5094381115 2 5734

Card 1247",6.09,,Posted,1135.61,2025-04-06,6.09,Recurring Withdrawal Debit Card - MC Debit Gator/OPENAI SAN FRANCISC CADate 03/08/25 0 5067339145 0 5734Card 1247,6.29875
4/6/2025,,"Withdrawal Debit Card MC Debit Gator/HOSTINGER* HOSTINGER.C WILMINGTON DE

Date 04/04/25 0 5094291695 2 7372

Card 1247",14.98,,Posted,1141.7,2025-04-06,14.98,"Recurring Withdrawal Debit Card - MC Debit Gator/HOSTINGER* HOSTINGER.C WILMINGTON DE

Date 05/05/25 0 5125011239 1 7372

Card 1247",14.98
4/6/2025,,"Withdrawal Debit Card MC Debit Gator/INSTACART*159 SAN FRANCISC CA

Date 04/05/25 0 5095016197 1 5411

Card 1247",38.02,,Posted,1156.68,2025-04-06,38.02,"Withdrawal Debit Card MC Debit Gator/INSTACART*159 SAN FRANCISC CA

Date 03/22/25 0 5081791779 0 5411

Card 1247",38.010000000000005
4/6/2025,,"Withdrawal Debit Card MC Debit Gator/IONOS INC. CHESTERBROOK PA

Date 04/05/25 0 5095015218 1 4816

Card 1247",18.0,,Posted,1194.7,2025-04-06,18.0,"Withdrawal Debit Card MC Debit Gator/IONOS INC. CHESTERBROOK PA

Date 06/05/25 0 5156041339 1 4816

Card 1247",18.0
4/4/2025,,"Withdrawal ACH XAI LLC/TYPE: XAI LLC ID: 1800948598 CO: XAI LLC

NAME: STEVEN J CHAPLINSKI

Entry Class Code: WEB",5.0,,Posted,1212.7,2025-04-04,5.0,"Withdrawal ACH XAI LLC/TYPE: XAI LLC ID: 1800948598 CO: XAI LLC

NAME: STEVEN J CHAPLINSKI

Entry Class Code: WEB",5.0
4/4/2025,,"Withdrawal Debit Card MC Debit Gator/HOSTINGER* HOSTINGER.C WILMINGTON DE

Date 04/04/25 0 5094028682 1 7372

Card 1247",13.17,,Posted,1217.7,2025-04-04,13.17,"Recurring Withdrawal Debit Card - MC Debit Gator/HOSTINGER* HOSTINGER.C WILMINGTON DE

Date 05/05/25 0 5125011239 1 7372

Card 1247",13.17
4/4/2025,,"Recurring Withdrawal Debit Card - MC Debit Gator/APPLE.COM/BILL 866-712-7753 CA

Date 04/03/25 0 5093962196 0 5818

Card 1247",2.99,,Posted,1230.87,2025-04-04,2.99,Recurring Withdrawal Debit Card - MC Debit Gator/APPLE.COM/BILL 866-712-7753 CADate 01/05/25 0 5005839185 0 5818Card 1247,2.99
4/3/2025,,"Withdrawal Bill Payment #000000362529/CS Addtl Storage Park Avenue,345

CA

Card 1247",9.99,,Posted,1233.86,2025-04-03,9.99,"Withdrawal Bill Payment #000000362529/CS Addtl Storage Park Avenue,345

CA

Card 1247",9.99
4/3/2025,,"Withdrawal Bill Payment #000000366741/Adobe Park Avenue,345 adobe.com CA

Card 1247",19.99,,Posted,1243.85,2025-04-03,19.99,"Withdrawal Bill Payment #000000366741/Adobe Park Avenue,345 adobe.com CA

Card 1247",19.99
4/3/2025,,"Withdrawal POS #000000995800/SUNOCO 8002212501 4234 SW 20TH AVE

GAINESVILLE FL

Card 1247",18.41,,Posted,1263.84,2025-04-03,18.41,"Withdrawal POS #000000666979/SUNOCO 8002212501 4234 SW 20TH AVE

GAINESVILLE FL

Card 1247",18.575
4/3/2025,,"Recurring Withdrawal Debit Card - MC Debit Gator/NOTION LABS, INC. SAN FRANCISC CA

Date 04/02/25 0 5092100172 1 7372

Card 1247",22.0,,Posted,1282.25,2025-04-03,22.0,"Recurring Withdrawal Debit Card - MC Debit Gator/NOTION LABS, INC. SAN FRANCISC CA

Date 06/02/25 0 5153210973 1 7372

Card 1247",22.0
4/2/2025,,"Recurring Withdrawal Debit Card - MC Debit Gator/MYDESIGNS - PRO - MON LAS VEGAS NV

Date 04/01/25 0 5091214195 1 5734

Card 1247",49.99,,Posted,1304.25,2025-04-02,49.99,"Recurring Withdrawal Debit Card - MC Debit Gator/MYDESIGNS - PRO - MON LAS VEGAS NV

Date 06/01/25 0 5152146505 1 5734

Card 1247",49.99
4/2/2025,,"Recurring Withdrawal Debit Card - MC Debit Gator/PARAMOUNT+ WEST HOLLYWO CA

Date 04/01/25 0 5091067744 1 4899

Card 1247",14.96,,Posted,1354.24,2025-04-02,14.96,Recurring Withdrawal Debit Card - MC Debit Gator/PARAMOUNT+ WEST HOLLYWO CADate 01/01/25 0 5001909499 0 4899Card 1247,14.96
4/2/2025,,"Withdrawal ACH Watson Realty Co/TYPE: WEB PMTS ID: 9000321157

CO: Watson Realty Co

NAME: Steven chaplinskiEntry Class Code: WEB",1179.0,,Posted,1369.2,2025-04-02,1179.0,"Withdrawal ACH Watson Realty Co/TYPE: WEB PMTS ID: 9000321157

CO: Watson Realty Co

NAME: Steven chaplinskiEntry Class Code: WEB",1179.0
4/2/2025,,"Withdrawal ACH FLUENT-Gainesvil/TYPE: PAYMENT ID: 1371804719

CO: FLUENT-Gainesvil

NAME: steven chaplinskiEntry Class Code: WEB",25.0,,Posted,2548.2,2025-04-02,25.0,"Withdrawal ACH FLUENT-Gainesvil/TYPE: PAYMENT ID: 1371804719

CO: FLUENT-Gainesvil

NAME: steven chaplinskiEntry Class Code: WEB",25.0
4/2/2025,,"Withdrawal ACH AppFolio, Inc. F/TYPE: WEB PMTS ID: 9001406550

CO: AppFolio, Inc. F

NAME: Steven chaplinskiEntry Class Code: WEB",2.49,,Posted,2573.2,2025-04-02,2.49,"Withdrawal ACH AppFolio, Inc. F/TYPE: WEB PMTS ID: 9001406550

CO: AppFolio, Inc. F

NAME: Steven chaplinskiEntry Class Code: WEB",2.49
4/1/2025,,"Recurring Withdrawal Debit Card - MC Debit Gator/PADDLE.NET* SETAPP NEW YORK NY

Date 04/01/25 0 5091930268 0 5817

Card 1247",9.99,,Posted,2575.69,2025-04-01,9.99,"Recurring Withdrawal Debit Card - MC Debit Gator/PADDLE.NET* SETAPP NEW YORK NY

Date 05/31/25 0 5151555568 2 5817

Card 1247",9.99
4/1/2025,,"Withdrawal Debit Card MC Debit Gator/INSTACART*159 SAN FRANCISC CA

Date 03/31/25 0 5090929413 0 5411

Card 1247",52.0,,Posted,2585.68,2025-04-01,52.0,Withdrawal Debit Card MC Debit Gator/INSTACART*159 SAN FRANCISC CADate 03/13/25 0 5072883709 0 5411Card 1247,52.0
4/1/2025,,"Withdrawal Debit Card Fee/MASTERCARD ISSUER CROSS-BORDER FEE

Date 03/31/25 0 5090929332 0 5817

Card 1247",0.08,,Posted,2637.68,2025-04-01,0.08,"Withdrawal Debit Card Fee/MASTERCARD ISSUER CROSS-BORDER FEE

Date 03/31/25 0 5090929332 0 5817

Card 1247",0.11399999999999999
4/1/2025,,"Withdrawal Debit Card MC Debit Gator/OBSIDIAN.MD OAKVILLE NOR ON

Date 03/31/25 0 5090929332 0 5817

Card 1247",10.0,,Posted,2637.76,2025-04-01,10.0,"Withdrawal Debit Card MC Debit Gator/OBSIDIAN.MD OAKVILLE NOR ON

Date 03/31/25 0 5090929332 0 5817

Card 1247",10.0
4/1/2025,,"Recurring Withdrawal Debit Card - MC Debit Gator/FS *RAINDROP.IO SANTA BARBAR CA

Date 03/31/25 0 5090928275 0 5734

Card 1247",3.0,,Posted,2647.76,2025-04-01,3.0,"Recurring Withdrawal Debit Card - MC Debit Gator/FS *RAINDROP.IO SANTA BARBAR CA

Date 04/30/25 0 5120038015 1 5734

Card 1247",3.0
4/1/2025,,"Withdrawal POS #000020856446/GOOGLE *YouTubePremium 1600 Amphitheatre

Parkw Mountain View CA

Card 1247",15.92,,Posted,2646.69,2025-04-01,15.92,"Withdrawal POS #000020312090/GOOGLE *YouTubePremium 1600 Amphitheatre

Parkw Mountain View CA

Card 1247",15.92
4/1/2025,,"Withdrawal POS #000000904370/SUNOCO 8002212501 4234 SW 20TH AVE

GAINESVILLE FL

Card 1247",18.41,,Posted,2662.61,2025-04-01,18.41,"Withdrawal POS #000000666979/SUNOCO 8002212501 4234 SW 20TH AVE

GAINESVILLE FL

Card 1247",18.575
3/31/2025,,"Withdrawal Debit Card MC Debit Gator/ANTHROPIC SAN FRANCISC CA

Date 03/30/25 0 5089101571 1 5734

Card 1247",5.0,,Posted,2681.02,2025-03-31,5.0,"Withdrawal Debit Card MC Debit Gator/VIDIQ SAN FRANCISC CA

Date 05/31/25 0 5151573162 0 5734

Card 1247",5.0
3/31/2025,,"Withdrawal Debit Card Fee/MASTERCARD ISSUER CROSS-BORDER FEE

Date 03/30/25 0 5089099408 1 5817

Card 1247",0.08,,Posted,2686.02,2025-03-31,0.08,"Withdrawal Debit Card Fee/MASTERCARD ISSUER CROSS-BORDER FEE

Date 03/31/25 0 5090929332 0 5817

Card 1247",0.11399999999999999
3/31/2025,,"Withdrawal Debit Card MC Debit Gator/HAILUOAI.VIDEO SINGAPORE SG

Date 03/30/25 0 5089099408 1 5817

Card 1247",9.99,,Posted,2686.1,2025-03-31,9.99,"Withdrawal Debit Card MC Debit Gator/HAILUOAI.VIDEO SINGAPORE SG

Date 03/30/25 0 5089099408 1 5817

Card 1247",9.99
3/31/2025,,"Withdrawal Debit Card Fee/MASTERCARD ISSUER CROSS-BORDER FEE

Date 03/30/25 0 5089270441 0 4816

Card 1247",0.04,,Posted,2696.09,2025-03-31,0.04,"Withdrawal Debit Card Fee/MASTERCARD ISSUER CROSS-BORDER FEE

Date 03/31/25 0 5090929332 0 5817

Card 1247",0.11399999999999999
3/31/2025,,"Withdrawal Debit Card MC Debit Gator/PAYPAL *SHENDUQRWEA 4029357733 HK

Date 03/30/25 0 5089270441 0 4816

Card 1247",5.3,,Posted,2696.13,2025-03-31,5.3,"Withdrawal Debit Card MC Debit Gator/PAYPAL *SHENDUQRWEA 4029357733 HK

Date 03/30/25 0 5089270441 0 4816

Card 1247",5.3
3/31/2025,,"Withdrawal ACH FLUENT-Gainesvil/TYPE: PAYMENT ID: 1371804719

CO: FLUENT-Gainesvil

NAME: steven chaplinskiEntry Class Code: WEB",35.0,,Posted,2701.43,2025-03-31,35.0,"Withdrawal ACH FLUENT-Gainesvil/TYPE: PAYMENT ID: 1371804719

CO: FLUENT-Gainesvil

NAME: steven chaplinskiEntry Class Code: WEB",35.0
3/31/2025,,"Withdrawal ACH FLUENT-Gainesvil/TYPE: PAYMENT ID: 1371804719

CO: FLUENT-Gainesvil

NAME: steven chaplinskiEntry Class Code: WEB",25.0,,Posted,2736.43,2025-03-31,25.0,"Withdrawal ACH FLUENT-Gainesvil/TYPE: PAYMENT ID: 1371804719

CO: FLUENT-Gainesvil

NAME: steven chaplinskiEntry Class Code: WEB",25.0
3/30/2025,,"Withdrawal POS #000000828055/SUNOCO 8002212501 4234 SW 20TH AVE

GAINESVILLE FL

Card 1247",18.41,,Posted,2761.43,2025-03-30,18.41,"Withdrawal POS #000000216148/SUNOCO 8002212501 4234 SW 20TH AVE

GAINESVILLE FL

Card 1247",18.41
3/30/2025,,"Withdrawal POS #000000362248/AMAZON.COM*S368X2NI3 SEATTLE WA

Card 1247",10.74,,Posted,2779.84,2025-03-30,10.74,"Withdrawal POS #000000134088/AMAZON.COM*N888H1072 SEATTLE WA

Card 1247",10.46
3/30/2025,,"Recurring Withdrawal Debit Card - MC Debit Gator/OPENAI SAN FRANCISC CA

Date 03/29/25 0 5088560328 2 5734

Card 1247",6.36,,Posted,2790.58,2025-03-30,6.36,Recurring Withdrawal Debit Card - MC Debit Gator/OPENAI SAN FRANCISC CADate 03/08/25 0 5067339145 0 5734Card 1247,6.29875
3/30/2025,,"Recurring Withdrawal Debit Card - MC Debit Gator/SUPERPOWER CHATGPT MIDDLETOWN DE

Date 03/29/25 0 5088037830 1 5734

Card 1247",15.0,,Posted,2796.94,2025-03-30,15.0,"Recurring Withdrawal Debit Card - MC Debit Gator/SUPERPOWER CHATGPT MIDDLETOWN DE

Date 06/05/25 0 5156229550 1 5734

Card 1247",15.0
3/30/2025,,"Withdrawal Debit Card MC Debit Gator/IONOS INC. CHESTERBROOK PA

Date 03/29/25 0 5088910148 0 4816

Card 1247",3.5,,Posted,2811.94,2025-03-30,3.5,"Withdrawal Debit Card MC Debit Gator/IONOS INC. CHESTERBROOK PA

Date 06/05/25 0 5156041339 1 4816

Card 1247",3.0
3/30/2025,,"Withdrawal Debit Card MC Debit Gator/WALGREENS #5024 GAINESVILLE FL

Date 03/28/25 0 5087551811 2 5912

Card 1247",15.0,,Posted,2815.44,2025-03-30,15.0,"Withdrawal Debit Card MC Debit Gator/WALGREENS #9304 GAINESVILLE FL

Date 05/30/25 0 5150232309 1 5912

Card 1247",15.0
3/30/2025,,"Withdrawal Debit Card MC Debit Gator/CIRCLE K # 06782 GAINESVILLE FL

Date 03/28/25 0 5087904842 0 5499

Card 1247",19.33,,Posted,2830.44,2025-03-30,19.33,"Withdrawal Debit Card MC Debit Gator/CIRCLE K # 06782 GAINESVILLE FL

Date 04/09/25 0 5099980889 0 5499

Card 1247",19.54
3/30/2025,,"Withdrawal POS #000000000089/AMAZON.COM*NF6Z16BF3 SEATTLE WA

Card 1247",20.36,,Posted,2849.77,2025-03-30,20.36,"Withdrawal POS #000000000003/AMAZON.COM*1U8092W83 SEATTLE WA

Card 1247",20.36
3/28/2025,,"Withdrawal POS #000000721608/SUNOCO 8002212501 4234 SW 20TH AVE

GAINESVILLE FL

Card 1247",18.41,,Posted,2870.13,2025-03-28,18.41,"Withdrawal POS #000000216148/SUNOCO 8002212501 4234 SW 20TH AVE

GAINESVILLE FL

Card 1247",18.41
3/28/2025,,"Withdrawal Debit Card MC Debit Gator/INSTACART*159 SAN FRANCISC CA

Date 03/27/25 0 5086352176 0 5411

Card 1247",63.11,,Posted,2888.54,2025-03-28,63.11,Withdrawal Debit Card MC Debit Gator/INSTACART*159 SAN FRANCISC CADate 03/13/25 0 5072883709 0 5411Card 1247,63.11
3/28/2025,,"Withdrawal Debit Card MC Debit Gator/CIRCLE K # 06782 GAINESVILLE FL

Date 03/26/25 0 5085313150 1 5499

Card 1247",3.86,,Posted,2951.65,2025-03-28,3.86,Withdrawal Debit Card MC Debit Gator/CIRCLE K # 06782 GAINESVILLE FLDate 01/31/25 0 5031331003 1 5499Card 1247,3.86
3/28/2025,,"Withdrawal POS #000010144479/WALGREENS 2415 SW 75TH 2415 SW 75TH ST

GAINESVILLE FL

Card 1247",17.03,,Posted,2955.51,2025-03-28,17.03,"Withdrawal POS #000010144479/WALGREENS 2415 SW 75TH 2415 SW 75TH ST

GAINESVILLE FL

Card 1247",17.03
3/27/2025,,"Withdrawal Debit Card MC Debit Gator/INSTACART*159 SAN FRANCISC CA

Date 03/26/25 0 5085947835 0 5411

Card 1247",35.13,,Posted,2972.54,2025-03-27,35.13,Withdrawal Debit Card MC Debit Gator/INSTACART*159 SAN FRANCISC CADate 03/13/25 0 5072883709 0 5411Card 1247,35.565
3/27/2025,,"Recurring Withdrawal Debit Card - MC Debit Gator/APPLE.COM/BILL 866-712-7753 CA

Date 03/26/25 0 5085687073 0 5818

Card 1247",15.99,,Posted,3007.67,2025-03-27,15.99,Recurring Withdrawal Debit Card - MC Debit Gator/APPLE.COM/BILL 866-712-7753 CADate 01/05/25 0 5005839185 0 5818Card 1247,15.99
3/27/2025,,"Withdrawal POS #000000666979/SUNOCO 8002212501 4234 SW 20TH AVE

GAINESVILLE FL

Card 1247",18.41,,Posted,3023.66,2025-03-27,18.41,"Withdrawal POS #000000666979/SUNOCO 8002212501 4234 SW 20TH AVE

GAINESVILLE FL

Card 1247",18.575
3/26/2025,,"Recurring Withdrawal Debit Card - MC Debit Gator/IC* INSTACART*SUBSCRIP SAN FRANCISC CA

Date 03/25/25 0 5084015896 1 5411

Card 1247",9.99,,Posted,-7.93,2025-03-26,9.99,"Recurring Withdrawal Debit Card - MC Debit Gator/IC* INSTACART*SUBSCRIP SAN FRANCISC CA

Date 05/27/25 0 5147989663 0 5411

Card 1247",9.99
3/26/2025,,"Withdrawal ACH FLUENT-Gainesvil/TYPE: PAYMENT ID: 1371804719

CO: FLUENT-Gainesvil

NAME: steven chaplinskiEntry Class Code: WEB",20.0,,Posted,2.06,2025-03-26,20.0,"Withdrawal ACH FLUENT-Gainesvil/TYPE: PAYMENT ID: 1371804719

CO: FLUENT-Gainesvil

NAME: steven chaplinskiEntry Class Code: WEB",20.5
3/26/2025,,"Withdrawal POS #000096294989/FAST TRACK #200 GAINESVILLE GAINESVILLE

Card 1247",11.35,,Posted,22.06,2025-03-26,11.35,"Withdrawal POS #000096294989/FAST TRACK #200 GAINESVILLE GAINESVILLE

Card 1247",11.35
3/25/2025,,"Withdrawal Debit Card MC Debit Gator/INSTACART*159 SAN FRANCISC CA

Date 03/24/25 0 5083900436 0 5411

Card 1247",29.0,,Posted,33.41,2025-03-25,29.0,Withdrawal Debit Card MC Debit Gator/INSTACART*159 SAN FRANCISC CADate 03/13/25 0 5072883709 0 5411Card 1247,29.0
3/24/2025,,"Withdrawal POS #000000564898/WAWA 5325 2373 SW ARCHER ROAD

FL

Card 1247",14.71,,Posted,12.41,2025-03-24,14.71,"Withdrawal POS #000000564898/WAWA 5325 2373 SW ARCHER ROAD

FL

Card 1247",14.71
3/23/2025,,"Withdrawal POS #000000519848/SUNOCO 8002212501 4234 SW 20TH AVE

GAINESVILLE FL

Card 1247",19.9,,Posted,27.12,2025-03-23,19.9,"Withdrawal POS #000000216148/SUNOCO 8002212501 4234 SW 20TH AVE

GAINESVILLE FL

Card 1247",20.33
3/23/2025,,"Withdrawal Debit Card MC Debit Gator/INSTACART*159 SAN FRANCISC CA

Date 03/22/25 0 5081791779 0 5411

Card 1247",1.25,,Posted,47.02,2025-03-23,1.25,Withdrawal Debit Card MC Debit Gator/INSTACART*159 SAN FRANCISC CADate 03/13/25 0 5072883709 0 5411Card 1247,1.125
3/23/2025,,"Withdrawal Debit Card MC Debit Gator/INSTACART*159 SAN FRANCISC CA

Date 03/22/25 0 5081281165 0 5411

Card 1247",52.02,,Posted,48.27,2025-03-23,52.02,"Withdrawal Debit Card MC Debit Gator/INSTACART*159 SAN FRANCISC CA

Date 03/22/25 0 5081791779 0 5411

Card 1247",52.02
3/23/2025,,"Recurring Withdrawal Bill Payment - #000000017652/NETFLIX COM LOS GATOS CA

Card 1247",20.71,,Posted,100.29,2025-03-23,20.71,"Recurring Withdrawal Bill Payment - #000000017652/NETFLIX COM LOS GATOS CA

Card 1247",20.71
3/22/2025,,"Withdrawal POS #000000936870/AMAZON.COM*V86L723P3 SEATTLE WA

Card 1247",20.36,,Posted,121.0,2025-03-22,20.36,"Withdrawal POS #000000134088/AMAZON.COM*N888H1072 SEATTLE WA

Card 1247",20.295
3/22/2025,,"Withdrawal ATM Fee/EFT 3401 W University Ave Gainesville FL

Card 1247",2.0,,Posted,141.36,2025-03-22,2.0,"Withdrawal ATM Fee/EFT 3401 W University Ave Gainesville FL

Card 1247",2.0
3/22/2025,,"Withdrawal at ATM #000000776623/EFT 3401 W University Ave Gainesville FL

Card 1247",23.0,,Posted,143.36,2025-03-22,23.0,"Withdrawal at ATM #000000776623/EFT 3401 W University Ave Gainesville FL

Card 1247",23.0
3/22/2025,,"Withdrawal POS #000000470173/SUNOCO 8002212501 4234 SW 20TH AVE

GAINESVILLE FL

Card 1247",21.84,,Posted,166.36,2025-03-22,21.84,"Withdrawal POS #000000347331/SUNOCO 8002212501 4234 SW 20TH AVE

GAINESVILLE FL

Card 1247",21.84
3/21/2025,,"Recurring Withdrawal Debit Card - MC Debit Gator/CANVA* I04461-36076553 CAMDEN DE

Date 03/20/25 0 5079931674 0 7333

Card 1247",12.99,,Posted,-11.8,2025-03-21,12.99,"Recurring Withdrawal Debit Card - MC Debit Gator/CANVA* I04522-50593645 CAMDEN DE

Date 05/20/25 0 5140963894 0 7333

Card 1247",12.99
3/21/2025,,"Withdrawal Debit Card MC Debit Gator/INSTACART*159 SAN FRANCISC CA

Date 03/20/25 0 5079931393 0 5411

Card 1247",36.0,,Posted,1.19,2025-03-21,36.0,Withdrawal Debit Card MC Debit Gator/INSTACART*159 SAN FRANCISC CADate 03/13/25 0 5072883709 0 5411Card 1247,35.565
3/20/2025,,"Withdrawal POS #000000402629/SUNOCO 8002212501 4234 SW 20TH AVE

GAINESVILLE FL

Card 1247",19.9,,Posted,37.19,2025-03-20,19.9,"Withdrawal POS #000000666979/SUNOCO 8002212501 4234 SW 20TH AVE

GAINESVILLE FL

Card 1247",19.685
3/20/2025,,"Withdrawal ACH FLUENT-Gainesvil/TYPE: PAYMENT ID: 1371804719

CO: FLUENT-Gainesvil

NAME: steven chaplinskiEntry Class Code: WEB",15.0,,Posted,57.09,2025-03-20,15.0,"Withdrawal ACH FLUENT-Gainesvil/TYPE: PAYMENT ID: 1371804719

CO: FLUENT-Gainesvil

NAME: steven chaplinskiEntry Class Code: WEB",15.0
3/19/2025,,"Withdrawal POS #000000336821/SUNOCO 8002212501 4234 SW 20TH AVE

GAINESVILLE FL

Card 1247",23.87,,Posted,72.09,2025-03-19,23.87,"Withdrawal POS #000000216148/SUNOCO 8002212501 4234 SW 20TH AVE

GAINESVILLE FL

Card 1247",23.655
3/19/2025,,"Withdrawal Debit Card MC Debit Gator/INSTACART*159 SAN FRANCISC CA

Date 03/18/25 0 5077362198 0 5411

Card 1247",43.0,,Posted,95.96,2025-03-19,43.0,Withdrawal Debit Card MC Debit Gator/INSTACART*159 SAN FRANCISC CADate 03/13/25 0 5072883709 0 5411Card 1247,43.0
3/19/2025,,"Withdrawal Debit Card MC Debit Gator/WAWA 5325 GAINESVILLE FL

Date 03/18/25 0 5077155043 1 5541

Card 1247",16.64,,Posted,138.96,2025-03-19,16.64,"Withdrawal Debit Card MC Debit Gator/WAWA 5325 GAINESVILLE FL

Date 03/18/25 0 5077155043 1 5541

Card 1247",16.64
3/18/2025,,"Recurring Withdrawal Debit Card - MC Debit Gator/AMAZON PRIME*RT81V9UJ3 AMZN.COM/BIL WA

Date 03/17/25 0 5076013448 1 5968

Card 1247",15.13,,Posted,155.6,2025-03-18,15.13,"Recurring Withdrawal Debit Card - MC Debit Gator/AMAZON PRIME*NZ72M6V92 AMZN.COM/BIL WA

Date 05/17/25 0 5137026065 1 5968

Card 1247",15.13
3/18/2025,,"Withdrawal POS #000000293182/SUNOCO 8002212501 4234 SW 20TH AVE

GAINESVILLE FL

Card 1247",23.44,,Posted,170.73,2025-03-18,23.44,"Withdrawal POS #000000216148/SUNOCO 8002212501 4234 SW 20TH AVE

GAINESVILLE FL

Card 1247",23.655
3/17/2025,,"Recurring Withdrawal Debit Card - MC Debit Gator/OPENAI SAN FRANCISC CA

Date 03/17/25 0 5076063070 1 5734

Card 1247",6.06,,Posted,194.17,2025-03-17,6.06,Recurring Withdrawal Debit Card - MC Debit Gator/OPENAI SAN FRANCISC CADate 03/08/25 0 5067339145 0 5734Card 1247,6.29875
3/17/2025,,"Recurring Withdrawal Debit Card - MC Debit Gator/APPLE.COM/BILL 866-712-7753 CA

Date 03/16/25 0 5075055681 1 5818

Card 1247",21.99,,Posted,200.23,2025-03-17,21.99,"Recurring Withdrawal Debit Card - MC Debit Gator/APPLE.COM/BILL 866-712-7753 CA

Date 06/03/25 0 5154093226 1 5818

Card 1247",21.99
3/17/2025,,"Withdrawal POS #000000237561/SUNOCO 8002212501 4234 SW 20TH AVE

GAINESVILLE FL

Card 1247",21.84,,Posted,222.22,2025-03-17,21.84,"Withdrawal POS #000000216148/SUNOCO 8002212501 4234 SW 20TH AVE

GAINESVILLE FL

Card 1247",21.84
3/16/2025,,"Withdrawal POS #000000209606/SUNOCO 8002212501 4234 SW 20TH AVE

GAINESVILLE FL

Card 1247",18.41,,Posted,244.06,2025-03-16,18.41,"Withdrawal POS #000000666979/SUNOCO 8002212501 4234 SW 20TH AVE

GAINESVILLE FL

Card 1247",18.575
3/16/2025,,"Withdrawal Bill Payment #000000406377/APPLE COM ONE APPLE PARK WAY ONE APPLE

CA

Card 1247",0.99,,Posted,262.47,2025-03-16,0.99,"Withdrawal Bill Payment #000000176250/APPLE COM ONE APPLE PARK WAY ONE APPLE

CA

Card 1247",0.99
3/14/2025,,Withdrawal Debit Card MC Debit Gator/INSTACART*159 SAN FRANCISC CADate 03/13/25 0 5072883709 0 5411Card 1247,72.0,,Posted,263.46,2025-03-14,72.0,Withdrawal Debit Card MC Debit Gator/INSTACART*159 SAN FRANCISC CADate 03/13/25 0 5072883709 0 5411Card 1247,72.0
3/14/2025,,Withdrawal POS #000000138065/SUNOCO 8002212501 4234 SW 20TH AVEGAINESVILLE FLCard 1247,23.65,,Posted,335.46,2025-03-14,23.65,Withdrawal POS #000000231268/SUNOCO 8002212501 4234 SW 20TH AVEGAINESVILLE FLCard 1247,23.545
3/12/2025,,Withdrawal POS #000000029649/SUNOCO 8002212501 4234 SW 20TH AVEGAINESVILLE FLCard 1247,19.9,,Posted,359.11,2025-03-12,19.9,Withdrawal POS #000000231268/SUNOCO 8002212501 4234 SW 20TH AVEGAINESVILLE FLCard 1247,19.955
3/11/2025,,Withdrawal Debit Card MC Debit Gator/AMAZON PRIME*CU90U9EJ3 AMZN.COM/BIL WADate 03/11/25 0 5070388912 1 5818Card 1247,3.4,,Posted,379.01,2025-03-11,3.4,Withdrawal Debit Card MC Debit Gator/AMAZON PRIME*CU90U9EJ3 AMZN.COM/BIL WADate 03/11/25 0 5070388912 1 5818Card 1247,3.4
3/10/2025,,Withdrawal Debit Card MC Debit Gator/GRU/EZ-PAY WEB PYMT 352-334-3434 FLDate 03/09/25 0 5068009425 1 4900Card 1247,182.55,,Posted,382.41,2025-03-10,182.55,Withdrawal Debit Card MC Debit Gator/GRU/EZ-PAY WEB PYMT 352-334-3434 FLDate 03/09/25 0 5068009425 1 4900Card 1247,182.55
3/10/2025,,Withdrawal Debit Card MC Debit Gator/COX GAINESVILLE COMM 800-234-3993 FLDate 03/09/25 0 5068137922 1 4899Card 1247,156.13,,Posted,564.96,2025-03-10,156.13,Withdrawal Debit Card MC Debit Gator/COX GAINESVILLE COMM 800-234-3993 FLDate 03/09/25 0 5068137922 1 4899Card 1247,156.13
3/10/2025,,Withdrawal ACH FLUENT-Gainesvil/TYPE: PAYMENT ID: 1371804719CO: FLUENT-GainesvilNAME: steven chaplinskiEntry Class Code: WEB,75.0,,Posted,721.09,2025-03-10,75.0,Withdrawal ACH FLUENT-Gainesvil/TYPE: PAYMENT ID: 1371804719CO: FLUENT-GainesvilNAME: steven chaplinski,75.0
3/10/2025,,Withdrawal ACH SUNO INC./TYPE: SUNO INC. ID: 1800948598CO: SUNO INC. NAME: STEVEN J CHAPLINSKIEntry Class Code: WEB,10.0,,Posted,796.09,2025-03-10,10.0,"Withdrawal ACH SUNO INC./TYPE: SUNO INC. ID: 1800948598

CO: SUNO INC. NAME: STEVEN J CHAPLINSKI

Entry Class Code: WEB",10.0
3/10/2025,,Withdrawal ACH QUORA.COM/TYPE: QUORA.COM ID: 4270465600CO: QUORA.COM NAME: STEVEN J CHAPLINSKIEntry Class Code: WEB,4.99,,Posted,806.09,2025-03-10,4.99,Withdrawal ACH QUORA.COM/TYPE: QUORA.COM ID: 4270465600CO: QUORA.COM NAME: STEVEN J CHAPLINSKIEntry Class Code: WEB,4.99
3/10/2025,,Withdrawal POS #000000160477/SUNOCO 8002212501 4234 SW 20TH AVEGAINESVILLE FLCard 1247,34.84,,Posted,811.08,2025-03-10,34.84,Withdrawal POS #000000616677/SUNOCO 8002212501 4234 SW 20TH AVEGAINESVILLE FLCard 1231,34.76
3/9/2025,,Withdrawal Debit Card MC Debit Gator/I-BLOCKLIST/PEERBLOCK MIAMI FLDate 03/08/25 0 5067675779 3 5734Card 1247,9.99,,Posted,843.93,2025-03-09,9.99,Withdrawal Debit Card MC Debit Gator/I-BLOCKLIST/PEERBLOCK MIAMI FLDate 03/08/25 0 5067675779 3 5734Card 1247,9.99
3/9/2025,,Recurring Withdrawal Debit Card - MC Debit Gator/OPENAI SAN FRANCISC CADate 03/08/25 0 5067339145 0 5734Card 1247,6.1,,Posted,853.92,2025-03-09,6.1,Recurring Withdrawal Debit Card - MC Debit Gator/OPENAI SAN FRANCISC CADate 03/08/25 0 5067339145 0 5734Card 1247,6.29875
3/9/2025,,Recurring Withdrawal Debit Card - MC Debit Gator/TUBEBUDDYCOM* 8668823239 CADate 03/07/25 0 5066672774 3 5045Card 1247,7.5,,Posted,860.02,2025-03-09,7.5,Recurring Withdrawal Debit Card - MC Debit Gator/TUBEBUDDYCOM* 8668823239 CADate 03/07/25 0 5066672774 3 5045Card 1247,7.5
3/9/2025,,Recurring Withdrawal Debit Card - MC Debit Gator/INVIDEO INC COUNTRY OF S DEDate 03/07/25 0 5066671640 3 5734Card 1247,35.0,,Posted,867.52,2025-03-09,35.0,Recurring Withdrawal Debit Card - MC Debit Gator/INVIDEO INC COUNTRY OF S DEDate 03/07/25 0 5066671640 3 5734Card 1247,35.0
3/9/2025,,Recurring Withdrawal Debit Card Fee/MASTERCARD ISSUER CROSS-BORDER FEEDate 03/08/25 0 5067338695 0 5734Card 1247,0.06,,Posted,902.52,2025-03-09,0.06,Withdrawal Debit Card Fee/MASTERCARD ISSUER CROSS-BORDER FEEDate 03/01/25 0 5060117430 2 5967Card 1247,0.15333333333333332
3/9/2025,,Recurring Withdrawal Debit Card - MC Debit Gator/IDEOGRAM AI TORONTO ONDate 03/08/25 0 5067338695 0 5734Card 1247,8.0,,Posted,902.58,2025-03-09,8.0,"Recurring Withdrawal Debit Card - MC Debit Gator/IDEOGRAM AI TORONTO ON

Date 04/08/25 0 5098321266 0 5734

Card 1247",8.0
3/9/2025,,Recurring Withdrawal Debit Card Fee/MASTERCARD ISSUER CROSS-BORDER FEEDate 03/08/25 0 5067744961 0 5734Card 1247,0.23,,Posted,910.58,2025-03-09,0.23,Withdrawal Debit Card Fee/MASTERCARD ISSUER CROSS-BORDER FEEDate 03/01/25 0 5060117430 2 5967Card 1247,0.15333333333333332
3/9/2025,,Recurring Withdrawal Debit Card - MC Debit Gator/NOTEGPT.IO ADMIRALTY KODate 03/08/25 0 5067744961 0 5734Card 1247,29.0,,Posted,910.81,2025-03-09,29.0,Recurring Withdrawal Debit Card - MC Debit Gator/NOTEGPT.IO ADMIRALTY KODate 02/08/25 0 5039144067 2 5734Card 1247,29.0
3/9/2025,,Withdrawal Debit Card MC Debit Gator/IONOS INC. CHESTERBROOK PADate 03/08/25 0 5067522264 1 4816Card 1247,23.0,,Posted,939.81,2025-03-09,23.0,Withdrawal Debit Card MC Debit Gator/IONOS INC. CHESTERBROOK PADate 03/08/25 0 5067522264 1 4816Card 1247,23.0
3/9/2025,,Recurring Withdrawal Debit Card - MC Debit Gator/APPLE.COM/BILL 866-712-7753 CADate 03/08/25 0 5067516617 1 5818Card 1247,14.97,,Posted,962.81,2025-03-09,14.97,Recurring Withdrawal Debit Card MC Debit/APPLE.COM/BILL 866-712-7753 CADate 06/18/23 0 3169087519 1 5818Card 2801,14.97
3/9/2025,,Withdrawal POS #000000571139/AMAZON.COM*BI6JD3LZ3 SEATTLE WACard 1247,18.2,,Posted,977.78,2025-03-09,18.2,Withdrawal POS #000000571139/AMAZON.COM*BI6JD3LZ3 SEATTLE WACard 1247,18.2
3/9/2025,,Withdrawal POS #000000000099/AMAZON.COM*VA0IZ8DO3 SEATTLE WACard 1247,33.84,,Posted,995.98,2025-03-09,33.84,Withdrawal POS #000000000099/AMAZON.COM*VA0IZ8DO3 SEATTLE WACard 1247,33.84
3/8/2025,,Withdrawal POS #000000117409/SUNOCO 8002212501 4234 SW 20TH AVEGAINESVILLE FLCard 1247,18.41,,Posted,1029.82,2025-03-08,18.41,Withdrawal POS #000000129774/SUNOCO 8002212501 4234 SW 20TH AVEGAINESVILLE FLCard 1247,18.41
3/8/2025,,Withdrawal POS #000061190506/SMOKE CITY 2120 SW 34TH ST GAINESVILLECard 1247,6.34,,Posted,1048.23,2025-03-08,6.34,"Withdrawal POS #000080196760/SMOKE CITY 2120 SW 34TH ST GAINESVILLE

Card 1247",6.34
3/8/2025,,Withdrawal POS #000000788547/PUBLIX 3100 SW 35TH BLVD GAINESVILLE FLCard 1247,26.8,,Posted,1054.57,2025-03-08,26.8,Withdrawal POS #000000058955/PUBLIX 3100 SW 35TH BLVD GAINESVILLE FLCard 2801,26.8
3/7/2025,,Withdrawal POS #000000956289/SUNOCO 8002212501 4234 SW 20TH AVEGAINESVILLE FLCard 1247,21.84,,Posted,1081.37,2025-03-07,21.84,Withdrawal POS #000000231268/SUNOCO 8002212501 4234 SW 20TH AVEGAINESVILLE FLCard 1247,21.625
3/6/2025,,Withdrawal Debit Card MC Debit Gator/WWW.PERPLEXITY.AI SAN FRANCISC CADate 03/06/25 0 5065324957 1 5815Card 1247,4.0,,Posted,1103.21,2025-03-06,4.0,Withdrawal Debit Card MC Debit Gator/WWW.PERPLEXITY.AI SAN FRANCISC CADate 03/06/25 0 5065324957 1 5815Card 1247,4.0
3/6/2025,,Recurring Withdrawal Debit Card - MC Debit Gator/OPENAI SAN FRANCISC CADate 03/06/25 0 5065324949 1 5734Card 1247,10.0,,Posted,1107.21,2025-03-06,10.0,Recurring Withdrawal Debit Card - MC Debit Gator/OPENAI SAN FRANCISC CADate 03/08/25 0 5067339145 0 5734Card 1247,10.0
3/6/2025,,Recurring Withdrawal Debit Card - MC Debit Gator/SUPERPOWER CHATGPT MIDDLETOWN DEDate 03/06/25 0 5065760660 0 5734Card 1247,15.0,,Posted,1117.21,2025-03-06,15.0,"Recurring Withdrawal Debit Card - MC Debit Gator/SUPERPOWER CHATGPT MIDDLETOWN DE

Date 06/05/25 0 5156229550 1 5734

Card 1247",15.0
3/6/2025,,Recurring Withdrawal Debit Card - MC Debit Gator/SUPERPOWER CHATGPT MIDDLETOWN DEDate 03/06/25 0 5065760659 0 5734Card 1247,15.0,,Posted,1132.21,2025-03-06,15.0,"Recurring Withdrawal Debit Card - MC Debit Gator/SUPERPOWER CHATGPT MIDDLETOWN DE

Date 06/05/25 0 5156229550 1 5734

Card 1247",15.0
3/6/2025,,Withdrawal Debit Card MC Debit Gator/INSTACART*159 SAN FRANCISC CADate 03/05/25 0 5064759595 0 5411Card 1247,4.09,,Posted,1147.21,2025-03-06,4.09,Withdrawal Debit Card MC Debit Gator/INSTACART*159 SAN FRANCISC CADate 03/13/25 0 5072883709 0 5411Card 1247,3.75
3/6/2025,,Withdrawal Debit Card MC Debit Gator/INSTACART*159 SAN FRANCISC CADate 03/05/25 0 5064759594 0 5411Card 1247,49.98,,Posted,1151.3,2025-03-06,49.98,Withdrawal Debit Card MC Debit Gator/INSTACART*159 SAN FRANCISC CADate 03/13/25 0 5072883709 0 5411Card 1247,49.66
3/6/2025,,Withdrawal Debit Card MC Debit Gator/IONOS INC. CHESTERBROOK PADate 03/05/25 0 5064758543 0 4816Card 1247,17.0,,Posted,1201.28,2025-03-06,17.0,Withdrawal Debit Card MC Debit Gator/IONOS INC. CHESTERBROOK PADate 03/08/25 0 5067522264 1 4816Card 1247,16.5
3/5/2025,,Recurring Withdrawal Debit Card - MC Debit Gator/OPENAI *CHATGPT SUBSCR SAN FRANCISC CADate 03/04/25 0 5063322854 0 5734Card 1247,20.0,,Posted,1218.28,2025-03-05,20.0,Recurring Withdrawal Debit Card - MC Debit Gator/OPENAI SAN FRANCISC CADate 03/08/25 0 5067339145 0 5734Card 1247,20.0
3/5/2025,,Withdrawal Debit Card MC Debit Gator/IONOS INC. CHESTERBROOK PADate 03/04/25 0 5063027389 1 4816Card 1247,1.0,,Posted,1238.28,2025-03-05,1.0,Withdrawal Debit Card MC Debit Gator/IONOS INC. CHESTERBROOK PADate 03/08/25 0 5067522264 1 4816Card 1247,1.0
3/5/2025,,Withdrawal POS #000000403709/SUNOCO 8002212501 4234 SW 20TH AVEGAINESVILLE FLCard 1247,21.84,,Posted,1239.28,2025-03-05,21.84,Withdrawal POS #000000764400/SUNOCO 8002212501 4234 SW 20TH AVEGAINESVILLE FLCard 1247,21.84
3/4/2025,,"Withdrawal Bill Payment #000000352498/Adobe Park Avenue,345 San Jose CACard 1247",19.99,,Posted,1261.12,2025-03-04,19.99,"Withdrawal Bill Payment #000000352498/Adobe Park Avenue,345 San Jose CACard 1247",19.99
3/4/2025,,Withdrawal POS #000000897140/SUNOCO 8002212501 4234 SW 20TH AVEGAINESVILLE FLCard 1247,21.84,,Posted,1281.11,2025-03-04,21.84,Withdrawal POS #000000129774/SUNOCO 8002212501 4234 SW 20TH AVEGAINESVILLE FLCard 1247,21.97
3/3/2025,,"Recurring Withdrawal Debit Card - MC Debit Gator/NOTION LABS, INC. SAN FRANCISC CADate 03/02/25 0 5061145246 1 7372Card 1247",22.0,,Posted,1302.95,2025-03-03,22.0,Recurring Withdrawal Debit Card - MC Debit Gator/OPENAI SAN FRANCISC CADate 03/08/25 0 5067339145 0 5734Card 1247,22.0
3/3/2025,,Recurring Withdrawal Debit Card - MC Debit Gator/APPLE.COM/BILL 866-712-7753 CADate 03/03/25 0 5062986121 0 5818Card 1247,2.99,,Posted,1324.95,2025-03-03,2.99,Recurring Withdrawal Debit Card - MC Debit Gator/APPLE.COM/BILL 866-712-7753 CADate 01/05/25 0 5005839185 0 5818Card 1247,2.99
3/3/2025,,Withdrawal ACH Watson Realty Co/TYPE: WEB PMTS ID: 9000321157CO: Watson Realty CoNAME: Steven chaplinskiEntry Class Code: WEB,1179.0,,Posted,1327.94,2025-03-03,1179.0,Withdrawal ACH Watson Realty Co/TYPE: WEB PMTS ID: 9000321157CO: Watson Realty CoEntry Class Code: WEB,1179.0
3/3/2025,,Withdrawal ACH FLUENT-Gainesvil/TYPE: PAYMENT ID: 1371804719CO: FLUENT-GainesvilNAME: steven chaplinskiEntry Class Code: WEB,30.0,,Posted,2506.94,2025-03-03,30.0,Withdrawal ACH FLUENT-Gainesvil/TYPE: PAYMENT ID: 1371804719CO: FLUENT-GainesvilNAME: steven chaplinski,30.0
3/3/2025,,"Withdrawal ACH AppFolio, Inc. F/TYPE: WEB PMTS ID: 9001406550CO: AppFolio, Inc. FNAME: Steven chaplinskiEntry Class Code: WEB",2.49,,Posted,2536.94,2025-03-03,2.49,"Withdrawal ACH AppFolio, Inc. F/TYPE: WEB PMTS ID: 9001406550

CO: AppFolio, Inc. F

NAME: Steven chaplinskiEntry Class Code: WEB",2.49
3/2/2025,,Withdrawal Debit Card Fee/MASTERCARD ISSUER CROSS-BORDER FEEDate 03/01/25 0 5060117430 2 5967Card 1247,0.03,,Posted,2539.43,2025-03-02,0.03,Withdrawal Debit Card Fee/MASTERCARD ISSUER CROSS-BORDER FEEDate 03/01/25 0 5060117430 2 5967Card 1247,0.15333333333333332
3/2/2025,,Withdrawal Debit Card MC Debit Gator/SEEMYHELP.COM 15143341887 NLDate 03/01/25 0 5060117430 2 5967Card 1247,3.17,,Posted,2539.46,2025-03-02,3.17,Withdrawal Debit Card MC Debit Gator/SEEMYHELP.COM 15143341887 NLDate 03/01/25 0 5060117430 2 5967Card 1247,3.17
3/2/2025,,Recurring Withdrawal Debit Card - MC Debit Gator/MYDESIGNS - PRO - MON LAS VEGAS NVDate 03/01/25 0 5060117238 2 5734Card 1247,49.99,,Posted,2542.63,2025-03-02,49.99,"Recurring Withdrawal Debit Card - MC Debit Gator/MYDESIGNS - PRO - MON LAS VEGAS NV

Date 06/01/25 0 5152146505 1 5734

Card 1247",49.99
3/2/2025,,Recurring Withdrawal Debit Card - MC Debit Gator/SUPERPOWER CHATGPT MIDDLETOWN DEDate 03/01/25 0 5060800147 3 5734Card 1247,15.0,,Posted,2592.62,2025-03-02,15.0,"Recurring Withdrawal Debit Card - MC Debit Gator/SUPERPOWER CHATGPT MIDDLETOWN DE

Date 06/05/25 0 5156229550 1 5734

Card 1247",15.0
3/2/2025,,Recurring Withdrawal Debit Card - MC Debit Gator/PARAMOUNT+ WEST HOLLYWO CADate 03/01/25 0 5060115089 2 4899Card 1247,14.96,,Posted,2607.62,2025-03-02,14.96,Recurring Withdrawal Debit Card - MC Debit Gator/PARAMOUNT+ WEST HOLLYWO CADate 01/01/25 0 5001909499 0 4899Card 1247,14.96
3/2/2025,,Recurring Withdrawal Debit Card - MC Debit Gator/PADDLE.NET* SETAPP NEW YORK NYDate 03/01/25 0 5060337134 0 5817Card 1247,9.99,,Posted,2622.58,2025-03-02,9.99,"Recurring Withdrawal Debit Card - MC Debit Gator/PADDLE.NET* SETAPP NEW YORK NY

Date 05/31/25 0 5151555568 2 5817

Card 1247",9.99
3/2/2025,,Withdrawal Debit Card MC Debit Gator/CIRCLE K # 06782 GAINESVILLE FLDate 02/27/25 0 5058785660 3 5499Card 1247,15.47,,Posted,2632.57,2025-03-02,15.47,Withdrawal Debit Card MC Debit Gator/CIRCLE K # 06782 GAINESVILLE FLDate 01/31/25 0 5031331003 1 5499Card 1247,15.425
3/2/2025,,Withdrawal POS #000000754970/SUNOCO 8002212501 4234 SW 20TH AVEGAINESVILLE FLCard 1247,18.41,,Posted,2648.04,2025-03-02,18.41,Withdrawal POS #000000129774/SUNOCO 8002212501 4234 SW 20TH AVEGAINESVILLE FLCard 1247,18.41
3/1/2025,,Withdrawal POS #000000764400/SUNOCO 8002212501 4234 SW 20TH AVEGAINESVILLE FLCard 1247,18.41,,Posted,2666.45,2025-03-01,18.41,Withdrawal POS #000000782633/SUNOCO 8002212501 4234 SW 20TH AVEGAINESVILLE FLCard 1247,18.54
3/1/2025,,Withdrawal POS #000019039802/GOOGLE *YouTubePremium 1600 AmphitheatreParkw Mountain View CACard 1247,15.92,,Posted,2684.86,2025-03-01,15.92,"Withdrawal POS #000020312090/GOOGLE *YouTubePremium 1600 Amphitheatre

Parkw Mountain View CA

Card 1247",15.92
3/1/2025,,Withdrawal POS #000000774167/PUBLIX 3100 SW 35TH BLVD GAINESVILLE FLCard 1247,45.09,,Posted,2700.78,2025-03-01,45.09,Withdrawal POS #000000741171/PUBLIX 3100 SW 35TH BLVD GAINESVILLE FLCard 2801,45.09
2/28/2025,,Withdrawal Debit Card MC Debit Gator/WALGREENS #5024 GAINESVILLE FLDate 02/27/25 0 5058715205 1 5912Card 1247,15.0,,Posted,2745.87,2025-02-28,15.0,"Withdrawal Debit Card MC Debit Gator/WALGREENS #9304 GAINESVILLE FL

Date 05/30/25 0 5150232309 1 5912

Card 1247",15.0
2/28/2025,,Withdrawal Debit Card MC Debit Gator/WALGREENS #5024 GAINESVILLE FLDate 02/27/25 0 5058715204 1 5912Card 1247,36.66,,Posted,2760.87,2025-02-28,36.66,"Withdrawal Debit Card MC Debit Gator/WALGREENS #9304 GAINESVILLE FL

Date 05/30/25 0 5150232309 1 5912

Card 1247",36.66
2/28/2025,,Withdrawal Debit Card MC Debit Gator/CIRCLE K # 26146 GAINESVILLE FLDate 02/26/25 0 5057712171 1 5499Card 1247,15.38,,Posted,2797.53,2025-02-28,15.38,Withdrawal Debit Card MC Debit Gator/CIRCLE K # 06782 GAINESVILLE FLDate 01/31/25 0 5031331003 1 5499Card 1247,15.425
2/27/2025,,Withdrawal ATM Fee/EFT 3401 W University Ave Gainesville FLCard 1247,2.0,,Posted,1812.91,2025-02-27,2.0,"Withdrawal ATM Fee/EFT 3401 W University Ave Gainesville FL

Card 1247",2.0
2/27/2025,,Withdrawal at ATM #000000570838/EFT 3401 W University Ave Gainesville FLCard 1247,23.0,,Posted,1814.91,2025-02-27,23.0,"Withdrawal at ATM #000000776623/EFT 3401 W University Ave Gainesville FL

Card 1247",23.0
2/26/2025,,Withdrawal POS #000000584528/SUNOCO 8002212501 4234 SW 20TH AVEGAINESVILLE FLCard 1247,21.84,,Posted,1837.91,2025-02-26,21.84,Withdrawal POS #000000231268/SUNOCO 8002212501 4234 SW 20TH AVEGAINESVILLE FLCard 1247,21.625
2/26/2025,,Withdrawal Debit Card MC Debit Gator/INSTACART*159 SAN FRANCISC CADate 02/25/25 0 5056880216 0 5411Card 1247,45.23,,Posted,1859.75,2025-02-26,45.23,Withdrawal Debit Card MC Debit Gator/INSTACART*159 SAN FRANCISC CADate 03/13/25 0 5072883709 0 5411Card 1247,45.41
2/25/2025,,Recurring Withdrawal Debit Card - MC Debit Gator/IC* INSTACART*SUBSCRIP SAN FRANCISC CADate 02/24/25 0 5055823500 0 5411Card 1247,9.99,,Posted,1904.98,2025-02-25,9.99,"Recurring Withdrawal Debit Card - MC Debit Gator/IC* INSTACART*SUBSCRIP SAN FRANCISC CA

Date 05/27/25 0 5147989663 0 5411

Card 1247",9.99
2/25/2025,,Withdrawal POS #000000509694/SUNOCO 8002212501 4234 SW 20TH AVEGAINESVILLE FLCard 1247,21.84,,Posted,1914.97,2025-02-25,21.84,Withdrawal POS #000000129774/SUNOCO 8002212501 4234 SW 20TH AVEGAINESVILLE FLCard 1247,21.97
2/24/2025,,Withdrawal ATM Fee/EFT 3401 W University Ave Gainesville FLCard 1247,2.0,,Posted,1936.81,2025-02-24,2.0,"Withdrawal ATM Fee/EFT 3401 W University Ave Gainesville FL

Card 1247",2.0
2/24/2025,,Withdrawal at ATM #000000359753/EFT 3401 W University Ave Gainesville FLCard 1247,33.0,,Posted,1938.81,2025-02-24,33.0,"Withdrawal at ATM #000000776623/EFT 3401 W University Ave Gainesville FL

Card 1247",33.0
2/24/2025,,Withdrawal POS #000000517746/SUNOCO 8002212501 4234 SW 20TH AVEGAINESVILLE FLCard 1247,21.84,,Posted,1971.81,2025-02-24,21.84,Withdrawal POS #000000231268/SUNOCO 8002212501 4234 SW 20TH AVEGAINESVILLE FLCard 1247,21.625
2/23/2025,,Withdrawal Debit Card MC Debit Gator/INSTACART*159 SAN FRANCISC CADate 02/22/25 0 5053321628 0 5411Card 1247,50.0,,Posted,-6.35,2025-02-23,50.0,Withdrawal Debit Card MC Debit Gator/INSTACART*159 SAN FRANCISC CADate 03/13/25 0 5072883709 0 5411Card 1247,49.66
2/23/2025,,Withdrawal Debit Card MC Debit Gator/CIRCLE K # 26146 GAINESVILLE FLDate 02/21/25 0 5052836319 0 5499Card 1247,17.19,,Posted,43.65,2025-02-23,17.19,Withdrawal Debit Card MC Debit Gator/CIRCLE K # 06782 GAINESVILLE FLDate 01/31/25 0 5031331003 1 5499Card 1247,17.05333333333333
2/23/2025,,Recurring Withdrawal Bill Payment - #000000331607/NETFLIX COM LOS GATOS CACard 1247,20.71,,Posted,60.84,2025-02-23,20.71,Recurring Withdrawal Bill Payment - #000000343444/NETFLIX COM LOS GATOS CACard 1231,20.71
2/22/2025,,Withdrawal ATM Fee/EFT 3401 W University Ave Gainesville FLCard 1247,2.0,,Posted,81.55,2025-02-22,2.0,"Withdrawal ATM Fee/EFT 3401 W University Ave Gainesville FL

Card 1247",2.0
2/22/2025,,Withdrawal at ATM #000000068777/EFT 3401 W University Ave Gainesville FLCard 1247,33.0,,Posted,83.55,2025-02-22,33.0,"Withdrawal at ATM #000000776623/EFT 3401 W University Ave Gainesville FL

Card 1247",33.0
2/21/2025,,Recurring Withdrawal Debit Card - MC Debit Gator/CANVA* I04433-39431369 CAMDEN DEDate 02/20/25 0 5051832939 0 7333Card 1247,12.99,,Posted,116.55,2025-02-21,12.99,Recurring Withdrawal Debit Card - MC Debit Gator/CANVA* I04433-39431369 CAMDEN DEDate 02/20/25 0 5051832939 0 7333Card 1247,12.99
2/21/2025,,Withdrawal POS #000000938881/SUNOCO 8002212501 4234 SW 20TH AVEGAINESVILLE FLCard 1247,21.84,,Posted,129.54,2025-02-21,21.84,Withdrawal POS #000000231268/SUNOCO 8002212501 4234 SW 20TH AVEGAINESVILLE FLCard 1247,21.625
2/20/2025,,Withdrawal POS #000000393434/SUNOCO 8002212501 4234 SW 20TH AVEGAINESVILLE FLCard 1247,18.41,,Posted,151.38,2025-02-20,18.41,Withdrawal POS #000000782633/SUNOCO 8002212501 4234 SW 20TH AVEGAINESVILLE FLCard 1247,18.54
2/19/2025,,Withdrawal ATM Fee/SOUTH STATE BK 3535 SW 34TH STREETGAINESVILLE FLCard 1247,2.0,,Posted,169.79,2025-02-19,2.0,Withdrawal ATM Fee/SOUTH STATE BK 3535 SW 34TH STREETGAINESVILLE FLCard 1247,2.0
2/19/2025,,Withdrawal at ATM #000000002102/SOUTH STATE BK 3535 SW 34TH STREETGAINESVILLE FLCard 1247,63.5,,Posted,171.79,2025-02-19,63.5,Withdrawal at ATM #000000002102/SOUTH STATE BK 3535 SW 34TH STREETGAINESVILLE FLCard 1247,63.5
2/19/2025,,Withdrawal POS #000000879769/SUNOCO 8002212501 4234 SW 20TH AVEGAINESVILLE FLCard 1247,21.41,,Posted,235.29,2025-02-19,21.41,Withdrawal POS #000000782633/SUNOCO 8002212501 4234 SW 20TH AVEGAINESVILLE FLCard 1247,21.625
2/19/2025,,Withdrawal Debit Card MC Debit Gator/INSTACART*159 SAN FRANCISC CADate 02/18/25 0 5049873156 0 5411Card 1247,45.0,,Posted,256.7,2025-02-19,45.0,Withdrawal Debit Card MC Debit Gator/INSTACART*159 SAN FRANCISC CADate 03/13/25 0 5072883709 0 5411Card 1247,45.41
2/18/2025,,Withdrawal POS #000000324063/SUNOCO 8002212501 4234 SW 20TH AVEGAINESVILLE FLCard 1247,21.84,,Posted,301.7,2025-02-18,21.84,Withdrawal POS #000000231268/SUNOCO 8002212501 4234 SW 20TH AVEGAINESVILLE FLCard 1247,21.625
2/18/2025,,Recurring Withdrawal Debit Card - MC Debit Gator/AMAZON PRIME*U74BM3BG3 AMZN.COM/BIL WADate 02/17/25 0 5048844767 0 5968Card 1247,15.13,,Posted,323.54,2025-02-18,15.13,Recurring Withdrawal Debit Card - MC Debit Gator/AMAZON PRIME*U74BM3BG3 AMZN.COM/BIL WADate 02/17/25 0 5048844767 0 5968Card 1247,15.13
2/17/2025,,Withdrawal POS #000000203758/SUNOCO 8002212501 4234 SW 20TH AVEGAINESVILLE FLCard 1247,20.01,,Posted,338.67,2025-02-17,20.01,Withdrawal POS #000000231268/SUNOCO 8002212501 4234 SW 20TH AVEGAINESVILLE FLCard 1247,19.955
2/16/2025,,Withdrawal Debit Card MC Debit Gator/INSTACART*159 SAN FRANCISC CADate 02/14/25 0 5045264835 0 5411Card 1247,49.0,,Posted,358.68,2025-02-16,49.0,Withdrawal Debit Card MC Debit Gator/INSTACART*159 SAN FRANCISC CADate 03/13/25 0 5072883709 0 5411Card 1247,49.66
2/16/2025,,Withdrawal POS #000000193415/SUNOCO 8002212501 4234 SW 20TH AVEGAINESVILLE FLCard 1247,23.44,,Posted,407.68,2025-02-16,23.44,Withdrawal POS #000000231268/SUNOCO 8002212501 4234 SW 20TH AVEGAINESVILLE FLCard 1247,23.545
2/15/2025,,Withdrawal POS #000000267044/SUNOCO 8002212501 4234 SW 20TH AVEGAINESVILLE FLCard 1247,21.41,,Posted,431.12,2025-02-15,21.41,Withdrawal POS #000000231268/SUNOCO 8002212501 4234 SW 20TH AVEGAINESVILLE FLCard 1247,21.625
2/13/2025,,Withdrawal POS #000000159674/SUNOCO 8002212501 4234 SW 20TH AVEGAINESVILLE FLCard 1247,23.65,,Posted,452.53,2025-02-13,23.65,Withdrawal POS #000000231268/SUNOCO 8002212501 4234 SW 20TH AVEGAINESVILLE FLCard 1247,23.545
2/12/2025,,Withdrawal ATM Fee/EFT 6419 W Newberry Rd Gainesville FLCard 1247,2.0,,Posted,476.18,2025-02-12,2.0,"Withdrawal ATM Fee/EFT 6419 W Newberry Rd Gainesville FL

Card 1247",2.0
2/12/2025,,Withdrawal at ATM #000000160796/EFT 6419 W Newberry Rd Gainesville FLCard 1247,48.0,,Posted,478.18,2025-02-12,48.0,"Withdrawal at ATM #000000785755/EFT 6419 W Newberry Rd Gainesville FL

Card 1247",48.0
2/12/2025,,Withdrawal POS #000000126612/SUNOCO 8002212501 4234 SW 20TH AVEGAINESVILLE FLCard 1247,21.84,,Posted,526.18,2025-02-12,21.84,Withdrawal POS #000000231268/SUNOCO 8002212501 4234 SW 20TH AVEGAINESVILLE FLCard 1247,21.625
2/11/2025,,Withdrawal Debit Card MC Debit Gator/AMAZON PRIME*B45DR82X3 AMZN.COM/BIL WADate 02/11/25 0 5042051984 1 5818Card 1247,3.4,,Posted,548.02,2025-02-11,3.4,Withdrawal Debit Card MC Debit Gator/AMAZON PRIME*CU90U9EJ3 AMZN.COM/BIL WADate 03/11/25 0 5070388912 1 5818Card 1247,3.4
2/11/2025,,Withdrawal POS #000000072493/SUNOCO 8002212501 4234 SW 20TH AVEGAINESVILLE FLCard 1247,18.41,,Posted,551.42,2025-02-11,18.41,Withdrawal POS #000000782633/SUNOCO 8002212501 4234 SW 20TH AVEGAINESVILLE FLCard 1247,18.54
2/11/2025,,Withdrawal POS #000000446485/AMAZON.COM*XN90T43R3 SEATTLE WACard 1247,20.38,,Posted,569.83,2025-02-11,20.38,Withdrawal POS #000000446485/AMAZON.COM*XN90T43R3 SEATTLE WACard 1247,20.38
2/11/2025,,Withdrawal POS #000000000004/AMAZON.COM*Q443411V3 SEATTLE WACard 1247,20.38,,Posted,590.21,2025-02-11,20.38,Withdrawal POS #000000000007/AMAZON.COM*2864R4HI1 SEATTLE WACard 1140,20.713333333333335
2/10/2025,,Withdrawal Debit Card MC Debit Gator/GRU/EZ-PAY WEB PYMT 352-334-3434 FLDate 02/09/25 0 5040010734 1 4900Card 1247,172.98,,Posted,610.59,2025-02-10,172.98,Withdrawal Debit Card MC Debit Gator/GRU/EZ-PAY WEB PYMT 352-334-3434 FLDate 03/09/25 0 5068009425 1 4900Card 1247,172.98
2/9/2025,,Withdrawal POS #000000943545/SUNOCO 8002212501 4234 SW 20TH AVEGAINESVILLE FLCard 1247,20.88,,Posted,783.57,2025-02-09,20.88,Withdrawal POS #000000455581/SUNOCO 8002212501 4234 SW 20TH AVEGAINESVILLE FLCard 1247,20.695
2/9/2025,,Withdrawal Debit Card MC Debit Gator/INSTACART*159 SAN FRANCISC CADate 02/08/25 0 5039877461 0 5411Card 1247,1.0,,Posted,804.45,2025-02-09,1.0,Withdrawal Debit Card MC Debit Gator/INSTACART*159 SAN FRANCISC CADate 03/13/25 0 5072883709 0 5411Card 1247,1.125
2/9/2025,,Withdrawal Debit Card MC Debit Gator/INSTACART*159 SAN FRANCISC CADate 02/08/25 0 5039378930 0 5411Card 1247,46.0,,Posted,805.45,2025-02-09,46.0,Withdrawal Debit Card MC Debit Gator/INSTACART*159 SAN FRANCISC CADate 03/13/25 0 5072883709 0 5411Card 1247,45.41
2/9/2025,,Recurring Withdrawal Debit Card Fee/MASTERCARD ISSUER CROSS-BORDER FEEDate 02/08/25 0 5039378735 0 5734Card 1247,0.06,,Posted,851.45,2025-02-09,0.06,Recurring Withdrawal Debit Card Fee/MASTERCARD ISSUER CROSS-BORDER FEEDate 03/08/25 0 5067338695 0 5734Card 1247,0.06
2/9/2025,,Recurring Withdrawal Debit Card - MC Debit Gator/IDEOGRAM AI TORONTO ONDate 02/08/25 0 5039378735 0 5734Card 1247,8.0,,Posted,851.51,2025-02-09,8.0,"Recurring Withdrawal Debit Card - MC Debit Gator/IDEOGRAM AI TORONTO ON

Date 04/08/25 0 5098321266 0 5734

Card 1247",8.0
2/9/2025,,Recurring Withdrawal Debit Card Fee/MASTERCARD ISSUER CROSS-BORDER FEEDate 02/08/25 0 5039144067 2 5734Card 1247,0.23,,Posted,859.51,2025-02-09,0.23,Withdrawal Debit Card Fee/MASTERCARD ISSUER CROSS-BORDER FEEDate 03/01/25 0 5060117430 2 5967Card 1247,0.15333333333333332
2/9/2025,,Recurring Withdrawal Debit Card - MC Debit Gator/NOTEGPT.IO ADMIRALTY KODate 02/08/25 0 5039144067 2 5734Card 1247,29.0,,Posted,859.74,2025-02-09,29.0,Recurring Withdrawal Debit Card - MC Debit Gator/NOTEGPT.IO ADMIRALTY KODate 02/08/25 0 5039144067 2 5734Card 1247,29.0
2/9/2025,,Withdrawal Debit Card MC Debit Gator/IONOS INC. CHESTERBROOK PADate 02/08/25 0 5039876633 0 4816Card 1247,23.0,,Posted,888.74,2025-02-09,23.0,Withdrawal Debit Card MC Debit Gator/IONOS INC. CHESTERBROOK PADate 03/08/25 0 5067522264 1 4816Card 1247,23.0
2/9/2025,,Recurring Withdrawal Debit Card - MC Debit Gator/APPLE.COM/BILL 866-712-7753 CADate 02/08/25 0 5039325895 2 5818Card 1247,12.99,,Posted,911.74,2025-02-09,12.99,Recurring Withdrawal Debit Card MC Debit/APPLE.COM/BILL 866-712-7753 CADate 06/18/23 0 3169087519 1 5818Card 2801,12.99
2/9/2025,,Withdrawal Debit Card MC Debit Gator/COX GAINESVILLE COMM 800-234-3993 FLDate 02/08/25 0 5039376753 0 4899Card 1247,156.13,,Posted,924.73,2025-02-09,156.13,Withdrawal Debit Card MC Debit Gator/COX GAINESVILLE COMM 800-234-3993 FLDate 03/09/25 0 5068137922 1 4899Card 1247,156.13
2/8/2025,,Withdrawal POS #000000957137/SUNOCO 8002212501 4234 SW 20TH AVEGAINESVILLE FLCard 1247,21.84,,Posted,1080.86,2025-02-08,21.84,Withdrawal POS #000000782633/SUNOCO 8002212501 4234 SW 20TH AVEGAINESVILLE FLCard 1247,21.625
2/7/2025,,Withdrawal Debit Card MC Debit Gator/IONOS INC. CHESTERBROOK PADate 02/06/25 0 5037921337 0 4816Card 1247,16.0,,Posted,1102.7,2025-02-07,16.0,Withdrawal Debit Card MC Debit Gator/IONOS INC. CHESTERBROOK PADate 03/08/25 0 5067522264 1 4816Card 1247,16.5
2/7/2025,,Withdrawal POS #000000827056/SUNOCO 8002212501 4234 SW 20TH AVEGAINESVILLE FLCard 1247,18.41,,Posted,1118.7,2025-02-07,18.41,Withdrawal POS #000000782633/SUNOCO 8002212501 4234 SW 20TH AVEGAINESVILLE FLCard 1247,18.54
2/6/2025,,Withdrawal Debit Card MC Debit Gator/IONOS INC. CHESTERBROOK PADate 02/05/25 0 5036019016 1 4816Card 1247,1.0,,Posted,1107.12,2025-02-06,1.0,Withdrawal Debit Card MC Debit Gator/IONOS INC. CHESTERBROOK PADate 03/08/25 0 5067522264 1 4816Card 1247,1.0
2/5/2025,,Recurring Withdrawal Debit Card - MC Debit Gator/OPENAI SAN FRANCISC CADate 02/04/25 0 5035991425 0 5734Card 1247,0.63,,Posted,1108.12,2025-02-05,0.63,Recurring Withdrawal Debit Card - MC Debit Gator/OPENAI SAN FRANCISC CADate 03/08/25 0 5067339145 0 5734Card 1247,0.63
2/5/2025,,Recurring Withdrawal Debit Card - MC Debit Gator/OPENAI *CHATGPT SUBSCR SAN FRANCISC CADate 02/04/25 0 5035323752 0 5734Card 1247,20.0,,Posted,1108.75,2025-02-05,20.0,Recurring Withdrawal Debit Card - MC Debit Gator/OPENAI SAN FRANCISC CADate 03/08/25 0 5067339145 0 5734Card 1247,20.0
2/5/2025,,Withdrawal Debit Card Fee/MASTERCARD ISSUER CROSS-BORDER FEEDate 02/03/25 0 5034323004 0 5967Card 1247,0.03,,Posted,1128.75,2025-02-05,0.03,Withdrawal Debit Card Fee/MASTERCARD ISSUER CROSS-BORDER FEEDate 03/01/25 0 5060117430 2 5967Card 1247,0.15333333333333332
2/5/2025,,Withdrawal Debit Card MC Debit Gator/ZUBBHELP.COM HAARLEM NLDate 02/03/25 0 5034323004 0 5967Card 1247,3.17,,Posted,1128.78,2025-02-05,3.17,Withdrawal Debit Card MC Debit Gator/ZUBBHELP.COM HAARLEM NLDate 02/03/25 0 5034323004 0 5967Card 1247,3.17
2/5/2025,,Withdrawal Debit Card MC Debit Gator/YVETTE GODET DMD GAINESVILLE FLDate 02/04/25 0 5035835029 0 8021Card 1247,56.8,,Posted,1131.95,2025-02-05,56.8,Withdrawal Debit Card MC Debit Gator/YVETTE GODET DMD GAINESVILLE FLDate 02/04/25 0 5035835029 0 8021Card 1247,56.8
2/5/2025,,Withdrawal Debit Card MC Debit Gator/CIRCLE K # 06782 GAINESVILLE FLDate 02/03/25 0 5034984751 0 5499Card 1247,20.84,,Posted,1188.75,2025-02-05,20.84,Withdrawal Debit Card MC Debit Gator/CIRCLE K # 06782 GAINESVILLE FLDate 01/31/25 0 5031331003 1 5499Card 1247,20.73
2/5/2025,,Withdrawal POS #000000734068/PUBLIX 3100 SW 35TH BLVD GAINESVILLE FLCard 1247,60.92,,Posted,1209.59,2025-02-05,60.92,"Withdrawal POS #000000752480/PUBLIX 3100 SW 35TH BLVD GAINESVILLE FL

Card 1247",60.92
2/5/2025,,Withdrawal ATM Fee/EFT 3401 W University Ave Gainesville FLCard 1247,2.0,,Posted,1270.51,2025-02-05,2.0,"Withdrawal ATM Fee/EFT 3401 W University Ave Gainesville FL

Card 1247",2.0
2/5/2025,,Withdrawal at ATM #000000464773/EFT 3401 W University Ave Gainesville FLCard 1247,43.0,,Posted,1272.51,2025-02-05,43.0,"Withdrawal at ATM #000000776623/EFT 3401 W University Ave Gainesville FL

Card 1247",43.0
2/4/2025,,Withdrawal POS #000000646864/AMAZON.COM*MZ5BC8D43 SEATTLE WACard 1247,10.19,,Posted,1315.51,2025-02-04,10.19,Withdrawal POS #000000446485/AMAZON.COM*XN90T43R3 SEATTLE WACard 1247,10.19
2/4/2025,,Recurring Withdrawal Debit Card - MC Debit Gator/APPLE.COM/BILL 866-712-7753 CADate 02/04/25 0 5035127693 1 5818Card 1247,29.99,,Posted,1325.7,2025-02-04,29.99,Recurring Withdrawal Debit Card MC Debit/APPLE.COM/BILL 866-712-7753 CADate 06/18/23 0 3169087519 1 5818Card 2801,29.99
2/4/2025,,"Withdrawal Bill Payment #000000199905/Adobe Park Avenue,345 San Jose CACard 1247",19.99,,Posted,1355.69,2025-02-04,19.99,"Withdrawal Bill Payment #000000352498/Adobe Park Avenue,345 San Jose CACard 1247",19.99
2/3/2025,,"Recurring Withdrawal Debit Card - MC Debit Gator/NOTION LABS, INC. SAN FRANCISC CADate 02/02/25 0 5033134219 1 7372Card 1247",22.0,,Posted,1375.68,2025-02-03,22.0,"Recurring Withdrawal Debit Card - MC Debit Gator/NOTION LABS, INC. SAN FRANCISC CA

Date 06/02/25 0 5153210973 1 7372

Card 1247",22.0
2/3/2025,,Recurring Withdrawal Debit Card - MC Debit Gator/OPENAI SAN FRANCISC CADate 02/02/25 0 5033247681 1 5734Card 1247,5.0,,Posted,1397.68,2025-02-03,5.0,Recurring Withdrawal Debit Card - MC Debit Gator/OPENAI SAN FRANCISC CADate 03/08/25 0 5067339145 0 5734Card 1247,5.0
2/3/2025,,Recurring Withdrawal Debit Card - MC Debit Gator/OPENAI SAN FRANCISC CADate 02/02/25 0 5033247680 1 5734Card 1247,5.0,,Posted,1402.68,2025-02-03,5.0,Recurring Withdrawal Debit Card - MC Debit Gator/OPENAI SAN FRANCISC CADate 03/08/25 0 5067339145 0 5734Card 1247,5.0
2/3/2025,,Recurring Withdrawal Debit Card - MC Debit Gator/APPLE.COM/BILL 866-712-7753 CADate 02/03/25 0 5034963465 0 5818Card 1247,2.99,,Posted,1407.68,2025-02-03,2.99,Recurring Withdrawal Debit Card - MC Debit Gator/APPLE.COM/BILL 866-712-7753 CADate 01/05/25 0 5005839185 0 5818Card 1247,2.99
2/3/2025,,Recurring Withdrawal Debit Card - MC Debit Gator/APPLE.COM/BILL 866-712-7753 CADate 02/02/25 0 5033127007 1 5818Card 1247,29.99,,Posted,1410.67,2025-02-03,29.99,Recurring Withdrawal Debit Card MC Debit/APPLE.COM/BILL 866-712-7753 CADate 06/18/23 0 3169087519 1 5818Card 2801,29.99
2/3/2025,,Withdrawal ACH Watson Realty Co/TYPE: WEB PMTS ID: 9000321157CO: Watson Realty CoNAME: Steven chaplinskiEntry Class Code: WEB,1179.0,,Posted,1440.66,2025-02-03,1179.0,Withdrawal ACH Watson Realty Co/TYPE: WEB PMTS ID: 9000321157CO: Watson Realty CoEntry Class Code: WEB,1179.0
2/3/2025,,"Withdrawal ACH AppFolio, Inc. F/TYPE: WEB PMTS ID: 9001406550CO: AppFolio, Inc. FNAME: Steven chaplinskiEntry Class Code: WEB",2.49,,Posted,2619.66,2025-02-03,2.49,"Withdrawal ACH AppFolio, Inc. F/TYPE: WEB PMTS ID: 9001406550

CO: AppFolio, Inc. F

NAME: Steven chaplinskiEntry Class Code: WEB",2.49
2/2/2025,,Withdrawal POS #000000781738/SUNOCO 8002212501 4234 SW 20TH AVEGAINESVILLE FLCard 1247,17.08,,Posted,2622.15,2025-02-02,17.08,Withdrawal POS #000000782633/SUNOCO 8002212501 4234 SW 20TH AVEGAINESVILLE FLCard 1247,17.08
2/2/2025,,Recurring Withdrawal Debit Card - MC Debit Gator/PARAMOUNT+ WEST HOLLYWO CADate 02/01/25 0 5032847059 0 4899Card 1247,14.96,,Posted,2639.23,2025-02-02,14.96,Recurring Withdrawal Debit Card - MC Debit Gator/PARAMOUNT+ WEST HOLLYWO CADate 01/01/25 0 5001909499 0 4899Card 1247,14.96
2/2/2025,,Withdrawal Debit Card MC Debit Gator/INSTACART*159 SAN FRANCISC CADate 01/31/25 0 5031931716 1 5411Card 1247,52.0,,Posted,2654.19,2025-02-02,52.0,Withdrawal Debit Card MC Debit Gator/INSTACART*159 SAN FRANCISC CADate 03/13/25 0 5072883709 0 5411Card 1247,52.0
2/2/2025,,Recurring Withdrawal Debit Card Fee/MASTERCARD ISSUER CROSS-BORDER FEEDate 02/01/25 0 5032990634 0 5967Card 1247,0.01,,Posted,2706.19,2025-02-02,0.01,Withdrawal Debit Card Fee/MASTERCARD ISSUER CROSS-BORDER FEEDate 03/01/25 0 5060117430 2 5967Card 1247,0.15333333333333332
2/2/2025,,Recurring Withdrawal Debit Card - MC Debit Gator/PROBILLER.COM 855-232-9555 CYDate 02/01/25 0 5032990634 0 5967Card 1247,1.14,,Posted,2706.2,2025-02-02,1.14,Recurring Withdrawal Debit Card - MC Debit Gator/PROBILLER.COM 855-232-9555 CYDate 02/01/25 0 5032990634 0 5967Card 1247,1.14
2/2/2025,,Withdrawal Debit Card Fee/MASTERCARD ISSUER CROSS-BORDER FEEDate 02/01/25 0 5032990633 0 5967Card 1247,0.01,,Posted,2707.34,2025-02-02,0.01,Withdrawal Debit Card Fee/MASTERCARD ISSUER CROSS-BORDER FEEDate 03/01/25 0 5060117430 2 5967Card 1247,0.15333333333333332
2/2/2025,,Withdrawal Debit Card MC Debit Gator/PROBILLER.COM 855-232-9555 CYDate 02/01/25 0 5032990633 0 5967Card 1247,1.14,,Posted,2707.35,2025-02-02,1.14,Recurring Withdrawal Debit Card - MC Debit Gator/PROBILLER.COM 855-232-9555 CYDate 02/01/25 0 5032990634 0 5967Card 1247,1.14
2/2/2025,,Withdrawal Debit Card MC Debit Gator/IONOS INC. CHESTERBROOK PADate 01/31/25 0 5031845289 0 4816Card 1247,40.0,,Posted,2708.49,2025-02-02,40.0,Withdrawal Debit Card MC Debit Gator/IONOS INC. CHESTERBROOK PADate 03/08/25 0 5067522264 1 4816Card 1247,40.0
2/2/2025,,Withdrawal Debit Card MC Debit Gator/CIRCLE K # 06782 GAINESVILLE FLDate 01/31/25 0 5031331003 1 5499Card 1247,16.99,,Posted,2748.49,2025-02-02,16.99,Withdrawal Debit Card MC Debit Gator/CIRCLE K # 06782 GAINESVILLE FLDate 01/31/25 0 5031331003 1 5499Card 1247,17.05333333333333
2/1/2025,,Withdrawal POS #000000675669/SUNOCO 8002212501 4234 SW 20TH AVEGAINESVILLE FLCard 1247,17.08,,Posted,2765.48,2025-02-01,17.08,Withdrawal POS #000000782633/SUNOCO 8002212501 4234 SW 20TH AVEGAINESVILLE FLCard 1247,17.08
2/1/2025,,Withdrawal POS #000000364287/ETSY.COM*US WWW.ETSY.COM/ BROOKLYN NYCard 1247,0.6,,Posted,2782.56,2025-02-01,0.6,Withdrawal POS #000000364287/ETSY.COM*US WWW.ETSY.COM/ BROOKLYN NYCard 1247,0.6
1/31/2025,,Recurring Withdrawal Debit Card - MC Debit Gator/APPLE.COM/BILL 866-712-7753 CADate 01/31/25 0 5031045448 1 5818Card 1247,2.99,,Posted,1783.16,2025-01-31,2.99,Recurring Withdrawal Debit Card MC Debit/APPLE.COM/BILL 866-712-7753 CADate 06/18/23 0 3169087519 1 5818Card 2801,2.99
1/31/2025,,Recurring Withdrawal Debit Card - MC Debit Gator/APPLE.COM/BILL 866-712-7753 CADate 01/31/25 0 5031045443 1 5818Card 1247,24.99,,Posted,1786.15,2025-01-31,24.99,Recurring Withdrawal Debit Card MC Debit/APPLE.COM/BILL 866-712-7753 CADate 06/18/23 0 3169087519 1 5818Card 2801,24.99
1/31/2025,,Recurring Withdrawal Debit Card - MC Debit Gator/NETFLIX.COM CADate 01/30/25 0 5030869462 0 4899Card 1247,17.84,,Posted,1811.14,2025-01-31,17.84,Recurring Withdrawal Debit Card - MC Debit Gator/NETFLIX.COM CADate 01/30/25 0 5030869462 0 4899Card 1247,17.84
1/31/2025,,Withdrawal POS #000000000043/AMAZON.COM*ZC1UW3U40 SEATTLE WACard 1247,10.19,,Posted,1828.98,2025-01-31,10.19,Withdrawal POS #000000000099/AMAZON.COM*VA0IZ8DO3 SEATTLE WACard 1247,10.19
1/31/2025,,Withdrawal POS #000000000343/CIRCLE K # 06782 5237 GAINESVILLE FLCard 1247,10.01,,Posted,1839.17,2025-01-31,10.01,Withdrawal POS #000000882351/CIRCLE K # 06782 GAINESVILLE FLCard 1140,10.42
1/30/2025,,Withdrawal POS #000019353777/GOOGLE *YouTubePremium 1600 AmphitheatreParkw Mountain View CACard 1247,9.1,,Posted,1849.18,2025-01-30,9.1,"Withdrawal POS #000020312090/GOOGLE *YouTubePremium 1600 Amphitheatre

Parkw Mountain View CA

Card 1247",9.1
1/30/2025,,Recurring Withdrawal Debit Card - MC Debit Gator/MYDESIGNS - PRO - MON LAS VEGAS NVDate 01/29/25 0 5029913031 0 5734Card 1247,49.99,,Posted,1858.28,2025-01-30,49.99,"Recurring Withdrawal Debit Card - MC Debit Gator/MYDESIGNS - PRO - MON LAS VEGAS NV

Date 06/01/25 0 5152146505 1 5734

Card 1247",49.99
1/30/2025,,Recurring Withdrawal Debit Card - MC Debit Gator/SUPERPOWER CHATGPT MIDDLETOWN DEDate 01/29/25 0 5029912376 0 5734Card 1247,15.0,,Posted,1908.27,2025-01-30,15.0,"Recurring Withdrawal Debit Card - MC Debit Gator/SUPERPOWER CHATGPT MIDDLETOWN DE

Date 06/05/25 0 5156229550 1 5734

Card 1247",15.0
1/30/2025,,Recurring Withdrawal Debit Card - MC Debit Gator/PADDLE.NET* SETAPP NEW YORK NYDate 01/29/25 0 5029860662 0 5817Card 1247,14.5,,Posted,1923.27,2025-01-30,14.5,"Recurring Withdrawal Debit Card - MC Debit Gator/PADDLE.NET* SETAPP NEW YORK NY

Date 05/31/25 0 5151555568 2 5817

Card 1247",14.5
1/30/2025,,Withdrawal Debit Card MC Debit Gator/CANVA* I04402-39206221 CAMDEN DEDate 01/29/25 0 5029860414 0 7333Card 1247,12.99,,Posted,1937.77,2025-01-30,12.99,Withdrawal Debit Card MC Debit Gator/CANVA* I04402-39206221 CAMDEN DEDate 01/29/25 0 5029860414 0 7333Card 1247,12.99
1/30/2025,,Withdrawal Debit Card MC Debit Gator/COPYTONOTI WILMINGTON DEDate 01/29/25 0 5029909612 0 5817Card 1247,47.0,,Posted,1950.76,2025-01-30,47.0,Withdrawal Debit Card MC Debit Gator/COPYTONOTI WILMINGTON DEDate 01/29/25 0 5029909612 0 5817Card 1247,47.0
1/30/2025,,Withdrawal Debit Card MC Debit Gator/WALGREENS #5024 GAINESVILLE FLDate 01/29/25 0 5029087400 1 5912Card 1247,15.0,,Posted,1997.76,2025-01-30,15.0,"Withdrawal Debit Card MC Debit Gator/WALGREENS #9304 GAINESVILLE FL

Date 05/30/25 0 5150232309 1 5912

Card 1247",15.0
1/30/2025,,Withdrawal Debit Card MC Debit Gator/CIRCLE K # 06782 GAINESVILLE FLDate 01/28/25 0 5028905568 0 5499Card 1247,15.47,,Posted,2012.76,2025-01-30,15.47,Withdrawal Debit Card MC Debit Gator/CIRCLE K # 06782 GAINESVILLE FLDate 01/31/25 0 5031331003 1 5499Card 1247,15.425
1/29/2025,,Withdrawal POS #000000525481/SUNOCO 8002212501 4234 SW 20TH AVEGAINESVILLE FLCard 1247,17.08,,Posted,28.23,2025-01-29,17.08,Withdrawal POS #000000455581/SUNOCO 8002212501 4234 SW 20TH AVEGAINESVILLE FLCard 1247,17.08
1/29/2025,,Withdrawal Debit Card MC Debit Gator/WALGREENS #5024 GAINESVILLE FLDate 01/28/25 0 5028088379 1 5912Card 1247,10.81,,Posted,45.31,2025-01-29,10.81,"Withdrawal Debit Card MC Debit Gator/WALGREENS #9304 GAINESVILLE FL

Date 05/30/25 0 5150232309 1 5912

Card 1247",10.81
1/27/2025,,Withdrawal Debit Card MC Debit Gator/INSTACART*159 SAN FRANCISC CADate 01/26/25 0 5026250026 0 5411Card 1247,50.23,,Posted,56.12,2025-01-27,50.23,Withdrawal Debit Card MC Debit Gator/INSTACART*159 SAN FRANCISC CADate 03/13/25 0 5072883709 0 5411Card 1247,50.23
1/27/2025,,Withdrawal ATM Fee/EFT 6419 W Newberry Rd Gainesville FLCard 1247,2.0,,Posted,106.35,2025-01-27,2.0,"Withdrawal ATM Fee/EFT 6419 W Newberry Rd Gainesville FL

Card 1247",2.0
1/27/2025,,Withdrawal at ATM #000000618599/EFT 6419 W Newberry Rd Gainesville FLCard 1247,53.0,,Posted,108.35,2025-01-27,53.0,"Withdrawal at ATM #000000785755/EFT 6419 W Newberry Rd Gainesville FL

Card 1247",53.0
1/27/2025,,Withdrawal POS #000000553411/WAWA 5325 2373 SW ARCHER ROADFLCard 1247,14.71,,Posted,161.35,2025-01-27,14.71,Withdrawal POS #000000553411/WAWA 5325 2373 SW ARCHER ROADFLCard 1247,14.71
1/26/2025,,Withdrawal ATM Fee/EFT 6419 W Newberry Rd Gainesville FLCard 1247,2.0,,Posted,176.06,2025-01-26,2.0,"Withdrawal ATM Fee/EFT 6419 W Newberry Rd Gainesville FL

Card 1247",2.0
1/26/2025,,Withdrawal at ATM #000000554718/EFT 6419 W Newberry Rd Gainesville FLCard 1247,23.0,,Posted,178.06,2025-01-26,23.0,"Withdrawal at ATM #000000785755/EFT 6419 W Newberry Rd Gainesville FL

Card 1247",23.0
1/26/2025,,Withdrawal POS #000097243000/WAWA 5325 2373 SW ARCHER ROADFLCard 1247,10.98,,Posted,1.06,2025-01-26,10.98,Withdrawal POS #000000553411/WAWA 5325 2373 SW ARCHER ROADFLCard 1247,10.98
1/25/2025,,Withdrawal POS #000000455581/SUNOCO 8002212501 4234 SW 20TH AVEGAINESVILLE FLCard 1247,20.51,,Posted,10.04,2025-01-25,20.51,Withdrawal POS #000000455581/SUNOCO 8002212501 4234 SW 20TH AVEGAINESVILLE FLCard 1247,20.695
1/24/2025,,Withdrawal ATM Fee/EFT 6419 W Newberry Rd Gainesville FLCard 1247,2.0,,Posted,30.55,2025-01-24,2.0,"Withdrawal ATM Fee/EFT 6419 W Newberry Rd Gainesville FL

Card 1247",2.0
1/24/2025,,Withdrawal at ATM #000000365727/EFT 6419 W Newberry Rd Gainesville FLCard 1247,28.0,,Posted,32.55,2025-01-24,28.0,"Withdrawal at ATM #000000785755/EFT 6419 W Newberry Rd Gainesville FL

Card 1247",28.0
1/24/2025,,Recurring Withdrawal Debit Card - MC Debit Gator/IC* INSTACART*SUBSCRIP SAN FRANCISC CADate 01/24/25 0 5024009804 1 5411Card 1247,9.99,,Posted,60.55,2025-01-24,9.99,"Recurring Withdrawal Debit Card - MC Debit Gator/IC* INSTACART*SUBSCRIP SAN FRANCISC CA

Date 05/27/25 0 5147989663 0 5411

Card 1247",9.99
1/24/2025,,Withdrawal POS #000000439538/SUNOCO 8002212501 4234 SW 20TH AVEGAINESVILLE FLCard 1247,22.87,,Posted,70.54,2025-01-24,22.87,Withdrawal POS #000000782633/SUNOCO 8002212501 4234 SW 20TH AVEGAINESVILLE FLCard 1247,22.87
1/24/2025,,Withdrawal POS #000000507326/AMAZON.COM*ZG65P87B0 SEATTLE WACard 1247,44.65,,Posted,93.41,2025-01-24,44.65,Withdrawal POS #000000507326/AMAZON.COM*ZG65P87B0 SEATTLE WACard 1247,44.65
1/23/2025,,Withdrawal POS #000000375346/SUNOCO 8002212501 4234 SW 20TH AVEGAINESVILLE FLCard 1247,17.08,,Posted,38.06,2025-01-23,17.08,Withdrawal POS #000000782633/SUNOCO 8002212501 4234 SW 20TH AVEGAINESVILLE FLCard 1247,17.08
1/23/2025,,Withdrawal POS #000000409491/AMAZON.COM*Z55VK0Y01 SEATTLE WACard 1247,10.19,,Posted,55.14,2025-01-23,10.19,Withdrawal POS #000000914130/AMAZON.COM*ZR50X2ML1 SEATTLE WACard 1231,10.46
1/22/2025,,Withdrawal POS #000000268342/SUNOCO 8002212501 4234 SW 20TH AVEGAINESVILLE FLCard 1247,20.51,,Posted,65.33,2025-01-22,20.51,Withdrawal POS #000000028242/SUNOCO 8002212501 4234 SW 20TH AVEGAINESVILLE FLCard 1231,20.51
1/21/2025,,Withdrawal Debit Card MC Debit Gator/INSTACART*159 SAN FRANCISC CADate 01/20/25 0 5020903203 0 5411Card 1247,58.79,,Posted,85.84,2025-01-21,58.79,Withdrawal Debit Card MC Debit Gator/INSTACART*159 SAN FRANCISC CADate 03/13/25 0 5072883709 0 5411Card 1247,58.79
1/21/2025,,Withdrawal Debit Card MC Debit Gator/CIRCLE K # 26146 GAINESVILLE FLDate 01/19/25 0 5019898493 0 5499Card 1247,16.98,,Posted,144.63,2025-01-21,16.98,Withdrawal Debit Card MC Debit Gator/CIRCLE K # 06782 GAINESVILLE FLDate 01/31/25 0 5031331003 1 5499Card 1247,17.05333333333333
1/21/2025,,Withdrawal ACH FLUENT-Gainesvil/TYPE: PAYMENT ID: 1371804719CO: FLUENT-GainesvilNAME: steven chaplinskiEntry Class Code: WEB,15.0,,Posted,161.61,2025-01-21,15.0,Withdrawal ACH FLUENT-Gainesvil/TYPE: PAYMENT ID: 1371804719CO: FLUENT-GainesvilNAME: steven chaplinski,15.0
1/20/2025,,Withdrawal POS #000000308001/SUNOCO 8002212501 4234 SW 20TH AVEGAINESVILLE FLCard 1247,20.51,,Posted,176.61,2025-01-20,20.51,Withdrawal POS #000000455581/SUNOCO 8002212501 4234 SW 20TH AVEGAINESVILLE FLCard 1247,20.695
1/20/2025,,Withdrawal Debit Card MC Debit Gator/CIRCLE K # 06782 GAINESVILLE FLDate 01/18/25 0 5018029946 1 5499Card 1247,20.62,,Posted,-2.88,2025-01-20,20.62,Withdrawal Debit Card MC Debit Gator/CIRCLE K # 06782 GAINESVILLE FLDate 01/31/25 0 5031331003 1 5499Card 1247,20.73
1/19/2025,,Withdrawal POS #000000187957/SUNOCO 8002212501 4234 SW 20TH AVEGAINESVILLE FLCard 1247,14.92,,Posted,17.74,2025-01-19,14.92,Withdrawal POS #000000129774/SUNOCO 8002212501 4234 SW 20TH AVEGAINESVILLE FLCard 1247,14.92
1/19/2025,,Recurring Withdrawal Debit Card - MC Debit Gator/AMAZON PRIME*Z585917C0 AMZN.COM/BIL WADate 01/17/25 0 5017190493 2 5968Card 1247,15.13,,Posted,32.66,2025-01-19,15.13,Recurring Withdrawal Debit Card - MC Debit Gator/AMAZON PRIME*U74BM3BG3 AMZN.COM/BIL WADate 02/17/25 0 5048844767 0 5968Card 1247,15.13
1/19/2025,,Withdrawal POS #000000759580/PUBLIX 3100 SW 35TH BLVD GAINESVILLE FLCard 1247,14.74,,Posted,47.79,2025-01-19,14.74,Withdrawal POS #000000058955/PUBLIX 3100 SW 35TH BLVD GAINESVILLE FLCard 2801,14.74
1/17/2025,,Withdrawal POS #000000120665/SUNOCO 8002212501 4234 SW 20TH AVEGAINESVILLE FLCard 1247,17.08,,Posted,62.53,2025-01-17,17.08,Withdrawal POS #000000231268/SUNOCO 8002212501 4234 SW 20TH AVEGAINESVILLE FLCard 1247,17.08
1/17/2025,,Withdrawal ACH FLUENT-Gainesvil/TYPE: PAYMENT ID: 1371804719CO: FLUENT-GainesvilNAME: steven chaplinskiEntry Class Code: WEB,27.5,,Posted,79.61,2025-01-17,27.5,Withdrawal ACH FLUENT-Gainesvil/TYPE: PAYMENT ID: 1371804719CO: FLUENT-GainesvilNAME: steven chaplinski,27.5
1/16/2025,,Withdrawal POS #000000129774/SUNOCO 8002212501 4234 SW 20TH AVEGAINESVILLE FLCard 1247,22.1,,Posted,107.11,2025-01-16,22.1,Withdrawal POS #000000129774/SUNOCO 8002212501 4234 SW 20TH AVEGAINESVILLE FLCard 1247,21.97
1/15/2025,,Withdrawal POS #000000300162/SUNOCO 8002212501 4234 SW 20TH AVEGAINESVILLE FLCard 1247,17.08,,Posted,129.21,2025-01-15,17.08,Withdrawal POS #000000900121/SUNOCO 8002212501 4234 SW 20TH AVEGAINESVILLE FLCard 1231,17.08
1/14/2025,,Withdrawal POS #000000194849/ETSY.COM*US WWW.ETSY.COM/ BROOKLYN NYCard 1247,11.8,,Posted,146.29,2025-01-14,11.8,Withdrawal POS #000000364287/ETSY.COM*US WWW.ETSY.COM/ BROOKLYN NYCard 1247,11.8
1/14/2025,,Withdrawal POS #000000753028/PUBLIX 3930 SW ARCHER ROAD GAINESVILLECard 1247,22.97,,Posted,158.09,2025-01-14,22.97,Withdrawal POS #000000753028/PUBLIX 3930 SW ARCHER ROAD GAINESVILLECard 1247,22.665
1/14/2025,,Withdrawal POS #000096297241/FAST TRACK #200 GAINESVILLE GAINESVILLECard 1247,10.0,,Posted,181.06,2025-01-14,10.0,"Withdrawal POS #000096294989/FAST TRACK #200 GAINESVILLE GAINESVILLE

Card 1247",10.0
1/14/2025,,Withdrawal POS #000000230647/SUNOCO 8002212501 4234 SW 20TH AVEGAINESVILLE FLCard 1247,0.17,,Posted,191.06,2025-01-14,0.17,Withdrawal POS #000000231268/SUNOCO 8002212501 4234 SW 20TH AVEGAINESVILLE FLCard 1247,0.17
1/14/2025,,Withdrawal POS #000000223141/SUNOCO 8002212501 4234 SW 20TH AVEGAINESVILLE FLCard 1247,17.08,,Posted,191.23,2025-01-14,17.08,Withdrawal POS #000000231268/SUNOCO 8002212501 4234 SW 20TH AVEGAINESVILLE FLCard 1247,17.08
1/13/2025,,Withdrawal ACH VENMO/TYPE: PAYMENT ID: 3264681992 CO: VENMONAME: AVATAR ARTSEntry Class Code: WEB,14.99,,Posted,208.31,2025-01-13,14.99,Withdrawal ACH VENMO/TYPE: PAYMENT ID: 3264681992 CO: VENMONAME: AVATAR ARTSEntry Class Code: WEB,14.99
1/13/2025,,Withdrawal POS #000000758317/PUBLIX 3100 SW 35TH BLVD GAINESVILLE FLCard 1247,37.08,,Posted,223.3,2025-01-13,37.08,Withdrawal POS #000000741171/PUBLIX 3100 SW 35TH BLVD GAINESVILLE FLCard 2801,37.08
1/12/2025,,Recurring Withdrawal Debit Card - MC Debit Gator/APPLE.COM/BILL 866-712-7753 CADate 01/11/25 0 5011099289 2 5818Card 1247,9.99,,Posted,260.38,2025-01-12,9.99,Recurring Withdrawal Debit Card MC Debit/APPLE.COM/BILL 866-712-7753 CADate 06/18/23 0 3169087519 1 5818Card 2801,9.99
1/12/2025,,Withdrawal Debit Card MC Debit Gator/AMAZON PRIME*ZD49Q6KK0 AMZN.COM/BIL WADate 01/11/25 0 5011099282 2 5818Card 1247,3.4,,Posted,270.37,2025-01-12,3.4,Withdrawal Debit Card MC Debit Gator/AMAZON PRIME*CU90U9EJ3 AMZN.COM/BIL WADate 03/11/25 0 5070388912 1 5818Card 1247,3.4
1/11/2025,,Withdrawal POS #000000169586/SUNOCO 8002212501 4234 SW 20TH AVEGAINESVILLE FLCard 1247,17.08,,Posted,273.77,2025-01-11,17.08,Withdrawal POS #000000231268/SUNOCO 8002212501 4234 SW 20TH AVEGAINESVILLE FLCard 1247,17.08
1/11/2025,,Withdrawal POS #000000757925/PUBLIX 3100 SW 35TH BLVD GAINESVILLE FLCard 1247,57.86,,Posted,290.85,2025-01-11,57.86,Withdrawal POS #000000058955/PUBLIX 3100 SW 35TH BLVD GAINESVILLE FLCard 2801,58.075
1/10/2025,,Withdrawal ACH VENMO/TYPE: PAYMENT ID: 3264681992 CO: VENMONAME: AVATAR ARTSEntry Class Code: WEB,9.99,,Posted,348.71,2025-01-10,9.99,Withdrawal ACH VENMO/TYPE: PAYMENT ID: 3264681992 CO: VENMONAME: AVATAR ARTSEntry Class Code: WEB,9.99
1/9/2025,,Withdrawal POS #000000944455/SUNOCO 8002212501 4234 SW 20TH AVEGAINESVILLE FLCard 1247,22.42,,Posted,358.7,2025-01-09,22.42,Withdrawal POS #000000455581/SUNOCO 8002212501 4234 SW 20TH AVEGAINESVILLE FLCard 1247,22.42
1/7/2025,,Withdrawal Bill Payment #000000483994/GRU EZ PAY 301 SE 4TH AVE 301 SE 4TH AVCard 1247,169.56,,Posted,381.12,2025-01-07,169.56,Withdrawal Bill Payment #000000483994/GRU EZ PAY 301 SE 4TH AVE 301 SE 4TH AVCard 1247,169.56
1/7/2025,,Withdrawal POS #000000000007/AMAZON.COM*ZD7CG3LN0 SEATTLE WACard 1247,18.2,,Posted,550.68,2025-01-07,18.2,Withdrawal POS #000000507326/AMAZON.COM*ZG65P87B0 SEATTLE WACard 1247,18.2
1/6/2025,,"Recurring Withdrawal Debit Card - MC Debit Gator/NOTION LABS, INC. SAN FRANCISC CADate 01/05/25 0 5005050863 1 7372Card 1247",22.0,,Posted,568.88,2025-01-06,22.0,"Recurring Withdrawal Debit Card - MC Debit Gator/NOTION LABS, INC. SAN FRANCISC CA

Date 06/02/25 0 5153210973 1 7372

Card 1247",22.0
1/5/2025,,Withdrawal POS #000000348915/SUNOCO 8002212501 4234 SW 20TH AVEGAINESVILLE FLCard 1247,17.08,,Posted,590.88,2025-01-05,17.08,Withdrawal POS #000000455581/SUNOCO 8002212501 4234 SW 20TH AVEGAINESVILLE FLCard 1247,17.08
1/5/2025,,Recurring Withdrawal Debit Card - MC Debit Gator/OPENAI *CHATGPT SUBSCR SAN FRANCISC CADate 01/04/25 0 5004256434 0 5734Card 1247,20.0,,Posted,607.96,2025-01-05,20.0,Recurring Withdrawal Debit Card - MC Debit Gator/OPENAI SAN FRANCISC CADate 03/08/25 0 5067339145 0 5734Card 1247,20.0
1/5/2025,,Recurring Withdrawal Debit Card - MC Debit Gator/APPLE.COM/BILL 866-712-7753 CADate 01/05/25 0 5005839186 0 5818Card 1247,10.0,,Posted,627.96,2025-01-05,10.0,Recurring Withdrawal Debit Card - MC Debit Gator/APPLE.COM/BILL 866-712-7753 CADate 01/05/25 0 5005839185 0 5818Card 1247,10.0
1/5/2025,,Recurring Withdrawal Debit Card - MC Debit Gator/APPLE.COM/BILL 866-712-7753 CADate 01/05/25 0 5005839185 0 5818Card 1247,2.99,,Posted,637.96,2025-01-05,2.99,Recurring Withdrawal Debit Card - MC Debit Gator/APPLE.COM/BILL 866-712-7753 CADate 01/05/25 0 5005839185 0 5818Card 1247,2.99
1/5/2025,,Recurring Withdrawal Debit Card - MC Debit Gator/APPLE.COM/BILL 866-712-7753 CADate 01/05/25 0 5005839184 0 5818Card 1247,2.99,,Posted,640.95,2025-01-05,2.99,Recurring Withdrawal Debit Card - MC Debit Gator/APPLE.COM/BILL 866-712-7753 CADate 01/05/25 0 5005839185 0 5818Card 1247,2.99
1/5/2025,,"Withdrawal Bill Payment #000000192398/Adobe Park Avenue,345 San Jose CACard 1247",19.99,,Posted,643.94,2025-01-05,19.99,"Withdrawal Bill Payment #000000352498/Adobe Park Avenue,345 San Jose CACard 1247",19.99
1/3/2025,,Withdrawal POS #000000782633/SUNOCO 8002212501 4234 SW 20TH AVEGAINESVILLE FLCard 1247,18.67,,Posted,663.93,2025-01-03,18.67,Withdrawal POS #000000782633/SUNOCO 8002212501 4234 SW 20TH AVEGAINESVILLE FLCard 1247,18.54
1/3/2025,,Withdrawal Debit Card Fee/MASTERCARD ISSUER CROSS-BORDER FEEDate 01/02/25 0 5002325431 0 8999Card 1247,0.02,,Posted,682.6,2025-01-03,0.02,Withdrawal Debit Card Fee/MASTERCARD ISSUER CROSS-BORDER FEEDate 03/01/25 0 5060117430 2 5967Card 1247,0.15333333333333332
1/3/2025,,Withdrawal Debit Card MC Debit Gator/SOCIALWICK INNSBRUCK ATDate 01/02/25 0 5002325431 0 8999Card 1247,2.53,,Posted,682.62,2025-01-03,2.53,Withdrawal Debit Card MC Debit Gator/SOCIALWICK INNSBRUCK ATDate 01/02/25 0 5002325431 0 8999Card 1247,2.53
1/3/2025,,Withdrawal Debit Card MC Debit Gator/COX GAINESVILLE COMM 800-234-3993 FLDate 01/02/25 0 5002952888 0 4899Card 1247,156.13,,Posted,685.15,2025-01-03,156.13,Withdrawal Debit Card MC Debit Gator/COX GAINESVILLE COMM 800-234-3993 FLDate 03/09/25 0 5068137922 1 4899Card 1247,156.13
1/3/2025,,Withdrawal POS #000000837107/AMAZON.COM*ZD3F87JM2 SEATTLE WACard 1247,28.75,,Posted,841.28,2025-01-03,28.75,Withdrawal POS #000000507326/AMAZON.COM*ZG65P87B0 SEATTLE WACard 1247,28.75
1/2/2025,,Withdrawal POS #000000231268/SUNOCO 8002212501 4234 SW 20TH AVEGAINESVILLE FLCard 1247,24.59,,Posted,870.03,2025-01-02,24.59,Withdrawal POS #000000231268/SUNOCO 8002212501 4234 SW 20TH AVEGAINESVILLE FLCard 1247,24.59
1/2/2025,,Withdrawal Debit Card MC Debit Seminol/CIRCLE K # 26146 GAINESVILLE FLDate 12/31/24 0 4366909335 0 5499Card 1231,18.88,,Posted,894.62,2025-01-02,18.88,Withdrawal Debit Card MC Debit Seminol/CIRCLE K # 26146 GAINESVILLE FLDate 12/31/24 0 4366909335 0 5499Card 1231,18.88
1/2/2025,,Withdrawal Debit Card MC Debit Gator/OPENAI SAN FRANCISC CADate 01/02/25 0 5002915655 0 5734Card 1247,5.0,,Posted,913.5,2025-01-02,5.0,Recurring Withdrawal Debit Card - MC Debit Gator/OPENAI SAN FRANCISC CADate 03/08/25 0 5067339145 0 5734Card 1247,5.0
1/2/2025,,Recurring Withdrawal Debit Card - MC Debit Gator/PARAMOUNT+ WEST HOLLYWO CADate 01/01/25 0 5001909499 0 4899Card 1247,14.96,,Posted,918.5,2025-01-02,14.96,Recurring Withdrawal Debit Card - MC Debit Gator/PARAMOUNT+ WEST HOLLYWO CADate 01/01/25 0 5001909499 0 4899Card 1247,14.96
1/2/2025,,Withdrawal ACH Watson Realty Co/TYPE: WEB PMTS ID: 9000321157CO: Watson Realty CoNAME: Steven chaplinskiEntry Class Code: WEB,1179.0,,Posted,933.46,2025-01-02,1179.0,Withdrawal ACH Watson Realty Co/TYPE: WEB PMTS ID: 9000321157CO: Watson Realty CoEntry Class Code: WEB,1179.0
1/2/2025,,Withdrawal ACH FLUENT-Gainesvil/TYPE: PAYMENT ID: 1371804719CO: FLUENT-GainesvilNAME: steven chaplinskiEntry Class Code: WEB,54.0,,Posted,2112.46,2025-01-02,54.0,Withdrawal ACH FLUENT-Gainesvil/TYPE: PAYMENT ID: 1371804719CO: FLUENT-GainesvilNAME: steven chaplinski,53.75
1/2/2025,,"Withdrawal ACH AppFolio, Inc. F/TYPE: WEB PMTS ID: 9001406550CO: AppFolio, Inc. FNAME: Steven chaplinskiEntry Class Code: WEB",2.49,,Posted,2166.46,2025-01-02,2.49,"Withdrawal ACH AppFolio, Inc. F/TYPE: WEB PMTS ID: 9001406550

CO: AppFolio, Inc. F

NAME: Steven chaplinskiEntry Class Code: WEB",2.49
1/2/2025,,Withdrawal POS #000000305858/AMAZON.COM*ZP8I63AL0 SEATTLE WACard 1247,23.64,,Posted,2168.95,2025-01-02,23.64,Withdrawal POS #000000507326/AMAZON.COM*ZG65P87B0 SEATTLE WACard 1247,23.64
1/1/2025,,Withdrawal Debit Card MC Debit Seminol/GAINESVILLE PSYCHIATRY GAINESVILLE FLDate 12/31/24 0 4366974295 0 8011Card 1231,78.0,,Posted,2192.59,2025-01-01,78.0,Withdrawal Debit Card MC Debit Seminol/GAINESVILLE PSYCHIATRY GAINESVILLE FLDate 12/31/24 0 4366974295 0 8011Card 1231,78.0
1/1/2025,,Withdrawal Debit Card MC Debit Seminol/WALGREENS #5024 GAINESVILLE FLDate 12/31/24 0 4366953359 0 5912Card 1231,15.0,,Posted,2270.59,2025-01-01,15.0,Withdrawal Debit Card MC Debit Seminol/WALGREENS #9304 GAINESVILLE FLDate 12/20/23 0 3354958966 0 5912Card 2801,15.0
1/1/2025,,Recurring Withdrawal Debit Card - MC Debit Gator/FS *CONTEXTSFORMAC SANTA BARBAR CADate 12/31/24 0 4366973571 0 5734Card 1247,9.99,,Posted,2285.59,2025-01-01,9.99,Recurring Withdrawal Debit Card - MC Debit Gator/FS *CONTEXTSFORMAC SANTA BARBAR CADate 12/31/24 0 4366973571 0 5734Card 1247,9.99
12/31/2024,,Withdrawal POS #000082182619/SMOKE CITY 2120 SW 34TH ST GAINESVILLECard 1247,11.66,,Posted,2295.58,2024-12-31,11.66,"Withdrawal POS #000080196760/SMOKE CITY 2120 SW 34TH ST GAINESVILLE

Card 1247",11.66
12/31/2024,,Withdrawal POS #000000733350/PUBLIX 3100 SW 35TH BLVD GAINESVILLE FLCard 1247,29.57,,Posted,2307.24,2024-12-31,29.57,"Withdrawal POS #000000752480/PUBLIX 3100 SW 35TH BLVD GAINESVILLE FL

Card 1247",29.57
12/31/2024,,Withdrawal ATM Fee/EFT 3401 W University Ave Gainesville FLCard 1247,2.0,,Posted,2336.81,2024-12-31,2.0,"Withdrawal ATM Fee/EFT 3401 W University Ave Gainesville FL

Card 1247",2.0
12/31/2024,,Withdrawal at ATM #000000158366/EFT 3401 W University Ave Gainesville FLCard 1247,13.0,,Posted,2338.81,2024-12-31,13.0,"Withdrawal at ATM #000000776623/EFT 3401 W University Ave Gainesville FL

Card 1247",13.0
12/30/2024,,Withdrawal POS #000000188532/AMAZON.COM*ZP06Y6CW0 SEATTLE WACard 1231,18.2,,Posted,2351.81,2024-12-30,18.2,Withdrawal POS #000000188532/AMAZON.COM*ZP06Y6CW0 SEATTLE WACard 1231,18.2
12/30/2024,,Withdrawal POS #000000570772/SUNOCO 8002212501 4234 SW 20TH AVEGAINESVILLE FLCard 1231,17.08,,Posted,2370.01,2024-12-30,17.08,Withdrawal POS #000000778591/SUNOCO 8002212501 4234 SW 20TH AVEGAINESVILLE FLCard 1231,17.08
12/30/2024,,Withdrawal Debit Card MC Debit Seminol/IONOS INC. CHESTERBROOK PADate 12/29/24 0 4364954464 0 4816Card 1231,1.0,,Posted,2387.09,2024-12-30,1.0,Withdrawal Debit Card MC Debit Seminol/IONOS INC. CHESTERBROOK PADate 12/29/24 0 4364954464 0 4816Card 1231,0.8400000000000001
12/30/2024,,Withdrawal ACH FLUENT-Gainesvil/TYPE: PAYMENT ID: 1371804719CO: FLUENT-GainesvilNAME: steven chaplinskiEntry Class Code: WEB,54.0,,Posted,2388.09,2024-12-30,54.0,Withdrawal ACH FLUENT-Gainesvil/TYPE: PAYMENT ID: 1371804719CO: FLUENT-GainesvilNAME: steven chaplinski,53.75
12/30/2024,,Withdrawal POS #000000522639/SUNOCO 8002212501 4234 SW 20TH AVEGAINESVILLE FLCard 1231,18.67,,Posted,2442.09,2024-12-30,18.67,Withdrawal POS #000000778591/SUNOCO 8002212501 4234 SW 20TH AVEGAINESVILLE FLCard 1231,18.67
12/29/2024,,Withdrawal Debit Card MC Debit Seminol/SAMSUNG ELECTRONICS RIDGEFIELD P NJDate 12/27/24 0 4362999827 1 5734Card 1231,8.99,,Posted,2460.76,2024-12-29,8.99,Withdrawal Debit Card MC Debit Seminol/SAMSUNG ELECTRONICS RIDGEFIELD P NJDate 12/27/24 0 4362999827 1 5734Card 1231,8.99
12/29/2024,,Withdrawal Debit Card MC Debit Seminol/WAWA 5325 GAINESVILLE FLDate 12/28/24 0 4363858796 0 5541Card 1231,19.72,,Posted,2469.75,2024-12-29,19.72,Withdrawal Debit Card MC Debit Seminol/WAWA 5325 GAINESVILLE FLDate 12/28/24 0 4363858796 0 5541Card 1231,20.21
12/29/2024,,Withdrawal Debit Card MC Debit Seminol/WALGREENS #5024 GAINESVILLE FLDate 12/27/24 0 4362000611 2 5912Card 1231,23.78,,Posted,2489.47,2024-12-29,23.78,Withdrawal Debit Card MC Debit Seminol/WALGREENS #5024 GAINESVILLE FLDate 06/26/23 0 3177001861 1 5912Card 2801,24.265
12/29/2024,,Withdrawal POS #000000504303/SUNOCO 8002212501 4234 SW 20TH AVEGAINESVILLE FLCard 1231,22.42,,Posted,2513.25,2024-12-29,22.42,Withdrawal POS #000000488663/SUNOCO 8002212501 4234 SW 20TH AVEGAINESVILLE FLCard 1231,22.42
12/28/2024,,Withdrawal POS #000000443910/SUNOCO 8002212501 4234 SW 20TH AVEGAINESVILLE FLCard 1231,20.83,,Posted,1735.67,2024-12-28,20.83,Withdrawal POS #000000488663/SUNOCO 8002212501 4234 SW 20TH AVEGAINESVILLE FLCard 1231,20.67
12/27/2024,,Withdrawal POS #000000014638/SUNOCO 8002212501 4234 SW 20TH AVEGAINESVILLE FLCard 1231,20.83,,Posted,1756.5,2024-12-27,20.83,Withdrawal POS #000000488663/SUNOCO 8002212501 4234 SW 20TH AVEGAINESVILLE FLCard 1231,20.67
12/26/2024,,Withdrawal Debit Card MC Debit Seminol/CIRCLE K # 06782 GAINESVILLE FLDate 12/24/24 0 4359511759 0 5499Card 1231,18.67,,Posted,1777.33,2024-12-26,18.67,Withdrawal Debit Card MC Debit Seminol/CIRCLE K # 06782 GAINESVILLE FLDate 09/08/24 0 4252889868 0 5499Card 1231,18.67
12/25/2024,,Withdrawal Debit Card MC Debit Seminol/INSTACART*159 SAN FRANCISC CADate 12/24/24 0 4359294650 0 5411Card 1231,70.0,,Posted,1796.0,2024-12-25,70.0,Withdrawal Debit Card MC Debit Seminol/INSTACART*159 SAN FRANCISC CADate 12/24/24 0 4359294650 0 5411Card 1231,70.0
12/25/2024,,Recurring Withdrawal Debit Card - MC Debit Seminol/FS *ADOBE SANTA BARBAR CADate 12/24/24 0 4359034647 1 5734Card 1231,0.95,,Posted,1866.0,2024-12-25,0.95,Recurring Withdrawal Debit Card - MC Debit Seminol/FS *ADOBE SANTA BARBAR CADate 12/24/24 0 4359034647 1 5734Card 1231,0.95
12/24/2024,,Withdrawal POS #000013340229/WALGREENS 2415 SW 75TH 2415 SW 75TH STGAINESVILLE FLCard 1231,19.05,,Posted,1866.95,2024-12-24,19.05,Withdrawal POS #000013340229/WALGREENS 2415 SW 75TH 2415 SW 75TH STGAINESVILLE FLCard 1231,19.05
12/24/2024,,Withdrawal ACH FLUENT-Gainesvil/TYPE: PAYMENT ID: 1371804719CO: FLUENT-GainesvilNAME: steven chaplinskiEntry Class Code: WEB,42.5,,Posted,1886.0,2024-12-24,42.5,Withdrawal ACH FLUENT-Gainesvil/TYPE: PAYMENT ID: 1371804719CO: FLUENT-GainesvilNAME: steven chaplinski,42.7
12/24/2024,,Withdrawal POS #000000383621/SUNOCO 8002212501 4234 SW 20TH AVEGAINESVILLE FLCard 1231,20.51,,Posted,1928.5,2024-12-24,20.51,Withdrawal POS #000000488663/SUNOCO 8002212501 4234 SW 20TH AVEGAINESVILLE FLCard 1231,20.67
12/23/2024,,Withdrawal Debit Card MC Debit Seminol/INSTACART*159 SAN FRANCISC CADate 12/22/24 0 4357281797 0 5411Card 1231,59.0,,Posted,1949.01,2024-12-23,59.0,Withdrawal Debit Card MC Debit Seminol/INSTACART*159 SAN FRANCISC CADate 12/24/24 0 4359294650 0 5411Card 1231,59.0
12/23/2024,,Recurring Withdrawal Bill Payment - #000000122428/NETFLIX COM LOS GATOS CACard 1231,17.84,,Posted,2008.01,2024-12-23,17.84,Recurring Withdrawal Bill Payment - #000000343444/NETFLIX COM LOS GATOS CACard 1231,17.84
12/22/2024,,Withdrawal POS #000000255092/SUNOCO 8002212501 4234 SW 20TH AVEGAINESVILLE FLCard 1231,10.0,,Posted,2025.85,2024-12-22,10.0,Withdrawal POS #000000235720/SUNOCO 8002212501 4234 SW 20TH AVEGAINESVILLE FLCard 1231,10.0
12/22/2024,,Withdrawal POS #000000344581/SUNOCO 8002212501 4234 SW 20TH AVEGAINESVILLE FLCard 1231,14.92,,Posted,2035.85,2024-12-22,14.92,Withdrawal POS #000000488663/SUNOCO 8002212501 4234 SW 20TH AVEGAINESVILLE FLCard 1231,14.92
12/22/2024,,Recurring Withdrawal Debit Card - MC Debit Seminol/CANVA* I04371-41297102 CAMDEN DEDate 12/20/24 0 4355594081 2 7333Card 1231,12.99,,Posted,50.77,2024-12-22,12.99,Recurring Withdrawal Debit Card - MC Debit Seminol/CANVA* I04371-41297102 CAMDEN DEDate 12/20/24 0 4355594081 2 7333Card 1231,12.99
12/22/2024,,Withdrawal Debit Card MC Debit Seminol/WAWA 5325 GAINESVILLE FLDate 12/21/24 0 4356579974 1 5541Card 1231,17.18,,Posted,63.76,2024-12-22,17.18,Withdrawal Debit Card MC Debit Seminol/WAWA 5325 GAINESVILLE FLDate 12/28/24 0 4363858796 0 5541Card 1231,16.92
12/22/2024,,Withdrawal Debit Card MC Debit Seminol/APPLE.COM/BILL CUPERTINO CADate 12/21/24 0 4356190590 1 5818Card 1231,9.99,,Posted,80.94,2024-12-22,9.99,Withdrawal Debit Card MC Debit Seminol/APPLE.COM/BILL CUPERTINO CADate 12/21/24 0 4356190590 1 5818Card 1231,9.99
12/21/2024,,Withdrawal POS #000000223326/SUNOCO 8002212501 4234 SW 20TH AVEGAINESVILLE FLCard 1231,27.26,,Posted,90.93,2024-12-21,27.26,Withdrawal POS #000000028242/SUNOCO 8002212501 4234 SW 20TH AVEGAINESVILLE FLCard 1231,27.26
12/20/2024,,Withdrawal POS #000000282496/SUNOCO 8002212501 4234 SW 20TH AVEGAINESVILLE FLCard 1231,17.08,,Posted,118.19,2024-12-20,17.08,Withdrawal POS #000000028242/SUNOCO 8002212501 4234 SW 20TH AVEGAINESVILLE FLCard 1231,17.08
12/20/2024,,Withdrawal Debit Card MC Debit Seminol/CANNAMD 855-4209170 FLDate 12/19/24 0 4354703841 0 8011Card 1231,149.0,,Posted,135.27,2024-12-20,149.0,Withdrawal Debit Card MC Debit Seminol/CANNAMD 855-4209170 FLDate 12/19/24 0 4354703841 0 8011Card 1231,149.0
12/20/2024,,Withdrawal Debit Card MC Debit Seminol/INSTACART*159 SAN FRANCISC CADate 12/19/24 0 4354168310 1 5411Card 1231,46.0,,Posted,284.27,2024-12-20,46.0,Withdrawal Debit Card MC Debit Seminol/INSTACART*159 SAN FRANCISC CADate 12/24/24 0 4359294650 0 5411Card 1231,46.0
12/19/2024,,Withdrawal POS #000000205771/SUNOCO 8002212501 4234 SW 20TH AVEGAINESVILLE FLCard 1231,20.83,,Posted,230.27,2024-12-19,20.83,Withdrawal POS #000000778591/SUNOCO 8002212501 4234 SW 20TH AVEGAINESVILLE FLCard 1231,20.83
12/19/2024,,Recurring Withdrawal Debit Card Fee/MASTERCARD ISSUER CROSS-BORDER FEEDate 12/18/24 0 4353969048 0 5734Card 1231,0.05,,Posted,251.1,2024-12-19,0.05,Recurring Withdrawal Debit Card Fee/MASTERCARD ISSUER CROSS-BORDER FEEDate 12/11/21 0 1345316936 1 5817Card 2801,0.08666666666666667
12/19/2024,,Recurring Withdrawal Debit Card - MC Debit Seminol/SAVE TO NOTION VAUREAL ILDate 12/18/24 0 4353969048 0 5734Card 1231,5.99,,Posted,251.15,2024-12-19,5.99,Recurring Withdrawal Debit Card - MC Debit Seminol/SAVE TO NOTION VAUREAL ILDate 12/18/24 0 4353969048 0 5734Card 1231,5.99
12/18/2024,,Withdrawal POS #000000175132/SUNOCO 8002212501 4234 SW 20TH AVEGAINESVILLE FLCard 1231,24.26,,Posted,257.14,2024-12-18,24.26,Withdrawal POS #000000778591/SUNOCO 8002212501 4234 SW 20TH AVEGAINESVILLE FLCard 1231,24.26
12/18/2024,,Withdrawal Debit Card MC Debit Seminol/INSTACART*159 SAN FRANCISC CADate 12/17/24 0 4352953677 0 5411Card 1231,49.0,,Posted,281.4,2024-12-18,49.0,Withdrawal Debit Card MC Debit Seminol/INSTACART*159 SAN FRANCISC CADate 12/24/24 0 4359294650 0 5411Card 1231,49.5
12/18/2024,,Recurring Withdrawal Debit Card - MC Debit Seminol/AMAZON PRIME*Z97W01ZG2 AMZN.COM/BIL WADate 12/17/24 0 4352950216 0 5968Card 1231,15.11,,Posted,330.4,2024-12-18,15.11,Recurring Withdrawal Debit Card - MC Debit Seminol/AMAZON PRIME*Z97W01ZG2 AMZN.COM/BIL WADate 12/17/24 0 4352950216 0 5968Card 1231,15.120000000000001
12/17/2024,,Recurring Withdrawal Debit Card - MC Debit Seminol/SUPERPOWER CHATGPT MIDDLETOWN DEDate 12/17/24 0 4352703539 1 5734Card 1231,15.0,,Posted,345.51,2024-12-17,15.0,Recurring Withdrawal Debit Card - MC Debit Seminol/SUPERPOWER CHATGPT MIDDLETOWN DEDate 12/17/24 0 4352703539 1 5734Card 1231,15.094999999999999
12/17/2024,,Recurring Withdrawal Debit Card - MC Debit Seminol/PADDLE.NET* LEONARDOAI ASTORIA NYDate 12/16/24 0 4351323834 0 5817Card 1231,9.0,,Posted,360.51,2024-12-17,9.0,Withdrawal Debit Card MC Debit Seminol/PADDLE.NET* LEONARDOAI ASTORIA NYDate 10/26/23 0 3299263117 0 5817Card 2801,9.0
12/17/2024,,Recurring Withdrawal Debit Card - MC Debit Seminol/PADDLE.NET* SETAPP ASTORIA NYDate 12/16/24 0 4351886849 0 5817Card 1231,12.49,,Posted,369.51,2024-12-17,12.49,Recurring Withdrawal Debit Card - MC Debit Seminol/PADDLE.NET* SETAPP NEW YORK NYDate 10/14/24 0 4288882561 0 5817Card 1231,12.49
12/17/2024,,Recurring Withdrawal Debit Card Fee/MASTERCARD ISSUER CROSS-BORDER FEEDate 12/17/24 0 4352700468 1 5734Card 1231,0.16,,Posted,382.0,2024-12-17,0.16,Recurring Withdrawal Debit Card Fee/MASTERCARD ISSUER CROSS-BORDER FEEDate 12/11/21 0 1345316936 1 5817Card 2801,0.08666666666666667
12/17/2024,,Recurring Withdrawal Debit Card - MC Debit Seminol/IDEOGRAM AI TORONTO ONDate 12/17/24 0 4352700468 1 5734Card 1231,20.0,,Posted,382.16,2024-12-17,20.0,Recurring Withdrawal Debit Card - MC Debit Seminol/IDEOGRAM AI TORONTO ONDate 12/17/24 0 4352700468 1 5734Card 1231,20.0
12/16/2024,,Withdrawal Debit Card MC Debit Seminol/INSTACART*159 SAN FRANCISC CADate 12/15/24 0 4350919827 0 5411Card 1231,50.0,,Posted,402.16,2024-12-16,50.0,Withdrawal Debit Card MC Debit Seminol/INSTACART*159 SAN FRANCISC CADate 12/24/24 0 4359294650 0 5411Card 1231,49.5
12/15/2024,,Recurring Withdrawal Debit Card - MC Debit Seminol/RUNWAY STANDARD PLAN NEWARK DEDate 12/15/24 0 4350745942 1 5734Card 1231,15.0,,Posted,452.16,2024-12-15,15.0,Recurring Withdrawal Debit Card - MC Debit Seminol/RUNWAY STANDARD PLAN NEWARK DEDate 12/15/24 0 4350745942 1 5734Card 1231,15.0
12/13/2024,,Withdrawal POS #000000000027/CIRCLE K # 26146 3525 GAINESVILLE FLCard 1231,18.88,,Posted,467.16,2024-12-13,18.88,Withdrawal POS #000010941641/CIRCLE K # 26146 3525 GAINESVILLE FLCard 1231,18.88
12/13/2024,,Withdrawal ATM Fee/EFT 3401 W University Ave Gainesville FLCard 1231,2.0,,Posted,486.04,2024-12-13,2.0,"Withdrawal ATM Fee/EFT 3401 W University Ave Gainesville FL

Card 1247",2.0
12/13/2024,,Withdrawal at ATM #000000472357/EFT 3401 W University Ave Gainesville FLCard 1231,23.0,,Posted,488.04,2024-12-13,23.0,"Withdrawal at ATM #000000776623/EFT 3401 W University Ave Gainesville FL

Card 1247",23.0
12/13/2024,,Withdrawal Debit Card MC Debit Seminol/INSTACART*159 SAN FRANCISC CADate 12/12/24 0 4347002718 1 5411Card 1231,54.0,,Posted,511.04,2024-12-13,54.0,Withdrawal Debit Card MC Debit Seminol/INSTACART*159 SAN FRANCISC CADate 12/24/24 0 4359294650 0 5411Card 1231,53.5
12/12/2024,,Withdrawal POS #000000900121/SUNOCO 8002212501 4234 SW 20TH AVEGAINESVILLE FLCard 1231,24.26,,Posted,565.04,2024-12-12,24.26,Withdrawal POS #000000909995/SUNOCO 8002212501 4234 SW 20TH AVEGAINESVILLE FLCard 1231,24.26
12/12/2024,,Withdrawal ACH VENMO/TYPE: PAYMENT ID: 3264681992 CO: VENMONAME: AVATAR ARTSEntry Class Code: WEB,14.99,,Posted,339.3,2024-12-12,14.99,Withdrawal ACH VENMO/TYPE: PAYMENT ID: 3264681992 CO: VENMONAME: AVATAR ARTSEntry Class Code: WEB,14.99
12/11/2024,,Withdrawal Debit Card MC Debit Seminol/AMAZON PRIME*ZR78T8681 AMZN.COM/BIL WADate 12/11/24 0 4346447241 1 5818Card 1231,3.4,,Posted,354.29,2024-12-11,3.4,Withdrawal Debit Card MC Debit Seminol/AMAZON PRIME*ZR78T8681 AMZN.COM/BIL WADate 12/11/24 0 4346447241 1 5818Card 1231,3.4
12/11/2024,,Withdrawal POS #000000000041/CIRCLE K # 26146 3525 GAINESVILLE FLCard 1231,26.18,,Posted,357.69,2024-12-11,26.18,Withdrawal POS #000010941641/CIRCLE K # 26146 3525 GAINESVILLE FLCard 1231,26.25
12/10/2024,,Recurring Withdrawal Debit Card - MC Debit Seminol/INVIDEO INC COUNTRY OF S DEDate 12/09/24 0 4344808122 0 5734Card 1231,35.0,,Posted,383.87,2024-12-10,35.0,Recurring Withdrawal Debit Card - MC Debit Seminol/INVIDEO INC COUNTRY OF S DEDate 12/09/24 0 4344808122 0 5734Card 1231,35.0
12/10/2024,,Withdrawal POS #000000914130/AMAZON.COM*ZR50X2ML1 SEATTLE WACard 1231,11.91,,Posted,418.87,2024-12-10,11.91,Withdrawal POS #000000914130/AMAZON.COM*ZR50X2ML1 SEATTLE WACard 1231,11.91
12/10/2024,,Withdrawal ACH VENMO/TYPE: PAYMENT ID: 3264681992 CO: VENMONAME: AVATAR ARTSEntry Class Code: WEB,9.99,,Posted,430.78,2024-12-10,9.99,Withdrawal ACH VENMO/TYPE: PAYMENT ID: 3264681992 CO: VENMONAME: AVATAR ARTSEntry Class Code: WEB,9.99
12/9/2024,,Withdrawal POS #000000179448/AMAZON.COM*ZR3RB12D0 SEATTLE WACard 1231,19.12,,Posted,436.86,2024-12-09,19.12,Withdrawal POS #000000914130/AMAZON.COM*ZR50X2ML1 SEATTLE WACard 1231,19.12
12/9/2024,,Recurring Withdrawal Debit Card - MC Debit Seminol/MYDESIGNS - PRO - MON LAS VEGAS NVDate 12/08/24 0 4343357881 0 5734Card 1231,29.99,,Posted,455.98,2024-12-09,29.99,Recurring Withdrawal Debit Card - MC Debit Seminol/MYDESIGNS - PRO - MON LAS VEGAS NVDate 12/08/24 0 4343357881 0 5734Card 1231,29.99
12/9/2024,,Withdrawal Debit Card MC Debit Seminol/IONOS INC. CHESTERBROOK PADate 12/08/24 0 4343153168 1 4816Card 1231,23.0,,Posted,485.97,2024-12-09,23.0,Withdrawal Debit Card MC Debit Seminol/IONOS INC. CHESTERBROOK PADate 12/29/24 0 4364954464 0 4816Card 1231,23.0
12/9/2024,,Withdrawal ACH FLUENT-Gainesvil/TYPE: PAYMENT ID: 1371804719CO: FLUENT-GainesvilNAME: steven chaplinskiEntry Class Code: WEB,32.0,,Posted,508.97,2024-12-09,32.0,Withdrawal ACH FLUENT-Gainesvil/TYPE: PAYMENT ID: 1371804719CO: FLUENT-GainesvilNAME: steven chaplinski,32.5
12/9/2024,,Withdrawal POS #000020941197/GOOGLE *YouTubePremium 1600 AmphitheatreParkw Mountain View CACard 1231,9.1,,Posted,540.97,2024-12-09,9.1,"Withdrawal POS #000020312090/GOOGLE *YouTubePremium 1600 Amphitheatre

Parkw Mountain View CA

Card 1247",9.1
12/8/2024,,Recurring Withdrawal Debit Card - MC Debit Seminol/KREA.AI SAN FRANCISC CADate 12/06/24 0 4341842673 0 5734Card 1231,10.0,,Posted,550.07,2024-12-08,10.0,Recurring Withdrawal Debit Card - MC Debit Seminol/KREA.AI SAN FRANCISC CADate 12/06/24 0 4341842673 0 5734Card 1231,10.0
12/8/2024,,Recurring Withdrawal Debit Card - MC Debit Seminol/PADDLE.NET* COPYTONOTI NEW YORK NYDate 12/07/24 0 4342788023 3 5817Card 1231,9.0,,Posted,560.07,2024-12-08,9.0,Recurring Withdrawal Debit Card - MC Debit Seminol/PADDLE.NET* COPYTONOTI NEW YORK NYDate 12/07/24 0 4342788023 3 5817Card 1231,9.0
12/8/2024,,Withdrawal Debit Card MC Debit Seminol/SAMSUNG ELECTRONICS RIDGEFIELD P NJDate 12/06/24 0 4341784790 3 5734Card 1231,16.99,,Posted,569.07,2024-12-08,16.99,Withdrawal Debit Card MC Debit Seminol/SAMSUNG ELECTRONICS RIDGEFIELD P NJDate 12/27/24 0 4362999827 1 5734Card 1231,16.49
12/8/2024,,Recurring Withdrawal Debit Card - MC Debit Seminol/APPLE.COM/BILL 866-712-7753 CADate 12/06/24 0 4341327079 2 5818Card 1231,49.98,,Posted,586.06,2024-12-08,49.98,Recurring Withdrawal Debit Card - MC Debit Seminol/APPLE.COM/BILL 866-712-7753 CADate 12/06/24 0 4341327079 2 5818Card 1231,49.98
12/6/2024,,Withdrawal POS #000000000070/CIRCLE K # 26146 3525 GAINESVILLE FLCard 1231,37.34,,Posted,636.04,2024-12-06,37.34,Withdrawal POS #000010941641/CIRCLE K # 26146 3525 GAINESVILLE FLCard 1231,37.34
12/6/2024,,Withdrawal Debit Card MC Debit Seminol/PP*P321458226 2033189708 NYDate 12/05/24 0 4340999603 0 4816Card 1231,1.13,,Posted,673.38,2024-12-06,1.13,Withdrawal Debit Card MC Debit Seminol/PP*P321458226 2033189708 NYDate 12/05/24 0 4340999603 0 4816Card 1231,1.13
12/6/2024,,Recurring Withdrawal Debit Card - MC Debit Seminol/PADDLE.NET* SETAPP NEW YORK NYDate 12/05/24 0 4340998738 0 5817Card 1231,9.99,,Posted,674.51,2024-12-06,9.99,Recurring Withdrawal Debit Card - MC Debit Seminol/PADDLE.NET* SETAPP NEW YORK NYDate 10/14/24 0 4288882561 0 5817Card 1231,9.495000000000001
12/6/2024,,Withdrawal Debit Card MC Debit Seminol/IONOS INC. CHESTERBROOK PADate 12/05/24 0 4340534140 1 4816Card 1231,16.0,,Posted,684.5,2024-12-06,16.0,Withdrawal Debit Card MC Debit Seminol/IONOS INC. CHESTERBROOK PADate 12/29/24 0 4364954464 0 4816Card 1231,16.0
12/6/2024,,Withdrawal Debit Card MC Debit Seminol/CIRCLE K # 06782 GAINESVILLE FLDate 12/04/24 0 4339524954 1 5499Card 1231,31.57,,Posted,700.5,2024-12-06,31.57,Withdrawal Debit Card MC Debit Seminol/CIRCLE K # 06782 GAINESVILLE FLDate 09/08/24 0 4252889868 0 5499Card 1231,31.57
12/6/2024,,Withdrawal Debit Card MC Debit Seminol/GRU/EZ-PAY WEB PYMT 352-334-3434 FLDate 12/05/24 0 4340279271 0 4900Card 1231,171.03,,Posted,732.07,2024-12-06,171.03,Withdrawal Debit Card MC Debit Seminol/GRU/EZ-PAY WEB PYMT 352-334-3434 FLDate 12/05/24 0 4340279271 0 4900Card 1231,171.15
12/5/2024,,Recurring Withdrawal Debit Card - MC Debit Seminol/WWW.EVERBEE.IO AUSTIN TXDate 12/04/24 0 4339869891 0 5734Card 1231,29.99,,Posted,903.1,2024-12-05,29.99,Recurring Withdrawal Debit Card - MC Debit Seminol/WWW.EVERBEE.IO AUSTIN TXDate 12/04/24 0 4339869891 0 5734Card 1231,29.99
12/5/2024,,Recurring Withdrawal Debit Card - MC Debit Seminol/OPENAI *CHATGPT SUBSCR SAN FRANCISC CADate 12/04/24 0 4339869196 0 5734Card 1231,20.0,,Posted,933.09,2024-12-05,20.0,Recurring Withdrawal Debit Card - MC Debit Seminol/OPENAI *CHATGPT SUBSCR SAN FRANCISC CADate 12/04/24 0 4339869196 0 5734Card 1231,20.0
12/5/2024,,Withdrawal Debit Card MC Debit Seminol/INSTACART*159 SAN FRANCISC CADate 12/04/24 0 4339868026 0 5411Card 1231,51.0,,Posted,953.09,2024-12-05,51.0,Withdrawal Debit Card MC Debit Seminol/VIDIQ SAN FRANCISC CADate 12/03/24 0 4338664809 1 5734Card 1231,51.0
12/5/2024,,Recurring Withdrawal Debit Card Fee/MASTERCARD ISSUER CROSS-BORDER FEEDate 12/05/24 0 4340418348 1 5734Card 1231,0.1,,Posted,1004.09,2024-12-05,0.1,Recurring Withdrawal Debit Card Fee/MASTERCARD ISSUER CROSS-BORDER FEEDate 12/11/21 0 1345316936 1 5817Card 2801,0.08666666666666667
12/5/2024,,Recurring Withdrawal Debit Card - MC Debit Seminol/LEONARDO.AI NORTH SYDNEY NSDate 12/05/24 0 4340418348 1 5734Card 1231,12.0,,Posted,1004.19,2024-12-05,12.0,Recurring Withdrawal Debit Card - MC Debit Seminol/LEONARDO.AI NORTH SYDNEY NSDate 12/05/24 0 4340418348 1 5734Card 1231,12.0
12/5/2024,,Withdrawal Debit Card MC Debit Seminol/COX GAINESVILLE COMM 800-234-3993 FLDate 12/04/24 0 4339376311 0 4899Card 1231,156.13,,Posted,1016.19,2024-12-05,156.13,Withdrawal Debit Card MC Debit Seminol/COX GAINESVILLE COMM 800-234-3993 FLDate 12/04/24 0 4339376311 0 4899Card 1231,156.13
12/5/2024,,Recurring Withdrawal Debit Card - MC Debit Seminol/APPLE.COM/BILL 866-712-7753 CADate 12/04/24 0 4339984092 0 5818Card 1231,2.99,,Posted,1172.32,2024-12-05,2.99,Recurring Withdrawal Debit Card - MC Debit Seminol/APPLE.COM/BILL 866-712-7753 CADate 04/13/24 0 4104933092 1 5818Card 1231,2.99
12/4/2024,,Withdrawal POS #000083179688/SMOKE CITY 2120 SW 34TH ST GAINESVILLECard 1231,9.68,,Posted,1175.31,2024-12-04,9.68,"Withdrawal POS #000080196760/SMOKE CITY 2120 SW 34TH ST GAINESVILLE

Card 1247",9.68
12/4/2024,,Recurring Withdrawal Debit Card - MC Debit Seminol/SUPERPOWER CHATGPT MIDDLETOWN DEDate 12/04/24 0 4339846699 0 5734Card 1231,15.0,,Posted,1184.99,2024-12-04,15.0,Recurring Withdrawal Debit Card - MC Debit Seminol/SUPERPOWER CHATGPT MIDDLETOWN DEDate 12/17/24 0 4352703539 1 5734Card 1231,15.094999999999999
12/4/2024,,Recurring Withdrawal Debit Card - MC Debit Seminol/TUBEBUDDYCOM* 8668823239 CADate 12/03/24 0 4338443995 0 5045Card 1231,19.79,,Posted,1199.99,2024-12-04,19.79,Recurring Withdrawal Debit Card - MC Debit Seminol/TUBEBUDDYCOM* 8668823239 CADate 12/03/24 0 4338443995 0 5045Card 1231,19.79
12/4/2024,,Recurring Withdrawal Debit Card - MC Debit Seminol/APPLE.COM/BILL CUPERTINO CADate 12/03/24 0 4338442272 0 5818Card 1231,2.99,,Posted,1219.78,2024-12-04,2.99,Recurring Withdrawal Debit Card - MC Debit Seminol/APPLE.COM/BILL CUPERTINO CADate 05/03/24 0 4124646881 1 5735Card 1231,2.99
12/4/2024,,"Withdrawal Bill Payment #000000196200/Adobe Park Avenue,345 San Jose CACard 1231",19.99,,Posted,1222.77,2024-12-04,19.99,"Withdrawal Bill Payment #000000352498/Adobe Park Avenue,345 San Jose CACard 1247",19.99
12/3/2024,,Withdrawal POS #000000000049/AMAZON.COM*ZL4MI32Y2 SEATTLE WACard 1231,9.13,,Posted,1242.76,2024-12-03,9.13,Withdrawal POS #000000000006/AMAZON.COM*RJ6HJ7RA2 SEATTLE WACard 1231,9.13
12/3/2024,,"Recurring Withdrawal Debit Card - MC Debit Seminol/NOTION LABS, INC. SAN FRANCISC CADate 12/02/24 0 4337878572 0 7372Card 1231",17.86,,Posted,1251.89,2024-12-03,17.86,"Recurring Withdrawal Debit Card - MC Debit Seminol/NOTION LABS, INC. SAN FRANCISC CADate 12/02/24 0 4337878572 0 7372Card 1231",17.86
12/3/2024,,Withdrawal Debit Card MC Debit Seminol/VIDIQ SAN FRANCISC CADate 12/03/24 0 4338664809 1 5734Card 1231,19.0,,Posted,1269.75,2024-12-03,19.0,Withdrawal Debit Card MC Debit Seminol/VIDIQ SAN FRANCISC CADate 12/03/24 0 4338664809 1 5734Card 1231,19.0
12/3/2024,,Recurring Withdrawal Debit Card - MC Debit Seminol/TASKADE SAN FRANCISC CADate 12/03/24 0 4338877562 0 5734Card 1231,10.0,,Posted,1288.75,2024-12-03,10.0,Recurring Withdrawal Debit Card - MC Debit Seminol/VIDIQ SAN FRANCISC CADate 12/23/23 0 3357950683 0 5734Card 2801,10.0
12/3/2024,,Recurring Withdrawal Debit Card Fee/MASTERCARD ISSUER CROSS-BORDER FEEDate 12/02/24 0 4337877232 0 5734Card 1231,0.05,,Posted,1298.75,2024-12-03,0.05,Recurring Withdrawal Debit Card Fee/MASTERCARD ISSUER CROSS-BORDER FEEDate 01/06/24 0 4006875269 0 5815Card 2801,0.1366666666666667
12/3/2024,,Recurring Withdrawal Debit Card - MC Debit Seminol/IDEOGRAM AI TORONTO ONDate 12/02/24 0 4337877232 0 5734Card 1231,5.81,,Posted,1298.8,2024-12-03,5.81,Recurring Withdrawal Debit Card - MC Debit Seminol/IDEOGRAM AI TORONTO ONDate 12/17/24 0 4352700468 1 5734Card 1231,5.81
12/3/2024,,Withdrawal Debit Card MC Debit Seminol/WALGREENS #5024 GAINESVILLE FLDate 12/02/24 0 4337658312 1 5912Card 1231,31.74,,Posted,1304.61,2024-12-03,31.74,Withdrawal Debit Card MC Debit Seminol/WALGREENS #5024 GAINESVILLE FLDate 06/26/23 0 3177001861 1 5912Card 2801,31.74
12/3/2024,,Recurring Withdrawal POS #000006174112/PAYPAL *TUBEBUDDY TUBEBUD 2211 NorthStreet 8882211161 CACard 1231,19.79,,Posted,1336.35,2024-12-03,19.79,Recurring Withdrawal POS #000006174112/PAYPAL *TUBEBUDDY TUBEBUD 2211 NorthStreet 8882211161 CACard 1231,19.79
12/2/2024,,Withdrawal POS #000000513221/SUNOCO 8002212501 4234 SW 20TH AVEGAINESVILLE FLCard 1231,20.83,,Posted,1356.14,2024-12-02,20.83,Withdrawal POS #000000221295/SUNOCO 8002212501 4234 SW 20TH AVEGAINESVILLE FLCard 1231,20.83
12/2/2024,,Recurring Withdrawal Debit Card - MC Debit Seminol/IC* INSTACART*SUBSCRIP SAN FRANCISC CADate 11/30/24 0 4335692546 1 5411Card 1231,9.99,,Posted,1376.97,2024-12-02,9.99,Recurring Withdrawal Debit Card - MC Debit Seminol/IC* INSTACART*SUBSCRIP SAN FRANCISC CADate 11/30/24 0 4335692546 1 5411Card 1231,9.99
12/2/2024,,Withdrawal Debit Card MC Debit Seminol/SCRUBS CARWASH - GAINE GAINESVILLE FLDate 11/29/24 0 4334403825 2 7542Card 1231,6.0,,Posted,1386.96,2024-12-02,6.0,Withdrawal Debit Card MC Debit Seminol/SCRUBS CARWASH - GAINE GAINESVILLE FLDate 11/29/24 0 4334403825 2 7542Card 1231,5.875
12/2/2024,,Withdrawal ACH Watson Realty Co/TYPE: WEB PMTS ID: 9000321157CO: Watson Realty CoNAME: Steven chaplinskiEntry Class Code: WEB,1179.0,,Posted,1392.96,2024-12-02,1179.0,Withdrawal ACH Watson Realty Co/TYPE: WEB PMTS ID: 9000321157CO: Watson Realty CoEntry Class Code: WEB,1179.0
12/2/2024,,Withdrawal ACH FLUENT-Gainesvil/TYPE: PAYMENT ID: 1371804719CO: FLUENT-GainesvilNAME: steven chaplinskiEntry Class Code: WEB,40.0,,Posted,2571.96,2024-12-02,40.0,Withdrawal ACH FLUENT-Gainesvil/TYPE: PAYMENT ID: 1371804719CO: FLUENT-GainesvilNAME: steven chaplinski,40.0
12/2/2024,,Withdrawal ACH FLUENT-Gainesvil/TYPE: PAYMENT ID: 1371804719CO: FLUENT-GainesvilNAME: steven chaplinskiEntry Class Code: WEB,20.0,,Posted,2611.96,2024-12-02,20.0,Withdrawal ACH FLUENT-Gainesvil/TYPE: PAYMENT ID: 1371804719CO: FLUENT-GainesvilNAME: steven chaplinski,20.0
12/2/2024,,"Withdrawal ACH AppFolio, Inc. F/TYPE: WEB PMTS ID: 9001406550CO: AppFolio, Inc. FNAME: Steven chaplinskiEntry Class Code: WEB",2.49,,Posted,2631.96,2024-12-02,2.49,"Withdrawal ACH AppFolio, Inc. F/TYPE: WEB PMTS ID: 9001406550

CO: AppFolio, Inc. F

NAME: Steven chaplinskiEntry Class Code: WEB",2.49
12/2/2024,,Withdrawal Bill Payment #000000352178/Disney PLUS Recurring 1375 Buena VistaDrive Lake Buena Vi FLCard 1231,18.41,,Posted,2634.45,2024-12-02,18.41,Withdrawal Bill Payment #000000352178/Disney PLUS Recurring 1375 Buena VistaDrive Lake Buena Vi FLCard 1231,18.41
12/1/2024,,Withdrawal POS #000000047747/SUNOCO 8002212501 4234 SW 20TH AVEGAINESVILLE FLCard 1231,31.05,,Posted,2652.86,2024-12-01,31.05,Withdrawal POS #000000616677/SUNOCO 8002212501 4234 SW 20TH AVEGAINESVILLE FLCard 1231,31.05
11/30/2024,,Withdrawal Debit Card MC Debit Seminol/INSTACART*159 SAN FRANCISC CADate 11/29/24 0 4334853720 0 5411Card 1231,53.0,,Posted,2683.91,2024-11-30,53.0,Withdrawal Debit Card MC Debit Seminol/INSTACART*159 SAN FRANCISC CADate 12/24/24 0 4359294650 0 5411Card 1231,53.5
11/30/2024,,Withdrawal Debit Card MC Debit Seminol/IONOS INC. CHESTERBROOK PADate 11/29/24 0 4334602237 1 4816Card 1231,1.0,,Posted,2736.91,2024-11-30,1.0,Withdrawal Debit Card MC Debit Seminol/IONOS INC. CHESTERBROOK PADate 12/29/24 0 4364954464 0 4816Card 1231,0.8400000000000001
11/29/2024,,Withdrawal POS #000000292609/SUNOCO 8002212501 4234 SW 20TH AVEGAINESVILLE FLCard 1231,24.8,,Posted,2737.91,2024-11-29,24.8,Withdrawal POS #000000235720/SUNOCO 8002212501 4234 SW 20TH AVEGAINESVILLE FLCard 1231,24.8
11/29/2024,,Withdrawal Debit Card MC Debit Seminol/WAWA 5325 GAINESVILLE FLDate 11/28/24 0 4333451434 0 5541Card 1231,17.82,,Posted,2762.71,2024-11-29,17.82,Withdrawal Debit Card MC Debit Seminol/WAWA 5325 GAINESVILLE FLDate 12/28/24 0 4363858796 0 5541Card 1231,17.82
11/28/2024,,Withdrawal POS #000000296305/SUNOCO 8002212501 4234 SW 20TH AVEGAINESVILLE FLCard 1231,20.83,,Posted,2780.53,2024-11-28,20.83,Withdrawal POS #000000235720/SUNOCO 8002212501 4234 SW 20TH AVEGAINESVILLE FLCard 1231,20.83
11/28/2024,,Withdrawal Debit Card MC Debit Seminol/SAMSUNG ELECTRONICS RIDGEFIELD P NJDate 11/27/24 0 4332105121 1 5734Card 1231,8.99,,Posted,1.36,2024-11-28,8.99,Withdrawal Debit Card MC Debit Seminol/SAMSUNG ELECTRONICS RIDGEFIELD P NJDate 12/27/24 0 4362999827 1 5734Card 1231,8.99
11/27/2024,,Withdrawal POS #000000000029/AMAZON.COM*Z38LO1T72 SEATTLE WACard 1231,14.63,,Posted,10.35,2024-11-27,14.63,Withdrawal POS #000000400824/AMAZON.COM*HC3O110O2 SEATTLE WACard 2801,14.47
11/26/2024,,Withdrawal POS #000000238833/SILVER SPRINGS FOOD MART 5501 NE 35TH STSILVER SPRING FLCard 1231,10.0,,Posted,24.98,2024-11-26,10.0,Withdrawal POS #000000238833/SILVER SPRINGS FOOD MART 5501 NE 35TH STSILVER SPRING FLCard 1231,10.0
11/26/2024,,Withdrawal POS #000000201980/SUNOCO 8002212501 4234 SW 20TH AVEGAINESVILLE FLCard 1231,17.08,,Posted,34.98,2024-11-26,17.08,Withdrawal POS #000000221295/SUNOCO 8002212501 4234 SW 20TH AVEGAINESVILLE FLCard 1231,17.08
11/26/2024,,Withdrawal Debit Card MC Debit Seminol/ARCHER ANIMAL HOSPITAL ARCHER FLDate 11/25/24 0 4330350737 0 0742Card 1231,49.24,,Posted,52.06,2024-11-26,49.24,Withdrawal Debit Card MC Debit Seminol/ARCHER ANIMAL HOSPITAL ARCHER FLDate 11/25/24 0 4330350737 0 0742Card 1231,49.24
11/26/2024,,Withdrawal Debit Card MC Debit Seminol/WALGREENS #5024 GAINESVILLE FLDate 11/25/24 0 4330149353 1 5912Card 1231,10.81,,Posted,101.3,2024-11-26,10.81,Withdrawal Debit Card MC Debit Seminol/WALGREENS #9304 GAINESVILLE FLDate 10/30/24 0 4304125853 1 5912Card 1231,10.81
11/25/2024,,Withdrawal POS #000000144391/SUNOCO 8002212501 4234 SW 20TH AVEGAINESVILLE FLCard 1231,21.35,,Posted,110.76,2024-11-25,21.35,Withdrawal POS #000000144391/SUNOCO 8002212501 4234 SW 20TH AVEGAINESVILLE FLCard 1231,21.35
11/25/2024,,Recurring Withdrawal Debit Card - MC Debit Seminol/FS *ADOBE SANTA BARBAR CADate 11/24/24 0 4329138605 1 5734Card 1231,0.95,,Posted,132.11,2024-11-25,0.95,Recurring Withdrawal Debit Card - MC Debit Seminol/FS *ADOBE SANTA BARBAR CADate 12/24/24 0 4359034647 1 5734Card 1231,0.95
11/25/2024,,Withdrawal Courtesy Pay Fee/Entry Class Code: WEB,35.0,,Posted,-41.94,2024-11-25,35.0,Withdrawal Courtesy Pay Fee/Entry Class Code: WEB,35.0
11/25/2024,,Withdrawal ACH FLUENT-Gainesvil/TYPE: PAYMENT ID: 1371804719CO: FLUENT-GainesvilNAME: steven chaplinski,18.0,,Posted,-6.94,2024-11-25,18.0,Withdrawal ACH FLUENT-Gainesvil/TYPE: PAYMENT ID: 1371804719CO: FLUENT-GainesvilNAME: steven chaplinski,18.0
11/25/2024,,Withdrawal POS #000000125261/SUNOCO 8002212501 4234 SW 20TH AVEGAINESVILLE FLCard 1231,14.92,,Posted,11.06,2024-11-25,14.92,Withdrawal POS #000000235720/SUNOCO 8002212501 4234 SW 20TH AVEGAINESVILLE FLCard 1231,15.135
11/24/2024,,Withdrawal Debit Card MC Debit Seminol/INSTACART*159 SAN FRANCISC CADate 11/23/24 0 4328257179 0 5411Card 1231,41.06,,Posted,25.98,2024-11-24,41.06,Withdrawal Debit Card MC Debit Seminol/INSTACART*159 SAN FRANCISC CADate 12/24/24 0 4359294650 0 5411Card 1231,41.06
11/24/2024,,Withdrawal Debit Card MC Debit Seminol/WAWA 5325 GAINESVILLE FLDate 11/23/24 0 4328070994 1 5541Card 1231,20.7,,Posted,67.04,2024-11-24,20.7,Withdrawal Debit Card MC Debit Seminol/WAWA 5325 GAINESVILLE FLDate 12/28/24 0 4363858796 0 5541Card 1231,20.21
11/24/2024,,Withdrawal POS #000000000055/CIRCLE K # 06782 5237 GAINESVILLE FLCard 1231,16.76,,Posted,87.74,2024-11-24,16.76,Withdrawal POS #000000882351/CIRCLE K # 06782 GAINESVILLE FLCard 1140,16.37
11/23/2024,,Withdrawal POS #000000064289/SUNOCO 8002212501 4234 SW 20TH AVEGAINESVILLE FLCard 1231,22.42,,Posted,104.5,2024-11-23,22.42,Withdrawal POS #000000028242/SUNOCO 8002212501 4234 SW 20TH AVEGAINESVILLE FLCard 1231,22.42
11/23/2024,,Recurring Withdrawal Bill Payment - #000000145767/NETFLIX COM LOS GATOS CACard 1231,17.84,,Posted,126.92,2024-11-23,17.84,Recurring Withdrawal Bill Payment - #000000343444/NETFLIX COM LOS GATOS CACard 1231,17.84
11/22/2024,,Withdrawal POS #000000994295/SUNOCO 8002212501 4234 SW 20TH AVEGAINESVILLE FLCard 1231,22.1,,Posted,19.76,2024-11-22,22.1,Withdrawal POS #000000221295/SUNOCO 8002212501 4234 SW 20TH AVEGAINESVILLE FLCard 1231,22.1
11/22/2024,,Withdrawal Debit Card MC Debit Seminol/WAWA 5325 GAINESVILLE FLDate 11/21/24 0 4326148333 1 5541Card 1231,16.66,,Posted,41.86,2024-11-22,16.66,Withdrawal Debit Card MC Debit Seminol/WAWA 5325 GAINESVILLE FLDate 12/28/24 0 4363858796 0 5541Card 1231,16.92
11/21/2024,,Withdrawal POS #000000998084/AMAZON.COM*9I40T2VL3 SEATTLE WACard 1231,10.73,,Posted,58.52,2024-11-21,10.73,Withdrawal POS #000000914130/AMAZON.COM*ZR50X2ML1 SEATTLE WACard 1231,10.46
11/21/2024,,Recurring Withdrawal Debit Card - MC Debit Seminol/CANVA* I04341-45036624 CAMDEN DEDate 11/20/24 0 4325914916 0 7333Card 1231,12.99,,Posted,69.25,2024-11-21,12.99,Recurring Withdrawal Debit Card - MC Debit Seminol/CANVA* I04249-43399962 CAMDEN DEDate 08/20/24 0 4233594945 0 7221Card 1231,12.99
11/21/2024,,Withdrawal POS #000000951422/SUNOCO 8002212501 4234 SW 20TH AVEGAINESVILLE FLCard 1231,22.42,,Posted,82.24,2024-11-21,22.42,Withdrawal POS #000000909995/SUNOCO 8002212501 4234 SW 20TH AVEGAINESVILLE FLCard 1231,22.42
11/20/2024,,Withdrawal POS #000000000009/CIRCLE K # 06782 5237 GAINESVILLE FLCard 1231,20.4,,Posted,104.66,2024-11-20,20.4,Withdrawal POS #000000000343/CIRCLE K # 06782 5237 GAINESVILLE FLCard 1247,20.2
11/19/2024,,Recurring Withdrawal Debit Card Fee/MASTERCARD ISSUER CROSS-BORDER FEEDate 11/18/24 0 4323867046 0 5734Card 1231,0.05,,Posted,125.06,2024-11-19,0.05,Withdrawal Debit Card Fee/MASTERCARD ISSUER CROSS-BORDER FEEDate 05/13/24 0 4134864561 0 5734Card 1231,0.1366666666666667
11/19/2024,,Recurring Withdrawal Debit Card - MC Debit Seminol/SAVE TO NOTION VAUREAL ILDate 11/18/24 0 4323867046 0 5734Card 1231,5.99,,Posted,125.11,2024-11-19,5.99,Recurring Withdrawal Debit Card - MC Debit Seminol/SAVE TO NOTION VAUREAL ILDate 12/18/24 0 4353969048 0 5734Card 1231,5.99
11/18/2024,,Withdrawal POS #000000359086/INSTACART*159 WWW.INSTACART.COM/ SANFRANCISCO CACard 1231,43.0,,Posted,131.1,2024-11-18,43.0,Withdrawal POS #000000804821/INSTACART*159 WWW.INSTACART.COM/ SANFRANCISCO CACard 1231,42.96
11/18/2024,,Recurring Withdrawal Debit Card - MC Debit Seminol/SUPERPOWER CHATGPT MIDDLETOWN DEDate 11/17/24 0 4322285245 0 5734Card 1231,15.0,,Posted,174.1,2024-11-18,15.0,Recurring Withdrawal Debit Card - MC Debit Seminol/SUPERPOWER CHATGPT MIDDLETOWN DEDate 12/17/24 0 4352703539 1 5734Card 1231,15.094999999999999
11/18/2024,,Recurring Withdrawal Debit Card Fee/MASTERCARD ISSUER CROSS-BORDER FEEDate 11/17/24 0 4322076165 1 5734Card 1231,0.06,,Posted,189.1,2024-11-18,0.06,Recurring Withdrawal Debit Card Fee/MASTERCARD ISSUER CROSS-BORDER FEEDate 12/11/21 0 1345316936 1 5817Card 2801,0.08666666666666667
11/18/2024,,Recurring Withdrawal Debit Card - MC Debit Seminol/IDEOGRAM AI TORONTO ONDate 11/17/24 0 4322076165 1 5734Card 1231,8.0,,Posted,189.16,2024-11-18,8.0,Recurring Withdrawal Debit Card - MC Debit Seminol/IDEOGRAM AI TORONTO ONDate 12/17/24 0 4352700468 1 5734Card 1231,8.0
11/18/2024,,Recurring Withdrawal Debit Card - MC Debit Seminol/AMAZON PRIME*LF6U08PC3 AMZN.COM/BIL WADate 11/17/24 0 4322071074 1 5968Card 1231,15.11,,Posted,197.16,2024-11-18,15.11,Recurring Withdrawal Debit Card - MC Debit Seminol/AMAZON PRIME*Z97W01ZG2 AMZN.COM/BIL WADate 12/17/24 0 4352950216 0 5968Card 1231,15.120000000000001
11/17/2024,,Recurring Withdrawal Debit Card - MC Debit Seminol/PADDLE.NET* LEONARDOAI ASTORIA NYDate 11/16/24 0 4321386811 0 5817Card 1231,9.0,,Posted,212.27,2024-11-17,9.0,Withdrawal Debit Card MC Debit Seminol/PADDLE.NET* LEONARDOAI ASTORIA NYDate 10/26/23 0 3299263117 0 5817Card 2801,9.0
11/17/2024,,Recurring Withdrawal Debit Card - MC Debit Seminol/PADDLE.NET* SETAPP ASTORIA NYDate 11/16/24 0 4321038237 1 5817Card 1231,12.49,,Posted,221.27,2024-11-17,12.49,Recurring Withdrawal Debit Card - MC Debit Seminol/PADDLE.NET* SETAPP NEW YORK NYDate 10/14/24 0 4288882561 0 5817Card 1231,12.49
11/15/2024,,Withdrawal POS #000000000003/INSTACART*159 WWW.INSTACART.COM/ SANFRANCISCO CACard 1231,69.0,,Posted,233.76,2024-11-15,69.0,Withdrawal POS #000000000003/INSTACART*159 WWW.INSTACART.COM/ SANFRANCISCO CACard 1231,69.0
11/15/2024,,"Recurring Withdrawal Debit Card - MC Debit Seminol/NOTION LABS, INC. SAN FRANCISC CADate 11/15/24 0 4320097919 1 7372Card 1231",10.0,,Posted,302.76,2024-11-15,10.0,"Recurring Withdrawal Debit Card - MC Debit Seminol/NOTION LABS, INC. SAN FRANCISC CADate 12/02/24 0 4337878572 0 7372Card 1231",10.0
11/15/2024,,Recurring Withdrawal Debit Card - MC Debit Seminol/RUNWAY STANDARD PLAN NEWARK DEDate 11/15/24 0 4320097866 1 5734Card 1231,15.0,,Posted,312.76,2024-11-15,15.0,Recurring Withdrawal Debit Card - MC Debit Seminol/RUNWAY STANDARD PLAN NEWARK DEDate 12/15/24 0 4350745942 1 5734Card 1231,15.0
11/14/2024,,"Withdrawal Home Banking Transfer refund/To CHAPLINSKI,LEONA 3496297 Share 0090",414.0,,Posted,327.76,2024-11-14,414.0,"Withdrawal Home Banking Transfer refund/To CHAPLINSKI,LEONA 3496297 Share 0090",414.0
11/14/2024,,Withdrawal POS #000000639340/SUNOCO 8002212501 4234 SW 20TH AVEGAINESVILLE FLCard 1231,44.56,,Posted,327.76,2024-11-14,44.56,Withdrawal POS #000000909995/SUNOCO 8002212501 4234 SW 20TH AVEGAINESVILLE FLCard 1231,44.56
11/14/2024,,Withdrawal POS #000000353696/INSTACART*159 WWW.INSTACART.COM/ SANFRANCISCO CACard 1231,64.0,,Posted,372.32,2024-11-14,64.0,Withdrawal POS #000000792733/INSTACART*159 WWW.INSTACART.COM/ SANFRANCISCO CACard 1231,64.0
11/12/2024,,Recurring Withdrawal Debit Card - MC Debit Seminol/CAPCUT WILMINGTON DEDate 11/11/24 0 4316889558 0 5734Card 1231,9.99,,Posted,436.32,2024-11-12,9.99,Recurring Withdrawal Debit Card - MC Debit Seminol/CAPCUT WILMINGTON DEDate 11/11/24 0 4316889558 0 5734Card 1231,9.99
11/12/2024,,Withdrawal Debit Card MC Debit Seminol/ARCHER ANIMAL HOSPITAL ARCHER FLDate 11/11/24 0 4316304922 0 0742Card 1231,82.28,,Posted,446.31,2024-11-12,82.28,Withdrawal Debit Card MC Debit Seminol/ARCHER ANIMAL HOSPITAL ARCHER FLDate 11/25/24 0 4330350737 0 0742Card 1231,82.28
11/12/2024,,Recurring Withdrawal Debit Card - MC Debit Seminol/APPLE.COM/BILL 866-712-7753 CADate 11/11/24 0 4316616813 0 5818Card 1231,5.99,,Posted,528.59,2024-11-12,5.99,Recurring Withdrawal Debit Card - MC Debit Seminol/APPLE.COM/BILL 866-712-7753 CADate 12/13/23 0 3347838871 0 5818Card 2801,5.99
11/12/2024,,Recurring Withdrawal Debit Card - MC Debit Seminol/APPLE.COM/BILL 866-712-7753 CADate 11/11/24 0 4316616811 0 5818Card 1231,9.99,,Posted,534.58,2024-11-12,9.99,Recurring Withdrawal Debit Card - MC Debit Seminol/APPLE.COM/BILL 866-712-7753 CADate 12/13/23 0 3347838871 0 5818Card 2801,9.99
11/12/2024,,Withdrawal ACH VENMO/TYPE: PAYMENT ID: 3264681992 CO: VENMONAME: AVATAR ARTSEntry Class Code: WEB,14.99,,Posted,544.57,2024-11-12,14.99,Withdrawal ACH VENMO/TYPE: PAYMENT ID: 3264681992 CO: VENMONAME: AVATAR ARTSEntry Class Code: WEB,14.99
11/12/2024,,Withdrawal ACH VENMO/TYPE: PAYMENT ID: 3264681992 CO: VENMONAME: AVATAR ARTSEntry Class Code: WEB,9.99,,Posted,559.56,2024-11-12,9.99,Withdrawal ACH VENMO/TYPE: PAYMENT ID: 3264681992 CO: VENMONAME: AVATAR ARTSEntry Class Code: WEB,9.99
11/11/2024,,Withdrawal Debit Card MC Debit Seminol/AMAZON PRIME*2Z8Q443B3 AMZN.COM/BIL WADate 11/11/24 0 4316267232 1 5818Card 1231,3.4,,Posted,289.55,2024-11-11,3.4,Withdrawal Debit Card MC Debit Seminol/AMAZON PRIME*XS2HD1WH3 AMZN.COM/BIL WADate 09/11/24 0 4255908162 0 5818Card 1231,3.4
11/11/2024,,Withdrawal POS #000000359959/INSTACART*159 WWW.INSTACART.COM/ SANFRANCISCO CACard 1231,55.0,,Posted,292.95,2024-11-11,55.0,Withdrawal POS #000000000003/INSTACART*159 WWW.INSTACART.COM/ SANFRANCISCO CACard 1231,55.0
11/10/2024,,Recurring Withdrawal Debit Card - MC Debit Seminol/MYDESIGNS - PRO - MON LAS VEGAS NVDate 11/08/24 0 4313744024 0 5734Card 1231,29.99,,Posted,347.95,2024-11-10,29.99,Withdrawal Debit Card MC Debit Seminol/MYDESIGNS - PRO - MON LAS VEGAS NVDate 09/01/23 0 3244164229 1 5734Card 2801,29.99
11/10/2024,,Recurring Withdrawal Debit Card - MC Debit Seminol/OPENAI SAN FRANCISC CADate 11/10/24 0 4315698126 1 5734Card 1231,15.01,,Posted,377.94,2024-11-10,15.01,Recurring Withdrawal Debit Card - MC Debit Seminol/OPENAI *CHATGPT SUBSCR SAN FRANCISC CADate 12/04/24 0 4339869196 0 5734Card 1231,15.01
11/10/2024,,Recurring Withdrawal Debit Card - MC Debit Seminol/INVIDEO INC COUNTRY OF S DEDate 11/09/24 0 4314032712 1 5734Card 1231,25.0,,Posted,392.95,2024-11-10,25.0,Recurring Withdrawal Debit Card - MC Debit Seminol/INVIDEO INC COUNTRY OF S DEDate 12/09/24 0 4344808122 0 5734Card 1231,25.0
11/10/2024,,Withdrawal Debit Card MC Debit Seminol/IONOS INC. CHESTERBROOK PADate 11/08/24 0 4313995164 0 4816Card 1231,23.0,,Posted,417.95,2024-11-10,23.0,Withdrawal Debit Card MC Debit Seminol/IONOS INC. CHESTERBROOK PADate 12/29/24 0 4364954464 0 4816Card 1231,23.0
11/10/2024,,Withdrawal Debit Card MC Debit Seminol/COX GAINESVILLE COMM 800-234-3993 FLDate 11/08/24 0 4313741580 0 4899Card 1231,156.13,,Posted,440.95,2024-11-10,156.13,Withdrawal Debit Card MC Debit Seminol/COX GAINESVILLE COMM 800-234-3993 FLDate 12/04/24 0 4339376311 0 4899Card 1231,156.13
11/10/2024,,Withdrawal POS #000000548638/SUNOCO 8002212501 4234 SW 20TH AVEGAINESVILLE FLCard 1231,41.74,,Posted,597.08,2024-11-10,41.74,Withdrawal POS #000000488663/SUNOCO 8002212501 4234 SW 20TH AVEGAINESVILLE FLCard 1231,41.42
11/9/2024,,Withdrawal POS #000020542095/GOOGLE *YouTubePremium 1600 AmphitheatreParkw Mountain View CACard 1231,9.1,,Posted,638.82,2024-11-09,9.1,"Withdrawal POS #000020312090/GOOGLE *YouTubePremium 1600 Amphitheatre

Parkw Mountain View CA

Card 1247",9.1
11/8/2024,,Withdrawal Debit Card MC Debit Seminol/GRU/EZ-PAY WEB PYMT 352-334-3434 FLDate 11/07/24 0 4312396219 0 4900Card 1231,171.27,,Posted,647.92,2024-11-08,171.27,Withdrawal Debit Card MC Debit Seminol/GRU/EZ-PAY WEB PYMT 352-334-3434 FLDate 12/05/24 0 4340279271 0 4900Card 1231,171.15
11/8/2024,,Withdrawal POS #000000000016/INSTACART*159 WWW.INSTACART.COM/ SANFRANCISCO CACard 1231,55.22,,Posted,819.19,2024-11-08,55.22,Withdrawal POS #000000804821/INSTACART*159 WWW.INSTACART.COM/ SANFRANCISCO CACard 1231,55.22
11/8/2024,,Withdrawal POS #000000470276/SUNOCO 8002212501 4234 SW 20TH AVEGAINESVILLE FLCard 1231,38.31,,Posted,874.41,2024-11-08,38.31,Withdrawal POS #000000616677/SUNOCO 8002212501 4234 SW 20TH AVEGAINESVILLE FLCard 1231,38.31
11/8/2024,,Withdrawal POS #000000000002/AMAZON.COM*5A0D46X63 SEATTLE WACard 1231,17.94,,Posted,912.72,2024-11-08,17.94,Withdrawal POS #000000000023/AMAZON.COM*AU8ER6ZT3 SEATTLE WACard 2801,17.94
11/7/2024,,Recurring Withdrawal Debit Card - MC Debit Seminol/KREA.AI SAN FRANCISC CADate 11/06/24 0 4311608810 0 5734Card 1231,10.0,,Posted,930.66,2024-11-07,10.0,Recurring Withdrawal Debit Card - MC Debit Seminol/KREA.AI SAN FRANCISC CADate 12/06/24 0 4341842673 0 5734Card 1231,10.0
11/7/2024,,Recurring Withdrawal Debit Card - MC Debit Seminol/PADDLE.NET* COPYTONOTI NEW YORK NYDate 11/07/24 0 4312608046 0 5817Card 1231,9.0,,Posted,940.66,2024-11-07,9.0,Recurring Withdrawal Debit Card - MC Debit Seminol/PADDLE.NET* SETAPP NEW YORK NYDate 10/14/24 0 4288882561 0 5817Card 1231,9.495000000000001
11/7/2024,,Recurring Withdrawal Debit Card - MC Debit Seminol/TUBEBUDDYCOM* 8668823239 CADate 11/07/24 0 4312454387 1 5734Card 1231,7.5,,Posted,949.66,2024-11-07,7.5,Recurring Withdrawal Debit Card - MC Debit Seminol/TUBEBUDDYCOM* 8668823239 CADate 12/03/24 0 4338443995 0 5045Card 1231,7.5
11/7/2024,,Withdrawal Debit Card MC Debit Seminol/SAMSUNG ELECTRONICS RIDGEFIELD P NJDate 11/06/24 0 4311606417 0 5734Card 1231,16.99,,Posted,957.16,2024-11-07,16.99,Withdrawal Debit Card MC Debit Seminol/SAMSUNG ELECTRONICS RIDGEFIELD P NJDate 12/27/24 0 4362999827 1 5734Card 1231,16.49
11/7/2024,,Withdrawal POS #000000685024/AMAZON.COM*AS4EW0V93 SEATTLE WACard 1231,13.85,,Posted,974.15,2024-11-07,13.85,Withdrawal POS #000000049785/AMAZON.COM*AV5RE3583 SEATTLE WACard 1231,13.85
11/6/2024,,Withdrawal Debit Card MC Debit Seminol/IONOS INC. CHESTERBROOK PADate 11/05/24 0 4310089629 1 4816Card 1231,16.0,,Posted,988.0,2024-11-06,16.0,Withdrawal Debit Card MC Debit Seminol/IONOS INC. CHESTERBROOK PADate 12/29/24 0 4364954464 0 4816Card 1231,16.0
11/6/2024,,Withdrawal ACH FLUENT-Gainesvil/TYPE: PAYMENT ID: 1371804719CO: FLUENT-GainesvilNAME: steven chaplinskiEntry Class Code: WEB,52.0,,Posted,1004.0,2024-11-06,52.0,Withdrawal ACH FLUENT-Gainesvil/TYPE: PAYMENT ID: 1371804719CO: FLUENT-GainesvilNAME: steven chaplinski,51.75
11/5/2024,,Recurring Withdrawal Debit Card - MC Debit Seminol/OPENAI *CHATGPT SUBSCR SAN FRANCISC CADate 11/04/24 0 4309006198 1 5734Card 1231,20.0,,Posted,1056.0,2024-11-05,20.0,Recurring Withdrawal Debit Card - MC Debit Seminol/OPENAI *CHATGPT SUBSCR SAN FRANCISC CADate 12/04/24 0 4339869196 0 5734Card 1231,20.0
11/5/2024,,Recurring Withdrawal Debit Card - MC Debit Seminol/PADDLE.NET* SETAPP NEW YORK NYDate 11/05/24 0 4310972348 0 5817Card 1231,9.99,,Posted,1076.0,2024-11-05,9.99,Recurring Withdrawal Debit Card - MC Debit Seminol/PADDLE.NET* SETAPP NEW YORK NYDate 10/14/24 0 4288882561 0 5817Card 1231,9.495000000000001
11/5/2024,,Recurring Withdrawal Debit Card - MC Debit Seminol/WWW.EVERBEE.IO AUSTIN TXDate 11/05/24 0 4310004793 1 5734Card 1231,29.99,,Posted,1085.99,2024-11-05,29.99,Recurring Withdrawal Debit Card - MC Debit Seminol/WWW.EVERBEE.IO AUSTIN TXDate 12/04/24 0 4339869891 0 5734Card 1231,29.99
11/5/2024,,Withdrawal Debit Card MC Debit Seminol/WAWA CARD RELOAD MEDIA PADate 11/03/24 0 4308001823 1 6540Card 1231,15.0,,Posted,1115.98,2024-11-05,15.0,Withdrawal Debit Card MC Debit Seminol/WAWA CARD RELOAD MEDIA PADate 11/03/24 0 4308001823 1 6540Card 1231,15.0
11/5/2024,,Recurring Withdrawal Debit Card - MC Debit Seminol/APPLE.COM/BILL 866-712-7753 CADate 11/05/24 0 4310965680 0 5818Card 1231,2.99,,Posted,1130.98,2024-11-05,2.99,Recurring Withdrawal Debit Card - MC Debit Seminol/APPLE.COM/BILL 866-712-7753 CADate 01/08/24 0 4008756344 0 5818Card 2801,2.99
11/5/2024,,Withdrawal POS #000000794627/SUNOCO 8002212501 4234 SW 20TH AVEGAINESVILLE FLCard 1231,34.56,,Posted,1069.93,2024-11-05,34.56,Withdrawal POS #000000616677/SUNOCO 8002212501 4234 SW 20TH AVEGAINESVILLE FLCard 1231,34.76
11/4/2024,,"Withdrawal Bill Payment #000000195926/Adobe Park Avenue,345 San Jose CACard 1231",19.99,,Posted,1104.49,2024-11-04,19.99,"Withdrawal Bill Payment #000000352498/Adobe Park Avenue,345 San Jose CACard 1247",19.99
11/4/2024,,Recurring Withdrawal Debit Card - MC Debit Seminol/SUPERPOWER CHATGPT MIDDLETOWN DEDate 11/03/24 0 4308505507 0 5734Card 1231,15.0,,Posted,1124.48,2024-11-04,15.0,Recurring Withdrawal Debit Card - MC Debit Seminol/SUPERPOWER CHATGPT MIDDLETOWN DEDate 12/17/24 0 4352703539 1 5734Card 1231,15.094999999999999
11/4/2024,,Recurring Withdrawal Debit Card - MC Debit Seminol/SALESAMURAI SOFTWARE BOULDER CODate 11/04/24 0 4309610111 1 5734Card 1231,1.0,,Posted,1139.48,2024-11-04,1.0,Recurring Withdrawal Debit Card - MC Debit Seminol/SALESAMURAI SOFTWARE BOULDER CODate 11/04/24 0 4309610111 1 5734Card 1231,1.0
11/4/2024,,Withdrawal Debit Card MC Debit Seminol/WALGREENS #5024 GAINESVILLE FLDate 11/03/24 0 4308603683 1 5912Card 1231,27.97,,Posted,1140.48,2024-11-04,27.97,Withdrawal Debit Card MC Debit Seminol/WALGREENS #5024 GAINESVILLE FLDate 04/14/24 0 4105827629 0 5912Card 1231,28.46
11/4/2024,,Recurring Withdrawal Debit Card - MC Debit Seminol/APPLE.COM/BILL 866-712-7753 CADate 11/04/24 0 4309601161 1 5818Card 1231,2.99,,Posted,1168.45,2024-11-04,2.99,Recurring Withdrawal Debit Card - MC Debit Seminol/APPLE.COM/BILL 866-712-7753 CADate 11/11/24 0 4316616811 0 5818Card 1231,2.99
11/4/2024,,Withdrawal ACH Watson Realty Co/TYPE: WEB PMTS ID: 9000321157CO: Watson Realty CoNAME: Steven chaplinskiEntry Class Code: WEB,1179.0,,Posted,1171.44,2024-11-04,1179.0,Withdrawal ACH Watson Realty Co/TYPE: WEB PMTS ID: 9000321157CO: Watson Realty CoEntry Class Code: WEB,1179.0
11/4/2024,,"Withdrawal ACH AppFolio, Inc. F/TYPE: WEB PMTS ID: 9001406550CO: AppFolio, Inc. FNAME: Steven chaplinskiEntry Class Code: WEB",2.49,,Posted,2350.44,2024-11-04,2.49,"Withdrawal ACH AppFolio, Inc. F/TYPE: WEB PMTS ID: 9001406550

CO: AppFolio, Inc. F

NAME: Steven chaplinskiEntry Class Code: WEB",2.49
11/3/2024,,Withdrawal POS #000000212529/AMAZON.COM*HG16B6833 SEATTLE WACard 1231,45.43,,Posted,2352.93,2024-11-03,45.43,Withdrawal POS #000000000021/AMAZON.COM*TQ9TB8YN3 SEATTLE WACard 1231,45.43
11/3/2024,,Withdrawal Debit Card MC Debit Seminol/IONOS INC. CHESTERBROOK PADate 11/01/24 0 4306766970 1 4816Card 1231,0.68,,Posted,2398.36,2024-11-03,0.68,Withdrawal Debit Card MC Debit Seminol/IONOS INC. CHESTERBROOK PADate 12/29/24 0 4364954464 0 4816Card 1231,0.8400000000000001
11/3/2024,,"Withdrawal Bill Payment #000000227815/Adobe Park Avenue,345 San Jose CACard 1231",34.99,,Posted,2399.04,2024-11-03,34.99,"Withdrawal Bill Payment #000000352498/Adobe Park Avenue,345 San Jose CACard 1247",34.99
11/3/2024,,Withdrawal POS #000000000013/CIRCLE K # 06782 5237 GAINESVILLE FLCard 1231,12.83,,Posted,2434.03,2024-11-03,12.83,Withdrawal POS #000000882351/CIRCLE K # 06782 GAINESVILLE FLCard 1140,13.165
11/2/2024,,Withdrawal POS #000000000021/AMAZON.COM*TQ9TB8YN3 SEATTLE WACard 1231,30.45,,Posted,2446.86,2024-11-02,30.45,Withdrawal POS #000000000021/AMAZON.COM*TQ9TB8YN3 SEATTLE WACard 1231,30.45
11/2/2024,,Withdrawal POS #000000680703/SUNOCO 8002212501 4234 SW 20TH AVEGAINESVILLE FLCard 1231,34.88,,Posted,2477.31,2024-11-02,34.88,Withdrawal POS #000000616677/SUNOCO 8002212501 4234 SW 20TH AVEGAINESVILLE FLCard 1231,34.76
11/2/2024,,Withdrawal Bill Payment #000000353116/Disney PLUS Recurring 1375 Buena VistaDrive Lake Buena Vi FLCard 1231,18.41,,Posted,2512.19,2024-11-02,18.41,Withdrawal Bill Payment #000000352178/Disney PLUS Recurring 1375 Buena VistaDrive Lake Buena Vi FLCard 1231,18.41
11/1/2024,,Recurring Withdrawal Debit Card - MC Debit Seminol/MYDESIGNS.IO LAS VEGAS NVDate 10/31/24 0 4305943289 0 5734Card 1231,30.57,,Posted,2530.6,2024-11-01,30.57,Withdrawal Debit Card MC Debit Seminol/MYDESIGNS.IO LAS VEGAS NVDate 01/07/24 0 4007751481 0 5734Card 2801,30.57
11/1/2024,,Withdrawal ACH FLUENT-Gainesvil/TYPE: PAYMENT ID: 1371804719CO: FLUENT-GainesvilNAME: steven chaplinskiEntry Class Code: WEB,36.0,,Posted,2561.17,2024-11-01,36.0,Withdrawal ACH FLUENT-Gainesvil/TYPE: PAYMENT ID: 1371804719CO: FLUENT-GainesvilNAME: steven chaplinski,36.0
10/31/2024,,Withdrawal POS #000000000000/INSTACART*159 WWW.INSTACART.COM/ SANFRANCISCO CACard 1231,70.69,,Posted,2597.17,2024-10-31,70.69,Withdrawal POS #000000000003/INSTACART*159 WWW.INSTACART.COM/ SANFRANCISCO CACard 1231,70.69
10/31/2024,,Withdrawal Debit Card MC Debit Seminol/WALGREENS #9304 GAINESVILLE FLDate 10/30/24 0 4304125853 1 5912Card 1231,10.81,,Posted,2667.86,2024-10-31,10.81,Withdrawal Debit Card MC Debit Seminol/WALGREENS #9304 GAINESVILLE FLDate 12/20/23 0 3354958966 0 5912Card 2801,10.81
10/30/2024,,Withdrawal POS #000000772673/INSTACART*159 WWW.INSTACART.COM/ SANFRANCISCO CACard 1231,59.1,,Posted,2678.67,2024-10-30,59.1,Withdrawal POS #000000792733/INSTACART*159 WWW.INSTACART.COM/ SANFRANCISCO CACard 1231,59.085
10/30/2024,,Recurring Withdrawal Debit Card - MC Debit Seminol/IC* INSTACART*SUBSCRIP SAN FRANCISC CADate 10/29/24 0 4303918463 0 5411Card 1231,9.99,,Posted,2665.77,2024-10-30,9.99,Recurring Withdrawal Debit Card - MC Debit Seminol/IC* INSTACART*SUBSCRIP SAN FRANCISC CADate 11/30/24 0 4335692546 1 5411Card 1231,9.99
10/30/2024,,Withdrawal POS #000000563213/SUNOCO 8002212501 4234 SW 20TH AVEGAINESVILLE FLCard 1231,38.64,,Posted,2675.76,2024-10-30,38.64,Withdrawal POS #000000555763/SUNOCO 8002212501 4234 SW 20TH AVEGAINESVILLE FLCard 1231,38.21
10/28/2024,,Withdrawal Debit Card MC Debit Seminol/SAMSUNG ELECTRONICS RIDGEFIELD P NJDate 10/27/24 0 4301061054 1 5734Card 1231,8.99,,Posted,-85.6,2024-10-28,8.99,Withdrawal Debit Card MC Debit Seminol/SAMSUNG ELECTRONICS RIDGEFIELD P NJDate 12/27/24 0 4362999827 1 5734Card 1231,8.99
10/27/2024,,Withdrawal CourtesyFeeDebit,35.0,,Posted,-76.61,2024-10-27,35.0,Withdrawal CourtesyFeeDebit,35.0
10/27/2024,,Withdrawal Debit Card MC Debit Seminol/IONOS INC. CHESTERBROOK PADate 10/26/24 0 4300913613 0 4816Card 1231,165.0,,Posted,-41.61,2024-10-27,165.0,Withdrawal Debit Card MC Debit Seminol/IONOS INC. CHESTERBROOK PADate 12/29/24 0 4364954464 0 4816Card 1231,165.0
10/27/2024,,Withdrawal POS #000000929659/SUNOCO 8002212501 4234 SW 20TH AVEGAINESVILLE FLCard 1231,18.89,,Posted,123.39,2024-10-27,18.89,Withdrawal POS #000000221295/SUNOCO 8002212501 4234 SW 20TH AVEGAINESVILLE FLCard 1231,18.89
10/26/2024,,Withdrawal POS #000000901989/SUNOCO 8002212501 4234 SW 20TH AVEGAINESVILLE FLCard 1231,22.42,,Posted,142.28,2024-10-26,22.42,Withdrawal POS #000000909995/SUNOCO 8002212501 4234 SW 20TH AVEGAINESVILLE FLCard 1231,22.42
10/25/2024,,Withdrawal POS #000000776690/INSTACART*159 WWW.INSTACART.COM/ SANFRANCISCO CACard 1231,72.0,,Posted,164.7,2024-10-25,72.0,Withdrawal POS #000000772291/INSTACART*159 WWW.INSTACART.COM/ SANFRANCISCO CACard 1231,72.0
10/25/2024,,Recurring Withdrawal Debit Card - MC Debit Seminol/FS *ADOBE SANTA BARBAR CADate 10/24/24 0 4298968563 0 5734Card 1231,0.95,,Posted,36.7,2024-10-25,0.95,Recurring Withdrawal Debit Card - MC Debit Seminol/FS *ADOBE SANTA BARBAR CADate 12/24/24 0 4359034647 1 5734Card 1231,0.95
10/25/2024,,Withdrawal POS #000000850898/SUNOCO 8002212501 4234 SW 20TH AVEGAINESVILLE FLCard 1231,25.96,,Posted,37.65,2024-10-25,25.96,Withdrawal POS #000000778591/SUNOCO 8002212501 4234 SW 20TH AVEGAINESVILLE FLCard 1231,25.96
10/24/2024,,Withdrawal POS #000000805070/SUNOCO 8002212501 4234 SW 20TH AVEGAINESVILLE FLCard 1231,22.42,,Posted,63.61,2024-10-24,22.42,Withdrawal POS #000000235720/SUNOCO 8002212501 4234 SW 20TH AVEGAINESVILLE FLCard 1231,22.42
10/23/2024,,Recurring Withdrawal Bill Payment - #000000864701/Netflix.com NETFLIX.COM LOS GATOS CACard 1231,17.84,,Posted,86.03,2024-10-23,17.84,Recurring Withdrawal Bill Payment - #000000864701/Netflix.com NETFLIX.COM LOS GATOS CACard 1231,17.84
10/23/2024,,Withdrawal POS #000000761115/PUBLIX 3100 SW 35TH BLVD GAINESVILLE FLCard 1231,10.08,,Posted,103.87,2024-10-23,10.08,Withdrawal POS #000000741171/PUBLIX 3100 SW 35TH BLVD GAINESVILLE FLCard 2801,10.08
10/23/2024,,Withdrawal POS #000000570907/SUNOCO 8002212501 4234 SW 20TH AVEGAINESVILLE FLCard 1231,22.42,,Posted,113.95,2024-10-23,22.42,Withdrawal POS #000000235720/SUNOCO 8002212501 4234 SW 20TH AVEGAINESVILLE FLCard 1231,22.42
10/22/2024,,Withdrawal POS #000000793069/INSTACART*159 WWW.INSTACART.COM/ SANFRANCISCO CACard 1231,55.94,,Posted,136.37,2024-10-22,55.94,Withdrawal POS #000000792733/INSTACART*159 WWW.INSTACART.COM/ SANFRANCISCO CACard 1231,55.94
10/21/2024,,Recurring Withdrawal Debit Card - MC Debit Seminol/CANVA* I04310-27668476 CAMDEN DEDate 10/20/24 0 4294054048 1 7333Card 1231,12.99,,Posted,175.59,2024-10-21,12.99,Recurring Withdrawal Debit Card - MC Debit Seminol/CANVA* I04371-41297102 CAMDEN DEDate 12/20/24 0 4355594081 2 7333Card 1231,12.99
10/21/2024,,Withdrawal ACH FLUENT-Gainesvil/TYPE: PAYMENT ID: 1371804719CO: FLUENT-GainesvilNAME: steven chaplinskiEntry Class Code: WEB,35.0,,Posted,188.58,2024-10-21,35.0,Withdrawal ACH FLUENT-Gainesvil/TYPE: PAYMENT ID: 1371804719CO: FLUENT-GainesvilNAME: steven chaplinski,34.5
10/20/2024,,Recurring Withdrawal Debit Card - MC Debit Seminol/OPENAI SAN FRANCISC CADate 10/18/24 0 4292079345 2 5734Card 1231,15.03,,Posted,223.58,2024-10-20,15.03,Withdrawal Debit Card MC Debit Seminol/OPENAI SAN FRANCISC CADate 02/16/24 0 4047896474 1 5734Card 1231,15.0325
10/20/2024,,Recurring Withdrawal Debit Card Fee/MASTERCARD ISSUER CROSS-BORDER FEEDate 10/18/24 0 4292359683 2 5734Card 1231,0.05,,Posted,238.61,2024-10-20,0.05,Recurring Withdrawal Debit Card Fee/MASTERCARD ISSUER CROSS-BORDER FEEDate 06/15/24 0 4167922806 1 5734Card 1231,0.08
10/20/2024,,Recurring Withdrawal Debit Card - MC Debit Seminol/SAVE TO NOTION VAUREAL ILDate 10/18/24 0 4292359683 2 5734Card 1231,5.99,,Posted,238.66,2024-10-20,5.99,Recurring Withdrawal Debit Card - MC Debit Seminol/SAVE TO NOTION VAUREAL ILDate 12/18/24 0 4353969048 0 5734Card 1231,5.99
10/20/2024,,Recurring Withdrawal Debit Card - MC Debit Seminol/MYDESIGNS.IO LAS VEGAS NVDate 10/18/24 0 4292077676 2 5734Card 1231,12.68,,Posted,244.65,2024-10-20,12.68,Recurring Withdrawal Debit Card - MC Debit Seminol/MYDESIGNS.IO LAS VEGAS NVDate 10/18/24 0 4292077676 2 5734Card 1231,12.68
10/20/2024,,Recurring Withdrawal Debit Card Fee/MASTERCARD ISSUER CROSS-BORDER FEEDate 10/19/24 0 4293358426 2 5817Card 1231,0.01,,Posted,257.33,2024-10-20,0.01,Recurring Withdrawal Debit Card Fee/MASTERCARD ISSUER CROSS-BORDER FEEDate 02/25/24 0 4056812425 0 4816Card 1231,0.13
10/20/2024,,Recurring Withdrawal Debit Card - MC Debit Seminol/CAPCUT SINGAPORE SGDate 10/19/24 0 4293358426 2 5817Card 1231,0.99,,Posted,257.34,2024-10-20,0.99,Recurring Withdrawal Debit Card - MC Debit Seminol/CAPCUT SINGAPORE SGDate 10/19/24 0 4293358426 2 5817Card 1231,0.99
10/18/2024,,Withdrawal POS #000000500838/SUNOCO 8002212501 4234 SW 20TH AVEGAINESVILLE FLCard 1231,37.78,,Posted,258.33,2024-10-18,37.78,Withdrawal POS #000000504303/SUNOCO 8002212501 4234 SW 20TH AVEGAINESVILLE FLCard 1231,37.78
10/18/2024,,Recurring Withdrawal Debit Card - MC Debit Seminol/AMAZON PRIME*ZZ8XZ1T22 AMZN.COM/BIL WADate 10/17/24 0 4291354760 0 5968Card 1231,15.11,,Posted,296.11,2024-10-18,15.11,Recurring Withdrawal Debit Card - MC Debit Seminol/AMAZON PRIME*QP8EE86P3 AMZN.COM/BIL WADate 07/04/23 0 3185799509 0 5968Card 2801,15.13
10/17/2024,,Withdrawal POS #000000514838/SUNOCO 8002212501 4234 SW 20TH AVEGAINESVILLE FLCard 1231,22.42,,Posted,71.22,2024-10-17,22.42,Withdrawal POS #000000488663/SUNOCO 8002212501 4234 SW 20TH AVEGAINESVILLE FLCard 1231,22.42
10/17/2024,,Recurring Withdrawal Debit Card - MC Debit Seminol/SUPERPOWER CHATGPT MIDDLETOWN DEDate 10/17/24 0 4291148991 1 5734Card 1231,15.0,,Posted,93.64,2024-10-17,15.0,Recurring Withdrawal Debit Card - MC Debit Seminol/SUPERPOWER CHATGPT MIDDLETOWN DEDate 12/17/24 0 4352703539 1 5734Card 1231,15.094999999999999
10/17/2024,,Recurring Withdrawal Debit Card - MC Debit Seminol/PADDLE.NET* LEONARDOAI ASTORIA NYDate 10/16/24 0 4290347897 0 5817Card 1231,9.0,,Posted,108.64,2024-10-17,9.0,Withdrawal Debit Card MC Debit Seminol/PADDLE.NET* LEONARDOAI ASTORIA NYDate 10/26/23 0 3299263117 0 5817Card 2801,9.0
10/17/2024,,Recurring Withdrawal Debit Card - MC Debit Seminol/PADDLE.NET* SETAPP ASTORIA NYDate 10/16/24 0 4290896850 0 5817Card 1231,12.49,,Posted,117.64,2024-10-17,12.49,Recurring Withdrawal Debit Card - MC Debit Seminol/PADDLE.NET* SETAPP NEW YORK NYDate 10/14/24 0 4288882561 0 5817Card 1231,12.49
10/17/2024,,Recurring Withdrawal Debit Card Fee/MASTERCARD ISSUER CROSS-BORDER FEEDate 10/17/24 0 4291146721 1 5734Card 1231,0.06,,Posted,130.13,2024-10-17,0.06,Recurring Withdrawal Debit Card Fee/MASTERCARD ISSUER CROSS-BORDER FEEDate 05/12/21 0 1132191600 1 7372Card 2801,0.09500000000000001
10/17/2024,,Recurring Withdrawal Debit Card - MC Debit Seminol/IDEOGRAM AI TORONTO ONDate 10/17/24 0 4291146721 1 5734Card 1231,8.0,,Posted,130.19,2024-10-17,8.0,Recurring Withdrawal Debit Card - MC Debit Seminol/IDEOGRAM AI TORONTO ONDate 12/17/24 0 4352700468 1 5734Card 1231,8.0
10/16/2024,,"Recurring Withdrawal Debit Card - MC Debit Seminol/NOTION LABS, INC. SAN FRANCISC CADate 10/15/24 0 4289885767 0 7372Card 1231",10.0,,Posted,138.19,2024-10-16,10.0,"Recurring Withdrawal Debit Card - MC Debit Seminol/NOTION LABS, INC. SAN FRANCISC CADate 12/02/24 0 4337878572 0 7372Card 1231",10.0
10/16/2024,,Recurring Withdrawal Debit Card - MC Debit Seminol/RUNWAY STANDARD PLAN NEWARK DEDate 10/15/24 0 4289885711 0 5734Card 1231,15.0,,Posted,148.19,2024-10-16,15.0,Recurring Withdrawal Debit Card - MC Debit Seminol/RUNWAY STANDARD PLAN NEWARK DEDate 12/15/24 0 4350745942 1 5734Card 1231,15.0
10/16/2024,,Withdrawal POS #000000796464/INSTACART*159 WWW.INSTACART.COM/ SANFRANCISCO CACard 1231,60.0,,Posted,163.19,2024-10-16,60.0,Withdrawal POS #000000772291/INSTACART*159 WWW.INSTACART.COM/ SANFRANCISCO CACard 1231,60.0
10/16/2024,,Withdrawal POS #000000388399/SUNOCO 8002212501 4234 SW 20TH AVEGAINESVILLE FLCard 1231,32.42,,Posted,223.19,2024-10-16,32.42,Withdrawal POS #000000488663/SUNOCO 8002212501 4234 SW 20TH AVEGAINESVILLE FLCard 1231,32.42
10/15/2024,,Recurring Withdrawal Debit Card - MC Debit Seminol/PADDLE.NET* SETAPP NEW YORK NYDate 10/14/24 0 4288882561 0 5817Card 1231,9.99,,Posted,254.39,2024-10-15,9.99,Recurring Withdrawal Debit Card - MC Debit Seminol/PADDLE.NET* SETAPP NEW YORK NYDate 10/14/24 0 4288882561 0 5817Card 1231,9.495000000000001
10/14/2024,,Recurring Withdrawal Debit Card - MC Debit Seminol/D-ID STUDIO WILMINGTON DEDate 10/13/24 0 4287011811 1 7399Card 1231,5.9,,Posted,264.38,2024-10-14,5.9,Recurring Withdrawal Debit Card - MC Debit Seminol/D-ID STUDIO WILMINGTON DEDate 10/13/24 0 4287011811 1 7399Card 1231,5.9
10/11/2024,,Withdrawal POS #000000219736/SUNOCO 8002212501 4234 SW 20TH AVEGAINESVILLE FLCard 1231,34.24,,Posted,270.28,2024-10-11,34.24,Withdrawal POS #000000221295/SUNOCO 8002212501 4234 SW 20TH AVEGAINESVILLE FLCard 1231,34.24
10/11/2024,,Recurring Withdrawal Debit Card Fee/MASTERCARD ISSUER CROSS-BORDER FEEDate 10/11/24 0 4285915368 0 5817Card 1231,0.08,,Posted,304.52,2024-10-11,0.08,Recurring Withdrawal Debit Card Fee/MASTERCARD ISSUER CROSS-BORDER FEEDate 12/11/21 0 1345316936 1 5817Card 2801,0.08666666666666667
10/11/2024,,Recurring Withdrawal Debit Card - MC Debit Seminol/CAPCUT SINGAPORE SGDate 10/11/24 0 4285915368 0 5817Card 1231,9.99,,Posted,304.6,2024-10-11,9.99,Recurring Withdrawal Debit Card - MC Debit Seminol/ETSYHUNT TECH SINGAPORE SGDate 06/14/24 0 4166958438 0 5734Card 1231,9.99
10/11/2024,,Withdrawal Debit Card MC Debit Seminol/AMAZON PRIME*NL5H74FI3 AMZN.COM/BIL WADate 10/11/24 0 4285071195 1 5818Card 1231,3.4,,Posted,314.59,2024-10-11,3.4,Withdrawal Debit Card MC Debit Seminol/AMAZON PRIME*XS2HD1WH3 AMZN.COM/BIL WADate 09/11/24 0 4255908162 0 5818Card 1231,3.4
10/11/2024,,Withdrawal ACH VENMO/TYPE: PAYMENT ID: 3264681992 CO: VENMONAME: AVATAR ARTSEntry Class Code: WEB,14.99,,Posted,317.99,2024-10-11,14.99,Withdrawal ACH VENMO/TYPE: PAYMENT ID: 3264681992 CO: VENMONAME: AVATAR ARTSEntry Class Code: WEB,14.99
10/10/2024,,Withdrawal ACH VENMO/TYPE: PAYMENT ID: 3264681992 CO: VENMONAME: AVATAR ARTSEntry Class Code: WEB,9.99,,Posted,332.98,2024-10-10,9.99,Withdrawal ACH VENMO/TYPE: PAYMENT ID: 3264681992 CO: VENMONAME: AVATAR ARTSEntry Class Code: WEB,9.99
10/9/2024,,Withdrawal POS #000000110496/SUNOCO 8002212501 4234 SW 20TH AVEGAINESVILLE FLCard 1231,37.78,,Posted,342.97,2024-10-09,37.78,Withdrawal POS #000000031004/SUNOCO 8002212501 4234 SW 20TH AVEGAINESVILLE FLCard 1231,37.78
10/9/2024,,Recurring Withdrawal Debit Card - MC Debit Seminol/INVIDEO INC COUNTRY OF S DEDate 10/09/24 0 4283111145 1 5734Card 1231,60.0,,Posted,380.75,2024-10-09,60.0,Recurring Withdrawal Debit Card - MC Debit Seminol/INVIDEO INC COUNTRY OF S DEDate 12/09/24 0 4344808122 0 5734Card 1231,60.0
10/9/2024,,Recurring Withdrawal Debit Card - MC Debit Seminol/MYDESIGNS - PRO - MON LAS VEGAS NVDate 10/09/24 0 4283929863 0 5734Card 1231,29.99,,Posted,440.75,2024-10-09,29.99,Withdrawal Debit Card MC Debit Seminol/MYDESIGNS - PRO - MON LAS VEGAS NVDate 09/01/23 0 3244164229 1 5734Card 2801,29.99
10/9/2024,,Withdrawal Debit Card MC Debit Seminol/CIRCLE K # 06782 GAINESVILLE FLDate 10/07/24 0 4281924124 0 5499Card 1231,33.08,,Posted,470.74,2024-10-09,33.08,Withdrawal Debit Card MC Debit Seminol/CIRCLE K # 06782 GAINESVILLE FLDate 09/08/24 0 4252889868 0 5499Card 1231,33.08
10/9/2024,,Recurring Withdrawal Debit Card - MC Debit Seminol/APPLE.COM/BILL 866-712-7753 CADate 10/08/24 0 4282739947 0 5818Card 1231,2.99,,Posted,503.82,2024-10-09,2.99,Recurring Withdrawal Debit Card - MC Debit Seminol/APPLE.COM/BILL 866-712-7753 CADate 01/08/24 0 4008756344 0 5818Card 2801,2.99
10/9/2024,,Withdrawal ACH FLUENT-Gainesvil/TYPE: PAYMENT ID: 1371804719CO: FLUENT-GainesvilNAME: steven chaplinskiEntry Class Code: WEB,33.0,,Posted,506.81,2024-10-09,33.0,Withdrawal ACH FLUENT-Gainesvil/TYPE: PAYMENT ID: 1371804719CO: FLUENT-GainesvilNAME: steven chaplinski,32.5
10/9/2024,,Withdrawal POS #000020628140/GOOGLE *YouTubePremium 1600 AmphitheatreParkw Mountain View CACard 1231,9.1,,Posted,539.81,2024-10-09,9.1,"Withdrawal POS #000020312090/GOOGLE *YouTubePremium 1600 Amphitheatre

Parkw Mountain View CA

Card 1247",9.1
10/7/2024,,Recurring Withdrawal Debit Card - MC Debit Seminol/TUBEBUDDYCOM* 8668823239 CADate 10/07/24 0 4281084817 2 5734Card 1231,7.5,,Posted,548.91,2024-10-07,7.5,Recurring Withdrawal Debit Card - MC Debit Seminol/TUBEBUDDYCOM* 8668823239 CADate 12/03/24 0 4338443995 0 5045Card 1231,7.5
10/7/2024,,Withdrawal Debit Card MC Debit Seminol/SAMSUNG ELECTRONICS RIDGEFIELD P NJDate 10/06/24 0 4280082073 2 5734Card 1231,16.99,,Posted,556.41,2024-10-07,16.99,Withdrawal Debit Card MC Debit Seminol/SAMSUNG ELECTRONICS RIDGEFIELD P NJDate 12/27/24 0 4362999827 1 5734Card 1231,16.49
10/7/2024,,Withdrawal Debit Card MC Debit Seminol/CIRCLE K # 06782 GAINESVILLE FLDate 10/05/24 0 4279070275 2 5499Card 1231,33.08,,Posted,573.4,2024-10-07,33.08,Withdrawal Debit Card MC Debit Seminol/CIRCLE K # 06782 GAINESVILLE FLDate 09/08/24 0 4252889868 0 5499Card 1231,33.08
10/7/2024,,Withdrawal Debit Card MC Debit Seminol/GRU/EZ-PAY WEB PYMT 352-334-3434 FLDate 10/06/24 0 4280069927 2 4900Card 1231,179.69,,Posted,606.48,2024-10-07,179.69,Withdrawal Debit Card MC Debit Seminol/GRU/EZ-PAY WEB PYMT 352-334-3434 FLDate 12/05/24 0 4340279271 0 4900Card 1231,179.69
10/6/2024,,Recurring Withdrawal Debit Card - MC Debit Seminol/OPENAI *CHATGPT SUBSCR SAN FRANCISC CADate 10/05/24 0 4279609183 4 5734Card 1231,20.0,,Posted,786.17,2024-10-06,20.0,Recurring Withdrawal Debit Card - MC Debit Seminol/OPENAI *CHATGPT SUBSCR SAN FRANCISC CADate 12/04/24 0 4339869196 0 5734Card 1231,20.0
10/6/2024,,Withdrawal Debit Card MC Debit Seminol/IONOS INC. CHESTERBROOK PADate 10/05/24 0 4279888536 2 4816Card 1231,16.0,,Posted,806.17,2024-10-06,16.0,Withdrawal Debit Card MC Debit Seminol/IONOS INC. CHESTERBROOK PADate 12/29/24 0 4364954464 0 4816Card 1231,16.0
10/6/2024,,Withdrawal Debit Card MC Debit Seminol/WALGREENS #5024 GAINESVILLE FLDate 10/05/24 0 4279879417 2 5912Card 1231,15.0,,Posted,822.17,2024-10-06,15.0,Withdrawal Debit Card MC Debit Seminol/WALGREENS #5024 GAINESVILLE FLDate 04/14/24 0 4105827629 0 5912Card 1231,15.0
10/6/2024,,Withdrawal Debit Card MC Debit Seminol/COX GAINESVILLE COMM 800-234-3993 FLDate 10/05/24 0 4279871365 2 4899Card 1231,156.13,,Posted,837.17,2024-10-06,156.13,Withdrawal Debit Card MC Debit Seminol/COX GAINESVILLE COMM 800-234-3993 FLDate 12/04/24 0 4339376311 0 4899Card 1231,156.13
10/6/2024,,Withdrawal POS #000000592618/AMAZON.COM*PF74M5SG3 SEATTLE WACard 1231,10.74,,Posted,993.3,2024-10-06,10.74,Withdrawal POS #000000592618/AMAZON.COM*PF74M5SG3 SEATTLE WACard 1231,10.74
10/4/2024,,Recurring Withdrawal Debit Card Fee/MASTERCARD ISSUER CROSS-BORDER FEEDate 10/03/24 0 4277044624 1 7399Card 1231,0.47,,Posted,1004.04,2024-10-04,0.47,Recurring Withdrawal Debit Card Fee/MASTERCARD ISSUER CROSS-BORDER FEEDate 12/17/24 0 4352700468 1 5734Card 1231,0.47
10/4/2024,,Recurring Withdrawal Debit Card - MC Debit Seminol/CREATIVE FABRICA AMSTERDAM NHDate 10/03/24 0 4277044624 1 7399Card 1231,59.16,,Posted,1004.51,2024-10-04,59.16,Recurring Withdrawal Debit Card - MC Debit Seminol/CREATIVE FABRICA AMSTERDAM NHDate 10/03/24 0 4277044624 1 7399Card 1231,59.16
10/4/2024,,Recurring Withdrawal Debit Card - MC Debit Seminol/APPLE.COM/BILL 866-712-7753 CADate 10/03/24 0 4277938820 0 5818Card 1231,2.99,,Posted,1063.67,2024-10-04,2.99,Recurring Withdrawal Debit Card - MC Debit Seminol/APPLE.COM/BILL 866-712-7753 CADate 12/13/23 0 3347838871 0 5818Card 2801,2.99
10/4/2024,,Withdrawal POS #000000784928/AMAZON.COM*NG4MN0L33 SEATTLE WACard 1231,32.84,,Posted,1066.66,2024-10-04,32.84,Withdrawal POS #000000049785/AMAZON.COM*AV5RE3583 SEATTLE WACard 1231,32.84
10/3/2024,,Withdrawal POS #000000757832/SUNOCO 8002212501 4234 SW 20TH AVEGAINESVILLE FLCard 1231,46.35,,Posted,1099.5,2024-10-03,46.35,Withdrawal POS #000000778591/SUNOCO 8002212501 4234 SW 20TH AVEGAINESVILLE FLCard 1231,46.35
10/3/2024,,Withdrawal Debit Card MC Debit Seminol/IONOS INC. CHESTERBROOK PADate 10/02/24 0 4276189742 1 4816Card 1231,1.0,,Posted,1145.85,2024-10-03,1.0,Withdrawal Debit Card MC Debit Seminol/IONOS INC. CHESTERBROOK PADate 12/29/24 0 4364954464 0 4816Card 1231,0.8400000000000001
10/3/2024,,"Withdrawal Bill Payment #000000776300/Adobe Park Avenue,345 San Jose CACard 1231",19.99,,Posted,1146.85,2024-10-03,19.99,"Withdrawal Bill Payment #000000352498/Adobe Park Avenue,345 San Jose CACard 1247",19.99
10/3/2024,,Withdrawal POS #000000772291/INSTACART*159 WWW.INSTACART.COM/ SANFRANCISCO CACard 1231,97.44,,Posted,1166.84,2024-10-03,97.44,Withdrawal POS #000000804821/INSTACART*159 WWW.INSTACART.COM/ SANFRANCISCO CACard 1231,97.44
10/2/2024,,Recurring Withdrawal Debit Card - MC Debit Seminol/DISNEY PLUS 8889057888 CADate 10/02/24 0 4276239357 1 4899Card 1231,16.11,,Posted,1264.28,2024-10-02,16.11,Recurring Withdrawal Debit Card - MC Debit Seminol/DISNEY PLUS 8889057888 CADate 10/02/24 0 4276239357 1 4899Card 1231,16.11
10/2/2024,,Withdrawal ACH Watson Realty Co/TYPE: WEB PMTS ID: 9000321157CO: Watson Realty CoNAME: Steven chaplinskiEntry Class Code: WEB,1179.0,,Posted,1280.39,2024-10-02,1179.0,Withdrawal ACH Watson Realty Co/TYPE: WEB PMTS ID: 9000321157CO: Watson Realty CoEntry Class Code: WEB,1179.0
10/2/2024,,"Withdrawal ACH AppFolio, Inc. F/TYPE: WEB PMTS ID: 9001406550CO: AppFolio, Inc. FNAME: Steven chaplinskiEntry Class Code: WEB",2.49,,Posted,2459.39,2024-10-02,2.49,"Withdrawal ACH AppFolio, Inc. F/TYPE: WEB PMTS ID: 9001406550

CO: AppFolio, Inc. F

NAME: Steven chaplinskiEntry Class Code: WEB",2.49
10/1/2024,,Withdrawal POS #000000680755/SUNOCO 8002212501 4234 SW 20TH AVEGAINESVILLE FLCard 1231,34.24,,Posted,2461.88,2024-10-01,34.24,Withdrawal POS #000000680755/SUNOCO 8002212501 4234 SW 20TH AVEGAINESVILLE FLCard 1231,34.24
10/1/2024,,Withdrawal Debit Card MC Debit Seminol/WALGREENS #9304 GAINESVILLE FLDate 09/30/24 0 4274152821 1 5912Card 1231,10.81,,Posted,2496.12,2024-10-01,10.81,Withdrawal Debit Card MC Debit Seminol/WALGREENS #9304 GAINESVILLE FLDate 10/30/24 0 4304125853 1 5912Card 1231,10.81
9/30/2024,,Withdrawal POS #000000000001/INSTACART*159 WWW.INSTACART.COM/ SANFRANCISCO CACard 1231,67.0,,Posted,2506.93,2024-09-30,67.0,Withdrawal POS #000000804821/INSTACART*159 WWW.INSTACART.COM/ SANFRANCISCO CACard 1231,67.0
9/30/2024,,Withdrawal POS #000000604407/SUNOCO 8002212501 4234 SW 20TH AVEGAINESVILLE FLCard 1231,34.24,,Posted,2573.93,2024-09-30,34.24,Withdrawal POS #000000680755/SUNOCO 8002212501 4234 SW 20TH AVEGAINESVILLE FLCard 1231,34.24
9/30/2024,,Withdrawal POS #000000741900/PUBLIX 3100 SW 35TH BLVD GAINESVILLE FLCard 1231,32.09,,Posted,2608.17,2024-09-30,32.09,Withdrawal POS #000000741171/PUBLIX 3100 SW 35TH BLVD GAINESVILLE FLCard 2801,32.09
9/30/2024,,Withdrawal ACH FLUENT-Gainesvil/TYPE: PAYMENT ID: 1371804719CO: FLUENT-GainesvilNAME: steven chaplinskiEntry Class Code: WEB,56.39,,Posted,2640.26,2024-09-30,56.39,Withdrawal ACH FLUENT-Gainesvil/TYPE: PAYMENT ID: 1371804719CO: FLUENT-GainesvilNAME: steven chaplinski,56.39
9/29/2024,,Recurring Withdrawal Debit Card - MC Debit Seminol/IC* INSTACART*SUBSCRIP SAN FRANCISC CADate 09/28/24 0 4272959868 0 5411Card 1231,9.99,,Posted,2696.65,2024-09-29,9.99,Recurring Withdrawal Debit Card - MC Debit Seminol/IC* INSTACART*SUBSCRIP SAN FRANCISC CADate 11/30/24 0 4335692546 1 5411Card 1231,9.99
9/29/2024,,Withdrawal Debit Card MC Debit Seminol/INSTACART*159 SAN FRANCISC CADate 09/28/24 0 4272170453 2 5411Card 1231,75.38,,Posted,2706.64,2024-09-29,75.38,Withdrawal Debit Card MC Debit Seminol/INSTACART*159 SAN FRANCISC CADate 12/24/24 0 4359294650 0 5411Card 1231,75.38
9/29/2024,,Withdrawal Debit Card MC Debit Seminol/SAMSUNG ELECTRONICS RIDGEFIELD P NJDate 09/27/24 0 4271170159 2 5734Card 1231,8.99,,Posted,2782.02,2024-09-29,8.99,Withdrawal Debit Card MC Debit Seminol/SAMSUNG ELECTRONICS RIDGEFIELD P NJDate 12/27/24 0 4362999827 1 5734Card 1231,8.99
9/28/2024,,Withdrawal POS #000000527167/SUNOCO 8002212501 4234 SW 20TH AVEGAINESVILLE FLCard 1231,30.7,,Posted,2791.01,2024-09-28,30.7,Withdrawal POS #000000555763/SUNOCO 8002212501 4234 SW 20TH AVEGAINESVILLE FLCard 1231,30.7
9/26/2024,,Withdrawal Debit Card MC Debit Seminol/CIRCLE K # 06782 GAINESVILLE FLDate 09/24/24 0 4268492649 1 5499Card 1231,18.34,,Posted,21.71,2024-09-26,18.34,Withdrawal Debit Card MC Debit Seminol/CIRCLE K # 26146 GAINESVILLE FLDate 07/28/23 0 3209802364 1 5541Card 2801,17.9
9/26/2024,,Withdrawal POS #000000408760/SUNOCO 8002212501 4234 SW 20TH AVEGAINESVILLE FLCard 1231,18.89,,Posted,40.05,2024-09-26,18.89,Withdrawal POS #000000488663/SUNOCO 8002212501 4234 SW 20TH AVEGAINESVILLE FLCard 1231,18.89
9/25/2024,,Recurring Withdrawal Debit Card - MC Debit Seminol/FS *ADOBE SANTA BARBAR CADate 09/24/24 0 4268906697 0 5734Card 1231,0.95,,Posted,58.94,2024-09-25,0.95,Recurring Withdrawal Debit Card - MC Debit Seminol/FS *ADOBE SANTA BARBAR CADate 12/24/24 0 4359034647 1 5734Card 1231,0.95
9/25/2024,,Withdrawal POS #000000395026/SUNOCO 8002212501 4234 SW 20TH AVEGAINESVILLE FLCard 1231,22.42,,Posted,59.89,2024-09-25,22.42,Withdrawal POS #000000235720/SUNOCO 8002212501 4234 SW 20TH AVEGAINESVILLE FLCard 1231,22.42
9/23/2024,,Withdrawal POS #000000786299/INSTACART*159 WWW.INSTACART.COM/ SANFRANCISCO CACard 1231,84.0,,Posted,77.44,2024-09-23,84.0,Withdrawal POS #000000804821/INSTACART*159 WWW.INSTACART.COM/ SANFRANCISCO CACard 1231,84.0
9/23/2024,,Recurring Withdrawal Bill Payment - #000000980999/Netflix.com NETFLIX.COM LOS GATOS CACard 1231,17.84,,Posted,11.44,2024-09-23,17.84,Recurring Withdrawal Bill Payment - #000000864701/Netflix.com NETFLIX.COM LOS GATOS CACard 1231,17.84
9/22/2024,,Recurring Withdrawal Debit Card - MC Debit Seminol/CANVA* I04280-41401823 CAMDEN DEDate 09/20/24 0 4264118913 2 7333Card 1231,12.99,,Posted,29.28,2024-09-22,12.99,Recurring Withdrawal Debit Card - MC Debit Seminol/CANVA* I04371-41297102 CAMDEN DEDate 12/20/24 0 4355594081 2 7333Card 1231,12.99
9/22/2024,,Withdrawal POS #000000764249/PUBLIX 3100 SW 35TH BLVD GAINESVILLE FLCard 1231,10.08,,Posted,42.27,2024-09-22,10.08,"Withdrawal POS #000000752480/PUBLIX 3100 SW 35TH BLVD GAINESVILLE FL

Card 1247",10.08
9/22/2024,,Withdrawal POS #000000745864/PUBLIX 3930 SW ARCHER ROAD GAINESVILLECard 1231,26.02,,Posted,52.35,2024-09-22,26.02,Withdrawal POS #000000753028/PUBLIX 3930 SW ARCHER ROAD GAINESVILLECard 1247,26.02
9/20/2024,,Withdrawal POS #000000161599/SUNOCO 8002212501 4234 SW 20TH AVEGAINESVILLE FLCard 1231,34.24,,Posted,78.37,2024-09-20,34.24,Withdrawal POS #000000161599/SUNOCO 8002212501 4234 SW 20TH AVEGAINESVILLE FLCard 1231,34.24
9/19/2024,,Withdrawal POS #000000794971/INSTACART*159 WWW.INSTACART.COM/ SANFRANCISCO CACard 1231,41.52,,Posted,112.61,2024-09-19,41.52,Withdrawal POS #000000804821/INSTACART*159 WWW.INSTACART.COM/ SANFRANCISCO CACard 1231,41.52
9/19/2024,,Recurring Withdrawal Debit Card Fee/MASTERCARD ISSUER CROSS-BORDER FEEDate 09/18/24 0 4262900658 0 5734Card 1231,0.05,,Posted,154.13,2024-09-19,0.05,Recurring Withdrawal Debit Card Fee/MASTERCARD ISSUER CROSS-BORDER FEEDate 06/11/22 0 2162900620 0 5734Card 2801,0.07500000000000001
9/19/2024,,Recurring Withdrawal Debit Card - MC Debit Seminol/SAVE TO NOTION VAUREAL ILDate 09/18/24 0 4262900658 0 5734Card 1231,5.99,,Posted,154.18,2024-09-19,5.99,Recurring Withdrawal Debit Card - MC Debit Seminol/SAVE TO NOTION VAUREAL ILDate 12/18/24 0 4353969048 0 5734Card 1231,5.99
9/18/2024,,Recurring Withdrawal Debit Card - MC Debit Seminol/AMAZON PRIME*DG9S32713 AMZN.COM/BIL WADate 09/17/24 0 4261881793 0 5968Card 1231,15.11,,Posted,160.17,2024-09-18,15.11,Recurring Withdrawal Debit Card - MC Debit Seminol/AMAZON PRIME*Z97W01ZG2 AMZN.COM/BIL WADate 12/17/24 0 4352950216 0 5968Card 1231,15.120000000000001
9/17/2024,,Withdrawal POS #000000794677/INSTACART*159 WWW.INSTACART.COM/ SANFRANCISCO CACard 1231,50.0,,Posted,175.28,2024-09-17,50.0,Withdrawal POS #000000792733/INSTACART*159 WWW.INSTACART.COM/ SANFRANCISCO CACard 1231,50.0
9/17/2024,,Withdrawal POS #000000607925/AMAZON.COM*796MW6TO3 SEATTLE WACard 1231,12.85,,Posted,225.28,2024-09-17,12.85,Withdrawal POS #000000592618/AMAZON.COM*PF74M5SG3 SEATTLE WACard 1231,12.85
9/17/2024,,Recurring Withdrawal Debit Card - MC Debit Seminol/SUPERPOWER CHATGPT MIDDLETOWN DEDate 09/17/24 0 4261105994 1 5734Card 1231,15.0,,Posted,238.13,2024-09-17,15.0,Recurring Withdrawal Debit Card - MC Debit Seminol/SUPERPOWER CHATGPT MIDDLETOWN DEDate 12/17/24 0 4352703539 1 5734Card 1231,15.094999999999999
9/17/2024,,Recurring Withdrawal Debit Card - MC Debit Seminol/PADDLE.NET* LEONARDOAI ASTORIA NYDate 09/16/24 0 4260359414 0 5817Card 1231,9.0,,Posted,253.13,2024-09-17,9.0,Withdrawal Debit Card MC Debit Seminol/PADDLE.NET* LEONARDOAI ASTORIA NYDate 10/26/23 0 3299263117 0 5817Card 2801,9.0
9/17/2024,,Recurring Withdrawal Debit Card - MC Debit Seminol/PADDLE.NET* SETAPP ASTORIA NYDate 09/16/24 0 4260853114 0 5817Card 1231,12.49,,Posted,262.13,2024-09-17,12.49,Recurring Withdrawal Debit Card - MC Debit Seminol/PADDLE.NET* SETAPP NEW YORK NYDate 10/14/24 0 4288882561 0 5817Card 1231,12.49
9/17/2024,,Recurring Withdrawal Debit Card Fee/MASTERCARD ISSUER CROSS-BORDER FEEDate 09/17/24 0 4261103470 1 5734Card 1231,0.06,,Posted,274.62,2024-09-17,0.06,Recurring Withdrawal Debit Card Fee/MASTERCARD ISSUER CROSS-BORDER FEEDate 05/12/21 0 1132191600 1 7372Card 2801,0.09500000000000001
9/17/2024,,Recurring Withdrawal Debit Card - MC Debit Seminol/IDEOGRAM AI TORONTO ONDate 09/17/24 0 4261103470 1 5734Card 1231,8.0,,Posted,274.68,2024-09-17,8.0,Recurring Withdrawal Debit Card - MC Debit Seminol/IDEOGRAM AI TORONTO ONDate 12/17/24 0 4352700468 1 5734Card 1231,8.0
9/17/2024,,Withdrawal POS #000000029377/SUNOCO 8002212501 4234 SW 20TH AVEGAINESVILLE FLCard 1231,34.24,,Posted,282.68,2024-09-17,34.24,Withdrawal POS #000000235720/SUNOCO 8002212501 4234 SW 20TH AVEGAINESVILLE FLCard 1231,34.24
9/16/2024,,"Recurring Withdrawal Debit Card - MC Debit Seminol/NOTION LABS, INC. SAN FRANCISC CADate 09/15/24 0 4259305128 0 7372Card 1231",10.0,,Posted,239.64,2024-09-16,10.0,"Recurring Withdrawal Debit Card - MC Debit Seminol/NOTION LABS, INC. SAN FRANCISC CADate 12/02/24 0 4337878572 0 7372Card 1231",10.0
9/16/2024,,Recurring Withdrawal Debit Card - MC Debit Seminol/RUNWAY STANDARD PLAN NEWARK DEDate 09/15/24 0 4259010239 1 5734Card 1231,15.0,,Posted,249.64,2024-09-16,15.0,Recurring Withdrawal Debit Card - MC Debit Seminol/RUNWAY STANDARD PLAN NEWARK DEDate 12/15/24 0 4350745942 1 5734Card 1231,15.0
9/16/2024,,Withdrawal ACH FLUENT-Gainesvil/TYPE: PAYMENT ID: 1371804719CO: FLUENT-GainesvilNAME: steven chaplinskiEntry Class Code: WEB,30.0,,Posted,264.64,2024-09-16,30.0,Withdrawal ACH FLUENT-Gainesvil/TYPE: PAYMENT ID: 1371804719CO: FLUENT-GainesvilNAME: steven chaplinski,30.0
9/15/2024,,Recurring Withdrawal Debit Card - MC Debit Seminol/PADDLE.NET* SETAPP NEW YORK NYDate 09/14/24 0 4258038199 1 5817Card 1231,9.99,,Posted,294.64,2024-09-15,9.99,Recurring Withdrawal Debit Card - MC Debit Seminol/PADDLE.NET* SETAPP NEW YORK NYDate 10/14/24 0 4288882561 0 5817Card 1231,9.495000000000001
9/15/2024,,Recurring Withdrawal Debit Card - MC Debit Seminol/D-ID STUDIO WILMINGTON DEDate 09/13/24 0 4257121975 2 7399Card 1231,2.95,,Posted,304.63,2024-09-15,2.95,Recurring Withdrawal Debit Card - MC Debit Seminol/D-ID STUDIO WILMINGTON DEDate 10/13/24 0 4287011811 1 7399Card 1231,2.95
9/15/2024,,Withdrawal Debit Card MC Debit Seminol/CIRCLE K # 26146 GAINESVILLE FLDate 09/12/24 0 4256143852 2 5499Card 1231,29.33,,Posted,307.58,2024-09-15,29.33,Withdrawal Debit Card MC Debit Seminol/CIRCLE K # 26146 GAINESVILLE FLDate 07/28/23 0 3209802364 1 5541Card 2801,29.81
9/13/2024,,Withdrawal Debit Card MC Debit Seminol/WAWA 5325 GAINESVILLE FLDate 09/12/24 0 4256163151 1 5541Card 1231,20.87,,Posted,336.91,2024-09-13,20.87,Withdrawal Debit Card MC Debit Seminol/WAWA 5325 GAINESVILLE FLDate 12/28/24 0 4363858796 0 5541Card 1231,20.87
9/12/2024,,Withdrawal POS #000000745537/PUBLIX 3100 SW 35TH BLVD GAINESVILLE FLCard 1231,23.93,,Posted,357.78,2024-09-12,23.93,Withdrawal POS #000000058955/PUBLIX 3100 SW 35TH BLVD GAINESVILLE FLCard 2801,23.93
9/12/2024,,Withdrawal POS #000000000009/AMAZON.COM*139PT8J63 SEATTLE WACard 1231,14.91,,Posted,381.71,2024-09-12,14.91,Withdrawal POS #000000000007/AMAZON.COM*2864R4HI1 SEATTLE WACard 1140,14.91
9/12/2024,,Withdrawal Debit Card MC Debit Seminol/CAPCUT WILMINGTON DEDate 09/11/24 0 4255891362 0 5734Card 1231,0.99,,Posted,396.62,2024-09-12,0.99,Recurring Withdrawal Debit Card - MC Debit Seminol/CAPCUT WILMINGTON DEDate 11/11/24 0 4316889558 0 5734Card 1231,0.99
9/12/2024,,Recurring Withdrawal Debit Card - MC Debit Seminol/MYDESIGNS.IO LAS VEGAS NVDate 09/12/24 0 4256961595 0 5734Card 1231,57.29,,Posted,397.61,2024-09-12,57.29,Recurring Withdrawal Debit Card - MC Debit Seminol/MYDESIGNS.IO LAS VEGAS NVDate 10/18/24 0 4292077676 2 5734Card 1231,57.29
9/12/2024,,Recurring Withdrawal Debit Card Fee/MASTERCARD ISSUER CROSS-BORDER FEEDate 09/12/24 0 4256890128 0 5817Card 1231,0.08,,Posted,454.9,2024-09-12,0.08,Recurring Withdrawal Debit Card Fee/MASTERCARD ISSUER CROSS-BORDER FEEDate 12/11/21 0 1345316936 1 5817Card 2801,0.08666666666666667
9/12/2024,,Recurring Withdrawal Debit Card - MC Debit Seminol/CAPCUT SINGAPORE SGDate 09/12/24 0 4256890128 0 5817Card 1231,9.99,,Posted,454.98,2024-09-12,9.99,Recurring Withdrawal Debit Card - MC Debit Seminol/CAPCUT SINGAPORE SGDate 10/19/24 0 4293358426 2 5817Card 1231,9.99
9/12/2024,,Withdrawal POS #000000651483/AMAZON.COM*I55DY6IV3 SEATTLE WACard 1231,19.12,,Posted,464.97,2024-09-12,19.12,Withdrawal POS #000000049785/AMAZON.COM*AV5RE3583 SEATTLE WACard 1231,19.12
9/11/2024,,Recurring Withdrawal Debit Card - MC Debit Seminol/AIRTABLE.COM/BILL SAN FRANCISC CADate 09/11/24 0 4255913774 0 7372Card 1231,31.0,,Posted,484.09,2024-09-11,31.0,Recurring Withdrawal Debit Card - MC Debit Seminol/AIRTABLE.COM/BILL SAN FRANCISC CADate 09/11/24 0 4255913774 0 7372Card 1231,31.0
9/11/2024,,Withdrawal Debit Card MC Debit Seminol/INSTACART*159 SAN FRANCISC CADate 09/10/24 0 4254818709 0 5411Card 1231,43.63,,Posted,515.09,2024-09-11,43.63,Withdrawal Debit Card MC Debit Seminol/INSTACART*159 SAN FRANCISC CADate 12/24/24 0 4359294650 0 5411Card 1231,43.63
9/11/2024,,Withdrawal Debit Card MC Debit Seminol/AMAZON PRIME*XS2HD1WH3 AMZN.COM/BIL WADate 09/11/24 0 4255908162 0 5818Card 1231,3.4,,Posted,558.72,2024-09-11,3.4,Withdrawal Debit Card MC Debit Seminol/AMAZON PRIME*XS2HD1WH3 AMZN.COM/BIL WADate 09/11/24 0 4255908162 0 5818Card 1231,3.4
9/11/2024,,Recurring Withdrawal Debit Card - MC Debit Seminol/AMAZON PRIME*Z81YY4CB1 AMZN.COM/BIL WADate 09/10/24 0 4254816559 0 5968Card 1231,2.01,,Posted,562.12,2024-09-11,2.01,Recurring Withdrawal Debit Card - MC Debit Seminol/AMAZON PRIME*QP8EE86P3 AMZN.COM/BIL WADate 07/04/23 0 3185799509 0 5968Card 2801,2.01
9/10/2024,,Withdrawal POS #000000049785/AMAZON.COM*AV5RE3583 SEATTLE WACard 1231,9.13,,Posted,564.13,2024-09-10,9.13,Withdrawal POS #000000049785/AMAZON.COM*AV5RE3583 SEATTLE WACard 1231,9.13
9/10/2024,,Withdrawal POS #000000010894/AMAZON.COM*Z82Y13CR1 SEATTLE WACard 1231,5.36,,Posted,573.26,2024-09-10,5.36,Withdrawal POS #000000000021/AMAZON.COM*TQ9TB8YN3 SEATTLE WACard 1231,5.36
9/10/2024,,Recurring Withdrawal Debit Card - MC Debit Seminol/OPENAI SAN FRANCISC CADate 09/09/24 0 4253896772 0 5734Card 1231,15.02,,Posted,578.62,2024-09-10,15.02,Withdrawal Debit Card MC Debit Seminol/OPENAI SAN FRANCISC CADate 02/16/24 0 4047896474 1 5734Card 1231,15.0325
9/10/2024,,Withdrawal Debit Card MC Debit Seminol/CIRCLE K # 06782 GAINESVILLE FLDate 09/08/24 0 4252889868 0 5499Card 1231,42.82,,Posted,593.64,2024-09-10,42.82,Withdrawal Debit Card MC Debit Seminol/CIRCLE K # 06782 GAINESVILLE FLDate 09/08/24 0 4252889868 0 5499Card 1231,42.82
9/10/2024,,Withdrawal ACH VENMO/TYPE: PAYMENT ID: 3264681992 CO: VENMONAME: AVATAR ARTSEntry Class Code: WEB,14.99,,Posted,636.46,2024-09-10,14.99,Withdrawal ACH VENMO/TYPE: PAYMENT ID: 3264681992 CO: VENMONAME: AVATAR ARTSEntry Class Code: WEB,14.99
9/10/2024,,Withdrawal ACH VENMO/TYPE: PAYMENT ID: 3264681992 CO: VENMONAME: AVATAR ARTSEntry Class Code: WEB,9.99,,Posted,651.45,2024-09-10,9.99,Withdrawal ACH VENMO/TYPE: PAYMENT ID: 3264681992 CO: VENMONAME: AVATAR ARTSEntry Class Code: WEB,9.99
9/10/2024,,Withdrawal POS #000000000046/CIRCLE K # 06782 5237 GAINESVILLE FLCard 1231,29.18,,Posted,661.44,2024-09-10,29.18,Withdrawal POS #000000000343/CIRCLE K # 06782 5237 GAINESVILLE FLCard 1247,29.18
9/9/2024,,Recurring Withdrawal Debit Card - MC Debit Seminol/INVIDEO INC COUNTRY OF S DEDate 09/09/24 0 4253873198 0 5734Card 1231,60.0,,Posted,688.29,2024-09-09,60.0,Recurring Withdrawal Debit Card - MC Debit Seminol/INVIDEO INC COUNTRY OF S DEDate 12/09/24 0 4344808122 0 5734Card 1231,60.0
9/9/2024,,Recurring Withdrawal Debit Card - MC Debit Seminol/MYDESIGNS - PRO - MON LAS VEGAS NVDate 09/08/24 0 4252079101 1 5734Card 1231,29.99,,Posted,748.29,2024-09-09,29.99,Withdrawal Debit Card MC Debit Seminol/MYDESIGNS - PRO - MON LAS VEGAS NVDate 09/01/23 0 3244164229 1 5734Card 2801,29.99
9/9/2024,,Withdrawal POS #000020599152/GOOGLE *YouTubePremium 1600 AmphitheatreParkw Mountain View CACard 1231,9.1,,Posted,778.28,2024-09-09,9.1,"Withdrawal POS #000020312090/GOOGLE *YouTubePremium 1600 Amphitheatre

Parkw Mountain View CA

Card 1247",9.1
9/8/2024,,Recurring Withdrawal Debit Card - MC Debit Seminol/TUBEBUDDYCOM* 8668823239 CADate 09/07/24 0 4251439681 2 5045Card 1231,7.5,,Posted,787.38,2024-09-08,7.5,Recurring Withdrawal Debit Card - MC Debit Seminol/TUBEBUDDYCOM* 8668823239 CADate 12/03/24 0 4338443995 0 5045Card 1231,7.5
9/8/2024,,Withdrawal Debit Card MC Debit Seminol/SAMSUNG ELECTRONICS RIDGEFIELD P NJDate 09/06/24 0 4250130158 2 5734Card 1231,16.99,,Posted,794.88,2024-09-08,16.99,Withdrawal Debit Card MC Debit Seminol/SAMSUNG ELECTRONICS RIDGEFIELD P NJDate 12/27/24 0 4362999827 1 5734Card 1231,16.49
9/8/2024,,Withdrawal Debit Card MC Debit Seminol/WAWA CARD RELOAD MEDIA PADate 09/07/24 0 4251918366 0 6540Card 1231,15.0,,Posted,811.87,2024-09-08,15.0,Withdrawal Debit Card MC Debit Seminol/WAWA CARD RELOAD MEDIA PADate 11/03/24 0 4308001823 1 6540Card 1231,15.0
9/8/2024,,Withdrawal Debit Card MC Debit Seminol/WALGREENS #5024 GAINESVILLE FLDate 09/06/24 0 4250431555 2 5912Card 1231,33.35,,Posted,826.87,2024-09-08,33.35,Withdrawal Debit Card MC Debit Seminol/WALGREENS #9304 GAINESVILLE FLDate 10/30/24 0 4304125853 1 5912Card 1231,33.35
9/8/2024,,Recurring Withdrawal Debit Card - MC Debit Seminol/APPLE.COM/BILL 866-712-7753 CADate 09/07/24 0 4251430319 2 5818Card 1231,2.99,,Posted,860.22,2024-09-08,2.99,Recurring Withdrawal Debit Card - MC Debit Seminol/APPLE.COM/BILL 866-712-7753 CADate 09/16/23 0 3259205559 2 5818Card 2801,2.99
9/8/2024,,Withdrawal POS #000000215944/AMAZON.COM*Z85JQ4LM2 SEATTLE WACard 1231,29.12,,Posted,863.21,2024-09-08,29.12,Withdrawal POS #000000914130/AMAZON.COM*ZR50X2ML1 SEATTLE WACard 1231,29.12
9/6/2024,,Withdrawal POS #000000000001/AMAZON.COM*ZT6072MV1 SEATTLE WACard 1231,16.11,,Posted,892.33,2024-09-06,16.11,Withdrawal POS #000000000007/AMAZON.COM*2864R4HI1 SEATTLE WACard 1140,16.61
9/6/2024,,Withdrawal Debit Card MC Debit Seminol/IONOS INC. CHESTERBROOK PADate 09/05/24 0 4249995627 0 4816Card 1231,16.0,,Posted,908.44,2024-09-06,16.0,Withdrawal Debit Card MC Debit Seminol/IONOS INC. CHESTERBROOK PADate 12/29/24 0 4364954464 0 4816Card 1231,16.0
9/6/2024,,Recurring Withdrawal Bill Payment - #000000026814/Netflix.com NETFLIX.COM LOS GATOS CACard 1231,8.05,,Posted,924.44,2024-09-06,8.05,Recurring Withdrawal Bill Payment - #000000864701/Netflix.com NETFLIX.COM LOS GATOS CACard 1231,8.05
9/5/2024,,Recurring Withdrawal Debit Card - MC Debit Seminol/OPENAI *CHATGPT SUBSCR SAN FRANCISC CADate 09/04/24 0 4248036028 1 5734Card 1231,20.0,,Posted,932.49,2024-09-05,20.0,Recurring Withdrawal Debit Card - MC Debit Seminol/OPENAI *CHATGPT SUBSCR SAN FRANCISC CADate 12/04/24 0 4339869196 0 5734Card 1231,20.0
9/5/2024,,Withdrawal POS #000000438983/SUNOCO 8002212501 4234 SW 20TH AVEGAINESVILLE FLCard 1231,34.24,,Posted,952.49,2024-09-05,34.24,Withdrawal POS #000000488663/SUNOCO 8002212501 4234 SW 20TH AVEGAINESVILLE FLCard 1231,34.24
9/4/2024,,Withdrawal Debit Card MC Debit Seminol/WALGREENS #5024 GAINESVILLE FLDate 09/03/24 0 4247223801 1 5912Card 1231,10.81,,Posted,986.73,2024-09-04,10.81,Withdrawal Debit Card MC Debit Seminol/WALGREENS #5024 GAINESVILLE FLDate 06/26/23 0 3177001861 1 5912Card 2801,11.275
9/4/2024,,Withdrawal Debit Card MC Debit Seminol/CIRCLE K # 06782 GAINESVILLE FLDate 09/02/24 0 4246221313 1 5499Card 1231,29.18,,Posted,997.54,2024-09-04,29.18,Withdrawal Debit Card MC Debit Seminol/CIRCLE K # 06782 GAINESVILLE FLDate 09/08/24 0 4252889868 0 5499Card 1231,28.96
9/4/2024,,Recurring Withdrawal Debit Card - MC Debit Seminol/APPLE.COM/BILL 866-712-7753 CADate 09/03/24 0 4247844436 0 5818Card 1231,2.99,,Posted,1026.72,2024-09-04,2.99,Recurring Withdrawal Debit Card - MC Debit Seminol/APPLE.COM/BILL 866-712-7753 CADate 01/08/24 0 4008756344 0 5818Card 2801,2.99
9/3/2024,,Withdrawal POS #000000749495/PUBLIX 3315 W. UNIVERSITY AVE.FLCard 1231,33.1,,Posted,923.5,2024-09-03,33.1,Withdrawal POS #000000749495/PUBLIX 3315 W. UNIVERSITY AVE.FLCard 1231,33.1
9/3/2024,,Recurring Withdrawal Debit Card - MC Debit Seminol/MYDESIGNS.IO LAS VEGAS NVDate 09/02/24 0 4246904059 0 5734Card 1231,27.26,,Posted,956.6,2024-09-03,27.26,Withdrawal Debit Card MC Debit Seminol/MYDESIGNS.IO LAS VEGAS NVDate 01/07/24 0 4007751481 0 5734Card 2801,27.26
9/3/2024,,Withdrawal Debit Card MC Debit Seminol/INSTACART*159 SAN FRANCISC CADate 09/02/24 0 4246902876 0 5411Card 1231,61.13,,Posted,983.86,2024-09-03,61.13,Withdrawal Debit Card MC Debit Seminol/INSTACART*159 SAN FRANCISC CADate 12/24/24 0 4359294650 0 5411Card 1231,61.13
9/3/2024,,Withdrawal ACH Watson Realty Co/TYPE: WEB PMTS ID: 9000321157CO: Watson Realty CoNAME: Steven chaplinskiEntry Class Code: WEB,1179.0,,Posted,1044.99,2024-09-03,1179.0,Withdrawal ACH Watson Realty Co/TYPE: WEB PMTS ID: 9000321157CO: Watson Realty CoEntry Class Code: WEB,1179.0
9/3/2024,,Withdrawal ACH FLUENT-Gainesvil/TYPE: PAYMENT ID: 1371804719CO: FLUENT-GainesvilNAME: steven chaplinskiEntry Class Code: WEB,45.0,,Posted,2223.99,2024-09-03,45.0,Withdrawal ACH FLUENT-Gainesvil/TYPE: PAYMENT ID: 1371804719CO: FLUENT-GainesvilNAME: steven chaplinski,45.0
9/3/2024,,"Withdrawal ACH AppFolio, Inc. F/TYPE: WEB PMTS ID: 9001406550CO: AppFolio, Inc. FNAME: Steven chaplinskiEntry Class Code: WEB",2.49,,Posted,2268.99,2024-09-03,2.49,"Withdrawal ACH AppFolio, Inc. F/TYPE: WEB PMTS ID: 9001406550

CO: AppFolio, Inc. F

NAME: Steven chaplinskiEntry Class Code: WEB",2.49
9/3/2024,,"Withdrawal Bill Payment #000000786503/Adobe Park Avenue,345 San Jose CACard 1231",19.99,,Posted,2271.48,2024-09-03,19.99,"Withdrawal Bill Payment #000000352498/Adobe Park Avenue,345 San Jose CACard 1247",19.99
9/2/2024,,Withdrawal Debit Card MC Debit Seminol/GRU/EZ-PAY WEB PYMT 352-334-3434 FLDate 09/01/24 0 4245989258 0 4900Card 1231,189.27,,Posted,2291.47,2024-09-02,189.27,Withdrawal Debit Card MC Debit Seminol/GRU/EZ-PAY WEB PYMT 352-334-3434 FLDate 12/05/24 0 4340279271 0 4900Card 1231,189.27
9/2/2024,,Withdrawal Debit Card MC Debit Seminol/COX GAINESVILLE COMM 800-234-3993 FLDate 08/31/24 0 4244993156 1 4899Card 1231,156.13,,Posted,2480.74,2024-09-02,156.13,Withdrawal Debit Card MC Debit Seminol/COX GAINESVILLE COMM 800-234-3993 FLDate 12/04/24 0 4339376311 0 4899Card 1231,156.13
8/31/2024,,Withdrawal POS #000000736143/PUBLIX 3100 SW 35TH BLVD GAINESVILLE FLCard 1231,18.46,,Posted,2636.87,2024-08-31,18.46,"Withdrawal POS #000000752480/PUBLIX 3100 SW 35TH BLVD GAINESVILLE FL

Card 1247",18.405
8/31/2024,,Withdrawal POS #000000004805/AMAZON.COM*RK4ZA05U1 SEATTLE WACard 1231,25.94,,Posted,2655.33,2024-08-31,25.94,Withdrawal POS #000000000006/AMAZON.COM*RJ6HJ7RA2 SEATTLE WACard 1231,25.94
8/31/2024,,Withdrawal POS #000000000085/CIRCLE K # 06782 5237 GAINESVILLE FLCard 1231,29.18,,Posted,2681.27,2024-08-31,29.18,Withdrawal POS #000000882351/CIRCLE K # 06782 GAINESVILLE FLCard 1140,29.18
8/30/2024,,Recurring Withdrawal Debit Card - MC Debit Seminol/MYDESIGNS.IO LAS VEGAS NVDate 08/29/24 0 4242999544 0 5734Card 1231,64.44,,Posted,2710.45,2024-08-30,64.44,Recurring Withdrawal Debit Card - MC Debit Seminol/MYDESIGNS.IO LAS VEGAS NVDate 10/18/24 0 4292077676 2 5734Card 1231,64.44
8/30/2024,,Withdrawal Debit Card MC Debit Seminol/AMAZON PRIME*RK8MN8K72 AMZN.COM/BIL WADate 08/30/24 0 4243993934 0 5818Card 1231,3.44,,Posted,2774.89,2024-08-30,3.44,Withdrawal Debit Card MC Debit Seminol/AMAZON PRIME*RK8MN8K72 AMZN.COM/BIL WADate 08/30/24 0 4243993934 0 5818Card 1231,3.44
8/29/2024,,Withdrawal POS #000000775931/INSTACART*159 WWW.INSTACART.COM/ SANFRANCISCO CACard 1231,68.63,,Posted,2778.33,2024-08-29,68.63,Withdrawal POS #000000792733/INSTACART*159 WWW.INSTACART.COM/ SANFRANCISCO CACard 1231,68.63
8/28/2024,,Withdrawal POS #000000073608/SUNOCO 8002212501 4234 SW 20TH AVEGAINESVILLE FLCard 1231,34.24,,Posted,46.96,2024-08-28,34.24,Withdrawal POS #000000031004/SUNOCO 8002212501 4234 SW 20TH AVEGAINESVILLE FLCard 1231,34.24
8/28/2024,,Withdrawal Debit Card MC Debit Seminol/SAMSUNG ELECTRONICS RIDGEFIELD P NJDate 08/27/24 0 4240911144 0 5734Card 1231,8.99,,Posted,81.2,2024-08-28,8.99,Withdrawal Debit Card MC Debit Seminol/SAMSUNG ELECTRONICS RIDGEFIELD P NJDate 12/27/24 0 4362999827 1 5734Card 1231,8.99
8/27/2024,,Recurring Withdrawal Debit Card - MC Debit Seminol/MYDESIGNS.IO LAS VEGAS NVDate 08/27/24 0 4240080985 1 5734Card 1231,17.03,,Posted,90.19,2024-08-27,17.03,Recurring Withdrawal Debit Card - MC Debit Seminol/MYDESIGNS.IO LAS VEGAS NVDate 10/18/24 0 4292077676 2 5734Card 1231,17.03
8/27/2024,,Withdrawal Debit Card MC Debit Seminol/IONOS INC. CHESTERBROOK PADate 08/26/24 0 4239887355 0 4816Card 1231,2.0,,Posted,107.22,2024-08-27,2.0,Withdrawal Debit Card MC Debit Seminol/IONOS INC. CHESTERBROOK PADate 12/29/24 0 4364954464 0 4816Card 1231,2.0
8/26/2024,,Withdrawal POS #000000963385/SUNOCO 8002212501 4234 SW 20TH AVEGAINESVILLE FLCard 1231,34.24,,Posted,96.45,2024-08-26,34.24,Withdrawal POS #000000680755/SUNOCO 8002212501 4234 SW 20TH AVEGAINESVILLE FLCard 1231,34.24
8/25/2024,,Withdrawal POS #000000784235/INSTACART*159 WWW.INSTACART.COM/ SANFRANCISCO CACard 1231,58.42,,Posted,130.69,2024-08-25,58.42,Withdrawal POS #000000804821/INSTACART*159 WWW.INSTACART.COM/ SANFRANCISCO CACard 1231,58.42
8/25/2024,,Recurring Withdrawal Debit Card - MC Debit Seminol/FS *ADOBE SANTA BARBAR CADate 08/24/24 0 4237923935 0 5734Card 1231,0.95,,Posted,189.11,2024-08-25,0.95,Recurring Withdrawal Debit Card - MC Debit Seminol/FS *ADOBE SANTA BARBAR CADate 12/24/24 0 4359034647 1 5734Card 1231,0.95
8/25/2024,,Recurring Withdrawal Debit Card - MC Debit Seminol/APPLE.COM/BILL 866-712-7753 CADate 08/25/24 0 4238111248 1 5818Card 1231,15.99,,Posted,190.06,2024-08-25,15.99,Recurring Withdrawal Debit Card - MC Debit Seminol/APPLE.COM/BILL 866-712-7753 CADate 07/29/24 0 4211570450 0 5818Card 1231,15.99
8/22/2024,,Withdrawal POS #000000773230/INSTACART*159 WWW.INSTACART.COM/ SANFRANCISCO CACard 1231,85.99,,Posted,206.05,2024-08-22,85.99,Withdrawal POS #000000792733/INSTACART*159 WWW.INSTACART.COM/ SANFRANCISCO CACard 1231,85.995
8/22/2024,,Withdrawal POS #000000170815/AMAZON.COM*R456X2LE0 SEATTLE WACard 1231,25.76,,Posted,292.04,2024-08-22,25.76,Withdrawal POS #000000049785/AMAZON.COM*AV5RE3583 SEATTLE WACard 1231,25.76
8/22/2024,,Withdrawal POS #000000902881/SUNOCO 8002212501 4234 SW 20TH AVEGAINESVILLE FLCard 1231,30.7,,Posted,317.8,2024-08-22,30.7,Withdrawal POS #000000028242/SUNOCO 8002212501 4234 SW 20TH AVEGAINESVILLE FLCard 1231,30.7
8/22/2024,,Withdrawal POS #000000777262/SUNOCO 8002212501 4234 SW 20TH AVEGAINESVILLE FLCard 1231,18.89,,Posted,148.5,2024-08-22,18.89,Withdrawal POS #000000794627/SUNOCO 8002212501 4234 SW 20TH AVEGAINESVILLE FLCard 1231,18.89
8/21/2024,,Recurring Withdrawal Debit Card - MC Debit Seminol/CANVA* I04249-43399962 CAMDEN DEDate 08/20/24 0 4233594945 0 7221Card 1231,12.99,,Posted,167.39,2024-08-21,12.99,Recurring Withdrawal Debit Card - MC Debit Seminol/CANVA* I04249-43399962 CAMDEN DEDate 08/20/24 0 4233594945 0 7221Card 1231,12.99
8/19/2024,,Withdrawal POS #000000670233/SUNOCO 8002212501 4234 SW 20TH AVEGAINESVILLE FLCard 1231,7.02,,Posted,160.46,2024-08-19,7.02,Withdrawal POS #000000504303/SUNOCO 8002212501 4234 SW 20TH AVEGAINESVILLE FLCard 1231,7.02
8/19/2024,,Withdrawal POS #000000732534/SUNOCO 8002212501 4234 SW 20TH AVEGAINESVILLE FLCard 1231,34.24,,Posted,167.48,2024-08-19,34.24,Withdrawal POS #000000175132/SUNOCO 8002212501 4234 SW 20TH AVEGAINESVILLE FLCard 1231,34.24
8/19/2024,,Recurring Withdrawal Debit Card Fee/MASTERCARD ISSUER CROSS-BORDER FEEDate 08/18/24 0 4231951752 0 5734Card 1231,0.05,,Posted,201.72,2024-08-19,0.05,Recurring Withdrawal Debit Card Fee/MASTERCARD ISSUER CROSS-BORDER FEEDate 02/25/24 0 4056812425 0 4816Card 1231,0.13
8/19/2024,,Recurring Withdrawal Debit Card - MC Debit Seminol/SAVE TO NOTION VAUREAL ILDate 08/18/24 0 4231951752 0 5734Card 1231,5.99,,Posted,201.77,2024-08-19,5.99,Recurring Withdrawal Debit Card - MC Debit Seminol/SAVE TO NOTION VAUREAL ILDate 12/18/24 0 4353969048 0 5734Card 1231,5.99
8/19/2024,,Withdrawal ACH FLUENT-Gainesvil/TYPE: PAYMENT ID: 1371804719CO: FLUENT-GainesvilNAME: steven chaplinskiEntry Class Code: WEB,30.0,,Posted,207.76,2024-08-19,30.0,Withdrawal ACH FLUENT-Gainesvil/TYPE: PAYMENT ID: 1371804719CO: FLUENT-GainesvilNAME: steven chaplinski,30.0
8/18/2024,,Recurring Withdrawal Debit Card - MC Debit Seminol/SUPERPOWER CHATGPT MIDDLETOWN DEDate 08/17/24 0 4230474948 0 5734Card 1231,15.0,,Posted,237.76,2024-08-18,15.0,Recurring Withdrawal Debit Card - MC Debit Seminol/SUPERPOWER CHATGPT MIDDLETOWN DEDate 12/17/24 0 4352703539 1 5734Card 1231,15.094999999999999
8/18/2024,,Recurring Withdrawal Debit Card - MC Debit Seminol/PADDLE.NET* LEONARDOAI ASTORIA NYDate 08/16/24 0 4229015017 1 5817Card 1231,9.0,,Posted,252.76,2024-08-18,9.0,Withdrawal Debit Card MC Debit Seminol/PADDLE.NET* LEONARDOAI ASTORIA NYDate 10/26/23 0 3299263117 0 5817Card 2801,9.0
8/18/2024,,Recurring Withdrawal Debit Card - MC Debit Seminol/PADDLE.NET* SETAPP ASTORIA NYDate 08/16/24 0 4229819554 1 5817Card 1231,12.49,,Posted,261.76,2024-08-18,12.49,Recurring Withdrawal Debit Card - MC Debit Seminol/PADDLE.NET* LEONARDOAI ASTORIA NYDate 12/16/24 0 4351323834 0 5817Card 1231,12.49
8/18/2024,,Recurring Withdrawal Debit Card Fee/MASTERCARD ISSUER CROSS-BORDER FEEDate 08/17/24 0 4230854170 0 5734Card 1231,0.06,,Posted,274.25,2024-08-18,0.06,Recurring Withdrawal Debit Card Fee/MASTERCARD ISSUER CROSS-BORDER FEEDate 06/11/22 0 2162900620 0 5734Card 2801,0.07500000000000001
8/18/2024,,Recurring Withdrawal Debit Card - MC Debit Seminol/IDEOGRAM AI TORONTO ONDate 08/17/24 0 4230854170 0 5734Card 1231,8.0,,Posted,274.31,2024-08-18,8.0,Withdrawal Debit Card MC Debit Seminol/IDEOGRAM.AI TORONTO ONDate 04/15/24 0 4106835174 0 5734Card 1231,8.190000000000001
8/17/2024,,Withdrawal POS #000000000048/CIRCLE K # 26146 3525 GAINESVILLE FLCard 1231,26.0,,Posted,282.31,2024-08-17,26.0,Withdrawal POS #000010941641/CIRCLE K # 26146 3525 GAINESVILLE FLCard 1231,26.25
8/16/2024,,Recurring Withdrawal Debit Card - MC Debit Seminol/INVIDEO INC COUNTRY OF S DEDate 08/15/24 0 4228943735 0 5734Card 1231,27.67,,Posted,308.31,2024-08-16,27.67,Recurring Withdrawal Debit Card - MC Debit Seminol/INVIDEO INC COUNTRY OF S DEDate 12/09/24 0 4344808122 0 5734Card 1231,27.67
8/15/2024,,Withdrawal POS #000000773008/Instacart 50 Beal St Suite 600 SanFrancisco CACard 1231,69.88,,Posted,335.98,2024-08-15,69.88,Withdrawal POS #000000773008/Instacart 50 Beal St Suite 600 SanFrancisco CACard 1231,69.88
8/15/2024,,"Withdrawal Debit Card MC Debit Seminol/NOTION LABS, INC. SAN FRANCISC CADate 08/15/24 0 4228171261 1 7372Card 1231",10.0,,Posted,405.86,2024-08-15,10.0,"Recurring Withdrawal Debit Card - MC Debit Seminol/NOTION LABS, INC. SAN FRANCISC CADate 12/02/24 0 4337878572 0 7372Card 1231",10.0
8/15/2024,,Recurring Withdrawal Debit Card - MC Debit Seminol/RUNWAY STANDARD PLAN NEWARK DEDate 08/15/24 0 4228171210 1 5734Card 1231,15.0,,Posted,415.86,2024-08-15,15.0,Recurring Withdrawal Debit Card - MC Debit Seminol/RUNWAY STANDARD PLAN NEWARK DEDate 12/15/24 0 4350745942 1 5734Card 1231,15.0
8/14/2024,,Withdrawal POS #000000623894/SUNOCO 8002212501 4234 SW 20TH AVEGAINESVILLE FLCard 1231,41.2,,Posted,430.86,2024-08-14,41.2,Withdrawal POS #000000028242/SUNOCO 8002212501 4234 SW 20TH AVEGAINESVILLE FLCard 1231,40.95
8/14/2024,,Recurring Withdrawal Debit Card - MC Debit Seminol/D-ID STUDIO WILMINGTON DEDate 08/13/24 0 4226859392 0 7399Card 1231,2.95,,Posted,472.06,2024-08-14,2.95,Recurring Withdrawal Debit Card - MC Debit Seminol/D-ID STUDIO WILMINGTON DEDate 10/13/24 0 4287011811 1 7399Card 1231,2.95
8/14/2024,,Recurring Withdrawal Debit Card - MC Debit Seminol/SUNO INC. CAMBRIDGE MADate 08/13/24 0 4226902139 0 5734Card 1231,10.0,,Posted,475.01,2024-08-14,10.0,Recurring Withdrawal Debit Card - MC Debit Seminol/SUNO INC. CAMBRIDGE MADate 08/13/24 0 4226902139 0 5734Card 1231,10.0
8/12/2024,,Recurring Withdrawal Debit Card - MC Debit Seminol/OPENAI SAN FRANCISC CADate 08/12/24 0 4225899261 0 5734Card 1231,15.03,,Posted,475.17,2024-08-12,15.03,Withdrawal Debit Card MC Debit Seminol/OPENAI SAN FRANCISC CADate 02/16/24 0 4047896474 1 5734Card 1231,15.0325
8/12/2024,,Recurring Withdrawal Debit Card - MC Debit Seminol/PAYPAL *PLAYSTATION 4029357733 CADate 08/09/24 0 4222963102 0 7994Card 1231,14.99,,Posted,490.2,2024-08-12,14.99,Recurring Withdrawal Debit Card - MC Debit Seminol/PAYPAL *PLAYSTATION 4029357733 CADate 08/09/24 0 4222963102 0 7994Card 1231,14.99
8/12/2024,,Recurring Withdrawal Debit Card - MC Debit Seminol/PAYPAL *PLAYSTATION 4029357733 CADate 08/09/24 0 4222963101 0 7994Card 1231,9.99,,Posted,505.19,2024-08-12,9.99,Recurring Withdrawal Debit Card - MC Debit Seminol/PAYPAL *PLAYSTATION 4029357733 CADate 08/09/24 0 4222963102 0 7994Card 1231,9.99
8/12/2024,,Withdrawal POS #000000427484/SUNOCO 8002212501 4234 SW 20TH AVEGAINESVILLE FLCard 1231,37.78,,Posted,515.18,2024-08-12,37.78,Withdrawal POS #000000028242/SUNOCO 8002212501 4234 SW 20TH AVEGAINESVILLE FLCard 1231,37.78
8/11/2024,,Recurring Withdrawal Debit Card - MC Debit Seminol/AIRTABLE.COM/BILL SAN FRANCISC CADate 08/11/24 0 4224906504 2 7372Card 1231,31.0,,Posted,552.96,2024-08-11,31.0,Recurring Withdrawal Debit Card - MC Debit Seminol/AIRTABLE.COM/BILL SAN FRANCISC CADate 09/11/24 0 4255913774 0 7372Card 1231,31.0
8/11/2024,,Withdrawal Debit Card MC Debit Seminol/IONOS INC. CHESTERBROOK PADate 08/09/24 0 4222244271 1 4816Card 1231,16.0,,Posted,583.96,2024-08-11,16.0,Withdrawal Debit Card MC Debit Seminol/IONOS INC. CHESTERBROOK PADate 12/29/24 0 4364954464 0 4816Card 1231,16.0
8/10/2024,,Withdrawal POS #000000334497/SUNOCO 8002212501 4234 SW 20TH AVEGAINESVILLE FLCard 1231,42.78,,Posted,599.96,2024-08-10,42.78,Withdrawal POS #000000144391/SUNOCO 8002212501 4234 SW 20TH AVEGAINESVILLE FLCard 1231,42.78
8/9/2024,,Recurring Withdrawal Debit Card - MC Debit Seminol/INVIDEO INC COUNTRY OF S DEDate 08/09/24 0 4222136862 1 5734Card 1231,25.0,,Posted,642.74,2024-08-09,25.0,Recurring Withdrawal Debit Card - MC Debit Seminol/INVIDEO INC COUNTRY OF S DEDate 12/09/24 0 4344808122 0 5734Card 1231,25.0
8/9/2024,,Recurring Withdrawal Debit Card - MC Debit Seminol/MYDESIGNS - PRO - MON LAS VEGAS NVDate 08/09/24 0 4222882568 0 5734Card 1231,29.99,,Posted,667.74,2024-08-09,29.99,Recurring Withdrawal Debit Card - MC Debit Seminol/MYDESIGNS - PRO - MON LAS VEGAS NVDate 12/08/24 0 4343357881 0 5734Card 1231,29.99
8/9/2024,,Recurring Withdrawal Debit Card Fee/MASTERCARD ISSUER CROSS-BORDER FEEDate 08/09/24 0 4222405366 0 5817Card 1231,0.08,,Posted,697.73,2024-08-09,0.08,Recurring Withdrawal Debit Card Fee/MASTERCARD ISSUER CROSS-BORDER FEEDate 01/06/24 0 4006875269 0 5815Card 2801,0.1366666666666667
8/9/2024,,Recurring Withdrawal Debit Card - MC Debit Seminol/CAPCUT SINGAPORE SGDate 08/09/24 0 4222405366 0 5817Card 1231,9.99,,Posted,697.81,2024-08-09,9.99,Recurring Withdrawal Debit Card - MC Debit Seminol/CAPCUT SINGAPORE SGDate 10/19/24 0 4293358426 2 5817Card 1231,9.99
8/9/2024,,Withdrawal Debit Card MC Debit Seminol/WALGREENS #5024 GAINESVILLE FLDate 08/08/24 0 4221131985 1 5912Card 1231,28.95,,Posted,707.8,2024-08-09,28.95,Withdrawal Debit Card MC Debit Seminol/WALGREENS #5024 GAINESVILLE FLDate 04/14/24 0 4105827629 0 5912Card 1231,28.46
8/9/2024,,Recurring Withdrawal Debit Card - MC Debit Seminol/AMAZON PRIME*RM70P9F91 AMZN.COM/BIL WADate 08/08/24 0 4221404019 0 5968Card 1231,15.13,,Posted,736.75,2024-08-09,15.13,Recurring Withdrawal Debit Card - MC Debit Seminol/AMAZON PRIME*Z97W01ZG2 AMZN.COM/BIL WADate 12/17/24 0 4352950216 0 5968Card 1231,15.120000000000001
8/9/2024,,Withdrawal POS #000020303936/GOOGLE *YouTubePremium 1600 AmphitheatreParkw Mountain View CACard 1231,9.1,,Posted,751.88,2024-08-09,9.1,"Withdrawal POS #000020312090/GOOGLE *YouTubePremium 1600 Amphitheatre

Parkw Mountain View CA

Card 1247",9.1
8/9/2024,,Withdrawal POS #000000792124/INSTACART*159 WWW.INSTACART.COM/ SANFRANCISCO CACard 1231,72.01,,Posted,760.98,2024-08-09,72.01,Withdrawal POS #000000804821/INSTACART*159 WWW.INSTACART.COM/ SANFRANCISCO CACard 1231,72.01
8/7/2024,,Withdrawal POS #000000212396/SUNOCO 8002212501 4234 SW 20TH AVEGAINESVILLE FLCard 1231,37.67,,Posted,682.99,2024-08-07,37.67,Withdrawal POS #000000221295/SUNOCO 8002212501 4234 SW 20TH AVEGAINESVILLE FLCard 1231,37.725
8/7/2024,,Withdrawal Debit Card MC Debit Seminol/SAMSUNG ELECTRONICS RIDGEFIELD P NJDate 08/06/24 0 4219920231 0 5734Card 1231,16.99,,Posted,720.66,2024-08-07,16.99,Withdrawal Debit Card MC Debit Seminol/SAMSUNG ELECTRONICS RIDGEFIELD P NJDate 12/27/24 0 4362999827 1 5734Card 1231,16.49
8/7/2024,,Withdrawal Debit Card MC Debit Seminol/GRU/EZ-PAY WEB PYMT 352-334-3434 FLDate 08/06/24 0 4219448708 0 4900Card 1231,220.95,,Posted,737.65,2024-08-07,220.95,Withdrawal Debit Card MC Debit Seminol/GRU/EZ-PAY WEB PYMT 352-334-3434 FLDate 12/05/24 0 4340279271 0 4900Card 1231,220.95
8/7/2024,,Withdrawal Debit Card MC Debit Seminol/COX GAINESVILLE COMM 800-234-3993 FLDate 08/06/24 0 4219854218 0 4899Card 1231,156.13,,Posted,958.6,2024-08-07,156.13,Withdrawal Debit Card MC Debit Seminol/COX GAINESVILLE COMM 800-234-3993 FLDate 12/04/24 0 4339376311 0 4899Card 1231,156.13
8/6/2024,,Recurring Withdrawal Bill Payment - #000000350295/Netflix.com NETFLIX.COM LOS GATOS CACard 1231,13.81,,Posted,1106.69,2024-08-06,13.81,Recurring Withdrawal Bill Payment - #000000864701/Netflix.com NETFLIX.COM LOS GATOS CACard 1231,13.81
8/6/2024,,Withdrawal POS #000000239287/SUNOCO 8002212501 4234 SW 20TH AVEGAINESVILLE FLCard 1231,33.06,,Posted,1120.5,2024-08-06,33.06,Withdrawal POS #000000235720/SUNOCO 8002212501 4234 SW 20TH AVEGAINESVILLE FLCard 1231,33.06
8/5/2024,,Recurring Withdrawal Debit Card - MC Debit Seminol/OPENAI *CHATGPT SUBSCR SAN FRANCISC CADate 08/04/24 0 4217020552 1 5734Card 1231,20.0,,Posted,1153.56,2024-08-05,20.0,Recurring Withdrawal Debit Card - MC Debit Seminol/OPENAI *CHATGPT SUBSCR SAN FRANCISC CADate 12/04/24 0 4339869196 0 5734Card 1231,20.0
8/5/2024,,Withdrawal ACH FLUENT-Gainesvil/TYPE: PAYMENT ID: 1371804719CO: FLUENT-GainesvilNAME: steven chaplinskiEntry Class Code: WEB,42.5,,Posted,1173.56,2024-08-05,42.5,Withdrawal ACH FLUENT-Gainesvil/TYPE: PAYMENT ID: 1371804719CO: FLUENT-GainesvilNAME: steven chaplinski,42.7
8/4/2024,,Withdrawal POS #000000786208/INSTACART*159 WWW.INSTACART.COM/ SANFRANCISCO CACard 1231,80.6,,Posted,1216.06,2024-08-04,80.6,Withdrawal POS #000000804821/INSTACART*159 WWW.INSTACART.COM/ SANFRANCISCO CACard 1231,80.6
8/4/2024,,Withdrawal Debit Card MC Debit Seminol/IONOS INC. CHESTERBROOK PADate 08/03/24 0 4216015505 2 4816Card 1231,17.74,,Posted,1296.66,2024-08-04,17.74,Withdrawal Debit Card MC Debit Seminol/IONOS INC. CHESTERBROOK PADate 12/29/24 0 4364954464 0 4816Card 1231,17.74
8/4/2024,,Withdrawal Debit Card MC Debit Seminol/WALGREENS #5024 GAINESVILLE FLDate 08/02/24 0 4215626223 4 5912Card 1231,10.81,,Posted,1314.4,2024-08-04,10.81,Withdrawal Debit Card MC Debit Seminol/WALGREENS #5024 GAINESVILLE FLDate 04/14/24 0 4105827629 0 5912Card 1231,10.81
8/4/2024,,Recurring Withdrawal Debit Card - MC Debit Seminol/APPLE.COM/BILL 866-712-7753 CADate 08/03/24 0 4216623643 4 5818Card 1231,2.99,,Posted,1325.21,2024-08-04,2.99,Recurring Withdrawal Debit Card - MC Debit Seminol/APPLE.COM/BILL 866-712-7753 CADate 11/11/24 0 4316616811 0 5818Card 1231,2.99
8/3/2024,,Withdrawal POS #000000156204/SUNOCO 8002212501 4234 SW 20TH AVEGAINESVILLE FLCard 1231,30.7,,Posted,1328.2,2024-08-03,30.7,Withdrawal POS #000000235720/SUNOCO 8002212501 4234 SW 20TH AVEGAINESVILLE FLCard 1231,30.7
8/3/2024,,"Withdrawal Bill Payment #000000783713/Adobe Park Avenue,345 San Jose CACard 1231",19.99,,Posted,1358.9,2024-08-03,19.99,"Withdrawal Bill Payment #000000352498/Adobe Park Avenue,345 San Jose CACard 1247",19.99
8/3/2024,,Withdrawal POS #000000775244/Instacart 50 Beal St Suite 600 SanFrancisco CACard 1231,66.13,,Posted,1378.89,2024-08-03,66.13,Withdrawal POS #000000773008/Instacart 50 Beal St Suite 600 SanFrancisco CACard 1231,66.13
8/2/2024,,Withdrawal Debit Card MC Debit Seminol/RANDY'S HAIRCUTS FOR M GAINESVILLE FLDate 08/01/24 0 4214894751 0 7230Card 1231,30.0,,Posted,1400.02,2024-08-02,30.0,Withdrawal Debit Card MC Debit Seminol/RANDY'S HAIRCUTS FOR M GAINESVILLE FLDate 08/01/24 0 4214894751 0 7230Card 1231,30.0
8/2/2024,,Withdrawal ACH Watson Realty Co/TYPE: WEB PMTS ID: 9000321157CO: Watson Realty CoNAME: Steven chaplinskiEntry Class Code: WEB,1179.0,,Posted,1430.02,2024-08-02,1179.0,Withdrawal ACH Watson Realty Co/TYPE: WEB PMTS ID: 9000321157CO: Watson Realty CoEntry Class Code: WEB,1179.0
8/2/2024,,"Withdrawal ACH AppFolio, Inc. F/TYPE: WEB PMTS ID: 9001406550CO: AppFolio, Inc. FNAME: Steven chaplinskiEntry Class Code: WEB",2.49,,Posted,2609.02,2024-08-02,2.49,"Withdrawal ACH AppFolio, Inc. F/TYPE: WEB PMTS ID: 9001406550

CO: AppFolio, Inc. F

NAME: Steven chaplinskiEntry Class Code: WEB",2.49
8/1/2024,,Withdrawal POS #000000000002/AMAZON.COM*RV6JQ8U41 SEATTLE WACard 1231,28.95,,Posted,2611.51,2024-08-01,28.95,Withdrawal POS #000000000007/AMAZON.COM*2864R4HI1 SEATTLE WACard 1140,28.95
8/1/2024,,Withdrawal POS #000000983835/SUNOCO 8002212501 4234 SW 20TH AVEGAINESVILLE FLCard 1231,30.7,,Posted,2640.46,2024-08-01,30.7,Withdrawal POS #000000488663/SUNOCO 8002212501 4234 SW 20TH AVEGAINESVILLE FLCard 1231,30.7
8/1/2024,,Withdrawal POS #000000735887/PUBLIX 3315 W. UNIVERSITY AVE.FLCard 1231,70.24,,Posted,2671.16,2024-08-01,70.24,Withdrawal POS #000000749495/PUBLIX 3315 W. UNIVERSITY AVE.FLCard 1231,70.24
7/31/2024,,Withdrawal POS #000000922607/SUNOCO 8002212501 4234 SW 20TH AVEGAINESVILLE FLCard 1231,34.24,,Posted,2741.4,2024-07-31,34.24,Withdrawal POS #000000235720/SUNOCO 8002212501 4234 SW 20TH AVEGAINESVILLE FLCard 1231,34.24
7/30/2024,,Withdrawal Debit Card MC Debit Seminol/AMAZON DIGIT*RV2ZN2GA1 AMZN.COM/BIL WADate 07/30/24 0 4212878109 0 5818Card 1231,3.44,,Posted,2775.64,2024-07-30,3.44,Withdrawal Debit Card MC Debit Seminol/AMAZON DIGIT*RV2ZN2GA1 AMZN.COM/BIL WADate 07/30/24 0 4212878109 0 5818Card 1231,3.44
7/30/2024,,Recurring Withdrawal Debit Card - MC Debit Seminol/APPLE.COM/BILL 866-712-7753 CADate 07/29/24 0 4211570450 0 5818Card 1231,7.98,,Posted,2779.08,2024-07-30,7.98,Recurring Withdrawal Debit Card - MC Debit Seminol/APPLE.COM/BILL 866-712-7753 CADate 03/27/24 0 4087824766 0 5818Card 1231,7.98
7/29/2024,,Withdrawal POS #000000782390/INSTACART*159 WWW.INSTACART.COM/ SANFRANCISCO CACard 1231,60.0,,Posted,2785.7,2024-07-29,60.0,Withdrawal POS #000000804821/INSTACART*159 WWW.INSTACART.COM/ SANFRANCISCO CACard 1231,60.0
7/29/2024,,Withdrawal Debit Card MC Debit Seminol/WAWA CARD RELOAD MEDIA PADate 07/28/24 0 4210031062 1 6540Card 1231,15.0,,Posted,2845.7,2024-07-29,15.0,Withdrawal Debit Card MC Debit Seminol/WAWA CARD RELOAD MEDIA PADate 11/03/24 0 4308001823 1 6540Card 1231,15.0
7/28/2024,,Withdrawal POS #000000575942/SUNOCO 8002212501 4234 SW 20TH AVEGAINESVILLE FLCard 1231,22.42,,Posted,60.7,2024-07-28,22.42,Withdrawal POS #000000778591/SUNOCO 8002212501 4234 SW 20TH AVEGAINESVILLE FLCard 1231,22.42
7/26/2024,,Withdrawal POS #000000665239/SUNOCO 8002212501 4234 SW 20TH AVEGAINESVILLE FLCard 1231,37.67,,Posted,83.12,2024-07-26,37.67,Withdrawal POS #000000488663/SUNOCO 8002212501 4234 SW 20TH AVEGAINESVILLE FLCard 1231,37.545
7/25/2024,,"Recurring Withdrawal Debit Card - MC Debit Seminol/YVETTE GODET, DMD GAINESVILLE FLDate 07/24/24 0 4206848776 0 8021Card 1231",20.0,,Posted,113.29,2024-07-25,20.0,"Recurring Withdrawal Debit Card - MC Debit Seminol/YVETTE GODET, DMD GAINESVILLE FLDate 07/24/24 0 4206848776 0 8021Card 1231",20.0
7/25/2024,,Recurring Withdrawal Debit Card - MC Debit Seminol/FS *ADOBE SANTA BARBAR CADate 07/24/24 0 4206889164 0 5734Card 1231,0.95,,Posted,133.29,2024-07-25,0.95,Recurring Withdrawal Debit Card - MC Debit Seminol/FS *CONTEXTSFORMAC SANTA BARBAR CADate 02/16/24 0 4047893711 1 5734Card 1231,0.95
7/25/2024,,Recurring Withdrawal Debit Card - MC Debit Seminol/APPLE.COM/BILL 866-712-7753 CADate 07/25/24 0 4207172375 1 5818Card 1231,0.29,,Posted,134.24,2024-07-25,0.29,Recurring Withdrawal Debit Card - MC Debit Seminol/APPLE.COM/BILL 866-712-7753 CADate 03/27/24 0 4087824766 0 5818Card 1231,0.29
7/25/2024,,Withdrawal POS #000000000006/AMAZON.COM*RJ6HJ7RA2 SEATTLE WACard 1231,8.59,,Posted,134.53,2024-07-25,8.59,Withdrawal POS #000000000007/AMAZON.COM*2864R4HI1 SEATTLE WACard 1140,8.59
7/24/2024,,Withdrawal POS #000000616677/SUNOCO 8002212501 4234 SW 20TH AVEGAINESVILLE FLCard 1231,21.56,,Posted,143.12,2024-07-24,21.56,Withdrawal POS #000000616677/SUNOCO 8002212501 4234 SW 20TH AVEGAINESVILLE FLCard 1231,21.56
7/24/2024,,Withdrawal POS #000000803033/IC* INSTACART*159 WWW.INSTACART.COM/ SANFRANCISCO CACard 1231,76.0,,Posted,164.68,2024-07-24,76.0,Withdrawal POS #000000794186/IC* INSTACART*159 WWW.INSTACART.COM/ SANFRANCISCO CACard 1231,76.0
7/23/2024,,Withdrawal POS #000000524840/SUNOCO 8002212501 4234 SW 20TH AVEGAINESVILLE FLCard 1231,37.78,,Posted,40.68,2024-07-23,37.78,Withdrawal POS #000000028242/SUNOCO 8002212501 4234 SW 20TH AVEGAINESVILLE FLCard 1231,37.78
7/21/2024,,Recurring Withdrawal Debit Card - MC Debit Seminol/CANVA* I04218-28500872 CAMDEN DEDate 07/20/24 0 4202716426 0 7221Card 1231,12.99,,Posted,66.93,2024-07-21,12.99,Recurring Withdrawal Debit Card - MC Debit Seminol/CANVA* I04249-43399962 CAMDEN DEDate 08/20/24 0 4233594945 0 7221Card 1231,12.99
7/21/2024,,Recurring Withdrawal Debit Card - MC Debit Seminol/TUBEBUDDYCOM 8668823239 CADate 07/20/24 0 4202875818 0 5734Card 1231,7.5,,Posted,79.92,2024-07-21,7.5,Recurring Withdrawal Debit Card - MC Debit Seminol/TUBEBUDDYCOM* 8668823239 CADate 12/03/24 0 4338443995 0 5045Card 1231,7.5
7/21/2024,,Withdrawal POS #000000000124/CIRCLE K # 06782 5237 GAINESVILLE FLCard 1231,26.83,,Posted,87.42,2024-07-21,26.83,Withdrawal POS #000000882351/CIRCLE K # 06782 GAINESVILLE FLCard 1140,26.83
7/19/2024,,Recurring Withdrawal Debit Card Fee/MASTERCARD ISSUER CROSS-BORDER FEEDate 07/18/24 0 4200710264 0 5734Card 1231,0.05,,Posted,104.26,2024-07-19,0.05,Recurring Withdrawal Debit Card Fee/MASTERCARD ISSUER CROSS-BORDER FEEDate 06/11/22 0 2162900620 0 5734Card 2801,0.07500000000000001
7/19/2024,,Recurring Withdrawal Debit Card - MC Debit Seminol/SAVE TO NOTION VAUREAL ILDate 07/18/24 0 4200710264 0 5734Card 1231,5.99,,Posted,104.31,2024-07-19,5.99,Recurring Withdrawal Debit Card - MC Debit Seminol/SAVE TO NOTION VAUREAL ILDate 12/18/24 0 4353969048 0 5734Card 1231,5.99
7/19/2024,,Recurring Withdrawal Debit Card - MC Debit Seminol/WORDPRESS YLZK812XJ6 SAN FRANCISC CADate 07/18/24 0 4200709907 0 5734Card 1231,9.0,,Posted,110.3,2024-07-19,9.0,Recurring Withdrawal Debit Card - MC Debit Seminol/WORDPRESS YLZK812XJ6 SAN FRANCISC CADate 07/18/24 0 4200709907 0 5734Card 1231,9.0
7/18/2024,,Withdrawal POS #000000357918/SUNOCO 8002212501 4234 SW 20TH AVEGAINESVILLE FLCard 1231,34.24,,Posted,119.3,2024-07-18,34.24,Withdrawal POS #000000778591/SUNOCO 8002212501 4234 SW 20TH AVEGAINESVILLE FLCard 1231,34.24
7/18/2024,,Recurring Withdrawal Debit Card - MC Debit Seminol/SUPERPOWER CHATGPT MIDDLETOWN DEDate 07/17/24 0 4199660339 0 5734Card 1231,15.0,,Posted,153.54,2024-07-18,15.0,Recurring Withdrawal Debit Card - MC Debit Seminol/SUPERPOWER CHATGPT MIDDLETOWN DEDate 12/17/24 0 4352703539 1 5734Card 1231,15.094999999999999
7/18/2024,,Withdrawal ACH FLUENT-Gainesvil/TYPE: PAYMENT ID: 1371804719CO: FLUENT-GainesvilNAME: steven chaplinskiEntry Class Code: WEB,36.0,,Posted,168.54,2024-07-18,36.0,Withdrawal ACH FLUENT-Gainesvil/TYPE: PAYMENT ID: 1371804719CO: FLUENT-GainesvilNAME: steven chaplinski,36.0
7/17/2024,,Withdrawal POS #000000976832/AMAZON.COM*RS88T71I1 SEATTLE WACard 1231,16.43,,Posted,175.34,2024-07-17,16.43,Withdrawal POS #000000049785/AMAZON.COM*AV5RE3583 SEATTLE WACard 1231,16.43
7/17/2024,,Recurring Withdrawal Debit Card - MC Debit Seminol/PADDLE.NET* LEONARDOAI ASTORIA NYDate 07/16/24 0 4198745563 0 5817Card 1231,9.0,,Posted,191.77,2024-07-17,9.0,Withdrawal Debit Card MC Debit Seminol/PADDLE.NET* LEONARDOAI ASTORIA NYDate 10/26/23 0 3299263117 0 5817Card 2801,9.0
7/17/2024,,Recurring Withdrawal Debit Card - MC Debit Seminol/PADDLE.NET* SETAPP ASTORIA NYDate 07/16/24 0 4198606327 0 5817Card 1231,12.49,,Posted,200.77,2024-07-17,12.49,Recurring Withdrawal Debit Card - MC Debit Seminol/PADDLE.NET* SETAPP NEW YORK NYDate 10/14/24 0 4288882561 0 5817Card 1231,12.49
7/17/2024,,Recurring Withdrawal Debit Card Fee/MASTERCARD ISSUER CROSS-BORDER FEEDate 07/17/24 0 4199108326 1 5734Card 1231,0.06,,Posted,213.26,2024-07-17,0.06,Recurring Withdrawal Debit Card Fee/MASTERCARD ISSUER CROSS-BORDER FEEDate 05/12/21 0 1132191600 1 7372Card 2801,0.09500000000000001
7/17/2024,,Recurring Withdrawal Debit Card - MC Debit Seminol/IDEOGRAM AI TORONTO ONDate 07/17/24 0 4199108326 1 5734Card 1231,8.0,,Posted,213.32,2024-07-17,8.0,Recurring Withdrawal Debit Card - MC Debit Seminol/IDEOGRAM AI TORONTO ONDate 12/17/24 0 4352700468 1 5734Card 1231,8.0
7/16/2024,,Withdrawal POS #000000795251/INSTACART*159 WWW.INSTACART.COM/ SANFRANCISCO CACard 1231,42.92,,Posted,221.32,2024-07-16,42.92,Withdrawal POS #000000804821/INSTACART*159 WWW.INSTACART.COM/ SANFRANCISCO CACard 1231,42.96
7/16/2024,,Withdrawal POS #000000271518/SUNOCO 8002212501 4234 SW 20TH AVEGAINESVILLE FLCard 1231,37.78,,Posted,234.76,2024-07-16,37.78,Withdrawal POS #000000778591/SUNOCO 8002212501 4234 SW 20TH AVEGAINESVILLE FLCard 1231,38.010000000000005
7/15/2024,,Recurring Withdrawal Debit Card - MC Debit Seminol/RUNWAY STANDARD PLAN NEWARK DEDate 07/15/24 0 4197591427 1 5734Card 1231,15.0,,Posted,272.54,2024-07-15,15.0,Recurring Withdrawal Debit Card - MC Debit Seminol/RUNWAY STANDARD PLAN NEWARK DEDate 12/15/24 0 4350745942 1 5734Card 1231,15.0
7/15/2024,,Withdrawal POS #000000211548/SUNOCO 8002212501 4234 SW 20TH AVEGAINESVILLE FLCard 1231,37.78,,Posted,287.54,2024-07-15,37.78,Withdrawal POS #000000221295/SUNOCO 8002212501 4234 SW 20TH AVEGAINESVILLE FLCard 1231,37.725
7/14/2024,,Recurring Withdrawal Debit Card - MC Debit Seminol/OPENAI SAN FRANCISC CADate 07/14/24 0 4196394793 1 5734Card 1231,15.01,,Posted,325.32,2024-07-14,15.01,Withdrawal Debit Card MC Debit Seminol/OPENAI SAN FRANCISC CADate 02/16/24 0 4047896474 1 5734Card 1231,15.0325
7/14/2024,,Recurring Withdrawal Debit Card - MC Debit Seminol/SUPERPOWER CHATGPT MIDDLETOWN DEDate 07/13/24 0 4195402190 0 5734Card 1231,15.0,,Posted,340.33,2024-07-14,15.0,Recurring Withdrawal Debit Card - MC Debit Seminol/SUPERPOWER CHATGPT MIDDLETOWN DEDate 12/17/24 0 4352703539 1 5734Card 1231,15.094999999999999
7/14/2024,,Recurring Withdrawal Debit Card - MC Debit Seminol/D-ID STUDIO WILMINGTON DEDate 07/13/24 0 4195852605 0 7399Card 1231,2.95,,Posted,355.33,2024-07-14,2.95,Recurring Withdrawal Debit Card - MC Debit Seminol/D-ID STUDIO WILMINGTON DEDate 10/13/24 0 4287011811 1 7399Card 1231,2.95
7/14/2024,,Recurring Withdrawal Debit Card - MC Debit Seminol/SUNO INC. CAMBRIDGE MADate 07/13/24 0 4195401634 0 5734Card 1231,10.0,,Posted,358.28,2024-07-14,10.0,Recurring Withdrawal Debit Card - MC Debit Seminol/SUNO INC. CAMBRIDGE MADate 08/13/24 0 4226902139 0 5734Card 1231,10.0
7/14/2024,,Recurring Withdrawal Debit Card - MC Debit Seminol/APPLE.COM/BILL 866-712-7753 CADate 07/13/24 0 4195115185 3 5818Card 1231,18.98,,Posted,368.28,2024-07-14,18.98,Recurring Withdrawal Debit Card - MC Debit Seminol/APPLE.COM/BILL 866-712-7753 CADate 09/16/23 0 3259205559 2 5818Card 2801,18.975
7/13/2024,,Withdrawal POS #000000165380/SUNOCO 8002212501 4234 SW 20TH AVEGAINESVILLE FLCard 1231,36.81,,Posted,387.26,2024-07-13,36.81,Withdrawal POS #000000161599/SUNOCO 8002212501 4234 SW 20TH AVEGAINESVILLE FLCard 1231,37.295
7/12/2024,,Withdrawal Debit Card MC Debit Seminol/WAWA CARD RELOAD MEDIA PADate 07/11/24 0 4193151203 1 6540Card 1231,15.0,,Posted,424.07,2024-07-12,15.0,Withdrawal Debit Card MC Debit Seminol/WAWA CARD RELOAD MEDIA PADate 11/03/24 0 4308001823 1 6540Card 1231,15.0
7/12/2024,,Withdrawal Debit Card MC Debit Seminol/WAWA CARD RELOAD MEDIA PADate 07/11/24 0 4193151202 1 6540Card 1231,20.0,,Posted,439.07,2024-07-12,20.0,Withdrawal Debit Card MC Debit Seminol/WAWA CARD RELOAD MEDIA PADate 11/03/24 0 4308001823 1 6540Card 1231,20.0
7/12/2024,,Withdrawal Debit Card MC Debit Seminol/CIRCLE K # 06782 GAINESVILLE FLDate 07/10/24 0 4192897494 0 5499Card 1231,21.77,,Posted,459.07,2024-07-12,21.77,Withdrawal Debit Card MC Debit Seminol/CIRCLE K # 06782 GAINESVILLE FLDate 09/08/24 0 4252889868 0 5499Card 1231,21.405
7/12/2024,,Withdrawal POS #000000037228/WAWA 5325 2373 SW ARCHER ROADFLCard 1231,18.03,,Posted,480.84,2024-07-12,18.03,Withdrawal POS #000000553411/WAWA 5325 2373 SW ARCHER ROADFLCard 1247,18.03
7/11/2024,,Recurring Withdrawal Debit Card - MC Debit Seminol/AIRTABLE.COM/BILL SAN FRANCISC CADate 07/10/24 0 4192868077 0 7372Card 1231,31.0,,Posted,448.87,2024-07-11,31.0,Recurring Withdrawal Debit Card - MC Debit Seminol/AIRTABLE.COM/BILL SAN FRANCISC CADate 09/11/24 0 4255913774 0 7372Card 1231,31.0
7/11/2024,,Withdrawal Debit Card MC Debit Seminol/WALGREENS #5024 GAINESVILLE FLDate 07/10/24 0 4192117338 1 5912Card 1231,36.44,,Posted,479.87,2024-07-11,36.44,Withdrawal Debit Card MC Debit Seminol/WALGREENS #5024 GAINESVILLE FLDate 04/14/24 0 4105827629 0 5912Card 1231,36.44
7/11/2024,,Withdrawal Debit Card MC Debit Seminol/B2P* FL OMMU MJ MED CA JACKSONVILLE FLDate 07/10/24 0 4192863496 0 9399Card 1231,77.75,,Posted,516.31,2024-07-11,77.75,Withdrawal Debit Card MC Debit Seminol/B2P* FL OMMU MJ MED CA JACKSONVILLE FLDate 07/10/24 0 4192863496 0 9399Card 1231,77.75
7/11/2024,,Withdrawal ACH FLUENT-Gainesvil/TYPE: PAYMENT ID: 1371804719CO: FLUENT-GainesvilNAME: steven chaplinskiEntry Class Code: WEB,48.0,,Posted,594.06,2024-07-11,48.0,Withdrawal ACH FLUENT-Gainesvil/TYPE: PAYMENT ID: 1371804719CO: FLUENT-GainesvilNAME: steven chaplinski,48.5
7/9/2024,,Withdrawal POS #000000041458/SUNOCO 8002212501 4234 SW 20TH AVEGAINESVILLE FLCard 1231,37.78,,Posted,642.06,2024-07-09,37.78,Withdrawal POS #000000031004/SUNOCO 8002212501 4234 SW 20TH AVEGAINESVILLE FLCard 1231,37.78
7/8/2024,,Recurring Withdrawal Debit Card - MC Debit Seminol/APPLE.COM/BILL 866-712-7753 CADate 07/08/24 0 4190849912 0 5818Card 1231,2.99,,Posted,679.84,2024-07-08,2.99,Recurring Withdrawal Debit Card - MC Debit Seminol/APPLE.COM/BILL 866-712-7753 CADate 01/08/24 0 4008756344 0 5818Card 2801,2.99
7/7/2024,,Withdrawal Debit Card MC Debit Seminol/SAMSUNG ELECTRONICS RIDGEFIELD P NJDate 07/06/24 0 4188926193 0 5734Card 1231,16.99,,Posted,682.83,2024-07-07,16.99,Withdrawal Debit Card MC Debit Seminol/SAMSUNG ELECTRONICS RIDGEFIELD P NJDate 12/27/24 0 4362999827 1 5734Card 1231,16.49
7/7/2024,,Withdrawal Debit Card MC Debit Seminol/WALGREENS #5024 GAINESVILLE FLDate 07/05/24 0 4187128964 2 5912Card 1231,24.75,,Posted,699.82,2024-07-07,24.75,Withdrawal Debit Card MC Debit Seminol/WALGREENS #5024 GAINESVILLE FLDate 06/26/23 0 3177001861 1 5912Card 2801,24.265
7/7/2024,,Withdrawal Debit Card MC Debit Seminol/GRU/EZ-PAY WEB PYMT 352-334-3434 FLDate 07/05/24 0 4187656509 0 4900Card 1231,200.0,,Posted,724.57,2024-07-07,200.0,Withdrawal Debit Card MC Debit Seminol/GRU/EZ-PAY WEB PYMT 352-334-3434 FLDate 12/05/24 0 4340279271 0 4900Card 1231,200.0
7/7/2024,,Withdrawal Debit Card MC Debit Seminol/COX GAINESVILLE COMM 800-234-3993 FLDate 07/05/24 0 4187656473 0 4899Card 1231,156.13,,Posted,924.57,2024-07-07,156.13,Withdrawal Debit Card MC Debit Seminol/COX GAINESVILLE COMM 800-234-3993 FLDate 12/04/24 0 4339376311 0 4899Card 1231,156.13
7/7/2024,,Withdrawal POS #000000792733/INSTACART*159 WWW.INSTACART.COM/ SANFRANCISCO CACard 1231,59.07,,Posted,1080.7,2024-07-07,59.07,Withdrawal POS #000000792733/INSTACART*159 WWW.INSTACART.COM/ SANFRANCISCO CACard 1231,59.085
7/6/2024,,Recurring Withdrawal Bill Payment - #000000404960/NETFLIX COM LOS GATOS CACard 1231,13.81,,Posted,1139.77,2024-07-06,13.81,Recurring Withdrawal Bill Payment - #000000343444/NETFLIX COM LOS GATOS CACard 1231,13.81
7/5/2024,,Withdrawal POS #000000828132/SUNOCO 8002212501 4234 SW 20TH AVEGAINESVILLE FLCard 1231,30.7,,Posted,1153.58,2024-07-05,30.7,Withdrawal POS #000000028242/SUNOCO 8002212501 4234 SW 20TH AVEGAINESVILLE FLCard 1231,30.7
7/5/2024,,Recurring Withdrawal Debit Card - MC Debit Seminol/OPENAI *CHATGPT SUBSCR SAN FRANCISC CADate 07/04/24 0 4186555750 0 5734Card 1231,20.0,,Posted,1184.28,2024-07-05,20.0,Recurring Withdrawal Debit Card - MC Debit Seminol/OPENAI *CHATGPT SUBSCR SAN FRANCISC CADate 12/04/24 0 4339869196 0 5734Card 1231,20.0
7/4/2024,,Withdrawal POS #000000601921/SUNOCO 8002212501 4234 SW 20TH AVEGAINESVILLE FLCard 1231,37.78,,Posted,1204.28,2024-07-04,37.78,Withdrawal POS #000000161599/SUNOCO 8002212501 4234 SW 20TH AVEGAINESVILLE FLCard 1231,37.295
7/4/2024,,Withdrawal POS #000000000004/INSTACART*159 WWW.INSTACART.COM/ SANFRANCISCO CACard 1231,95.0,,Posted,1242.06,2024-07-04,95.0,Withdrawal POS #000000804821/INSTACART*159 WWW.INSTACART.COM/ SANFRANCISCO CACard 1231,95.0
7/3/2024,,"Withdrawal POS #000000784963/ETSY, INC. ADAMS STREET BROOKLYN NYCard 1231",31.06,,Posted,1337.06,2024-07-03,31.06,"Withdrawal POS #000000784963/ETSY, INC. ADAMS STREET BROOKLYN NYCard 1231",31.06
7/3/2024,,Recurring Withdrawal Debit Card - MC Debit Seminol/DOCSIUM.COM SANTA CLARA CADate 07/02/24 0 4184077595 1 5734Card 1231,10.0,,Posted,1368.12,2024-07-03,10.0,Recurring Withdrawal Debit Card - MC Debit Seminol/DOCSIUM.COM SANTA CLARA CADate 07/02/24 0 4184077595 1 5734Card 1231,10.0
7/3/2024,,Recurring Withdrawal Debit Card - MC Debit Seminol/INVIDEO INC COUNTRY OF S DEDate 07/02/24 0 4184336533 0 5734Card 1231,50.0,,Posted,1378.12,2024-07-03,50.0,Recurring Withdrawal Debit Card - MC Debit Seminol/INVIDEO INC COUNTRY OF S DEDate 12/09/24 0 4344808122 0 5734Card 1231,50.0
7/3/2024,,Recurring Withdrawal Debit Card - MC Debit Seminol/APPLE.COM/BILL 866-712-7753 CADate 07/03/24 0 4185191278 1 5818Card 1231,2.99,,Posted,1428.12,2024-07-03,2.99,Recurring Withdrawal Debit Card - MC Debit Seminol/APPLE.COM/BILL 866-712-7753 CADate 04/13/24 0 4104933092 1 5818Card 1231,2.99
7/3/2024,,"Withdrawal Bill Payment #000000776267/Adobe Park Avenue,345 San Jose CACard 1231",19.99,,Posted,1431.11,2024-07-03,19.99,"Withdrawal Bill Payment #000000352498/Adobe Park Avenue,345 San Jose CACard 1247",19.99
7/2/2024,,Withdrawal POS #000000636425/WAWA 5325 2373 SW ARCHER ROADFLCard 1231,25.64,,Posted,1451.1,2024-07-02,25.64,Withdrawal POS #000000553411/WAWA 5325 2373 SW ARCHER ROADFLCard 1247,25.64
7/2/2024,,Withdrawal ACH Watson Realty Co/TYPE: WEB PMTS ID: 9000321157CO: Watson Realty CoNAME: Steven chaplinskiEntry Class Code: WEB,1079.0,,Posted,1476.74,2024-07-02,1079.0,Withdrawal ACH Watson Realty Co/TYPE: WEB PMTS ID: 9000321157CO: Watson Realty CoEntry Class Code: WEB,1079.0
7/2/2024,,"Withdrawal ACH AppFolio, Inc. F/TYPE: WEB PMTS ID: 9001406550CO: AppFolio, Inc. FNAME: Steven chaplinskiEntry Class Code: WEB",2.49,,Posted,2555.74,2024-07-02,2.49,"Withdrawal ACH AppFolio, Inc. F/TYPE: WEB PMTS ID: 9001406550

CO: AppFolio, Inc. F

NAME: Steven chaplinskiEntry Class Code: WEB",2.49
7/1/2024,,Withdrawal POS #000000794215/Etsy.com*US ADAMS STREET BROOKLYN NYCard 1231,19.38,,Posted,2558.23,2024-07-01,19.38,Withdrawal POS #000000794215/Etsy.com*US ADAMS STREET BROOKLYN NYCard 1231,19.38
6/30/2024,,Withdrawal Debit Card MC Debit Seminol/CIRCLE K # 06782 GAINESVILLE FLDate 06/27/24 0 4179059238 2 5499Card 1231,10.93,,Posted,2577.61,2024-06-30,10.93,Withdrawal Debit Card MC Debit Seminol/CIRCLE K # 06782 GAINESVILLE FLDate 09/08/24 0 4252889868 0 5499Card 1231,10.93
6/30/2024,,Withdrawal POS #000000585907/SUNOCO 8002212501 4234 SW 20TH AVEGAINESVILLE FLCard 1231,30.7,,Posted,2588.54,2024-06-30,30.7,Withdrawal POS #000000778591/SUNOCO 8002212501 4234 SW 20TH AVEGAINESVILLE FLCard 1231,30.39
6/30/2024,,Withdrawal POS #000000000002/INSTACART*159 WWW.INSTACART.COM/ SANFRANCISCO CACard 1231,3.0,,Posted,2619.24,2024-06-30,3.0,Withdrawal POS #000000804821/INSTACART*159 WWW.INSTACART.COM/ SANFRANCISCO CACard 1231,3.0
6/29/2024,,Withdrawal POS #000000794238/INSTACART*159 WWW.INSTACART.COM/ SANFRANCISCO CACard 1231,102.0,,Posted,2622.24,2024-06-29,102.0,Withdrawal POS #000000804821/INSTACART*159 WWW.INSTACART.COM/ SANFRANCISCO CACard 1231,102.0
6/28/2024,,Withdrawal ATM Fee/EFT 6419 W Newberry Rd Gainesville FLCard 1231,2.0,,Posted,2724.24,2024-06-28,2.0,"Withdrawal ATM Fee/EFT 6419 W Newberry Rd Gainesville FL

Card 1247",2.0
6/28/2024,,Withdrawal at ATM #000000187788/EFT 6419 W Newberry Rd Gainesville FLCard 1231,58.0,,Posted,2726.24,2024-06-28,58.0,"Withdrawal at ATM #000000785755/EFT 6419 W Newberry Rd Gainesville FL

Card 1247",58.0
6/27/2024,,Withdrawal POS #000000000163/CIRCLE K # 06782 5237 GAINESVILLE FLCard 1231,10.83,,Posted,2784.24,2024-06-27,10.83,Withdrawal POS #000000882351/CIRCLE K # 06782 GAINESVILLE FLCard 1140,10.42
6/25/2024,,"Recurring Withdrawal Debit Card - MC Debit Seminol/NOTION LABS, INC. SAN FRANCISC CADate 06/24/24 0 4176845324 0 7372Card 1231",28.0,,Posted,-4.93,2024-06-25,28.0,"Recurring Withdrawal Debit Card - MC Debit Seminol/NOTION LABS, INC. SAN FRANCISC CADate 12/02/24 0 4337878572 0 7372Card 1231",27.52
6/25/2024,,Recurring Withdrawal Debit Card - MC Debit Seminol/FS *ADOBE SANTA BARBAR CADate 06/24/24 0 4176843252 0 5734Card 1231,0.95,,Posted,23.07,2024-06-25,0.95,Recurring Withdrawal Debit Card - MC Debit Seminol/FS *ADOBE SANTA BARBAR CADate 12/24/24 0 4359034647 1 5734Card 1231,0.95
6/24/2024,,Recurring Withdrawal Debit Card - MC Debit Seminol/VIDIQ SAN FRANCISC CADate 06/23/24 0 4175962388 0 5734Card 1231,10.0,,Posted,24.02,2024-06-24,10.0,Recurring Withdrawal Debit Card - MC Debit Seminol/VIDIQ SAN FRANCISC CADate 12/23/23 0 3357950683 0 5734Card 2801,10.0
6/22/2024,,Withdrawal POS #000000222542/WAWA 5325 2373 SW ARCHER ROADFLCard 1231,21.03,,Posted,34.02,2024-06-22,21.03,Withdrawal POS #000000553411/WAWA 5325 2373 SW ARCHER ROADFLCard 1247,21.03
6/22/2024,,Withdrawal POS #000000736979/PUBLIX 3100 SW 35TH BLVD GAINESVILLE FLCard 1231,3.57,,Posted,55.05,2024-06-22,3.57,"Withdrawal POS #000000752480/PUBLIX 3100 SW 35TH BLVD GAINESVILLE FL

Card 1247",3.57
6/21/2024,,Recurring Withdrawal Debit Card - MC Debit Seminol/CANVA* I04188-40633252 CAMDEN DEDate 06/20/24 0 4172950372 0 7221Card 1231,12.99,,Posted,58.62,2024-06-21,12.99,Recurring Withdrawal Debit Card - MC Debit Seminol/CANVA* I04249-43399962 CAMDEN DEDate 08/20/24 0 4233594945 0 7221Card 1231,12.99
6/21/2024,,Recurring Withdrawal Debit Card - MC Debit Seminol/TUBEBUDDYCOM 8668823239 CADate 06/20/24 0 4172966177 0 5734Card 1231,7.5,,Posted,71.61,2024-06-21,7.5,Recurring Withdrawal Debit Card - MC Debit Seminol/TUBEBUDDYCOM* 8668823239 CADate 12/03/24 0 4338443995 0 5045Card 1231,7.5
6/20/2024,,Withdrawal POS #000000062103/SUNOCO 8002212501 4234 SW 20TH AVEGAINESVILLE FLCard 1231,27.17,,Posted,79.11,2024-06-20,27.17,Withdrawal POS #000000031004/SUNOCO 8002212501 4234 SW 20TH AVEGAINESVILLE FLCard 1231,27.17
6/20/2024,,Withdrawal POS #000075513000/WAWA 5325 2373 SW ARCHER ROADFLCard 1231,7.91,,Posted,6.28,2024-06-20,7.91,Withdrawal POS #000000553411/WAWA 5325 2373 SW ARCHER ROADFLCard 1247,7.5
6/20/2024,,Withdrawal POS #000003380654/GOOGLE *YouTubePremium 1600 AmphitheatreParkw Mountain View CACard 1231,15.92,,Posted,14.19,2024-06-20,15.92,"Withdrawal POS #000020312090/GOOGLE *YouTubePremium 1600 Amphitheatre

Parkw Mountain View CA

Card 1247",15.92
6/19/2024,,Recurring Withdrawal Debit Card - MC Debit Seminol/OPENAI SAN FRANCISC CADate 06/19/24 0 4171146931 1 5734Card 1231,15.07,,Posted,30.11,2024-06-19,15.07,Withdrawal Debit Card MC Debit Seminol/OPENAI SAN FRANCISC CADate 02/16/24 0 4047896474 1 5734Card 1231,15.0325
6/19/2024,,Recurring Withdrawal Debit Card Fee/MASTERCARD ISSUER CROSS-BORDER FEEDate 06/18/24 0 4170210550 0 5734Card 1231,0.05,,Posted,45.18,2024-06-19,0.05,Recurring Withdrawal Debit Card Fee/MASTERCARD ISSUER CROSS-BORDER FEEDate 06/11/22 0 2162900620 0 5734Card 2801,0.07500000000000001
6/19/2024,,Recurring Withdrawal Debit Card - MC Debit Seminol/SAVE TO NOTION VAUREAL ILDate 06/18/24 0 4170210550 0 5734Card 1231,5.99,,Posted,45.23,2024-06-19,5.99,Recurring Withdrawal Debit Card - MC Debit Seminol/SAVE TO NOTION VAUREAL ILDate 12/18/24 0 4353969048 0 5734Card 1231,5.99
6/19/2024,,Recurring Withdrawal Debit Card - MC Debit Seminol/WORDPRESS JTXC3339UX SAN FRANCISC CADate 06/18/24 0 4170210352 0 5734Card 1231,9.0,,Posted,51.22,2024-06-19,9.0,Recurring Withdrawal Debit Card - MC Debit Seminol/WORDPRESS YLZK812XJ6 SAN FRANCISC CADate 07/18/24 0 4200709907 0 5734Card 1231,9.0
6/19/2024,,Withdrawal Debit Card MC Debit Seminol/MYDESIGNS.IO LAS VEGAS NVDate 06/18/24 0 4170210349 0 5734Card 1231,24.26,,Posted,60.22,2024-06-19,24.26,Withdrawal Debit Card MC Debit Seminol/MYDESIGNS.IO LAS VEGAS NVDate 01/07/24 0 4007751481 0 5734Card 2801,24.26
6/19/2024,,Withdrawal Debit Card MC Debit Seminol/MYDESIGNS.IO LAS VEGAS NVDate 06/18/24 0 4170210348 0 5734Card 1231,22.77,,Posted,84.48,2024-06-19,22.77,Withdrawal Debit Card MC Debit Seminol/MYDESIGNS.IO LAS VEGAS NVDate 01/07/24 0 4007751481 0 5734Card 2801,22.77
6/18/2024,,Recurring Withdrawal Debit Card - MC Debit Seminol/SUPERPOWER CHATGPT MIDDLETOWN DEDate 06/17/24 0 4169773640 0 5734Card 1231,15.0,,Posted,107.25,2024-06-18,15.0,Recurring Withdrawal Debit Card - MC Debit Seminol/SUPERPOWER CHATGPT MIDDLETOWN DEDate 12/17/24 0 4352703539 1 5734Card 1231,15.094999999999999
6/18/2024,,Withdrawal POS #000010941641/CIRCLE K # 26146 3525 GAINESVILLE FLCard 1231,32.54,,Posted,122.25,2024-06-18,32.54,Withdrawal POS #000010941641/CIRCLE K # 26146 3525 GAINESVILLE FLCard 1231,32.305
6/17/2024,,Recurring Withdrawal Debit Card - MC Debit Seminol/LINKTREE* LINKTREE VENICE CADate 06/16/24 0 4168933314 0 7399Card 1231,9.0,,Posted,-45.21,2024-06-17,9.0,Recurring Withdrawal Debit Card - MC Debit Seminol/LINKTREE* LINKTREE VENICE CADate 06/16/24 0 4168933314 0 7399Card 1231,9.0
6/17/2024,,Recurring Withdrawal Debit Card - MC Debit Seminol/MYDESIGNS - PRO - MON LAS VEGAS NVDate 06/16/24 0 4168024493 1 5734Card 1231,29.99,,Posted,-36.21,2024-06-17,29.99,Withdrawal Debit Card MC Debit Seminol/MYDESIGNS - PRO - MON LAS VEGAS NVDate 09/01/23 0 3244164229 1 5734Card 2801,29.99
6/17/2024,,Recurring Withdrawal Debit Card - MC Debit Seminol/PADDLE.NET* LEONARDOAI ASTORIA NYDate 06/16/24 0 4168303365 0 5817Card 1231,9.0,,Posted,-6.22,2024-06-17,9.0,Recurring Withdrawal Debit Card - MC Debit Seminol/PADDLE.NET* LEONARDOAI ASTORIA NYDate 12/16/24 0 4351323834 0 5817Card 1231,9.0
6/17/2024,,Recurring Withdrawal Debit Card - MC Debit Seminol/PADDLE.NET* SETAPP ASTORIA NYDate 06/16/24 0 4168931750 0 5817Card 1231,12.49,,Posted,2.78,2024-06-17,12.49,Recurring Withdrawal Debit Card - MC Debit Seminol/PADDLE.NET* SETAPP NEW YORK NYDate 10/14/24 0 4288882561 0 5817Card 1231,12.49
6/17/2024,,Recurring Withdrawal Debit Card - MC Debit Seminol/WWW.EVERBEE.IO AUSTIN TXDate 06/16/24 0 4168931700 0 5734Card 1231,29.99,,Posted,15.27,2024-06-17,29.99,Recurring Withdrawal Debit Card - MC Debit Seminol/WWW.EVERBEE.IO AUSTIN TXDate 12/04/24 0 4339869891 0 5734Card 1231,29.99
6/17/2024,,Recurring Withdrawal Debit Card Fee/MASTERCARD ISSUER CROSS-BORDER FEEDate 06/17/24 0 4169858722 0 5734Card 1231,0.06,,Posted,45.26,2024-06-17,0.06,Recurring Withdrawal Debit Card Fee/MASTERCARD ISSUER CROSS-BORDER FEEDate 06/11/22 0 2162900620 0 5734Card 2801,0.07500000000000001
6/17/2024,,Recurring Withdrawal Debit Card - MC Debit Seminol/IDEOGRAM AI TORONTO ONDate 06/17/24 0 4169858722 0 5734Card 1231,8.0,,Posted,45.32,2024-06-17,8.0,Withdrawal Debit Card MC Debit Seminol/IDEOGRAM.AI TORONTO ONDate 04/15/24 0 4106835174 0 5734Card 1231,8.190000000000001
6/17/2024,,Withdrawal ACH FLUENT-Gainesvil/TYPE: PAYMENT ID: 1371804719CO: FLUENT-GainesvilNAME: steven chaplinskiEntry Class Code: WEB,42.9,,Posted,53.32,2024-06-17,42.9,Withdrawal ACH FLUENT-Gainesvil/TYPE: PAYMENT ID: 1371804719CO: FLUENT-GainesvilNAME: steven chaplinski,42.7
6/16/2024,,Withdrawal POS #000000909995/SUNOCO 8002212501 4234 SW 20TH AVEGAINESVILLE FLCard 1231,26.42,,Posted,96.22,2024-06-16,26.42,Withdrawal POS #000000909995/SUNOCO 8002212501 4234 SW 20TH AVEGAINESVILLE FLCard 1231,26.42
6/16/2024,,Recurring Withdrawal Debit Card - MC Debit Seminol/PP*DOORDASH BURGERKIN 4029357733 CADate 06/13/24 0 4165038114 2 5812Card 1231,23.7,,Posted,122.64,2024-06-16,23.7,Recurring Withdrawal Debit Card - MC Debit Seminol/PP*DOORDASH BURGERKIN 4029357733 CADate 06/13/24 0 4165038114 2 5812Card 1231,23.7
6/16/2024,,Recurring Withdrawal Debit Card Fee/MASTERCARD ISSUER CROSS-BORDER FEEDate 06/15/24 0 4167922806 1 5734Card 1231,0.13,,Posted,146.34,2024-06-16,0.13,Recurring Withdrawal Debit Card Fee/MASTERCARD ISSUER CROSS-BORDER FEEDate 05/12/21 0 1132191600 1 7372Card 2801,0.09500000000000001
6/16/2024,,Recurring Withdrawal Debit Card - MC Debit Seminol/VANCEAI CENTRAL HODate 06/15/24 0 4167922806 1 5734Card 1231,15.9,,Posted,146.47,2024-06-16,15.9,Recurring Withdrawal Debit Card - MC Debit Seminol/VANCEAI CENTRAL HODate 06/15/24 0 4167922806 1 5734Card 1231,15.9
6/16/2024,,Recurring Withdrawal Debit Card - MC Debit Seminol/APPLE.COM/BILL 866-712-7753 CADate 06/15/24 0 4167495198 2 5818Card 1231,9.99,,Posted,162.37,2024-06-16,9.99,Recurring Withdrawal Debit Card - MC Debit Seminol/APPLE.COM/BILL 866-712-7753 CADate 04/13/24 0 4104933092 1 5818Card 1231,9.99
6/14/2024,,Withdrawal Debit Card MC Debit Seminol/PIKA.ART PALO ALTO CADate 06/13/24 0 4165935401 0 5734Card 1231,10.0,,Posted,172.36,2024-06-14,10.0,Withdrawal Debit Card MC Debit Seminol/PIKA.ART PALO ALTO CADate 06/13/24 0 4165935401 0 5734Card 1231,10.0
6/14/2024,,Recurring Withdrawal Debit Card - MC Debit Seminol/SUPERPOWER CHATGPT MIDDLETOWN DEDate 06/13/24 0 4165297516 0 5734Card 1231,15.0,,Posted,182.36,2024-06-14,15.0,Recurring Withdrawal Debit Card - MC Debit Seminol/SUPERPOWER CHATGPT MIDDLETOWN DEDate 12/17/24 0 4352703539 1 5734Card 1231,15.094999999999999
6/14/2024,,Recurring Withdrawal Debit Card - MC Debit Seminol/D-ID STUDIO WILMINGTON DEDate 06/13/24 0 4165935259 0 7399Card 1231,5.9,,Posted,197.36,2024-06-14,5.9,Recurring Withdrawal Debit Card - MC Debit Seminol/D-ID STUDIO WILMINGTON DEDate 10/13/24 0 4287011811 1 7399Card 1231,5.9
6/14/2024,,Recurring Withdrawal Debit Card - MC Debit Seminol/SUNO INC. CAMBRIDGE MADate 06/13/24 0 4165296878 0 5734Card 1231,10.0,,Posted,203.26,2024-06-14,10.0,Recurring Withdrawal Debit Card - MC Debit Seminol/SUNO INC. CAMBRIDGE MADate 08/13/24 0 4226902139 0 5734Card 1231,10.0
6/14/2024,,Recurring Withdrawal Debit Card Fee/MASTERCARD ISSUER CROSS-BORDER FEEDate 06/14/24 0 4166958438 0 5734Card 1231,0.03,,Posted,213.26,2024-06-14,0.03,Recurring Withdrawal Debit Card Fee/MASTERCARD ISSUER CROSS-BORDER FEEDate 06/11/22 0 2162900620 0 5734Card 2801,0.07500000000000001
6/14/2024,,Recurring Withdrawal Debit Card - MC Debit Seminol/ETSYHUNT TECH SINGAPORE SGDate 06/14/24 0 4166958438 0 5734Card 1231,3.99,,Posted,213.29,2024-06-14,3.99,Recurring Withdrawal Debit Card - MC Debit Seminol/ETSYHUNT TECH SINGAPORE SGDate 06/14/24 0 4166958438 0 5734Card 1231,3.99
6/14/2024,,Withdrawal Debit Card MC Debit Seminol/WAWA CARD RELOAD MEDIA PADate 06/12/24 0 4164067788 1 6540Card 1231,20.0,,Posted,217.28,2024-06-14,20.0,Withdrawal Debit Card MC Debit Seminol/WAWA CARD RELOAD MEDIA PADate 11/03/24 0 4308001823 1 6540Card 1231,20.0
6/14/2024,,Withdrawal POS #000000000069/CIRCLE K # 26146 3525 GAINESVILLE FLCard 1231,28.89,,Posted,237.28,2024-06-14,28.89,Withdrawal POS #000010941641/CIRCLE K # 26146 3525 GAINESVILLE FLCard 1231,28.605
6/13/2024,,Withdrawal Debit Card MC Debit Seminol/CANNAMD 855-4209170 FLDate 06/12/24 0 4164913043 0 8011Card 1231,50.0,,Posted,266.17,2024-06-13,50.0,Withdrawal Debit Card MC Debit Seminol/CANNAMD 855-4209170 FLDate 12/19/24 0 4354703841 0 8011Card 1231,50.0
6/13/2024,,Recurring Withdrawal Debit Card - MC Debit Seminol/APPLE.COM/BILL 866-712-7753 CADate 06/13/24 0 4165138639 1 5818Card 1231,15.99,,Posted,316.17,2024-06-13,15.99,Recurring Withdrawal Debit Card - MC Debit Seminol/APPLE.COM/BILL 866-712-7753 CADate 04/13/24 0 4104933092 1 5818Card 1231,15.99
6/13/2024,,Recurring Withdrawal Debit Card - MC Debit Seminol/APPLE.COM/BILL 866-712-7753 CADate 06/13/24 0 4165138632 1 5818Card 1231,2.99,,Posted,332.16,2024-06-13,2.99,Recurring Withdrawal Debit Card - MC Debit Seminol/APPLE.COM/BILL 866-712-7753 CADate 04/13/24 0 4104933092 1 5818Card 1231,2.99
6/13/2024,,Withdrawal ACH Watson Realty Co/TYPE: WEB PMTS ID: 9000321157CO: Watson Realty CoNAME: Steven chaplinskiEntry Class Code: WEB,75.0,,Posted,335.15,2024-06-13,75.0,Withdrawal ACH Watson Realty Co/TYPE: WEB PMTS ID: 9000321157CO: Watson Realty CoEntry Class Code: WEB,75.0
6/13/2024,,"Withdrawal ACH AppFolio, Inc. F/TYPE: WEB PMTS ID: 9001406550CO: AppFolio, Inc. FNAME: Steven chaplinskiEntry Class Code: WEB",2.49,,Posted,410.15,2024-06-13,2.49,"Withdrawal ACH AppFolio, Inc. F/TYPE: WEB PMTS ID: 9001406550

CO: AppFolio, Inc. F

NAME: Steven chaplinskiEntry Class Code: WEB",2.49
6/12/2024,,Withdrawal POS #000000728249/SUNOCO 8002212501 4234 SW 20TH AVEGAINESVILLE FLCard 1231,38.24,,Posted,412.64,2024-06-12,38.24,Withdrawal POS #000000778591/SUNOCO 8002212501 4234 SW 20TH AVEGAINESVILLE FLCard 1231,38.010000000000005
6/12/2024,,Recurring Withdrawal Debit Card - MC Debit Seminol/OPENAI SAN FRANCISC CADate 06/12/24 0 4164955921 0 5734Card 1231,15.01,,Posted,450.88,2024-06-12,15.01,Recurring Withdrawal Debit Card - MC Debit Seminol/OPENAI *CHATGPT SUBSCR SAN FRANCISC CADate 12/04/24 0 4339869196 0 5734Card 1231,15.01
6/12/2024,,Recurring Withdrawal Debit Card - MC Debit Seminol/PADDLE.NET* SETAPP NEW YORK NYDate 06/12/24 0 4164955257 0 5817Card 1231,9.99,,Posted,465.89,2024-06-12,9.99,Recurring Withdrawal Debit Card - MC Debit Seminol/PADDLE.NET* SETAPP NEW YORK NYDate 10/14/24 0 4288882561 0 5817Card 1231,9.495000000000001
6/11/2024,,Withdrawal POS #000009220158/WALGREENS 2415 SW 75TH 2415 SW 75TH STGAINESVILLE FLCard 1231,4.3,,Posted,475.88,2024-06-11,4.3,Withdrawal POS #000013340229/WALGREENS 2415 SW 75TH 2415 SW 75TH STGAINESVILLE FLCard 1231,4.3
6/11/2024,,Withdrawal POS #000009214940/WALGREENS 2415 SW 75TH 2415 SW 75TH STGAINESVILLE FLCard 1231,29.58,,Posted,480.18,2024-06-11,29.58,Withdrawal POS #000013340229/WALGREENS 2415 SW 75TH 2415 SW 75TH STGAINESVILLE FLCard 1231,29.58
6/9/2024,,Withdrawal POS #000000794668/INSTACART*159 WWW.INSTACART.COM/ SANFRANCISCO CACard 1231,3.0,,Posted,486.5,2024-06-09,3.0,Withdrawal POS #000000804821/INSTACART*159 WWW.INSTACART.COM/ SANFRANCISCO CACard 1231,3.0
6/9/2024,,Withdrawal POS #000000000005/INSTACART*159 WWW.INSTACART.COM/ SANFRANCISCO CACard 1231,90.66,,Posted,489.5,2024-06-09,90.66,Withdrawal POS #000000000003/INSTACART*159 WWW.INSTACART.COM/ SANFRANCISCO CACard 1231,90.66
6/9/2024,,Withdrawal Debit Card MC Debit Seminol/WALGREENS #5024 GAINESVILLE FLDate 06/07/24 0 4159311957 2 5912Card 1231,10.81,,Posted,580.16,2024-06-09,10.81,Withdrawal Debit Card MC Debit Seminol/WALGREENS #5024 GAINESVILLE FLDate 04/14/24 0 4105827629 0 5912Card 1231,10.81
6/9/2024,,Recurring Withdrawal Debit Card - MC Debit Seminol/APPLE.COM/BILL 866-712-7753 CADate 06/07/24 0 4159617075 1 5818Card 1231,2.99,,Posted,590.97,2024-06-09,2.99,Recurring Withdrawal Debit Card - MC Debit Seminol/APPLE.COM/BILL 866-712-7753 CADate 04/13/24 0 4104933092 1 5818Card 1231,2.99
6/9/2024,,Withdrawal POS #000000596566/SUNOCO 8002212501 4234 SW 20TH AVEGAINESVILLE FLCard 1231,34.24,,Posted,593.96,2024-06-09,34.24,Withdrawal POS #000000555763/SUNOCO 8002212501 4234 SW 20TH AVEGAINESVILLE FLCard 1231,34.24
6/7/2024,,Withdrawal Debit Card MC Debit Seminol/COX GAINESVILLE COMM 800-234-3993 FLDate 06/06/24 0 4158037132 1 4899Card 1231,142.13,,Posted,628.2,2024-06-07,142.13,Withdrawal Debit Card MC Debit Seminol/COX GAINESVILLE COMM 800-234-3993 FLDate 12/04/24 0 4339376311 0 4899Card 1231,142.465
6/6/2024,,Withdrawal POS #000000792685/INSTACART*159 WWW.INSTACART.COM/ SANFRANCISCO CACard 1231,3.0,,Posted,770.33,2024-06-06,3.0,Withdrawal POS #000000792733/INSTACART*159 WWW.INSTACART.COM/ SANFRANCISCO CACard 1231,3.0
6/6/2024,,Withdrawal POS #000000793127/INSTACART*159 WWW.INSTACART.COM/ SANFRANCISCO CACard 1231,81.0,,Posted,773.33,2024-06-06,81.0,Withdrawal POS #000000792733/INSTACART*159 WWW.INSTACART.COM/ SANFRANCISCO CACard 1231,81.0
6/6/2024,,Withdrawal Bill Payment #000000144331/GRU EZ PAY 301 SE 4TH AVE 301 SE 4TH AVCard 1231,161.55,,Posted,854.33,2024-06-06,161.55,Withdrawal Bill Payment #000000483994/GRU EZ PAY 301 SE 4TH AVE 301 SE 4TH AVCard 1247,161.55
6/6/2024,,Withdrawal Debit Card MC Debit Seminol/SAMSUNG ELECTRONICS RIDGEFIELD P NJDate 06/06/24 0 4158976711 0 5734Card 1231,16.99,,Posted,1015.88,2024-06-06,16.99,Withdrawal Debit Card MC Debit Seminol/SAMSUNG ELECTRONICS RIDGEFIELD P NJDate 12/27/24 0 4362999827 1 5734Card 1231,16.49
6/6/2024,,Withdrawal POS #000000431904/SUNOCO 8002212501 4234 SW 20TH AVEGAINESVILLE FLCard 1231,28.64,,Posted,1032.87,2024-06-06,28.64,Withdrawal POS #000000031004/SUNOCO 8002212501 4234 SW 20TH AVEGAINESVILLE FLCard 1231,28.64
6/6/2024,,Recurring Withdrawal Bill Payment - #000000178852/NETFLIX COM LOS GATOS CACard 1231,13.81,,Posted,1061.51,2024-06-06,13.81,Recurring Withdrawal Bill Payment - #000006911729/NETFLIX COM LOS GATOS CACard 2801,13.504999999999999
6/5/2024,,Recurring Withdrawal Debit Card - MC Debit Seminol/OPENAI *CHATGPT SUBSCR SAN FRANCISC CADate 06/04/24 0 4156605279 0 5734Card 1231,20.0,,Posted,1075.32,2024-06-05,20.0,Recurring Withdrawal Debit Card - MC Debit Seminol/CHATGPT SUBSCRIPTION SAN FRANCISC CADate 05/04/24 0 4125659188 0 5734Card 1231,20.0
6/5/2024,,Withdrawal Debit Card MC Debit Seminol/1473 - QUINN EYE CENTE GAINESVILLE FLDate 06/04/24 0 4156985542 0 8042Card 1231,54.0,,Posted,1095.32,2024-06-05,54.0,Withdrawal Debit Card MC Debit Seminol/1473 - QUINN EYE CENTE GAINESVILLE FLDate 06/04/24 0 4156985542 0 8042Card 1231,54.0
6/5/2024,,Withdrawal Bill Payment #000009216703/PAYPAL *PARAMNTPLUS 2211 North FirstStreet 8882211161 CACard 1231,13.81,,Posted,1149.32,2024-06-05,13.81,Withdrawal Bill Payment #000009216703/PAYPAL *PARAMNTPLUS 2211 North FirstStreet 8882211161 CACard 1231,13.81
6/4/2024,,Withdrawal POS #000000775534/INSTACART*159 WWW.INSTACART.COM/ SANFRANCISCO CACard 1231,111.29,,Posted,1163.13,2024-06-04,111.29,Withdrawal POS #000000792733/INSTACART*159 WWW.INSTACART.COM/ SANFRANCISCO CACard 1231,111.29
6/4/2024,,Withdrawal POS #000000367990/SUNOCO 8002212501 4234 SW 20TH AVEGAINESVILLE FLCard 1231,25.96,,Posted,1274.42,2024-06-04,25.96,Withdrawal POS #000000161599/SUNOCO 8002212501 4234 SW 20TH AVEGAINESVILLE FLCard 1231,25.96
6/4/2024,,Withdrawal Debit Card MC Debit Seminol/CIRCLE K # 06782 GAINESVILLE FLDate 06/02/24 0 4154170879 1 5499Card 1231,28.74,,Posted,1300.38,2024-06-04,28.74,Withdrawal Debit Card MC Debit Seminol/CIRCLE K # 06782 GAINESVILLE FLDate 09/08/24 0 4252889868 0 5499Card 1231,28.96
6/4/2024,,Withdrawal ACH FLUENT-Gainesvil/TYPE: PAYMENT ID: 1371804719CO: FLUENT-GainesvilNAME: steven chaplinskiEntry Class Code: WEB,82.6,,Posted,1329.12,2024-06-04,82.6,Withdrawal ACH FLUENT-Gainesvil/TYPE: PAYMENT ID: 1371804719CO: FLUENT-GainesvilNAME: steven chaplinski,82.6
6/3/2024,,Recurring Withdrawal Debit Card - MC Debit Seminol/DOCSIUM.COM SANTA CLARA CADate 06/02/24 0 4154586018 1 5734Card 1231,10.0,,Posted,1385.68,2024-06-03,10.0,Recurring Withdrawal Debit Card - MC Debit Seminol/DOCSIUM.COM SANTA CLARA CADate 07/02/24 0 4184077595 1 5734Card 1231,10.0
6/3/2024,,Recurring Withdrawal Debit Card - MC Debit Seminol/INVIDEO INC COUNTRY OF S DEDate 06/02/24 0 4154049359 0 5734Card 1231,50.0,,Posted,1395.68,2024-06-03,50.0,Recurring Withdrawal Debit Card - MC Debit Seminol/INVIDEO INC COUNTRY OF S DEDate 12/09/24 0 4344808122 0 5734Card 1231,50.0
6/3/2024,,Withdrawal Debit Card MC Debit Seminol/WAWA CARD RELOAD MEDIA PADate 06/02/24 0 4154531671 1 6540Card 1231,25.0,,Posted,1445.68,2024-06-03,25.0,Withdrawal Debit Card MC Debit Seminol/WAWA CARD RELOAD MEDIA PADate 11/03/24 0 4308001823 1 6540Card 1231,25.0
6/3/2024,,Recurring Withdrawal Debit Card - MC Debit Seminol/APPLE.COM/BILL 866-712-7753 CADate 06/03/24 0 4155527708 1 5818Card 1231,2.99,,Posted,1470.68,2024-06-03,2.99,Recurring Withdrawal Debit Card - MC Debit Seminol/APPLE.COM/BILL 866-712-7753 CADate 04/13/24 0 4104933092 1 5818Card 1231,2.99
6/3/2024,,"Withdrawal Bill Payment #000000786071/Adobe Park Avenue,345 San Jose CACard 1231",19.99,,Posted,1473.67,2024-06-03,19.99,"Withdrawal Bill Payment #000000352498/Adobe Park Avenue,345 San Jose CACard 1247",19.99
6/3/2024,,Withdrawal ACH Watson Realty Co/TYPE: WEB PMTS ID: 9000321157CO: Watson Realty CoNAME: Steven chaplinskiEntry Class Code: WEB,1079.0,,Posted,1493.66,2024-06-03,1079.0,Withdrawal ACH Watson Realty Co/TYPE: WEB PMTS ID: 9000321157CO: Watson Realty CoEntry Class Code: WEB,1079.0
6/3/2024,,"Withdrawal ACH AppFolio, Inc. F/TYPE: WEB PMTS ID: 9001406550CO: AppFolio, Inc. FNAME: Steven chaplinskiEntry Class Code: WEB",2.49,,Posted,2572.66,2024-06-03,2.49,"Withdrawal ACH AppFolio, Inc. F/TYPE: WEB PMTS ID: 9001406550

CO: AppFolio, Inc. F

NAME: Steven chaplinskiEntry Class Code: WEB",2.49
6/2/2024,,Withdrawal POS #000000278995/SUNOCO 8002212501 4234 SW 20TH AVEGAINESVILLE FLCard 1231,22.42,,Posted,2575.15,2024-06-02,22.42,Withdrawal POS #000000778591/SUNOCO 8002212501 4234 SW 20TH AVEGAINESVILLE FLCard 1231,22.42
6/2/2024,,Withdrawal Bill Payment #000011385521/PAYPAL *SPOTIFYUSAI 2211 North FirstStreet 8882211161 CACard 1231,6.82,,Posted,2597.57,2024-06-02,6.82,Withdrawal Bill Payment #000009216703/PAYPAL *PARAMNTPLUS 2211 North FirstStreet 8882211161 CACard 1231,6.82
6/1/2024,,Withdrawal POS #000000774843/ETSY.COM*US WWW.ETSY.COM/ BROOKLYN NYCard 1231,28.29,,Posted,2604.39,2024-06-01,28.29,"Withdrawal POS #000000804240/ETSY, INC. WWW.ETSY.COM/ BROOKLYN NYCard 1231",28.29
5/31/2024,,Withdrawal POS #000000786599/INSTACART*159 WWW.INSTACART.COM/ SANFRANCISCO CACard 1231,5.0,,Posted,2632.68,2024-05-31,5.0,Withdrawal POS #000000359086/INSTACART*159 WWW.INSTACART.COM/ SANFRANCISCO CACard 1231,5.0
5/31/2024,,Withdrawal POS #000000000006/INSTACART*159 WWW.INSTACART.COM/ SANFRANCISCO CACard 1231,75.0,,Posted,2637.68,2024-05-31,75.0,Withdrawal POS #000000000003/INSTACART*159 WWW.INSTACART.COM/ SANFRANCISCO CACard 1231,75.0
5/30/2024,,Withdrawal Debit Card MC Debit Seminol/WALGREENS #5024 GAINESVILLE FLDate 05/29/24 0 4150067031 1 5912Card 1231,22.65,,Posted,2712.68,2024-05-30,22.65,Withdrawal Debit Card MC Debit Seminol/WALGREENS #5024 GAINESVILLE FLDate 06/26/23 0 3177001861 1 5912Card 2801,22.65
5/29/2024,,Withdrawal POS #000000803191/INSTACART*159 WWW.INSTACART.COM/ SANFRANCISCO CACard 1231,5.0,,Posted,2735.33,2024-05-29,5.0,Withdrawal POS #000000804821/INSTACART*159 WWW.INSTACART.COM/ SANFRANCISCO CACard 1231,5.0
5/29/2024,,Withdrawal POS #000000795511/INSTACART*159 WWW.INSTACART.COM/ SANFRANCISCO CACard 1231,60.0,,Posted,2740.33,2024-05-29,60.0,Withdrawal POS #000000772291/INSTACART*159 WWW.INSTACART.COM/ SANFRANCISCO CACard 1231,60.0
5/29/2024,,Withdrawal POS #000000131389/SUNOCO 8002212501 4234 SW 20TH AVEGAINESVILLE FLCard 1231,37.78,,Posted,2800.33,2024-05-29,37.78,Withdrawal POS #000000161599/SUNOCO 8002212501 4234 SW 20TH AVEGAINESVILLE FLCard 1231,37.295
5/28/2024,,Withdrawal POS #000000102672/SUNOCO 8002212501 4234 SW 20TH AVEGAINESVILLE FLCard 1231,10.61,,Posted,38.11,2024-05-28,10.61,Withdrawal POS #000000028242/SUNOCO 8002212501 4234 SW 20TH AVEGAINESVILLE FLCard 1231,10.61
5/28/2024,,Recurring Withdrawal Debit Card - MC Debit Seminol/APPLE.COM/BILL 866-712-7753 CADate 05/27/24 0 4148755967 0 5818Card 1231,9.99,,Posted,48.72,2024-05-28,9.99,Recurring Withdrawal Debit Card - MC Debit Seminol/APPLE.COM/BILL 866-712-7753 CADate 01/08/24 0 4008756344 0 5818Card 2801,10.49
5/27/2024,,Recurring Withdrawal Debit Card - MC Debit Seminol/BLAZE TODAY SUNNYVALE CADate 05/26/24 0 4147283808 0 5734Card 1231,8.39,,Posted,58.71,2024-05-27,8.39,Recurring Withdrawal Debit Card - MC Debit Seminol/BLAZE TODAY SUNNYVALE CADate 05/26/24 0 4147283808 0 5734Card 1231,8.39
5/27/2024,,Withdrawal POS #000000000000/IC* INSTACART*159 WWW.INSTACART.COM/ SANFRANCISCO CACard 1231,3.0,,Posted,67.1,2024-05-27,3.0,Withdrawal POS #000000803033/IC* INSTACART*159 WWW.INSTACART.COM/ SANFRANCISCO CACard 1231,3.0
5/27/2024,,Withdrawal POS #000000794186/IC* INSTACART*159 WWW.INSTACART.COM/ SANFRANCISCO CACard 1231,37.72,,Posted,70.1,2024-05-27,37.72,Withdrawal POS #000000795671/IC* INSTACART*159 WWW.INSTACART.COM/ SANFRANCISCO CACard 2801,37.72
5/27/2024,,Withdrawal Bill Payment #000007088724/PAYPAL *IONOS INC 2211 North First8882211161 CACard 1231,17.0,,Posted,107.82,2024-05-27,17.0,Withdrawal Bill Payment #000007088724/PAYPAL *IONOS INC 2211 North First8882211161 CACard 1231,17.0
5/26/2024,,"Recurring Withdrawal Debit Card - MC Debit Seminol/NOTION LABS, INC. SAN FRANCISC CADate 05/24/24 0 4145017161 2 7372Card 1231",28.0,,Posted,124.82,2024-05-26,28.0,"Recurring Withdrawal Debit Card - MC Debit Seminol/NOTION LABS, INC. SAN FRANCISC CADate 12/02/24 0 4337878572 0 7372Card 1231",27.52
5/26/2024,,Recurring Withdrawal Debit Card - MC Debit Seminol/FS *ADOBE SANTA BARBAR CADate 05/24/24 0 4145014325 2 5734Card 1231,0.95,,Posted,152.82,2024-05-26,0.95,Recurring Withdrawal Debit Card - MC Debit Seminol/FS *ADOBE SANTA BARBAR CADate 12/24/24 0 4359034647 1 5734Card 1231,0.95
5/26/2024,,Withdrawal POS #000000000001/INSTACART*159 WWW.INSTACART.COM/ SANFRANCISCO CACard 1231,3.0,,Posted,153.77,2024-05-26,3.0,Withdrawal POS #000000804821/INSTACART*159 WWW.INSTACART.COM/ SANFRANCISCO CACard 1231,3.0
5/26/2024,,Withdrawal POS #000000782598/INSTACART*159 WWW.INSTACART.COM/ SANFRANCISCO CACard 1231,60.0,,Posted,156.77,2024-05-26,60.0,Withdrawal POS #000000804821/INSTACART*159 WWW.INSTACART.COM/ SANFRANCISCO CACard 1231,60.0
5/25/2024,,Withdrawal Bill Payment #000006272109/PAYPAL *IONOS INC 2211 North First8882211161 CACard 1231,7.0,,Posted,16.77,2024-05-25,7.0,Withdrawal Bill Payment #000007088724/PAYPAL *IONOS INC 2211 North First8882211161 CACard 1231,7.0
5/24/2024,,Recurring Withdrawal Debit Card - MC Debit Seminol/AIRTABLE.COM/BILL SAN FRANCISC CADate 05/24/24 0 4145150548 1 7372Card 1231,32.8,,Posted,23.77,2024-05-24,32.8,Recurring Withdrawal Debit Card - MC Debit Seminol/AIRTABLE.COM/BILL SAN FRANCISC CADate 09/11/24 0 4255913774 0 7372Card 1231,32.8
5/24/2024,,Recurring Withdrawal Debit Card - MC Debit Seminol/VIDIQ SAN FRANCISC CADate 05/23/24 0 4144928316 0 5734Card 1231,10.0,,Posted,56.57,2024-05-24,10.0,Recurring Withdrawal Debit Card - MC Debit Seminol/VIDIQ SAN FRANCISC CADate 12/23/23 0 3357950683 0 5734Card 2801,10.0
5/21/2024,,Withdrawal POS #000000797901/SUNOCO 8002212501 4234 SW 20TH AVEGAINESVILLE FLCard 1231,25.96,,Posted,66.57,2024-05-21,25.96,Withdrawal POS #000000778591/SUNOCO 8002212501 4234 SW 20TH AVEGAINESVILLE FLCard 1231,25.96
5/21/2024,,Withdrawal Bill Payment #000007101908/PAYPAL *IONOS INC 2211 North First8882211161 CACard 1231,7.0,,Posted,92.53,2024-05-21,7.0,Withdrawal Bill Payment #000007088724/PAYPAL *IONOS INC 2211 North First8882211161 CACard 1231,7.0
5/21/2024,,Recurring Withdrawal Debit Card - MC Debit Seminol/CANVA* I04157-41978019 CAMDEN DEDate 05/20/24 0 4141808212 0 7221Card 1231,12.99,,Posted,99.53,2024-05-21,12.99,Recurring Withdrawal Debit Card - MC Debit Seminol/CANVA* I04005-37462786 CAMDEN DEDate 12/20/23 0 3354886372 0 7221Card 2801,12.99
5/21/2024,,Recurring Withdrawal Debit Card - MC Debit Seminol/TUBEBUDDYCOM 8668823239 CADate 05/20/24 0 4141845145 0 5734Card 1231,7.5,,Posted,112.52,2024-05-21,7.5,Recurring Withdrawal Debit Card - MC Debit Seminol/TUBEBUDDYCOM* 8668823239 CADate 12/03/24 0 4338443995 0 5045Card 1231,7.5
5/20/2024,,Recurring Withdrawal Debit Card Fee/MASTERCARD ISSUER CROSS-BORDER FEEDate 05/19/24 0 4140937257 0 5734Card 1231,0.07,,Posted,120.02,2024-05-20,0.07,Recurring Withdrawal Debit Card Fee/MASTERCARD ISSUER CROSS-BORDER FEEDate 02/25/24 0 4056812425 0 4816Card 1231,0.13
5/20/2024,,Recurring Withdrawal Debit Card - MC Debit Seminol/PAYPAL *PADDLE.NET 35314369001 GBDate 05/19/24 0 4140937257 0 5734Card 1231,9.0,,Posted,120.09,2024-05-20,9.0,Recurring Withdrawal Debit Card - MC Debit Seminol/PAYPAL *PADDLE.NET 35314369001 GBDate 05/19/24 0 4140937257 0 5734Card 1231,9.0
5/20/2024,,Withdrawal POS #000003232252/GOOGLE *YouTubePremium 1600 AmphitheatreParkw Mountain View CACard 1231,15.92,,Posted,129.09,2024-05-20,15.92,"Withdrawal POS #000020312090/GOOGLE *YouTubePremium 1600 Amphitheatre

Parkw Mountain View CA

Card 1247",15.92
5/19/2024,,Withdrawal POS #000000680126/WAWA 5325 2373 SW ARCHER ROADFLCard 1231,18.03,,Posted,145.01,2024-05-19,18.03,Withdrawal POS #000000553411/WAWA 5325 2373 SW ARCHER ROADFLCard 1247,18.03
5/19/2024,,Recurring Withdrawal Debit Card - MC Debit Seminol/SUPERPOWER CHATGPT MIDDLETOWN DEDate 05/17/24 0 4138018304 2 5734Card 1231,15.0,,Posted,163.04,2024-05-19,15.0,Recurring Withdrawal Debit Card - MC Debit Seminol/SUPERPOWER CHATGPT MIDDLETOWN DEDate 12/17/24 0 4352703539 1 5734Card 1231,15.094999999999999
5/19/2024,,Recurring Withdrawal Debit Card Fee/MASTERCARD ISSUER CROSS-BORDER FEEDate 05/18/24 0 4139958413 0 5734Card 1231,0.05,,Posted,178.04,2024-05-19,0.05,Recurring Withdrawal Debit Card Fee/MASTERCARD ISSUER CROSS-BORDER FEEDate 02/25/24 0 4056812425 0 4816Card 1231,0.13
5/19/2024,,Recurring Withdrawal Debit Card - MC Debit Seminol/SAVE TO NOTION VAUREAL ILDate 05/18/24 0 4139958413 0 5734Card 1231,5.99,,Posted,178.09,2024-05-19,5.99,Recurring Withdrawal Debit Card - MC Debit Seminol/SAVE TO NOTION VAUREAL ILDate 12/18/24 0 4353969048 0 5734Card 1231,5.99
5/19/2024,,Recurring Withdrawal Debit Card - MC Debit Seminol/WORDPRESS ZMTWVYVHAL SAN FRANCISC CADate 05/18/24 0 4139958144 0 7372Card 1231,9.0,,Posted,184.08,2024-05-19,9.0,Recurring Withdrawal Debit Card - MC Debit Seminol/WORDPRESS YLZK812XJ6 SAN FRANCISC CADate 07/18/24 0 4200709907 0 5734Card 1231,9.0
5/19/2024,,Withdrawal Debit Card Fee/MASTERCARD ISSUER CROSS-BORDER FEEDate 05/16/24 0 4137015306 2 4816Card 1231,0.12,,Posted,193.08,2024-05-19,0.12,Withdrawal Debit Card Fee/MASTERCARD ISSUER CROSS-BORDER FEEDate 10/06/23 0 3279122045 2 5815Card 2801,0.20833333333333334
5/19/2024,,Withdrawal Debit Card MC Debit Seminol/PAYPAL *2CO.COM 35314369001 NLDate 05/16/24 0 4137015306 2 4816Card 1231,14.99,,Posted,193.2,2024-05-19,14.99,Withdrawal Debit Card MC Debit Seminol/PAYPAL *2CO.COM 35314369001 NLDate 05/16/24 0 4137015306 2 4816Card 1231,14.99
5/19/2024,,Withdrawal POS #000000795687/IC* INSTACART*159 WWW.INSTACART.COM/ SANFRANCISCO CACard 1231,3.0,,Posted,208.19,2024-05-19,3.0,Withdrawal POS #000000795671/IC* INSTACART*159 WWW.INSTACART.COM/ SANFRANCISCO CACard 2801,3.0
5/19/2024,,Withdrawal POS #000000784752/IC* INSTACART*159 WWW.INSTACART.COM/ SANFRANCISCO CACard 1231,46.0,,Posted,211.19,2024-05-19,46.0,Withdrawal POS #000000795671/IC* INSTACART*159 WWW.INSTACART.COM/ SANFRANCISCO CACard 2801,46.0
5/17/2024,,Recurring Withdrawal Debit Card - MC Debit Seminol/LINKTREE* LINKTREE DOVER DEDate 05/16/24 0 4137933466 0 7399Card 1231,9.0,,Posted,257.19,2024-05-17,9.0,Recurring Withdrawal Debit Card - MC Debit Seminol/LINKTREE* LINKTREE DOVER DEDate 04/16/24 0 4107289275 0 7399Card 1231,9.0
5/17/2024,,Recurring Withdrawal Debit Card - MC Debit Seminol/MYDESIGNS - PRO - MON LAS VEGAS NVDate 05/16/24 0 4137953308 0 5734Card 1231,29.99,,Posted,266.19,2024-05-17,29.99,Recurring Withdrawal Debit Card - MC Debit Seminol/MYDESIGNS - PRO - MON LAS VEGAS NVDate 12/08/24 0 4343357881 0 5734Card 1231,29.99
5/17/2024,,Recurring Withdrawal Debit Card - MC Debit Seminol/PADDLE.NET* LEONARDOAI ASTORIA NYDate 05/16/24 0 4137285984 0 5817Card 1231,9.0,,Posted,296.18,2024-05-17,9.0,Withdrawal Debit Card MC Debit Seminol/PADDLE.NET* LEONARDOAI ASTORIA NYDate 10/26/23 0 3299263117 0 5817Card 2801,9.0
5/17/2024,,Recurring Withdrawal Debit Card - MC Debit Seminol/PADDLE.NET* SETAPP ASTORIA NYDate 05/16/24 0 4137932128 0 5817Card 1231,12.49,,Posted,305.18,2024-05-17,12.49,Recurring Withdrawal Debit Card - MC Debit Seminol/PADDLE.NET* SETAPP NEW YORK NYDate 10/14/24 0 4288882561 0 5817Card 1231,12.49
5/17/2024,,Recurring Withdrawal Debit Card - MC Debit Seminol/WWW.EVERBEE.IO AUSTIN TXDate 05/16/24 0 4137932088 0 5734Card 1231,29.99,,Posted,317.67,2024-05-17,29.99,Recurring Withdrawal Debit Card - MC Debit Seminol/WWW.EVERBEE.IO AUSTIN TXDate 12/04/24 0 4339869891 0 5734Card 1231,29.99
5/17/2024,,Recurring Withdrawal Debit Card Fee/MASTERCARD ISSUER CROSS-BORDER FEEDate 05/17/24 0 4138070362 1 5734Card 1231,0.06,,Posted,347.66,2024-05-17,0.06,Recurring Withdrawal Debit Card Fee/MASTERCARD ISSUER CROSS-BORDER FEEDate 05/12/21 0 1132191600 1 7372Card 2801,0.09500000000000001
5/17/2024,,Recurring Withdrawal Debit Card - MC Debit Seminol/IDEOGRAM.AI TORONTO ONDate 05/17/24 0 4138070362 1 5734Card 1231,8.0,,Posted,347.72,2024-05-17,8.0,Withdrawal Debit Card MC Debit Seminol/IDEOGRAM.AI TORONTO ONDate 04/15/24 0 4106835174 0 5734Card 1231,8.190000000000001
5/17/2024,,Withdrawal POS #000000585746/SUNOCO 8002212501 4234 SW 20TH AVEGAINESVILLE FLCard 1231,37.78,,Posted,355.72,2024-05-17,37.78,Withdrawal POS #000000555763/SUNOCO 8002212501 4234 SW 20TH AVEGAINESVILLE FLCard 1231,38.21
5/16/2024,,Withdrawal Debit Card Fee/MASTERCARD ISSUER CROSS-BORDER FEEDate 05/13/24 0 4134864561 0 5734Card 1231,0.62,,Posted,393.5,2024-05-16,0.62,Withdrawal Debit Card Fee/MASTERCARD ISSUER CROSS-BORDER FEEDate 12/25/22 0 2359739765 0 5734Card 2801,0.16428571428571428
5/16/2024,,Withdrawal Debit Card MC Debit Seminol/PAYPAL *PADDLE.NET 07790810231 GBDate 05/13/24 0 4134864561 0 5734Card 1231,77.07,,Posted,394.12,2024-05-16,77.07,Withdrawal Debit Card MC Debit Seminol/PAYPAL *PADDLE.NET 07790810231 GBDate 05/13/24 0 4134864561 0 5734Card 1231,77.07
5/15/2024,,Withdrawal POS #000000534382/SUNOCO 8002212501 4234 SW 20TH AVEGAINESVILLE FLCard 1231,37.78,,Posted,386.19,2024-05-15,37.78,Withdrawal POS #000000175132/SUNOCO 8002212501 4234 SW 20TH AVEGAINESVILLE FLCard 1231,37.78
5/15/2024,,Recurring Withdrawal Debit Card - MC Debit Seminol/MIDJOURNEY INC. SOUTH SAN FR CADate 05/14/24 0 4135994595 0 5734Card 1231,10.0,,Posted,423.97,2024-05-15,10.0,Recurring Withdrawal Debit Card - MC Debit Seminol/MIDJOURNEY INC. SOUTH SAN FR CADate 05/14/24 0 4135994595 0 5734Card 1231,10.0
5/15/2024,,Recurring Withdrawal Debit Card Fee/MASTERCARD ISSUER CROSS-BORDER FEEDate 05/15/24 0 4136993433 0 5734Card 1231,0.13,,Posted,433.97,2024-05-15,0.13,Withdrawal Debit Card Fee/MASTERCARD ISSUER CROSS-BORDER FEEDate 05/13/24 0 4134864561 0 5734Card 1231,0.1366666666666667
5/15/2024,,Recurring Withdrawal Debit Card - MC Debit Seminol/VANCEAI CENTRAL HODate 05/15/24 0 4136993433 0 5734Card 1231,15.9,,Posted,434.1,2024-05-15,15.9,Recurring Withdrawal Debit Card - MC Debit Seminol/VANCEAI CENTRAL HODate 06/15/24 0 4167922806 1 5734Card 1231,15.9
5/15/2024,,Withdrawal Debit Card MC Debit Seminol/CHIPOTLE ONLINE CHIPOTLE.COM CADate 05/14/24 0 4135921741 0 5814Card 1231,41.0,,Posted,450.0,2024-05-15,41.0,Withdrawal Debit Card MC Debit Seminol/CHIPOTLE ONLINE CHIPOTLE.COM CADate 05/14/24 0 4135921741 0 5814Card 1231,41.0
5/15/2024,,Withdrawal POS #000004117844/PAYPAL *PLAYSTATION 2211 North FirstStreet 8882211161 CACard 1231,9.99,,Posted,491.0,2024-05-15,9.99,Withdrawal POS #000004117844/PAYPAL *PLAYSTATION 2211 North FirstStreet 8882211161 CACard 1231,9.99
5/14/2024,,Recurring Withdrawal Debit Card - MC Debit Seminol/OPENAI SAN FRANCISC CADate 05/14/24 0 4135914307 0 5734Card 1231,15.02,,Posted,500.99,2024-05-14,15.02,Withdrawal Debit Card MC Debit Seminol/OPENAI SAN FRANCISC CADate 02/16/24 0 4047896474 1 5734Card 1231,15.0325
5/14/2024,,Recurring Withdrawal Debit Card - MC Debit Seminol/SUPERPOWER CHATGPT MIDDLETOWN DEDate 05/13/24 0 4134368690 0 5734Card 1231,15.0,,Posted,516.01,2024-05-14,15.0,Recurring Withdrawal Debit Card - MC Debit Seminol/SUPERPOWER CHATGPT MIDDLETOWN DEDate 12/17/24 0 4352703539 1 5734Card 1231,15.094999999999999
5/14/2024,,Recurring Withdrawal Debit Card Fee/MASTERCARD ISSUER CROSS-BORDER FEEDate 05/14/24 0 4135869366 0 5734Card 1231,0.03,,Posted,531.01,2024-05-14,0.03,Withdrawal Debit Card Fee/MASTERCARD ISSUER CROSS-BORDER FEEDate 05/13/24 0 4134864561 0 5734Card 1231,0.1366666666666667
5/14/2024,,Recurring Withdrawal Debit Card - MC Debit Seminol/ETSYHUNT TECH SINGAPORE SGDate 05/14/24 0 4135869366 0 5734Card 1231,3.99,,Posted,531.04,2024-05-14,3.99,Recurring Withdrawal Debit Card - MC Debit Seminol/ETSYHUNT TECH SINGAPORE SGDate 06/14/24 0 4166958438 0 5734Card 1231,3.99
5/14/2024,,Withdrawal Debit Card MC Debit Seminol/WALGREENS #5024 GAINESVILLE FLDate 05/13/24 0 4134909562 0 5912Card 1231,15.0,,Posted,535.03,2024-05-14,15.0,Withdrawal Debit Card MC Debit Seminol/WALGREENS #5024 GAINESVILLE FLDate 04/14/24 0 4105827629 0 5912Card 1231,15.0
5/13/2024,,Withdrawal POS #000014536880/WALGREENS 2415 SW 75TH 2415 SW 75TH STGAINESVILLE FLCard 1231,27.24,,Posted,550.03,2024-05-13,27.24,Withdrawal POS #000013340229/WALGREENS 2415 SW 75TH 2415 SW 75TH STGAINESVILLE FLCard 1231,27.24
5/13/2024,,Withdrawal POS #000000293405/WAL-MART #1081 Wal-Mart Super CenterGAINESVILLE FLCard 1231,74.97,,Posted,577.27,2024-05-13,74.97,Withdrawal POS #000000293405/WAL-MART #1081 Wal-Mart Super CenterGAINESVILLE FLCard 1231,74.97
5/13/2024,,Withdrawal POS #000000450318/SUNOCO 8002212501 4234 SW 20TH AVEGAINESVILLE FLCard 1231,37.78,,Posted,652.24,2024-05-13,37.78,Withdrawal POS #000000031004/SUNOCO 8002212501 4234 SW 20TH AVEGAINESVILLE FLCard 1231,37.78
5/13/2024,,Recurring Withdrawal Debit Card - MC Debit Seminol/APPLE.COM/BILL 866-712-7753 CADate 05/13/24 0 4134846731 0 5818Card 1231,23.98,,Posted,690.02,2024-05-13,23.98,Recurring Withdrawal Debit Card - MC Debit Seminol/APPLE.COM/BILL 866-712-7753 CADate 12/13/23 0 3347838871 0 5818Card 2801,23.98
5/12/2024,,Withdrawal Debit Card MC Debit Seminol/CHIPOTLE ONLINE CHIPOTLE.COM CADate 05/11/24 0 4132095312 1 5814Card 1231,17.14,,Posted,714.0,2024-05-12,17.14,Withdrawal Debit Card MC Debit Seminol/CHIPOTLE ONLINE CHIPOTLE.COM CADate 05/14/24 0 4135921741 0 5814Card 1231,17.66
5/12/2024,,Recurring Withdrawal Debit Card - MC Debit Seminol/APPLE.COM/BILL 866-712-7753 CADate 05/10/24 0 4131679078 1 5818Card 1231,7.99,,Posted,731.14,2024-05-12,7.99,Recurring Withdrawal Debit Card - MC Debit Seminol/APPLE.COM/BILL 866-712-7753 CADate 04/13/24 0 4104933092 1 5818Card 1231,7.99
5/12/2024,,Recurring Withdrawal Debit Card - MC Debit Seminol/APPLE.COM/BILL 866-712-7753 CADate 05/10/24 0 4131679029 1 5818Card 1231,18.97,,Posted,739.13,2024-05-12,18.97,Recurring Withdrawal Debit Card - MC Debit Seminol/APPLE.COM/BILL 866-712-7753 CADate 09/16/23 0 3259205559 2 5818Card 2801,18.975
5/10/2024,,Withdrawal POS #000000000004/INSTACART*159 WWW.INSTACART.COM/ SANFRANCISCO CACard 1231,5.0,,Posted,758.1,2024-05-10,5.0,Withdrawal POS #000000804821/INSTACART*159 WWW.INSTACART.COM/ SANFRANCISCO CACard 1231,5.0
5/10/2024,,Withdrawal POS #000000805593/INSTACART*159 WWW.INSTACART.COM/ SANFRANCISCO CACard 1231,92.46,,Posted,763.1,2024-05-10,92.46,Withdrawal POS #000000000003/INSTACART*159 WWW.INSTACART.COM/ SANFRANCISCO CACard 1231,92.46
5/10/2024,,Withdrawal ACH FLUENT-Gainesvil/TYPE: PAYMENT ID: 1371804719CO: FLUENT-GainesvilNAME: steven chaplinskiEntry Class Code: WEB,68.0,,Posted,855.56,2024-05-10,68.0,Withdrawal ACH FLUENT-Gainesvil/TYPE: PAYMENT ID: 1371804719CO: FLUENT-GainesvilNAME: steven chaplinski,68.0
5/9/2024,,Withdrawal Debit Card MC Debit Seminol/WALGREENS #5024 GAINESVILLE FLDate 05/08/24 0 4129217598 1 5912Card 1231,10.81,,Posted,923.56,2024-05-09,10.81,Withdrawal Debit Card MC Debit Seminol/WALGREENS #5024 GAINESVILLE FLDate 04/14/24 0 4105827629 0 5912Card 1231,10.81
5/8/2024,,Withdrawal POS #000000246839/SUNOCO 8002212501 4234 SW 20TH AVEGAINESVILLE FLCard 1231,34.24,,Posted,934.37,2024-05-08,34.24,Withdrawal POS #000000488663/SUNOCO 8002212501 4234 SW 20TH AVEGAINESVILLE FLCard 1231,34.24
5/8/2024,,Withdrawal POS #000011384494/PAYPAL *PLAYSTATION 2211 North FirstStreet 8882211161 CACard 1231,14.99,,Posted,968.61,2024-05-08,14.99,Withdrawal POS #000004117844/PAYPAL *PLAYSTATION 2211 North FirstStreet 8882211161 CACard 1231,14.99
5/7/2024,,Withdrawal POS #000000786829/INSTACART*159 WWW.INSTACART.COM/ SANFRANCISCO CACard 1231,5.0,,Posted,983.6,2024-05-07,5.0,Withdrawal POS #000000804821/INSTACART*159 WWW.INSTACART.COM/ SANFRANCISCO CACard 1231,5.0
5/7/2024,,Withdrawal POS #000000792260/INSTACART*159 WWW.INSTACART.COM/ SANFRANCISCO CACard 1231,86.0,,Posted,988.6,2024-05-07,86.0,Withdrawal POS #000000792733/INSTACART*159 WWW.INSTACART.COM/ SANFRANCISCO CACard 1231,85.995
5/6/2024,,Recurring Withdrawal Bill Payment - #000000343444/NETFLIX COM LOS GATOS CACard 1231,13.81,,Posted,1074.6,2024-05-06,13.81,Recurring Withdrawal Bill Payment - #000000343444/NETFLIX COM LOS GATOS CACard 1231,13.81
5/6/2024,,Withdrawal POS #000000171901/SUNOCO 8002212501 4234 SW 20TH AVEGAINESVILLE FLCard 1231,37.78,,Posted,1088.41,2024-05-06,37.78,Withdrawal POS #000000778591/SUNOCO 8002212501 4234 SW 20TH AVEGAINESVILLE FLCard 1231,38.010000000000005
5/5/2024,,Recurring Withdrawal Debit Card - MC Debit Seminol/CHATGPT SUBSCRIPTION SAN FRANCISC CADate 05/04/24 0 4125659188 0 5734Card 1231,20.0,,Posted,1126.19,2024-05-05,20.0,Recurring Withdrawal Debit Card - MC Debit Seminol/CHATGPT SUBSCRIPTION SAN FRANCISC CADate 05/04/24 0 4125659188 0 5734Card 1231,20.0
5/5/2024,,Withdrawal Debit Card MC Debit Seminol/CANNAMD 855-4209170 FLDate 05/03/24 0 4124568142 1 8011Card 1231,195.0,,Posted,1146.19,2024-05-05,195.0,Withdrawal Debit Card MC Debit Seminol/CANNAMD 855-4209170 FLDate 12/19/24 0 4354703841 0 8011Card 1231,195.0
5/5/2024,,Recurring Withdrawal Debit Card - MC Debit Seminol/APPLE.COM/BILL CUPERTINO CADate 05/03/24 0 4124646881 1 5735Card 1231,2.99,,Posted,1341.19,2024-05-05,2.99,Recurring Withdrawal Debit Card - MC Debit Seminol/APPLE.COM/BILL CUPERTINO CADate 05/03/24 0 4124646881 1 5735Card 1231,2.99
5/5/2024,,Recurring Withdrawal Debit Card - MC Debit Seminol/APPLE.COM/BILL 866-712-7753 CADate 05/04/24 0 4125577568 0 5818Card 1231,2.99,,Posted,1344.18,2024-05-05,2.99,Recurring Withdrawal Debit Card - MC Debit Seminol/APPLE.COM/BILL 866-712-7753 CADate 01/08/24 0 4008756344 0 5818Card 2801,2.99
5/5/2024,,Withdrawal Bill Payment #000009057953/PAYPAL *PARAMNTPLUS 2211 North FirstStreet 8882211161 CACard 1231,13.81,,Posted,1347.17,2024-05-05,13.81,Withdrawal Bill Payment #000009216703/PAYPAL *PARAMNTPLUS 2211 North FirstStreet 8882211161 CACard 1231,13.81
5/3/2024,,Recurring Withdrawal Debit Card - MC Debit Seminol/DOCSIUM.COM SANTA CLARA CADate 05/02/24 0 4123905624 0 5734Card 1231,10.0,,Posted,1360.98,2024-05-03,10.0,Recurring Withdrawal Debit Card - MC Debit Seminol/DOCSIUM.COM SANTA CLARA CADate 07/02/24 0 4184077595 1 5734Card 1231,10.0
5/3/2024,,Recurring Withdrawal Debit Card - MC Debit Seminol/INVIDEO INC COUNTRY OF S DEDate 05/02/24 0 4123988858 0 5734Card 1231,50.0,,Posted,1370.98,2024-05-03,50.0,Recurring Withdrawal Debit Card - MC Debit Seminol/INVIDEO INC COUNTRY OF S DEDate 12/09/24 0 4344808122 0 5734Card 1231,50.0
5/3/2024,,Withdrawal Debit Card MC Debit Seminol/COX GAINESVILLE COMM 800-234-3993 FLDate 05/02/24 0 4123982882 0 4899Card 1231,126.13,,Posted,1420.98,2024-05-03,126.13,Withdrawal Debit Card MC Debit Seminol/COX GAINESVILLE COMM 800-234-3993 FLDate 12/04/24 0 4339376311 0 4899Card 1231,126.13
5/3/2024,,"Withdrawal Bill Payment #000000774654/Adobe Park Avenue,345 San Jose CACard 1231",19.99,,Posted,1547.11,2024-05-03,19.99,"Withdrawal Bill Payment #000000352498/Adobe Park Avenue,345 San Jose CACard 1247",19.99
5/3/2024,,Withdrawal ACH Watson Realty Co/TYPE: WEB PMTS ID: 9000321157CO: Watson Realty CoNAME: Steven chaplinskiEntry Class Code: WEB,1079.0,,Posted,1567.1,2024-05-03,1079.0,Withdrawal ACH Watson Realty Co/TYPE: WEB PMTS ID: 9000321157CO: Watson Realty CoEntry Class Code: WEB,1079.0
5/3/2024,,"Withdrawal ACH AppFolio, Inc. F/TYPE: WEB PMTS ID: 9001406550CO: AppFolio, Inc. FNAME: Steven chaplinskiEntry Class Code: WEB",2.49,,Posted,2646.1,2024-05-03,2.49,"Withdrawal ACH AppFolio, Inc. F/TYPE: WEB PMTS ID: 9001406550

CO: AppFolio, Inc. F

NAME: Steven chaplinskiEntry Class Code: WEB",2.49
5/2/2024,,Withdrawal Bill Payment #000000284847/GRU EZ PAY 301 SE 4TH AVE 301 SE 4TH AVCard 1231,132.23,,Posted,2648.59,2024-05-02,132.23,Withdrawal Bill Payment #000000483994/GRU EZ PAY 301 SE 4TH AVE 301 SE 4TH AVCard 1247,132.23
5/2/2024,,Withdrawal Bill Payment #050211031354/PAYPAL *SPOTIFYUSAI 2211 North FirstStreet San Jose CACard 1231,6.82,,Posted,2780.82,2024-05-02,6.82,Withdrawal Bill Payment #050211031354/PAYPAL *SPOTIFYUSAI 2211 North FirstStreet San Jose CACard 1231,6.82
5/2/2024,,Withdrawal POS #000000804821/INSTACART*159 WWW.INSTACART.COM/ SANFRANCISCO CACard 1231,3.0,,Posted,2787.64,2024-05-02,3.0,Withdrawal POS #000000804821/INSTACART*159 WWW.INSTACART.COM/ SANFRANCISCO CACard 1231,3.0
5/2/2024,,Withdrawal POS #000000793624/INSTACART*159 WWW.INSTACART.COM/ SANFRANCISCO CACard 1231,94.95,,Posted,2790.64,2024-05-02,94.95,Withdrawal POS #000000792733/INSTACART*159 WWW.INSTACART.COM/ SANFRANCISCO CACard 1231,94.95
5/1/2024,,Withdrawal POS #000000217221/SUNOCO 8002212501 4234 SW 20TH AVEGAINESVILLE FLCard 1231,37.78,,Posted,2885.59,2024-05-01,37.78,Withdrawal POS #000000028242/SUNOCO 8002212501 4234 SW 20TH AVEGAINESVILLE FLCard 1231,37.78
4/28/2024,,Recurring Withdrawal Debit Card - MC Debit Seminol/BLAZE TODAY SUNNYVALE CADate 04/26/24 0 4117285439 0 5734Card 1231,8.39,,Posted,123.37,2024-04-28,8.39,Recurring Withdrawal Debit Card - MC Debit Seminol/BLAZE TODAY SUNNYVALE CADate 05/26/24 0 4147283808 0 5734Card 1231,8.39
4/27/2024,,Withdrawal Bill Payment #000008086025/PAYPAL *IONOS INC 2211 North FirstSan Jose CACard 1231,17.0,,Posted,131.76,2024-04-27,17.0,Withdrawal Bill Payment #000003047046/PAYPAL *HOSTGATOR 2211 North FirstSan Jose CACard 1231,17.0
4/26/2024,,Withdrawal POS #000000031004/SUNOCO 8002212501 4234 SW 20TH AVEGAINESVILLE FLCard 1231,37.78,,Posted,148.76,2024-04-26,37.78,Withdrawal POS #000000031004/SUNOCO 8002212501 4234 SW 20TH AVEGAINESVILLE FLCard 1231,37.78
4/26/2024,,Recurring Withdrawal Debit Card - MC Debit Seminol/FS *RAINDROP.IO SANTA BARBAR CADate 04/25/24 0 4116899101 0 5734Card 1231,3.0,,Posted,186.54,2024-04-26,3.0,Recurring Withdrawal Debit Card - MC Debit Seminol/FS *ADOBE SANTA BARBAR CADate 12/24/24 0 4359034647 1 5734Card 1231,3.0
4/26/2024,,Withdrawal Debit Card MC Debit Seminol/CIRCLE K # 06782 GAINESVILLE FLDate 04/24/24 0 4115893649 0 5499Card 1231,21.04,,Posted,189.54,2024-04-26,21.04,Withdrawal Debit Card MC Debit Seminol/CIRCLE K # 06782 GAINESVILLE FLDate 09/08/24 0 4252889868 0 5499Card 1231,21.405
4/26/2024,,Recurring Withdrawal Debit Card - MC Debit Seminol/APPLE.COM/BILL 866-712-7753 CADate 04/25/24 0 4116886532 0 5818Card 1231,5.99,,Posted,210.58,2024-04-26,5.99,Recurring Withdrawal Debit Card - MC Debit Seminol/APPLE.COM/BILL 866-712-7753 CADate 03/27/24 0 4087824766 0 5818Card 1231,5.99
4/25/2024,,Withdrawal POS #000000772089/INSTACART*159 WWW.INSTACART.COM/ SANFRANCISCO CACard 1231,1.0,,Posted,216.57,2024-04-25,1.0,Withdrawal POS #000000772291/INSTACART*159 WWW.INSTACART.COM/ SANFRANCISCO CACard 1231,1.0
4/25/2024,,Withdrawal POS #000000000765/INSTACART*159 WWW.INSTACART.COM/ SANFRANCISCO CACard 1231,65.4,,Posted,217.57,2024-04-25,65.4,Withdrawal POS #000000000003/INSTACART*159 WWW.INSTACART.COM/ SANFRANCISCO CACard 1231,65.4
4/25/2024,,"Recurring Withdrawal Debit Card - MC Debit Seminol/NOTION LABS, INC. SAN FRANCISC CADate 04/24/24 0 4115372320 0 7372Card 1231",27.04,,Posted,282.97,2024-04-25,27.04,"Recurring Withdrawal Debit Card - MC Debit Seminol/NOTION LABS, INC. SAN FRANCISC CADate 12/02/24 0 4337878572 0 7372Card 1231",27.52
4/25/2024,,Recurring Withdrawal Debit Card - MC Debit Seminol/FS *ADOBE SANTA BARBAR CADate 04/24/24 0 4115901267 0 5734Card 1231,0.95,,Posted,310.01,2024-04-25,0.95,Recurring Withdrawal Debit Card - MC Debit Seminol/FS *ADOBE SANTA BARBAR CADate 12/24/24 0 4359034647 1 5734Card 1231,0.95
4/25/2024,,Withdrawal Debit Card MC Debit Seminol/CHIPOTLE ONLINE CHIPOTLE.COM CADate 04/24/24 0 4115958339 0 5814Card 1231,18.0,,Posted,310.96,2024-04-25,18.0,Withdrawal Debit Card MC Debit Seminol/CHIPOTLE ONLINE CHIPOTLE.COM CADate 05/14/24 0 4135921741 0 5814Card 1231,17.66
4/24/2024,,Withdrawal POS #000002059014/PAYPAL *ETSY INC 2211 North First StreetSan Jose CACard 1231,19.76,,Posted,328.96,2024-04-24,19.76,Withdrawal POS #000002059014/PAYPAL *ETSY INC 2211 North First StreetSan Jose CACard 1231,19.76
4/24/2024,,Recurring Withdrawal Debit Card - MC Debit Seminol/GUMROAD.COM/C* AUCTOR SAN FRANCISC CADate 04/24/24 0 4115942524 0 5192Card 1231,5.35,,Posted,348.72,2024-04-24,5.35,Recurring Withdrawal Debit Card - MC Debit Seminol/GUMROAD.COM/C* AUCTOR SAN FRANCISC CADate 04/24/24 0 4115942524 0 5192Card 1231,5.35
4/24/2024,,Recurring Withdrawal Debit Card - MC Debit Seminol/GUMROAD.COM/C* AUCTOR SAN FRANCISC CADate 04/24/24 0 4115942523 0 5192Card 1231,5.35,,Posted,354.07,2024-04-24,5.35,Recurring Withdrawal Debit Card - MC Debit Seminol/GUMROAD.COM/C* AUCTOR SAN FRANCISC CADate 04/24/24 0 4115942524 0 5192Card 1231,5.35
4/24/2024,,Recurring Withdrawal Debit Card - MC Debit Seminol/VIDIQ SAN FRANCISC CADate 04/23/24 0 4114819971 0 5734Card 1231,10.0,,Posted,359.42,2024-04-24,10.0,Recurring Withdrawal Debit Card - MC Debit Seminol/VIDIQ SAN FRANCISC CADate 12/23/23 0 3357950683 0 5734Card 2801,10.0
4/24/2024,,Withdrawal Debit Card Fee/MASTERCARD ISSUER CROSS-BORDER FEEDate 04/23/24 0 4114819674 0 7392Card 1231,0.08,,Posted,369.42,2024-04-24,0.08,Withdrawal Debit Card Fee/MASTERCARD ISSUER CROSS-BORDER FEEDate 04/19/21 0 1109184122 1 7311Card 2801,0.1281818181818182
4/24/2024,,Withdrawal Debit Card MC Debit Seminol/WWW.GLH-GR* BUSINESS A LONDON LNDate 04/23/24 0 4114819674 0 7392Card 1231,10.0,,Posted,369.5,2024-04-24,10.0,Withdrawal Debit Card MC Debit Seminol/WWW.GLH-GR* BUSINESS A LONDON LNDate 04/23/24 0 4114819674 0 7392Card 1231,10.0
4/24/2024,,Withdrawal Debit Card Fee/MASTERCARD ISSUER CROSS-BORDER FEEDate 04/23/24 0 4114819673 0 7392Card 1231,0.04,,Posted,379.5,2024-04-24,0.04,Withdrawal Debit Card Fee/MASTERCARD ISSUER CROSS-BORDER FEEDate 04/19/21 0 1109184122 1 7311Card 2801,0.1281818181818182
4/24/2024,,Withdrawal Debit Card MC Debit Seminol/WWW.GLH-GR* BUSINESS A LONDON LNDate 04/23/24 0 4114819673 0 7392Card 1231,5.0,,Posted,379.54,2024-04-24,5.0,Withdrawal Debit Card MC Debit Seminol/WWW.GLH-GR* BUSINESS A LONDON LNDate 04/23/24 0 4114819674 0 7392Card 1231,5.0
4/23/2024,,Withdrawal Debit Card MC Debit Seminol/AIRTABLE.COM/BILL SAN FRANCISC CADate 04/23/24 0 4114941463 0 7372Card 1231,24.0,,Posted,384.54,2024-04-23,24.0,Recurring Withdrawal Debit Card - MC Debit Seminol/AIRTABLE.COM/BILL SAN FRANCISC CADate 09/11/24 0 4255913774 0 7372Card 1231,24.0
4/23/2024,,Recurring Withdrawal Debit Card - MC Debit Seminol/OPENAI SAN FRANCISC CADate 04/23/24 0 4114941406 0 5734Card 1231,15.03,,Posted,408.54,2024-04-23,15.03,Recurring Withdrawal Debit Card - MC Debit Seminol/VIDIQ SAN FRANCISC CADate 12/23/23 0 3357950683 0 5734Card 2801,15.015
4/23/2024,,Recurring Withdrawal Debit Card - MC Debit Seminol/RUNWAY STANDARD PLAN NEWARK DEDate 04/22/24 0 4113848879 0 5734Card 1231,15.0,,Posted,423.57,2024-04-23,15.0,Recurring Withdrawal Debit Card - MC Debit Seminol/RUNWAY STANDARD PLAN NEWARK DEDate 12/15/24 0 4350745942 1 5734Card 1231,15.0
4/23/2024,,Withdrawal POS #000000851229/SUNOCO 8002212501 4234 SW 20TH AVEGAINESVILLE FLCard 1231,27.17,,Posted,438.57,2024-04-23,27.17,Withdrawal POS #000000778591/SUNOCO 8002212501 4234 SW 20TH AVEGAINESVILLE FLCard 1231,27.17
4/22/2024,,Withdrawal ACH FLUENT-Gainesvil/TYPE: PAYMENT ID: 1371804719CO: FLUENT-GainesvilNAME: steven chaplinskiEntry Class Code: WEB,65.0,,Posted,465.74,2024-04-22,65.0,Withdrawal ACH FLUENT-Gainesvil/TYPE: PAYMENT ID: 1371804719CO: FLUENT-GainesvilNAME: steven chaplinski,65.0
4/22/2024,,Withdrawal Bill Payment #000007322712/PAYPAL *IONOS INC 2211 North FirstSan Jose CACard 1231,7.0,,Posted,530.74,2024-04-22,7.0,Withdrawal Bill Payment #000003047046/PAYPAL *HOSTGATOR 2211 North FirstSan Jose CACard 1231,7.0
4/21/2024,,Recurring Withdrawal Debit Card - MC Debit Seminol/CANVA* I04127-28722894 CAMDEN DEDate 04/20/24 0 4111985987 0 7221Card 1231,12.99,,Posted,537.74,2024-04-21,12.99,Recurring Withdrawal Debit Card - MC Debit Seminol/CANVA* I04249-43399962 CAMDEN DEDate 08/20/24 0 4233594945 0 7221Card 1231,12.99
4/21/2024,,Withdrawal Debit Card MC Debit Seminol/CIRCLE K # 26146 GAINESVILLE FLDate 04/18/24 0 4109064505 2 5499Card 1231,9.02,,Posted,550.73,2024-04-21,9.02,Withdrawal Debit Card MC Debit Seminol/CIRCLE K # 26146 GAINESVILLE FLDate 07/28/23 0 3209802364 1 5541Card 2801,9.02
4/21/2024,,Recurring Withdrawal Debit Card - MC Debit Seminol/TUBEBUDDYCOM 8668823239 CADate 04/20/24 0 4111932836 0 5734Card 1231,7.5,,Posted,559.75,2024-04-21,7.5,Recurring Withdrawal Debit Card - MC Debit Seminol/TUBEBUDDYCOM* 8668823239 CADate 12/03/24 0 4338443995 0 5045Card 1231,7.5
4/20/2024,,Withdrawal POS #000003089132/GOOGLE *YouTubePremium 1600 AmphitheatreParkw Mountain View CACard 1231,15.92,,Posted,567.25,2024-04-20,15.92,"Withdrawal POS #000020312090/GOOGLE *YouTubePremium 1600 Amphitheatre

Parkw Mountain View CA

Card 1247",15.92
4/19/2024,,Recurring Withdrawal Debit Card - MC Debit Seminol/WORDPRESS 6ZJ0S7Z01P SAN FRANCISC CADate 04/18/24 0 4109333578 0 7372Card 1231,9.0,,Posted,583.17,2024-04-19,9.0,Recurring Withdrawal Debit Card - MC Debit Seminol/WORDPRESS YLZK812XJ6 SAN FRANCISC CADate 07/18/24 0 4200709907 0 5734Card 1231,9.0
4/19/2024,,Withdrawal Bill Payment #000003047046/PAYPAL *HOSTGATOR 2211 North FirstSan Jose CACard 1231,15.99,,Posted,592.17,2024-04-19,15.99,Withdrawal Bill Payment #000003047046/PAYPAL *HOSTGATOR 2211 North FirstSan Jose CACard 1231,15.995000000000001
4/18/2024,,Withdrawal POS #000000051270/SUNOCO 8002212501 4234 SW 20TH AVEGAINESVILLE FLCard 1231,34.24,,Posted,608.16,2024-04-18,34.24,Withdrawal POS #000000031004/SUNOCO 8002212501 4234 SW 20TH AVEGAINESVILLE FLCard 1231,34.24
4/18/2024,,"Recurring Withdrawal Debit Card - MC Debit Seminol/PROMPT HUNT, INC. LOS ANGELES CADate 04/18/24 0 4109016478 1 5734Card 1231",1.99,,Posted,642.4,2024-04-18,1.99,"Recurring Withdrawal Debit Card - MC Debit Seminol/PROMPT HUNT, INC. LOS ANGELES CADate 04/18/24 0 4109016478 1 5734Card 1231",1.99
4/18/2024,,Recurring Withdrawal Debit Card - MC Debit Seminol/ELEVENLABS.IO NEW YORK NYDate 04/17/24 0 4108862142 0 5734Card 1231,22.0,,Posted,644.39,2024-04-18,22.0,Recurring Withdrawal Debit Card - MC Debit Seminol/ELEVENLABS.IO NEW YORK NYDate 04/17/24 0 4108862142 0 5734Card 1231,22.0
4/18/2024,,Withdrawal Debit Card MC Debit Seminol/CHIPOTLE ONLINE CHIPOTLE.COM CADate 04/17/24 0 4108013128 1 5814Card 1231,18.0,,Posted,666.39,2024-04-18,18.0,Withdrawal Debit Card MC Debit Seminol/CHIPOTLE ONLINE CHIPOTLE.COM CADate 05/14/24 0 4135921741 0 5814Card 1231,17.66
4/18/2024,,Withdrawal POS #000000805331/IC* INSTACART*159 WWW.INSTACART.COM/ SANFRANCISCO CACard 1231,77.14,,Posted,684.39,2024-04-18,77.14,Withdrawal POS #000000795671/IC* INSTACART*159 WWW.INSTACART.COM/ SANFRANCISCO CACard 2801,77.14
4/17/2024,,Recurring Withdrawal Debit Card - MC Debit Seminol/LINKTREE* LINKTREE DOVER DEDate 04/16/24 0 4107289275 0 7399Card 1231,9.0,,Posted,759.32,2024-04-17,9.0,Recurring Withdrawal Debit Card - MC Debit Seminol/LINKTREE* LINKTREE DOVER DEDate 04/16/24 0 4107289275 0 7399Card 1231,9.0
4/17/2024,,Recurring Withdrawal Debit Card - MC Debit Seminol/SUPERPOWER CHATGPT MIDDLETOWN DEDate 04/17/24 0 4108980411 0 5734Card 1231,15.0,,Posted,768.32,2024-04-17,15.0,Recurring Withdrawal Debit Card - MC Debit Seminol/SUPERPOWER CHATGPT MIDDLETOWN DEDate 12/17/24 0 4352703539 1 5734Card 1231,15.094999999999999
4/17/2024,,Recurring Withdrawal Debit Card - MC Debit Seminol/OPENAI SAN FRANCISC CADate 04/16/24 0 4107145993 0 5734Card 1231,10.0,,Posted,783.32,2024-04-17,10.0,Withdrawal Debit Card MC Debit Seminol/OPENAI SAN FRANCISC CADate 02/16/24 0 4047896474 1 5734Card 1231,10.0
4/17/2024,,Withdrawal Debit Card Fee/MASTERCARD ISSUER CROSS-BORDER FEEDate 04/16/24 0 4107738492 1 5815Card 1231,0.06,,Posted,793.32,2024-04-17,0.06,Withdrawal Debit Card Fee/MASTERCARD ISSUER CROSS-BORDER FEEDate 04/19/21 0 1109184122 1 7311Card 2801,0.1281818181818182
4/17/2024,,Withdrawal Debit Card MC Debit Seminol/PHOTOPEA.COM KOSTELEC NAD CZDate 04/16/24 0 4107738492 1 5815Card 1231,7.68,,Posted,793.38,2024-04-17,7.68,Withdrawal Debit Card MC Debit Seminol/PHOTOPEA.COM KOSTELEC NAD CZDate 04/16/24 0 4107738492 1 5815Card 1231,7.765
4/17/2024,,Recurring Withdrawal Debit Card - MC Debit Seminol/MYDESIGNS - PRO - MON LAS VEGAS NVDate 04/16/24 0 4107736414 1 5734Card 1231,29.99,,Posted,801.06,2024-04-17,29.99,Withdrawal Debit Card MC Debit Seminol/MYDESIGNS - PRO - MON LAS VEGAS NVDate 09/01/23 0 3244164229 1 5734Card 2801,29.99
4/17/2024,,Recurring Withdrawal Debit Card - MC Debit Seminol/PADDLE.NET* LEONARDOAI ASTORIA NYDate 04/16/24 0 4107288953 0 5817Card 1231,9.0,,Posted,831.05,2024-04-17,9.0,Withdrawal Debit Card MC Debit Seminol/PADDLE.NET* LEONARDOAI ASTORIA NYDate 10/26/23 0 3299263117 0 5817Card 2801,9.0
4/17/2024,,Recurring Withdrawal Debit Card Fee/MASTERCARD ISSUER CROSS-BORDER FEEDate 04/17/24 0 4108978436 0 5734Card 1231,0.16,,Posted,840.05,2024-04-17,0.16,Withdrawal Debit Card Fee/MASTERCARD ISSUER CROSS-BORDER FEEDate 05/13/24 0 4134864561 0 5734Card 1231,0.1366666666666667
4/17/2024,,Recurring Withdrawal Debit Card - MC Debit Seminol/IDEOGRAM.AI TORONTO ONDate 04/17/24 0 4108978436 0 5734Card 1231,20.0,,Posted,840.21,2024-04-17,20.0,Withdrawal Debit Card MC Debit Seminol/IDEOGRAM.AI TORONTO ONDate 04/15/24 0 4106835174 0 5734Card 1231,20.0
4/17/2024,,Recurring Withdrawal Debit Card Fee/MASTERCARD ISSUER CROSS-BORDER FEEDate 04/17/24 0 4108978435 0 5734Card 1231,0.39,,Posted,860.21,2024-04-17,0.39,Recurring Withdrawal Debit Card Fee/MASTERCARD ISSUER CROSS-BORDER FEEDate 02/25/24 0 4056812425 0 4816Card 1231,0.13
4/17/2024,,Recurring Withdrawal Debit Card - MC Debit Seminol/BROWSE.AI PLAN BURNABY BCDate 04/17/24 0 4108978435 0 5734Card 1231,48.75,,Posted,860.6,2024-04-17,48.75,Recurring Withdrawal Debit Card - MC Debit Seminol/BROWSE.AI PLAN BURNABY BCDate 04/17/24 0 4108978435 0 5734Card 1231,48.75
4/17/2024,,Recurring Withdrawal Debit Card - MC Debit Seminol/APPLE.COM/BILL 866-712-7753 CADate 04/17/24 0 4108973709 0 5818Card 1231,6.99,,Posted,909.35,2024-04-17,6.99,Recurring Withdrawal Debit Card - MC Debit Seminol/APPLE.COM/BILL 866-712-7753 CADate 01/08/24 0 4008756344 0 5818Card 2801,7.49
4/17/2024,,Recurring Withdrawal Debit Card - MC Debit Seminol/APPLE.COM/BILL 866-712-7753 CADate 04/17/24 0 4108973707 0 5818Card 1231,10.99,,Posted,916.34,2024-04-17,10.99,Recurring Withdrawal Debit Card - MC Debit Seminol/APPLE.COM/BILL 866-712-7753 CADate 01/08/24 0 4008756344 0 5818Card 2801,10.49
4/17/2024,,Withdrawal POS #041705070341/PAYPAL *FASTSPRING 2211 North FirstSan Jose CACard 1231,15.0,,Posted,927.33,2024-04-17,15.0,Withdrawal POS #041705070341/PAYPAL *FASTSPRING 2211 North FirstSan Jose CACard 1231,15.0
4/17/2024,,Withdrawal POS #000000796638/SUNOCO 8002212501 4234 SW 20TH AVEGAINESVILLE FLCard 1231,41.1,,Posted,942.33,2024-04-17,41.1,Withdrawal POS #000000488663/SUNOCO 8002212501 4234 SW 20TH AVEGAINESVILLE FLCard 1231,41.42
4/16/2024,,Recurring Withdrawal Debit Card - MC Debit Seminol/PADDLE.NET* SETAPP ASTORIA NYDate 04/15/24 0 4106277865 0 5817Card 1231,12.49,,Posted,983.43,2024-04-16,12.49,Recurring Withdrawal Debit Card - MC Debit Seminol/PADDLE.NET* SETAPP NEW YORK NYDate 10/14/24 0 4288882561 0 5817Card 1231,12.49
4/16/2024,,Withdrawal Debit Card MC Debit Seminol/LYFT *2 RIDES 04-14 SAN FRANCISC CADate 04/15/24 0 4106835374 0 4121Card 1231,31.52,,Posted,995.92,2024-04-16,31.52,Withdrawal Debit Card MC Debit Seminol/LYFT *2 RIDES 04-14 SAN FRANCISC CADate 04/15/24 0 4106835374 0 4121Card 1231,31.52
4/16/2024,,Withdrawal Debit Card MC Debit Seminol/IDEOGRAM.AI TORONTO ONDate 04/15/24 0 4106835174 0 5734Card 1231,0.58,,Posted,1027.44,2024-04-16,0.58,Withdrawal Debit Card MC Debit Seminol/IDEOGRAM.AI TORONTO ONDate 04/15/24 0 4106835174 0 5734Card 1231,0.58
4/16/2024,,Withdrawal POS #000006227588/PAYPAL *SOCIALBLADE 2211 North FirstStreet San Jose CACard 1231,3.99,,Posted,1028.02,2024-04-16,3.99,Withdrawal POS #000006227588/PAYPAL *SOCIALBLADE 2211 North FirstStreet San Jose CACard 1231,3.99
4/16/2024,,Withdrawal POS #000000665593/SUNOCO 8002212501 4234 SW 20TH AVEGAINESVILLE FLCard 1231,37.42,,Posted,1032.01,2024-04-16,37.42,Withdrawal POS #000000488663/SUNOCO 8002212501 4234 SW 20TH AVEGAINESVILLE FLCard 1231,37.545
4/15/2024,,Recurring Withdrawal Debit Card - MC Debit Seminol/MIDJOURNEY INC. SOUTH SAN FR CADate 04/14/24 0 4105078963 1 5734Card 1231,10.0,,Posted,1069.43,2024-04-15,10.0,Recurring Withdrawal Debit Card - MC Debit Seminol/MIDJOURNEY INC. SOUTH SAN FR CADate 05/14/24 0 4135994595 0 5734Card 1231,10.0
4/15/2024,,Recurring Withdrawal Debit Card Fee/MASTERCARD ISSUER CROSS-BORDER FEEDate 04/15/24 0 4106077756 1 5734Card 1231,0.13,,Posted,1079.43,2024-04-15,0.13,Recurring Withdrawal Debit Card Fee/MASTERCARD ISSUER CROSS-BORDER FEEDate 06/15/24 0 4167922806 1 5734Card 1231,0.08
4/15/2024,,Recurring Withdrawal Debit Card - MC Debit Seminol/VANCEAI CENTRAL HODate 04/15/24 0 4106077756 1 5734Card 1231,15.9,,Posted,1079.56,2024-04-15,15.9,Recurring Withdrawal Debit Card - MC Debit Seminol/VANCEAI CENTRAL HODate 06/15/24 0 4167922806 1 5734Card 1231,15.9
4/15/2024,,Withdrawal Debit Card MC Debit Seminol/WALGREENS #5024 GAINESVILLE FLDate 04/14/24 0 4105827629 0 5912Card 1231,16.39,,Posted,1095.46,2024-04-15,16.39,Withdrawal Debit Card MC Debit Seminol/WALGREENS #5024 GAINESVILLE FLDate 04/14/24 0 4105827629 0 5912Card 1231,16.39
4/15/2024,,Withdrawal POS #000001042040/PAYPAL *PLAYSTATION 2211 North FirstStreet San Jose CACard 1231,14.99,,Posted,1111.85,2024-04-15,14.99,Withdrawal POS #000001042040/PAYPAL *PLAYSTATION 2211 North FirstStreet San Jose CACard 1231,14.99
4/15/2024,,Withdrawal POS #000012007844/PAYPAL *PLAYSTATION 2211 North FirstStreet San Jose CACard 1231,24.99,,Posted,1126.84,2024-04-15,24.99,Withdrawal POS #000001042040/PAYPAL *PLAYSTATION 2211 North FirstStreet San Jose CACard 1231,24.99
4/14/2024,,Withdrawal POS #000000590860/SUNOCO 8002212501 4234 SW 20TH AVEGAINESVILLE FLCard 1231,25.96,,Posted,1151.83,2024-04-14,25.96,Withdrawal POS #000000900121/SUNOCO 8002212501 4234 SW 20TH AVEGAINESVILLE FLCard 1231,25.96
4/14/2024,,Withdrawal Debit Card MC Debit Seminol/LYFT *2 RIDES 04-11 SAN FRANCISC CADate 04/12/24 0 4103370191 0 4121Card 1231,38.92,,Posted,1177.79,2024-04-14,38.92,Withdrawal Debit Card MC Debit Seminol/LYFT *2 RIDES 04-14 SAN FRANCISC CADate 04/15/24 0 4106835374 0 4121Card 1231,38.92
4/14/2024,,Recurring Withdrawal Debit Card - MC Debit Seminol/APPLE.COM/BILL 866-712-7753 CADate 04/13/24 0 4104933092 1 5818Card 1231,22.47,,Posted,1216.71,2024-04-14,22.47,Recurring Withdrawal Debit Card - MC Debit Seminol/APPLE.COM/BILL 866-712-7753 CADate 04/13/24 0 4104933092 1 5818Card 1231,22.47
4/12/2024,,Withdrawal POS #000000773144/INSTACART*159 WWW.INSTACART.COM/ SANFRANCISCO CACard 1231,5.0,,Posted,1239.18,2024-04-12,5.0,Withdrawal POS #000000792733/INSTACART*159 WWW.INSTACART.COM/ SANFRANCISCO CACard 1231,5.0
4/12/2024,,Withdrawal POS #000000772370/INSTACART*159 WWW.INSTACART.COM/ SANFRANCISCO CACard 1231,90.0,,Posted,1244.18,2024-04-12,90.0,Withdrawal POS #000000792733/INSTACART*159 WWW.INSTACART.COM/ SANFRANCISCO CACard 1231,90.0
4/12/2024,,Withdrawal POS #000000518066/SUNOCO 8002212501 4234 SW 20TH AVEGAINESVILLE FLCard 1231,30.7,,Posted,1334.18,2024-04-12,30.7,Withdrawal POS #000000488663/SUNOCO 8002212501 4234 SW 20TH AVEGAINESVILLE FLCard 1231,30.7
4/10/2024,,Withdrawal POS #000000618024/SUNOCO 8002212501 4234 SW 20TH AVEGAINESVILLE FLCard 1231,37.78,,Posted,1364.88,2024-04-10,37.78,Withdrawal POS #000000028242/SUNOCO 8002212501 4234 SW 20TH AVEGAINESVILLE FLCard 1231,37.78
4/10/2024,,Withdrawal Debit Card MC Debit Seminol/LYFT *1 RIDE 04-08 SAN FRANCISC CADate 04/09/24 0 4100802332 0 4121Card 1231,8.67,,Posted,902.66,2024-04-10,8.67,Withdrawal Debit Card MC Debit Seminol/LYFT *2 RIDES 04-14 SAN FRANCISC CADate 04/15/24 0 4106835374 0 4121Card 1231,8.67
4/10/2024,,Withdrawal ACH FLUENT-Gainesvil/TYPE: PAYMENT ID: 1371804719CO: FLUENT-GainesvilNAME: steven chaplinskiEntry Class Code: WEB,49.0,,Posted,911.33,2024-04-10,49.0,Withdrawal ACH FLUENT-Gainesvil/TYPE: PAYMENT ID: 1371804719CO: FLUENT-GainesvilNAME: steven chaplinski,48.5
4/9/2024,,Withdrawal POS #000000000009/INSTACART*159 WWW.INSTACART.COM/ SANFRANCISCO CACard 1231,3.0,,Posted,960.33,2024-04-09,3.0,Withdrawal POS #000000000003/INSTACART*159 WWW.INSTACART.COM/ SANFRANCISCO CACard 1231,3.0
4/9/2024,,Withdrawal POS #000000804440/INSTACART*159 WWW.INSTACART.COM/ SANFRANCISCO CACard 1231,89.91,,Posted,963.33,2024-04-09,89.91,Withdrawal POS #000000804821/INSTACART*159 WWW.INSTACART.COM/ SANFRANCISCO CACard 1231,89.91
4/8/2024,,Withdrawal ATM Fee/FLUENT DISPE-375207 3400 SW 34TH STREETGAINESVILLE FLCard 1231,2.0,,Posted,1053.24,2024-04-08,2.0,Withdrawal ATM Fee/FLUENT DISPE-375207 3400 SW 34TH STREETGAINESVILLE FLCard 1231,1.5
4/8/2024,,Withdrawal at ATM #000000001720/FLUENT DISPE-375207 3400 SW 34TH STREETGAINESVILLE FLCard 1231,23.0,,Posted,1055.24,2024-04-08,23.0,Withdrawal at ATM #000000001720/FLUENT DISPE-375207 3400 SW 34TH STREETGAINESVILLE FLCard 1231,23.0
4/8/2024,,Withdrawal ATM Fee/INQ FLUENT DISPE-375207 3400 SW 34THSTREET GAINESVILLE FLCard 1231,1.0,,Posted,1078.24,2024-04-08,1.0,Withdrawal ATM Fee/FLUENT DISPE-375207 3400 SW 34TH STREETGAINESVILLE FLCard 1231,1.5
4/8/2024,,Withdrawal Debit Card MC Debit Seminol/WALGREENS #5024 GAINESVILLE FLDate 04/07/24 0 4098790166 0 5912Card 1231,23.78,,Posted,1079.24,2024-04-08,23.78,Withdrawal Debit Card MC Debit Seminol/WALGREENS #9304 GAINESVILLE FLDate 12/20/23 0 3354958966 0 5912Card 2801,23.78
4/7/2024,,Withdrawal POS #000000000072/IC* INSTACART*159 WWW.INSTACART.COM/ SANFRANCISCO CACard 1231,5.0,,Posted,1103.02,2024-04-07,5.0,Withdrawal POS #000000795671/IC* INSTACART*159 WWW.INSTACART.COM/ SANFRANCISCO CACard 2801,5.0
4/7/2024,,Withdrawal POS #000000000004/IC* INSTACART*159 WWW.INSTACART.COM/ SANFRANCISCO CACard 1231,56.68,,Posted,1108.02,2024-04-07,56.68,Withdrawal POS #000000803033/IC* INSTACART*159 WWW.INSTACART.COM/ SANFRANCISCO CACard 1231,56.68
4/7/2024,,Withdrawal POS #000000372860/SUNOCO 8002212501 4234 SW 20TH AVEGAINESVILLE FLCard 1231,37.78,,Posted,1164.7,2024-04-07,37.78,Withdrawal POS #000000235720/SUNOCO 8002212501 4234 SW 20TH AVEGAINESVILLE FLCard 1231,37.78
4/6/2024,,Recurring Withdrawal Bill Payment - #000000078357/NETFLIX COM LOS GATOS CACard 1231,13.81,,Posted,1202.48,2024-04-06,13.81,Recurring Withdrawal Bill Payment - #000000343444/NETFLIX COM LOS GATOS CACard 1231,13.81
4/5/2024,,Recurring Withdrawal Debit Card - MC Debit Seminol/CHATGPT SUBSCRIPTION SAN FRANCISC CADate 04/04/24 0 4095278410 0 5734Card 1231,20.0,,Posted,1216.29,2024-04-05,20.0,Recurring Withdrawal Debit Card - MC Debit Seminol/CHATGPT SUBSCRIPTION SAN FRANCISC CADate 05/04/24 0 4125659188 0 5734Card 1231,20.0
4/5/2024,,Withdrawal Debit Card MC Debit Seminol/COX GAINESVILLE COMM 800-234-3993 FLDate 04/04/24 0 4095901317 0 4899Card 1231,126.13,,Posted,1236.29,2024-04-05,126.13,Withdrawal Debit Card MC Debit Seminol/COX GAINESVILLE COMM 800-234-3993 FLDate 12/04/24 0 4339376311 0 4899Card 1231,126.13
4/5/2024,,Withdrawal Bill Payment #000009078159/PAYPAL *PARAMNTPLUS 2211 North FirstStreet San Jose CACard 1231,13.81,,Posted,1362.42,2024-04-05,13.81,Withdrawal Bill Payment #000002088135/PAYPAL *PYPL Payin4 2211 North FirstStreet San Jose CACard 2801,13.780000000000001
4/4/2024,,Recurring Withdrawal Debit Card - MC Debit Seminol/APPLE.COM/BILL CUPERTINO CADate 04/03/24 0 4094830660 0 5735Card 1231,2.99,,Posted,1376.23,2024-04-04,2.99,Recurring Withdrawal Debit Card - MC Debit Seminol/APPLE.COM/BILL CUPERTINO CADate 05/03/24 0 4124646881 1 5735Card 1231,2.99
4/4/2024,,Withdrawal Bill Payment #000000253521/GRU EZ PAY 301 SE 4TH AVE US GAINESVILLEFLCard 1231,137.08,,Posted,1379.22,2024-04-04,137.08,Withdrawal Bill Payment #000000253521/GRU EZ PAY 301 SE 4TH AVE US GAINESVILLEFLCard 1231,137.08
4/3/2024,,Recurring Withdrawal Debit Card - MC Debit Seminol/DOCSIUM.COM SANTA CLARA CADate 04/02/24 0 4093105111 1 5734Card 1231,10.0,,Posted,1516.3,2024-04-03,10.0,Recurring Withdrawal Debit Card - MC Debit Seminol/DOCSIUM.COM SANTA CLARA CADate 07/02/24 0 4184077595 1 5734Card 1231,10.0
4/3/2024,,Recurring Withdrawal Debit Card - MC Debit Seminol/INVIDEO INC COUNTRY OF S DEDate 04/02/24 0 4093284762 0 5734Card 1231,50.0,,Posted,1526.3,2024-04-03,50.0,Recurring Withdrawal Debit Card - MC Debit Seminol/INVIDEO INC COUNTRY OF S DEDate 12/09/24 0 4344808122 0 5734Card 1231,50.0
4/3/2024,,"Recurring Withdrawal Bill Payment - #000000782876/ADOBE PARK AVENUE,345 SAN JOSE CACard 1231",19.99,,Posted,1576.3,2024-04-03,19.99,"Recurring Withdrawal Bill Payment - #000000782876/ADOBE PARK AVENUE,345 SAN JOSE CACard 1231",19.99
4/3/2024,,Withdrawal ACH Watson Realty Co/TYPE: WEB PMTS ID: 9000321157CO: Watson Realty CoNAME: Steven chaplinskiEntry Class Code: WEB,1079.0,,Posted,1596.29,2024-04-03,1079.0,Withdrawal ACH Watson Realty Co/TYPE: WEB PMTS ID: 9000321157CO: Watson Realty CoEntry Class Code: WEB,1079.0
4/3/2024,,"Withdrawal ACH AppFolio, Inc. F/TYPE: WEB PMTS ID: 9001406550CO: AppFolio, Inc. FNAME: Steven chaplinskiEntry Class Code: WEB",2.49,,Posted,2675.29,2024-04-03,2.49,"Withdrawal ACH AppFolio, Inc. F/TYPE: WEB PMTS ID: 9001406550

CO: AppFolio, Inc. F

NAME: Steven chaplinskiEntry Class Code: WEB",2.49
4/2/2024,,Withdrawal Bill Payment #000011239590/PAYPAL *SPOTIFYUSAI 2211 North FirstStreet San Jose CACard 1231,6.82,,Posted,2677.78,2024-04-02,6.82,Withdrawal Bill Payment #050211031354/PAYPAL *SPOTIFYUSAI 2211 North FirstStreet San Jose CACard 1231,6.82
4/1/2024,,Withdrawal POS #000000776580/IC* INSTACART*159 WWW.INSTACART.COM/ SANFRANCISCO CACard 1231,5.0,,Posted,2684.6,2024-04-01,5.0,Withdrawal POS #000000795671/IC* INSTACART*159 WWW.INSTACART.COM/ SANFRANCISCO CACard 2801,5.0
4/1/2024,,Withdrawal POS #000000000006/IC* INSTACART*159 WWW.INSTACART.COM/ SANFRANCISCO CACard 1231,103.0,,Posted,2689.6,2024-04-01,103.0,Withdrawal POS #000000803033/IC* INSTACART*159 WWW.INSTACART.COM/ SANFRANCISCO CACard 1231,103.0
4/1/2024,,"Withdrawal POS #000000804240/ETSY, INC. WWW.ETSY.COM/ BROOKLYN NYCard 1231",24.62,,Posted,2792.6,2024-04-01,24.62,"Withdrawal POS #000000804240/ETSY, INC. WWW.ETSY.COM/ BROOKLYN NYCard 1231",24.62
3/31/2024,,Withdrawal POS #000000313260/SUNOCO 8002212501 4234 SW 20TH AVEGAINESVILLE FLCard 1231,37.78,,Posted,2817.22,2024-03-31,37.78,Withdrawal POS #000000031004/SUNOCO 8002212501 4234 SW 20TH AVEGAINESVILLE FLCard 1231,37.78
3/29/2024,,Withdrawal POS #000000210024/SUNOCO 8002212501 4234 SW 20TH AVEGAINESVILLE FLCard 1231,29.39,,Posted,55.0,2024-03-29,29.39,Withdrawal POS #000000028242/SUNOCO 8002212501 4234 SW 20TH AVEGAINESVILLE FLCard 1231,29.39
3/29/2024,,Recurring Withdrawal Debit Card - MC Debit Seminol/APPLE.COM/BILL 866-712-7753 CADate 03/28/24 0 4088852714 0 5818Card 1231,2.99,,Posted,84.39,2024-03-29,2.99,Recurring Withdrawal Debit Card - MC Debit Seminol/APPLE.COM/BILL 866-712-7753 CADate 12/13/23 0 3347838871 0 5818Card 2801,2.99
3/28/2024,,Withdrawal Debit Card MC Debit Seminol/ZAPIER.COM/CHARGE SAN FRANCISC CADate 03/28/24 0 4088973131 0 5734Card 1231,59.87,,Posted,87.38,2024-03-28,59.87,Withdrawal Debit Card MC Debit Seminol/ZAPIER.COM/CHARGE SAN FRANCISC CADate 03/28/24 0 4088973131 0 5734Card 1231,59.87
3/28/2024,,"Recurring Withdrawal Debit Card - MC Debit Seminol/NOTION LABS, INC. SAN FRANCISC CADate 03/27/24 0 4087303943 0 7372Card 1231",10.0,,Posted,147.25,2024-03-28,10.0,"Recurring Withdrawal Debit Card - MC Debit Seminol/NOTION LABS, INC. SAN FRANCISC CADate 12/02/24 0 4337878572 0 7372Card 1231",10.0
3/28/2024,,Recurring Withdrawal Debit Card - MC Debit Seminol/APPLE.COM/BILL 866-712-7753 CADate 03/27/24 0 4087824766 0 5818Card 1231,7.99,,Posted,157.25,2024-03-28,7.99,Recurring Withdrawal Debit Card - MC Debit Seminol/APPLE.COM/BILL 866-712-7753 CADate 01/08/24 0 4008756344 0 5818Card 2801,7.49
3/27/2024,,Withdrawal POS #000000030230/SUNOCO 8002212501 4234 SW 20TH AVEGAINESVILLE FLCard 1231,34.24,,Posted,165.24,2024-03-27,34.24,Withdrawal POS #000000031004/SUNOCO 8002212501 4234 SW 20TH AVEGAINESVILLE FLCard 1231,34.24
3/27/2024,,Withdrawal Bill Payment #000010368568/PAYPAL *IONOS INC 2211 North FirstSan Jose CACard 1231,17.0,,Posted,-0.52,2024-03-27,17.0,Withdrawal Bill Payment #000003047046/PAYPAL *HOSTGATOR 2211 North FirstSan Jose CACard 1231,17.0
3/26/2024,,Recurring Withdrawal Debit Card - MC Debit Seminol/OPENAI SAN FRANCISC CADate 03/25/24 0 4085797776 0 5734Card 1231,7.0,,Posted,16.48,2024-03-26,7.0,Recurring Withdrawal Debit Card - MC Debit Seminol/VIDIQ SAN FRANCISC CADate 12/23/23 0 3357950683 0 5734Card 2801,7.0
3/25/2024,,Withdrawal POS #000000050354/SUNOCO 8002212501 4234 SW 20TH AVEGAINESVILLE FLCard 1231,7.07,,Posted,23.48,2024-03-25,7.07,Withdrawal POS #000000031004/SUNOCO 8002212501 4234 SW 20TH AVEGAINESVILLE FLCard 1231,7.07
3/25/2024,,Recurring Withdrawal Debit Card - MC Debit Seminol/FS *ADOBE SANTA BARBAR CADate 03/24/24 0 4084969709 0 5734Card 1231,0.95,,Posted,30.55,2024-03-25,0.95,Recurring Withdrawal Debit Card - MC Debit Seminol/FS *CONTEXTSFORMAC SANTA BARBAR CADate 02/16/24 0 4047893711 1 5734Card 1231,0.95
3/24/2024,,Withdrawal POS #000000933167/SUNOCO 8002212501 4234 SW 20TH AVEGAINESVILLE FLCard 1231,11.81,,Posted,31.5,2024-03-24,11.81,Withdrawal POS #000000616677/SUNOCO 8002212501 4234 SW 20TH AVEGAINESVILLE FLCard 1231,11.81
3/24/2024,,Recurring Withdrawal Debit Card - MC Debit Seminol/RUNWAY STANDARD PLAN NEWARK DEDate 03/22/24 0 4082877888 1 5734Card 1231,15.0,,Posted,43.31,2024-03-24,15.0,Recurring Withdrawal Debit Card - MC Debit Seminol/RUNWAY STANDARD PLAN NEWARK DEDate 12/15/24 0 4350745942 1 5734Card 1231,15.0
3/24/2024,,Recurring Withdrawal Debit Card - MC Debit Seminol/VIDIQ SAN FRANCISC CADate 03/23/24 0 4083879208 0 5734Card 1231,10.0,,Posted,58.31,2024-03-24,10.0,Recurring Withdrawal Debit Card - MC Debit Seminol/VIDIQ SAN FRANCISC CADate 12/23/23 0 3357950683 0 5734Card 2801,10.0
3/24/2024,,Withdrawal POS #000000892167/SUNOCO 8002212501 4234 SW 20TH AVEGAINESVILLE FLCard 1231,12.07,,Posted,68.31,2024-03-24,12.07,Withdrawal POS #000000778591/SUNOCO 8002212501 4234 SW 20TH AVEGAINESVILLE FLCard 1231,12.07
3/22/2024,,"Recurring Withdrawal Debit Card - MC Debit Seminol/AIPRM, CORP. WILMINGTON DEDate 03/21/24 0 4081866631 0 5734Card 1231",9.71,,Posted,80.38,2024-03-22,9.71,"Recurring Withdrawal Debit Card - MC Debit Seminol/AIPRM, CORP. WILMINGTON DEDate 12/21/23 0 3355965402 0 5734Card 2801",9.355
3/22/2024,,Withdrawal Bill Payment #000009082470/PAYPAL *IONOS INC 2211 North FirstSan Jose CACard 1231,7.0,,Posted,90.09,2024-03-22,7.0,Withdrawal Bill Payment #000003047046/PAYPAL *HOSTGATOR 2211 North FirstSan Jose CACard 1231,7.0
3/21/2024,,Withdrawal ATM Fee/EFT 3401 W University Ave Gainesville FLCard 1231,2.0,,Posted,97.09,2024-03-21,2.0,"Withdrawal ATM Fee/EFT 3401 W University Ave Gainesville FL

Card 1247",2.0
3/21/2024,,Withdrawal at ATM #000000029376/EFT 3401 W University Ave Gainesville FLCard 1231,8.0,,Posted,99.09,2024-03-21,8.0,"Withdrawal at ATM #000000776623/EFT 3401 W University Ave Gainesville FL

Card 1247",8.0
3/21/2024,,Withdrawal POS #000000731021/SUNOCO 8002212501 4234 SW 20TH AVEGAINESVILLE FLCard 1231,37.78,,Posted,107.09,2024-03-21,37.78,Withdrawal POS #000000031004/SUNOCO 8002212501 4234 SW 20TH AVEGAINESVILLE FLCard 1231,37.78
3/21/2024,,Recurring Withdrawal Debit Card - MC Debit Seminol/CANVA* I04096-42257036 CAMDEN DEDate 03/20/24 0 4080874207 0 7221Card 1231,12.99,,Posted,144.87,2024-03-21,12.99,Recurring Withdrawal Debit Card - MC Debit Seminol/CANVA* I04005-37462786 CAMDEN DEDate 12/20/23 0 3354886372 0 7221Card 2801,12.99
3/21/2024,,Recurring Withdrawal Debit Card - MC Debit Seminol/TUBEBUDDYCOM 8668823239 CADate 03/20/24 0 4080896528 0 5045Card 1231,7.5,,Posted,157.86,2024-03-21,7.5,Recurring Withdrawal Debit Card - MC Debit Seminol/TUBEBUDDYCOM* 8668823239 CADate 12/03/24 0 4338443995 0 5045Card 1231,7.5
3/20/2024,,Withdrawal Debit Card MC Debit Seminol/PRINTIFY.COM WILMINGTON DEDate 03/19/24 0 4079795188 0 7333Card 1231,12.74,,Posted,65.36,2024-03-20,12.74,Withdrawal Debit Card MC Debit Seminol/PRINTIFY.COM WILMINGTON DEDate 03/19/24 0 4079795188 0 7333Card 1231,12.74
3/20/2024,,Withdrawal POS #000003210549/GOOGLE *YouTubePremium 1600 AmphitheatreParkw Mountain View CACard 1231,15.92,,Posted,78.1,2024-03-20,15.92,Withdrawal POS #000003285955/GOOGLE *YouTubePremium 1600 AmphitheatreParkw Mountain View CACard 2801,15.92
3/19/2024,,Withdrawal POS #000000736878/SUNOCO 8002212501 4234 SW 20TH AVEGAINESVILLE FLCard 1231,37.78,,Posted,94.02,2024-03-19,37.78,Withdrawal POS #000000778591/SUNOCO 8002212501 4234 SW 20TH AVEGAINESVILLE FLCard 1231,38.010000000000005
3/19/2024,,Withdrawal Debit Card MC Debit Seminol/CHIPOTLE ONLINE CHIPOTLE.COM CADate 03/18/24 0 4078974465 0 5814Card 1231,17.84,,Posted,131.8,2024-03-19,17.84,Withdrawal Debit Card MC Debit Seminol/CHIPOTLE ONLINE CHIPOTLE.COM CADate 05/14/24 0 4135921741 0 5814Card 1231,17.66
3/19/2024,,Withdrawal ACH FLUENT-Gainesvil/TYPE: PAYMENT ID: 1371804719CO: FLUENT-GainesvilNAME: steven chaplinskiEntry Class Code: WEB,34.0,,Posted,149.64,2024-03-19,34.0,Withdrawal ACH FLUENT-Gainesvil/TYPE: PAYMENT ID: 1371804719CO: FLUENT-GainesvilNAME: steven chaplinski,34.5
3/19/2024,,Withdrawal Bill Payment #000003021539/PAYPAL *HOSTGATOR 2211 North FirstSan Jose CACard 1231,15.99,,Posted,183.64,2024-03-19,15.99,Withdrawal Bill Payment #000003047046/PAYPAL *HOSTGATOR 2211 North FirstSan Jose CACard 1231,15.995000000000001
3/18/2024,,Withdrawal Debit Card Fee/MASTERCARD ISSUER CROSS-BORDER FEEDate 03/17/24 0 4077994868 0 5815Card 1231,0.06,,Posted,199.63,2024-03-18,0.06,Withdrawal Debit Card Fee/MASTERCARD ISSUER CROSS-BORDER FEEDate 05/13/24 0 4134864561 0 5734Card 1231,0.1366666666666667
3/18/2024,,Withdrawal Debit Card MC Debit Seminol/PHOTOPEA.COM KOSTELEC NAD CZDate 03/17/24 0 4077994868 0 5815Card 1231,7.85,,Posted,199.69,2024-03-18,7.85,Withdrawal Debit Card MC Debit Seminol/PHOTOPEA.COM KOSTELEC NAD CZDate 04/16/24 0 4107738492 1 5815Card 1231,7.765
3/18/2024,,Withdrawal Debit Card MC Debit Seminol/ELEVENLABS.IO NEW YORK NYDate 03/17/24 0 4077908969 0 5734Card 1231,11.0,,Posted,207.54,2024-03-18,11.0,Withdrawal Debit Card MC Debit Seminol/ELEVENLABS.IO NEW YORK NYDate 10/07/23 0 3280076314 2 5734Card 2801,11.0
3/17/2024,,Withdrawal POS #000000000082/CIRCLE K # 26146 3525 GAINESVILLE FLCard 1231,26.57,,Posted,218.54,2024-03-17,26.57,Withdrawal POS #000010941641/CIRCLE K # 26146 3525 GAINESVILLE FLCard 1231,26.25
3/17/2024,,Withdrawal Debit Card MC Debit Seminol/LINKTREE* LINKTREE DOVER DEDate 03/17/24 0 4077836772 0 7399Card 1231,9.0,,Posted,245.11,2024-03-17,9.0,Recurring Withdrawal Debit Card - MC Debit Seminol/LINKTREE* LINKTREE DOVER DEDate 04/16/24 0 4107289275 0 7399Card 1231,9.0
3/17/2024,,Recurring Withdrawal Debit Card - MC Debit Seminol/MYDESIGNS - PRO - MON LAS VEGAS NVDate 03/16/24 0 4076835673 0 5734Card 1231,29.99,,Posted,254.11,2024-03-17,29.99,Recurring Withdrawal Debit Card - MC Debit Seminol/MYDESIGNS.IO LAS VEGAS NVDate 10/18/24 0 4292077676 2 5734Card 1231,29.99
3/17/2024,,Recurring Withdrawal Debit Card - MC Debit Seminol/PADDLE.NET* LEONARDOAI ASTORIA NYDate 03/16/24 0 4076599401 0 5817Card 1231,9.0,,Posted,284.1,2024-03-17,9.0,Withdrawal Debit Card MC Debit Seminol/PADDLE.NET* LEONARDOAI ASTORIA NYDate 10/26/23 0 3299263117 0 5817Card 2801,9.0
3/17/2024,,Recurring Withdrawal Debit Card Fee/MASTERCARD ISSUER CROSS-BORDER FEEDate 03/17/24 0 4077006794 1 5734Card 1231,0.06,,Posted,293.1,2024-03-17,0.06,Recurring Withdrawal Debit Card Fee/MASTERCARD ISSUER CROSS-BORDER FEEDate 06/15/24 0 4167922806 1 5734Card 1231,0.08
3/17/2024,,Recurring Withdrawal Debit Card - MC Debit Seminol/IDEOGRAM.AI TORONTO ONDate 03/17/24 0 4077006794 1 5734Card 1231,8.0,,Posted,293.16,2024-03-17,8.0,Withdrawal Debit Card MC Debit Seminol/IDEOGRAM.AI TORONTO ONDate 04/15/24 0 4106835174 0 5734Card 1231,8.190000000000001
3/17/2024,,Withdrawal Debit Card Fee/MASTERCARD ISSUER CROSS-BORDER FEEDate 03/17/24 0 4077006793 1 5734Card 1231,0.39,,Posted,301.16,2024-03-17,0.39,Withdrawal Debit Card Fee/MASTERCARD ISSUER CROSS-BORDER FEEDate 05/13/24 0 4134864561 0 5734Card 1231,0.1366666666666667
3/17/2024,,Withdrawal Debit Card MC Debit Seminol/BROWSE.AI PLAN BURNABY BCDate 03/17/24 0 4077006793 1 5734Card 1231,48.75,,Posted,301.55,2024-03-17,48.75,Recurring Withdrawal Debit Card - MC Debit Seminol/BROWSE.AI PLAN BURNABY BCDate 04/17/24 0 4108978435 0 5734Card 1231,48.75
3/17/2024,,Withdrawal Debit Card MC Debit Seminol/WALGREENS #5024 GAINESVILLE FLDate 03/16/24 0 4076002444 1 5912Card 1231,19.99,,Posted,350.3,2024-03-17,19.99,Withdrawal Debit Card MC Debit Seminol/WALGREENS #5024 GAINESVILLE FLDate 06/26/23 0 3177001861 1 5912Card 2801,19.96
3/17/2024,,Withdrawal POS #031705851390/PAYPAL *FASTSPRING 2211 North FirstSan Jose CACard 1231,15.0,,Posted,370.29,2024-03-17,15.0,Withdrawal POS #041705070341/PAYPAL *FASTSPRING 2211 North FirstSan Jose CACard 1231,15.0
3/17/2024,,Withdrawal POS #000006228614/PAYPAL *HAVOCMARKET HAVOC 2211 NorthStreet San Jose CACard 1231,1.49,,Posted,385.29,2024-03-17,1.49,Withdrawal POS #000006228614/PAYPAL *HAVOCMARKET HAVOC 2211 NorthStreet San Jose CACard 1231,1.49
3/17/2024,,Withdrawal POS #000001014760/PAYPAL *PLAYSTATION 2211 North FirstStreet San Jose CACard 1231,14.99,,Posted,386.78,2024-03-17,14.99,Withdrawal POS #000001042040/PAYPAL *PLAYSTATION 2211 North FirstStreet San Jose CACard 1231,14.99
3/17/2024,,Withdrawal POS #000009276996/PAYPAL *PLAYSTATION 2211 North FirstStreet San Jose CACard 1231,39.99,,Posted,401.77,2024-03-17,39.99,Withdrawal POS #000001042040/PAYPAL *PLAYSTATION 2211 North FirstStreet San Jose CACard 1231,39.99
3/16/2024,,Withdrawal POS #000000697185/SUNOCO 8002212501 4234 SW 20TH AVEGAINESVILLE FLCard 1231,14.15,,Posted,441.76,2024-03-16,14.15,Withdrawal POS #000000778591/SUNOCO 8002212501 4234 SW 20TH AVEGAINESVILLE FLCard 1231,14.15
3/16/2024,,Withdrawal POS #000006245883/PAYPAL *SOCIALBLADE 2211 North FirstStreet San Jose CACard 1231,3.99,,Posted,455.91,2024-03-16,3.99,Withdrawal POS #000006227588/PAYPAL *SOCIALBLADE 2211 North FirstStreet San Jose CACard 1231,3.99
3/16/2024,,Withdrawal POS #000065583144/URGENT VET- GAINESVILL 2680 CLARK BUTLERBLVD. GAINESVILLE FLCard 1231,154.0,,Posted,309.9,2024-03-16,154.0,Withdrawal POS #000065583144/URGENT VET- GAINESVILL 2680 CLARK BUTLERBLVD. GAINESVILLE FLCard 1231,154.0
3/14/2024,,Withdrawal POS #000015057686/WALGREENS 2415 SW 75TH GAINESVILLE FLCard 1231,9.66,,Posted,463.9,2024-03-14,9.66,Withdrawal POS #000015057686/WALGREENS 2415 SW 75TH GAINESVILLE FLCard 1231,9.66
3/14/2024,,Withdrawal POS #000000555763/SUNOCO 8002212501 4234 SW 20TH AVEGAINESVILLE FLCard 1231,37.78,,Posted,473.56,2024-03-14,37.78,Withdrawal POS #000000555763/SUNOCO 8002212501 4234 SW 20TH AVEGAINESVILLE FLCard 1231,38.21
3/13/2024,,Withdrawal POS #000000803119/IC* INSTACART*159 WWW.INSTACART.COM/ SANFRANCISCO CACard 1231,3.0,,Posted,511.34,2024-03-13,3.0,Withdrawal POS #000000803033/IC* INSTACART*159 WWW.INSTACART.COM/ SANFRANCISCO CACard 1231,3.0
3/13/2024,,Withdrawal POS #000000782038/Instacart 50 Beal St Suite 600 SanFrancisco CACard 1231,24.94,,Posted,514.34,2024-03-13,24.94,Withdrawal POS #000000773008/Instacart 50 Beal St Suite 600 SanFrancisco CACard 1231,24.94
3/13/2024,,Withdrawal POS #000000782026/IC* INSTACART*159 WWW.INSTACART.COM/ SANFRANCISCO CACard 1231,125.0,,Posted,539.28,2024-03-13,125.0,Withdrawal POS #000000795671/IC* INSTACART*159 WWW.INSTACART.COM/ SANFRANCISCO CACard 2801,125.0
3/13/2024,,Withdrawal POS #000000488663/SUNOCO 8002212501 4234 SW 20TH AVEGAINESVILLE FLCard 1231,29.5,,Posted,664.28,2024-03-13,29.5,Withdrawal POS #000000488663/SUNOCO 8002212501 4234 SW 20TH AVEGAINESVILLE FLCard 1231,29.5
3/13/2024,,Recurring Withdrawal Debit Card - MC Debit Seminol/APPLE.COM/BILL 866-712-7753 CADate 03/13/24 0 4073882836 0 5818Card 1231,18.98,,Posted,693.78,2024-03-13,18.98,Recurring Withdrawal Debit Card - MC Debit Seminol/APPLE.COM/BILL 866-712-7753 CADate 12/13/23 0 3347838871 0 5818Card 2801,18.98
3/12/2024,,Recurring Withdrawal Debit Card - MC Debit Seminol/MIDJOURNEY INC. SOUTH SAN FR CADate 03/11/24 0 4071281515 0 5734Card 1231,30.0,,Posted,712.76,2024-03-12,30.0,Recurring Withdrawal Debit Card - MC Debit Seminol/MIDJOURNEY INC. SOUTH SAN FR CADate 05/14/24 0 4135994595 0 5734Card 1231,30.0
3/12/2024,,Withdrawal Debit Card MC Debit Seminol/SCRUBS CARWASH - GAINE GAINESVILLE FLDate 03/11/24 0 4071879202 0 7542Card 1231,3.5,,Posted,742.76,2024-03-12,3.5,Withdrawal Debit Card MC Debit Seminol/SCRUBS CARWASH - GAINE GAINESVILLE FLDate 11/29/24 0 4334403825 2 7542Card 1231,3.5
3/11/2024,,Withdrawal POS #000000514197/SUNOCO 8002212501 4234 SW 20TH AVEGAINESVILLE FLCard 1231,37.78,,Posted,746.26,2024-03-11,37.78,Withdrawal POS #000000161599/SUNOCO 8002212501 4234 SW 20TH AVEGAINESVILLE FLCard 1231,37.295
3/10/2024,,Withdrawal Debit Card MC Debit Seminol/CHIPOTLE ONLINE CHIPOTLE.COM CADate 03/08/24 0 4068694631 2 5814Card 1231,34.68,,Posted,784.04,2024-03-10,34.68,Withdrawal Debit Card MC Debit Seminol/CHIPOTLE ONLINE CHIPOTLE.COM CADate 05/14/24 0 4135921741 0 5814Card 1231,34.68
3/10/2024,,Withdrawal Debit Card MC Debit Seminol/WALGREENS #5024 GAINESVILLE FLDate 03/08/24 0 4068690235 2 5912Card 1231,10.81,,Posted,818.72,2024-03-10,10.81,Withdrawal Debit Card MC Debit Seminol/WALGREENS #5024 GAINESVILLE FLDate 04/14/24 0 4105827629 0 5912Card 1231,10.81
3/9/2024,,Withdrawal POS #000000000008/IC* INSTACART*159 WWW.INSTACART.COM/ SANFRANCISCO CACard 1231,5.0,,Posted,829.53,2024-03-09,5.0,Withdrawal POS #000000803033/IC* INSTACART*159 WWW.INSTACART.COM/ SANFRANCISCO CACard 1231,5.0
3/9/2024,,Withdrawal POS #000000000065/IC* INSTACART*159 WWW.INSTACART.COM/ SANFRANCISCO CACard 1231,163.69,,Posted,834.53,2024-03-09,163.69,Withdrawal POS #000000803033/IC* INSTACART*159 WWW.INSTACART.COM/ SANFRANCISCO CACard 1231,163.69
3/8/2024,,Withdrawal POS #000000221295/SUNOCO 8002212501 4234 SW 20TH AVEGAINESVILLE FLCard 1231,40.7,,Posted,998.22,2024-03-08,40.7,Withdrawal POS #000000028242/SUNOCO 8002212501 4234 SW 20TH AVEGAINESVILLE FLCard 1231,40.95
3/8/2024,,Recurring Withdrawal Debit Card - MC Debit Seminol/APPLE.COM/BILL 866-712-7753 CADate 03/08/24 0 4068976803 0 5818Card 1231,2.99,,Posted,1038.92,2024-03-08,2.99,Recurring Withdrawal Debit Card - MC Debit Seminol/APPLE.COM/BILL 866-712-7753 CADate 01/08/24 0 4008756344 0 5818Card 2801,2.99
3/7/2024,,Recurring Withdrawal Debit Card - MC Debit Seminol/OPENAI SAN FRANCISC CADate 03/07/24 0 4067912809 0 5734Card 1231,7.74,,Posted,1041.91,2024-03-07,7.74,Withdrawal Debit Card MC Debit Seminol/OPENAI SAN FRANCISC CADate 02/16/24 0 4047896474 1 5734Card 1231,7.74
3/6/2024,,Recurring Withdrawal Debit Card - MC Debit Seminol/PIKA.ART MOUNTAIN VIE CADate 03/05/24 0 4065950684 0 5734Card 1231,10.0,,Posted,1049.65,2024-03-06,10.0,Recurring Withdrawal Debit Card - MC Debit Seminol/PIKA.ART MOUNTAIN VIE CADate 03/05/24 0 4065950684 0 5734Card 1231,10.0
3/6/2024,,Withdrawal ACH FLUENT-Gainesvil/TYPE: PAYMENT ID: 1371804719CO: FLUENT-GainesvilNAME: steven chaplinskiEntry Class Code: WEB,51.5,,Posted,1059.65,2024-03-06,51.5,Withdrawal ACH FLUENT-Gainesvil/TYPE: PAYMENT ID: 1371804719CO: FLUENT-GainesvilNAME: steven chaplinski,51.75
3/6/2024,,Recurring Withdrawal Bill Payment - #000000134816/NETFLIX COM LOS GATOS CACard 1231,13.81,,Posted,1111.15,2024-03-06,13.81,Recurring Withdrawal Bill Payment - #000000343444/NETFLIX COM LOS GATOS CACard 1231,13.81
3/5/2024,,Withdrawal POS #000000783607/IC* INSTACART*159 WWW.INSTACART.COM/ SANFRANCISCO CACard 1231,5.0,,Posted,1124.96,2024-03-05,5.0,Withdrawal POS #000000795671/IC* INSTACART*159 WWW.INSTACART.COM/ SANFRANCISCO CACard 2801,5.0
3/5/2024,,Withdrawal POS #000000000040/IC* INSTACART*159 WWW.INSTACART.COM/ SANFRANCISCO CACard 1231,136.27,,Posted,1129.96,2024-03-05,136.27,Withdrawal POS #000000803033/IC* INSTACART*159 WWW.INSTACART.COM/ SANFRANCISCO CACard 1231,136.27
3/5/2024,,Recurring Withdrawal Debit Card - MC Debit Seminol/CHATGPT SUBSCRIPTION SAN FRANCISC CADate 03/04/24 0 4064324144 0 5734Card 1231,20.0,,Posted,1266.23,2024-03-05,20.0,Recurring Withdrawal Debit Card - MC Debit Seminol/CHATGPT SUBSCRIPTION SAN FRANCISC CADate 05/04/24 0 4125659188 0 5734Card 1231,20.0
3/5/2024,,Withdrawal Debit Card MC Debit Seminol/COX GAINESVILLE COMM 800-234-3993 FLDate 03/04/24 0 4064754380 0 4899Card 1231,142.8,,Posted,1286.23,2024-03-05,142.8,Withdrawal Debit Card MC Debit Seminol/COX GAINESVILLE COMM 800-234-3993 FLDate 12/04/24 0 4339376311 0 4899Card 1231,142.465
3/4/2024,,Withdrawal Bill Payment #000000378137/GRU EZ PAY 301 SE 4TH AVE US GAINESVILLEFLCard 1231,165.01,,Posted,1429.03,2024-03-04,165.01,Withdrawal Bill Payment #000000253521/GRU EZ PAY 301 SE 4TH AVE US GAINESVILLEFLCard 1231,165.01
3/4/2024,,Withdrawal POS #000000246748/SUNOCO 8002212501 4234 SW 20TH AVEGAINESVILLE FLCard 1231,34.24,,Posted,1594.04,2024-03-04,34.24,Withdrawal POS #000000794627/SUNOCO 8002212501 4234 SW 20TH AVEGAINESVILLE FLCard 1231,34.24
3/4/2024,,Recurring Withdrawal Debit Card - MC Debit Seminol/APPLE.COM/BILL 866-712-7753 CADate 03/03/24 0 4063943695 0 5818Card 1231,2.99,,Posted,1628.28,2024-03-04,2.99,Recurring Withdrawal Debit Card - MC Debit Seminol/APPLE.COM/BILL 866-712-7753 CADate 01/08/24 0 4008756344 0 5818Card 2801,2.99
3/4/2024,,Withdrawal ACH Watson Realty Co/TYPE: WEB PMTS ID: 9000321157CO: Watson Realty CoNAME: Steven chaplinskiEntry Class Code: WEB,1079.0,,Posted,1631.27,2024-03-04,1079.0,Withdrawal ACH Watson Realty Co/TYPE: WEB PMTS ID: 9000321157CO: Watson Realty CoEntry Class Code: WEB,1079.0
3/4/2024,,"Withdrawal ACH AppFolio, Inc. F/TYPE: WEB PMTS ID: 9001406550CO: AppFolio, Inc. FNAME: Steven chaplinskiEntry Class Code: WEB",2.49,,Posted,2710.27,2024-03-04,2.49,"Withdrawal ACH AppFolio, Inc. F/TYPE: WEB PMTS ID: 9001406550

CO: AppFolio, Inc. F

NAME: Steven chaplinskiEntry Class Code: WEB",2.49
3/3/2024,,Recurring Withdrawal Debit Card - MC Debit Seminol/INVIDEO INC COUNTRY OF S DEDate 03/02/24 0 4062554503 0 5734Card 1231,50.0,,Posted,2712.76,2024-03-03,50.0,Recurring Withdrawal Debit Card - MC Debit Seminol/INVIDEO INC COUNTRY OF S DEDate 12/09/24 0 4344808122 0 5734Card 1231,50.0
3/3/2024,,Recurring Withdrawal Debit Card - MC Debit Seminol/DOCSIUM.COM SANTA CLARA CADate 03/02/24 0 4062554502 0 5734Card 1231,10.0,,Posted,2762.76,2024-03-03,10.0,Recurring Withdrawal Debit Card - MC Debit Seminol/DOCSIUM.COM SANTA CLARA CADate 07/02/24 0 4184077595 1 5734Card 1231,10.0
3/3/2024,,"Withdrawal Bill Payment #000000795978/Adobe Park Avenue,345 San Jose CACard 1231",19.99,,Posted,2772.76,2024-03-03,19.99,"Withdrawal Bill Payment #000000352498/Adobe Park Avenue,345 San Jose CACard 1247",19.99
3/2/2024,,Withdrawal Bill Payment #030210607517/PAYPAL *SPOTIFYUSAI 2211 North FirstStreet San Jose CACard 1231,6.82,,Posted,2792.75,2024-03-02,6.82,Withdrawal Bill Payment #050211031354/PAYPAL *SPOTIFYUSAI 2211 North FirstStreet San Jose CACard 1231,6.82
3/1/2024,,"Withdrawal POS #000000784744/ETSY, INC. WWW.ETSY.COM/ BROOKLYN NYCard 1231",17.44,,Posted,2799.57,2024-03-01,17.44,"Withdrawal POS #000000804240/ETSY, INC. WWW.ETSY.COM/ BROOKLYN NYCard 1231",17.44
2/29/2024,,Withdrawal POS #000000785940/IC* INSTACART*159 WWW.INSTACART.COM/ SANFRANCISCO CACard 1231,3.0,,Posted,2817.01,2024-02-29,3.0,Withdrawal POS #000000795671/IC* INSTACART*159 WWW.INSTACART.COM/ SANFRANCISCO CACard 2801,3.0
2/29/2024,,Withdrawal POS #000000804013/IC* INSTACART*159 WWW.INSTACART.COM/ SANFRANCISCO CACard 1231,122.37,,Posted,2820.01,2024-02-29,122.37,Withdrawal POS #000000794186/IC* INSTACART*159 WWW.INSTACART.COM/ SANFRANCISCO CACard 1231,122.37
2/28/2024,,Withdrawal Debit Card MC Debit Seminol/ZAPIER.COM/CHARGE SAN FRANCISC CADate 02/27/24 0 4058887137 0 5734Card 1231,29.99,,Posted,2942.38,2024-02-28,29.99,Withdrawal Debit Card MC Debit Seminol/ZAPIER.COM/CHARGE SAN FRANCISC CADate 03/28/24 0 4088973131 0 5734Card 1231,29.99
2/28/2024,,Recurring Withdrawal Debit Card Fee/MASTERCARD ISSUER CROSS-BORDER FEEDate 02/25/24 0 4056812425 0 4816Card 1231,0.12,,Posted,2972.37,2024-02-28,0.12,Recurring Withdrawal Debit Card Fee/MASTERCARD ISSUER CROSS-BORDER FEEDate 01/06/24 0 4006875269 0 5815Card 2801,0.1366666666666667
2/28/2024,,Recurring Withdrawal Debit Card - MC Debit Seminol/PAYPAL *HOSTINGER 35314369001 CYDate 02/25/24 0 4056812425 0 4816Card 1231,14.98,,Posted,2972.49,2024-02-28,14.98,Recurring Withdrawal Debit Card - MC Debit Seminol/PAYPAL *HOSTINGER 35314369001 CYDate 02/25/24 0 4056812425 0 4816Card 1231,14.98
2/28/2024,,Recurring Withdrawal Debit Card Fee/MASTERCARD ISSUER CROSS-BORDER FEEDate 02/25/24 0 4056812424 0 4816Card 1231,0.02,,Posted,2987.47,2024-02-28,0.02,Recurring Withdrawal Debit Card Fee/MASTERCARD ISSUER CROSS-BORDER FEEDate 01/06/24 0 4006875269 0 5815Card 2801,0.1366666666666667
2/28/2024,,Recurring Withdrawal Debit Card - MC Debit Seminol/PAYPAL *HOSTINGER 35314369001 CYDate 02/25/24 0 4056812424 0 4816Card 1231,2.17,,Posted,2987.49,2024-02-28,2.17,Recurring Withdrawal Debit Card - MC Debit Seminol/PAYPAL *HOSTINGER 35314369001 CYDate 02/25/24 0 4056812425 0 4816Card 1231,2.17
2/28/2024,,Withdrawal Debit Card MC Debit Seminol/CHIPOTLE ONLINE CHIPOTLE.COM CADate 02/27/24 0 4058906372 0 5814Card 1231,32.37,,Posted,2989.66,2024-02-28,32.37,Withdrawal Debit Card MC Debit Seminol/CHIPOTLE ONLINE CHIPOTLE.COM CADate 05/14/24 0 4135921741 0 5814Card 1231,32.56
2/28/2024,,Recurring Withdrawal Debit Card - MC Debit Seminol/APPLE.COM/BILL 866-712-7753 CADate 02/28/24 0 4059902873 0 5818Card 1231,14.98,,Posted,3022.03,2024-02-28,14.98,Recurring Withdrawal Debit Card - MC Debit Seminol/APPLE.COM/BILL 866-712-7753 CADate 01/08/24 0 4008756344 0 5818Card 2801,14.98
2/27/2024,,Withdrawal POS #000000965925/SUNOCO 8002212501 4234 SW 20TH AVEGAINESVILLE FLCard 1231,22.42,,Posted,237.01,2024-02-27,22.42,Withdrawal POS #000000909995/SUNOCO 8002212501 4234 SW 20TH AVEGAINESVILLE FLCard 1231,22.42
2/27/2024,,Withdrawal Bill Payment #000009017556/PAYPAL *IONOS INC 2211 North FirstSan Jose CACard 1231,17.0,,Posted,259.43,2024-02-27,17.0,Withdrawal Bill Payment #000003047046/PAYPAL *HOSTGATOR 2211 North FirstSan Jose CACard 1231,17.0
2/25/2024,,Recurring Withdrawal Debit Card - MC Debit Seminol/SHOPIFY* 218664050 ELK GROVE VI ILDate 02/24/24 0 4055933818 1 5734Card 1231,1.0,,Posted,276.43,2024-02-25,1.0,Recurring Withdrawal Debit Card - MC Debit Seminol/SHOPIFY* 218664050 ELK GROVE VI ILDate 02/24/24 0 4055933818 1 5734Card 1231,1.0
2/25/2024,,Recurring Withdrawal Debit Card - MC Debit Seminol/VIDIQ SAN FRANCISC CADate 02/23/24 0 4054865006 1 5734Card 1231,10.0,,Posted,277.43,2024-02-25,10.0,Recurring Withdrawal Debit Card - MC Debit Seminol/VIDIQ SAN FRANCISC CADate 12/23/23 0 3357950683 0 5734Card 2801,10.0
2/25/2024,,Recurring Withdrawal Debit Card - MC Debit Seminol/FS *ADOBE SANTA BARBAR CADate 02/24/24 0 4055835597 0 5734Card 1231,0.95,,Posted,287.43,2024-02-25,0.95,Recurring Withdrawal Debit Card - MC Debit Seminol/FS *CONTEXTSFORMAC SANTA BARBAR CADate 02/16/24 0 4047893711 1 5734Card 1231,0.95
2/23/2024,,Recurring Withdrawal Debit Card - MC Debit Seminol/RUNWAY STANDARD PLAN NEWARK DEDate 02/22/24 0 4053857135 0 5734Card 1231,15.0,,Posted,288.38,2024-02-23,15.0,Recurring Withdrawal Debit Card - MC Debit Seminol/RUNWAY STANDARD PLAN NEWARK DEDate 12/15/24 0 4350745942 1 5734Card 1231,15.0
2/23/2024,,Withdrawal Debit Card MC Debit Seminol/IC* INSTACART*159 SAN FRANCISC CADate 02/23/24 0 4054872144 0 5411Card 1231,108.76,,Posted,303.38,2024-02-23,108.76,Withdrawal Debit Card MC Debit Seminol/IC* INSTACART*159 SAN FRANCISC CADate 02/23/24 0 4054872144 0 5411Card 1231,108.76
2/23/2024,,Withdrawal Debit Card MC Debit Seminol/APPLE.COM/BILL CUPERTINO CADate 02/22/24 0 4053853179 0 5735Card 1231,6.99,,Posted,412.14,2024-02-23,6.99,Withdrawal Debit Card MC Debit Seminol/APPLE.COM/BILL CUPERTINO CADate 08/18/23 0 3230028421 2 5735Card 2801,6.99
2/23/2024,,Withdrawal POS #000000000006/IC* INSTACART*159 WWW.INSTACART.COM/ SANFRANCISCO CACard 1231,5.0,,Posted,419.13,2024-02-23,5.0,Withdrawal POS #000000803033/IC* INSTACART*159 WWW.INSTACART.COM/ SANFRANCISCO CACard 1231,5.0
2/23/2024,,Withdrawal POS #000000768640/SUNOCO 8002212501 4234 SW 20TH AVEGAINESVILLE FLCard 1231,34.24,,Posted,424.13,2024-02-23,34.24,Withdrawal POS #000000680755/SUNOCO 8002212501 4234 SW 20TH AVEGAINESVILLE FLCard 1231,34.24
2/22/2024,,"Recurring Withdrawal Debit Card - MC Debit Seminol/AIPRM, CORP. WILMINGTON DEDate 02/21/24 0 4052801927 0 5734Card 1231",9.71,,Posted,258.37,2024-02-22,9.71,"Recurring Withdrawal Debit Card - MC Debit Seminol/AIPRM, CORP. WILMINGTON DEDate 12/21/23 0 3355965402 0 5734Card 2801",9.355
2/21/2024,,Recurring Withdrawal Debit Card - MC Debit Seminol/OPENAI SAN FRANCISC CADate 02/21/24 0 4052816296 0 5734Card 1231,15.0,,Posted,268.08,2024-02-21,15.0,Recurring Withdrawal Debit Card - MC Debit Seminol/VIDIQ SAN FRANCISC CADate 12/23/23 0 3357950683 0 5734Card 2801,15.015
2/21/2024,,Recurring Withdrawal Debit Card - MC Debit Seminol/CANVA* I04067-39730644 CAMDEN DEDate 02/20/24 0 4051830672 0 7221Card 1231,12.99,,Posted,283.08,2024-02-21,12.99,Recurring Withdrawal Debit Card - MC Debit Seminol/CANVA* I04005-37462786 CAMDEN DEDate 12/20/23 0 3354886372 0 7221Card 2801,12.99
2/21/2024,,Withdrawal Debit Card MC Debit Seminol/CHIPOTLE ONLINE CHIPOTLE.COM CADate 02/20/24 0 4051813723 0 5814Card 1231,17.14,,Posted,296.07,2024-02-21,17.14,Withdrawal Debit Card MC Debit Seminol/CHIPOTLE ONLINE CHIPOTLE.COM CADate 05/14/24 0 4135921741 0 5814Card 1231,17.66
2/21/2024,,Withdrawal POS #000000710759/SUNOCO 8002212501 4234 SW 20TH AVEGAINESVILLE FLCard 1231,41.31,,Posted,313.21,2024-02-21,41.31,Withdrawal POS #000000778591/SUNOCO 8002212501 4234 SW 20TH AVEGAINESVILLE FLCard 1231,41.31
2/20/2024,,Withdrawal POS #000003336793/GOOGLE *YouTubePremium 1600 AmphitheatreParkw Mountain View CACard 1231,15.92,,Posted,354.52,2024-02-20,15.92,"Withdrawal POS #000020312090/GOOGLE *YouTubePremium 1600 Amphitheatre

Parkw Mountain View CA

Card 1247",15.92
2/19/2024,,Withdrawal Debit Card MC Debit Seminol/IC* INSTACART*159 SAN FRANCISC CADate 02/18/24 0 4049816277 0 5411Card 1231,80.0,,Posted,370.44,2024-02-19,80.0,Withdrawal Debit Card MC Debit Seminol/IC* INSTACART*159 SAN FRANCISC CADate 02/23/24 0 4054872144 0 5411Card 1231,80.0
2/19/2024,,Withdrawal Bill Payment #000003063817/PAYPAL *HOSTGATOR 2211 North FirstSan Jose CACard 1231,15.99,,Posted,404.46,2024-02-19,15.99,Withdrawal Bill Payment #000003047046/PAYPAL *HOSTGATOR 2211 North FirstSan Jose CACard 1231,15.995000000000001
2/18/2024,,Withdrawal POS #000005360799/PAYPAL *ETSY INC 2211 North First StreetSan Jose CACard 1231,15.0,,Posted,420.45,2024-02-18,15.0,Withdrawal POS #000005013671/PAYPAL *PRINTIFY 2211 North First StreetSan Jose CACard 2801,15.0
2/18/2024,,Withdrawal POS #000000564527/SUNOCO 8002212501 4234 SW 20TH AVEGAINESVILLE FLCard 1231,37.78,,Posted,435.45,2024-02-18,37.78,Withdrawal POS #000000555763/SUNOCO 8002212501 4234 SW 20TH AVEGAINESVILLE FLCard 1231,38.21
2/18/2024,,Withdrawal POS #000000793050/IC* INSTACART*159 WWW.INSTACART.COM/ SANFRANCISCO CACard 1231,5.0,,Posted,473.23,2024-02-18,5.0,Withdrawal POS #000000795671/IC* INSTACART*159 WWW.INSTACART.COM/ SANFRANCISCO CACard 2801,5.0
2/18/2024,,Withdrawal Debit Card MC Debit Seminol/OPENAI SAN FRANCISC CADate 02/16/24 0 4047896474 1 5734Card 1231,35.09,,Posted,478.23,2024-02-18,35.09,Withdrawal Debit Card MC Debit Seminol/OPENAI SAN FRANCISC CADate 02/16/24 0 4047896474 1 5734Card 1231,35.09
2/18/2024,,Withdrawal Debit Card MC Debit Seminol/INVIDEO INC COUNTRY OF S DEDate 02/16/24 0 4047895344 1 5734Card 1231,20.38,,Posted,513.32,2024-02-18,20.38,Recurring Withdrawal Debit Card - MC Debit Seminol/INVIDEO INC COUNTRY OF S DEDate 12/09/24 0 4344808122 0 5734Card 1231,20.38
2/18/2024,,Withdrawal Debit Card Fee/MASTERCARD ISSUER CROSS-BORDER FEEDate 02/17/24 0 4048895127 1 5734Card 1231,0.06,,Posted,533.7,2024-02-18,0.06,Withdrawal Debit Card Fee/MASTERCARD ISSUER CROSS-BORDER FEEDate 04/19/21 0 1109184122 1 7311Card 2801,0.1281818181818182
2/18/2024,,Withdrawal Debit Card MC Debit Seminol/IDEOGRAM.AI TORONTO ONDate 02/17/24 0 4048895127 1 5734Card 1231,8.0,,Posted,533.76,2024-02-18,8.0,Withdrawal Debit Card MC Debit Seminol/IDEOGRAM.AI TORONTO ONDate 04/15/24 0 4106835174 0 5734Card 1231,8.190000000000001
2/18/2024,,Recurring Withdrawal Debit Card - MC Debit Seminol/FS *CONTEXTSFORMAC SANTA BARBAR CADate 02/16/24 0 4047893711 1 5734Card 1231,9.99,,Posted,541.76,2024-02-18,9.99,Recurring Withdrawal Debit Card - MC Debit Seminol/FS *CONTEXTSFORMAC SANTA BARBAR CADate 02/16/24 0 4047893711 1 5734Card 1231,9.99
2/18/2024,,Withdrawal Debit Card MC Debit Seminol/WALGREENS #5024 GAINESVILLE FLDate 02/16/24 0 4047928029 1 5912Card 1231,27.97,,Posted,551.75,2024-02-18,27.97,Withdrawal Debit Card MC Debit Seminol/WALGREENS #5024 GAINESVILLE FLDate 04/14/24 0 4105827629 0 5912Card 1231,28.46
2/18/2024,,"Withdrawal Bill Payment #000000783899/Adobe Park Avenue,345 San Jose CACard 1231",19.99,,Posted,556.73,2024-02-18,19.99,"Withdrawal Bill Payment #000000352498/Adobe Park Avenue,345 San Jose CACard 1247",19.99
2/18/2024,,"Withdrawal Bill Payment #000000795070/Adobe Park Avenue,345 San Jose CACard 1231",22.99,,Posted,576.72,2024-02-18,22.99,"Withdrawal Bill Payment #000000352498/Adobe Park Avenue,345 San Jose CACard 1247",22.99
2/17/2024,,Withdrawal POS #021701718368/PAYPAL *FASTSPRING 2211 North FirstSan Jose CACard 1231,15.0,,Posted,599.71,2024-02-17,15.0,Withdrawal POS #041705070341/PAYPAL *FASTSPRING 2211 North FirstSan Jose CACard 1231,15.0
2/17/2024,,Withdrawal Bill Payment #021702810023/PAYPAL *HOSTGATOR 2211 North FirstSan Jose CACard 1231,15.99,,Posted,614.71,2024-02-17,15.99,Withdrawal Bill Payment #000003047046/PAYPAL *HOSTGATOR 2211 North FirstSan Jose CACard 1231,15.995000000000001
2/17/2024,,Withdrawal POS #000009211307/PAYPAL *SOCIALBLADE 2211 North FirstStreet San Jose CACard 1231,3.99,,Posted,630.7,2024-02-17,3.99,Withdrawal POS #000006227588/PAYPAL *SOCIALBLADE 2211 North FirstStreet San Jose CACard 1231,3.99
2/17/2024,,Withdrawal Bill Payment #000008014696/PAYPAL *IONOS INC 2211 North FirstSan Jose CACard 1231,16.0,,Posted,634.69,2024-02-17,16.0,Withdrawal Bill Payment #000003047046/PAYPAL *HOSTGATOR 2211 North FirstSan Jose CACard 1231,15.995000000000001
2/16/2024,,Withdrawal POS #000000570329/SUNOCO 8002212501 4234 SW 20TH AVEGAINESVILLE FLCard 1231,41.31,,Posted,650.69,2024-02-16,41.31,Withdrawal POS #000000555763/SUNOCO 8002212501 4234 SW 20TH AVEGAINESVILLE FLCard 1231,41.31
2/16/2024,,Withdrawal Bill Payment #000008363326/PAYPAL *MEDIUM.COM 2211 North FirstSan Jose CACard 1231,50.0,,Posted,692.0,2024-02-16,50.0,Withdrawal Bill Payment #000003047046/PAYPAL *HOSTGATOR 2211 North FirstSan Jose CACard 1231,50.0
2/15/2024,,Withdrawal Debit Card MC Debit Seminol/IC* INSTACART*159 SAN FRANCISC CADate 02/14/24 0 4045833788 0 5411Card 1231,97.56,,Posted,742.0,2024-02-15,97.56,Withdrawal Debit Card MC Debit Seminol/IC* INSTACART*159 SAN FRANCISC CADate 02/23/24 0 4054872144 0 5411Card 1231,97.56
2/15/2024,,Withdrawal Debit Card MC Debit Seminol/LYFT 2 RIDES 02-13 8558659553 CADate 02/14/24 0 4045828699 0 4121Card 1231,31.88,,Posted,839.56,2024-02-15,31.88,Withdrawal Debit Card MC Debit Seminol/LYFT 2 RIDES 02-13 8558659553 CADate 02/14/24 0 4045828699 0 4121Card 1231,31.88
2/14/2024,,Withdrawal POS #000000000001/IC* INSTACART*159 WWW.INSTACART.COM/ SANFRANCISCO CACard 1231,3.0,,Posted,871.44,2024-02-14,3.0,Withdrawal POS #000000803033/IC* INSTACART*159 WWW.INSTACART.COM/ SANFRANCISCO CACard 1231,3.0
2/14/2024,,Recurring Withdrawal Debit Card - MC Debit Seminol/APPLE.COM/BILL CUPERTINO CADate 02/13/24 0 4044890161 0 5735Card 1231,15.99,,Posted,874.44,2024-02-14,15.99,Recurring Withdrawal Debit Card - MC Debit Seminol/APPLE.COM/BILL CUPERTINO CADate 05/03/24 0 4124646881 1 5735Card 1231,15.99
2/13/2024,,Withdrawal Debit Card MC Debit Seminol/LYFT 2 RIDES 02-11 8558659553 CADate 02/12/24 0 4043681210 0 4121Card 1231,26.29,,Posted,890.43,2024-02-13,26.29,Withdrawal Debit Card MC Debit Seminol/LYFT 2 RIDES 02-13 8558659553 CADate 02/14/24 0 4045828699 0 4121Card 1231,26.29
2/13/2024,,Withdrawal ACH FLUENT-Gainesvil/TYPE: PAYMENT ID: 1371804719CO: FLUENT-GainesvilNAME: steven chaplinskiEntry Class Code: WEB,73.0,,Posted,916.72,2024-02-13,73.0,Withdrawal ACH FLUENT-Gainesvil/TYPE: PAYMENT ID: 1371804719CO: FLUENT-GainesvilNAME: steven chaplinski,72.75
2/12/2024,,Withdrawal POS #000000325837/SUNOCO 8002212501 4234 SW 20TH AVEGAINESVILLE FLCard 1231,37.78,,Posted,989.72,2024-02-12,37.78,Withdrawal POS #000000383621/SUNOCO 8002212501 4234 SW 20TH AVEGAINESVILLE FLCard 1231,37.78
2/12/2024,,Recurring Withdrawal Debit Card - MC Debit Seminol/MIDJOURNEY INC. SOUTH SAN FR CADate 02/11/24 0 4042266296 0 5734Card 1231,30.0,,Posted,1027.5,2024-02-12,30.0,Withdrawal Debit Card MC Debit Seminol/MIDJOURNEY INC. SOUTH SAN FR CADate 10/16/23 0 3289666656 0 5734Card 2801,30.0
2/11/2024,,Withdrawal Debit Card MC Debit Seminol/IC* INSTACART*159 SAN FRANCISC CADate 02/09/24 0 4040832330 0 5411Card 1231,130.36,,Posted,1057.5,2024-02-11,130.36,Withdrawal Debit Card MC Debit Seminol/IC* INSTACART*159 SAN FRANCISC CADate 02/23/24 0 4054872144 0 5411Card 1231,130.36
2/11/2024,,Withdrawal Debit Card MC Debit Seminol/LYFT 1 RIDE 02-08 8558659553 CADate 02/09/24 0 4040200188 1 4121Card 1231,14.99,,Posted,1187.86,2024-02-11,14.99,Withdrawal Debit Card MC Debit Seminol/LYFT 2 RIDES 02-13 8558659553 CADate 02/14/24 0 4045828699 0 4121Card 1231,14.99
2/9/2024,,Withdrawal POS #000000341143/SUNOCO 8002212501 4234 SW 20TH AVEGAINESVILLE FLCard 1231,36.53,,Posted,1202.85,2024-02-09,36.53,Withdrawal POS #000000144391/SUNOCO 8002212501 4234 SW 20TH AVEGAINESVILLE FLCard 1231,36.53
2/9/2024,,Recurring Withdrawal Debit Card - MC Debit Seminol/APPLE.COM/BILL CUPERTINO CADate 02/08/24 0 4039766268 0 5735Card 1231,2.99,,Posted,1239.38,2024-02-09,2.99,Recurring Withdrawal Debit Card - MC Debit Seminol/APPLE.COM/BILL CUPERTINO CADate 05/03/24 0 4124646881 1 5735Card 1231,2.99
2/9/2024,,Withdrawal Debit Card MC Debit Seminol/WALGREENS #5024 GAINESVILLE FLDate 02/08/24 0 4039910522 0 5912Card 1231,10.81,,Posted,1242.37,2024-02-09,10.81,Withdrawal Debit Card MC Debit Seminol/WALGREENS #5024 GAINESVILLE FLDate 04/14/24 0 4105827629 0 5912Card 1231,10.81
2/9/2024,,Recurring Withdrawal Debit Card - MC Debit Seminol/NETFLIX.COM CADate 02/09/24 0 4040905249 0 4899Card 1231,13.2,,Posted,1253.18,2024-02-09,13.2,Recurring Withdrawal Debit Card - MC Debit Seminol/NETFLIX.COM CADate 02/09/24 0 4040905249 0 4899Card 1231,13.2
2/9/2024,,Withdrawal POS #000000804934/IC* INSTACART*159 WWW.INSTACART.COM/ SANFRANCISCO CACard 1231,5.0,,Posted,1266.38,2024-02-09,5.0,Withdrawal POS #000000794186/IC* INSTACART*159 WWW.INSTACART.COM/ SANFRANCISCO CACard 1231,5.0
2/6/2024,,Withdrawal Debit Card MC Debit Seminol/PIKA.ART MOUNTAIN VIE CADate 02/05/24 0 4036916837 0 5734Card 1231,10.0,,Posted,1149.71,2024-02-06,10.0,Recurring Withdrawal Debit Card - MC Debit Seminol/PIKA.ART MOUNTAIN VIE CADate 03/05/24 0 4065950684 0 5734Card 1231,10.0
2/6/2024,,Withdrawal Debit Card MC Debit Seminol/IC* INSTACART*159 SAN FRANCISC CADate 02/05/24 0 4036668571 0 5411Card 1231,76.44,,Posted,1159.71,2024-02-06,76.44,Withdrawal Debit Card MC Debit Seminol/IC* INSTACART*159 SAN FRANCISC CADate 02/23/24 0 4054872144 0 5411Card 1231,76.44
2/5/2024,,Withdrawal POS #000000235720/SUNOCO 8002212501 4234 SW 20TH AVEGAINESVILLE FLCard 1231,36.53,,Posted,1236.15,2024-02-05,36.53,Withdrawal POS #000000235720/SUNOCO 8002212501 4234 SW 20TH AVEGAINESVILLE FLCard 1231,36.53
2/5/2024,,Recurring Withdrawal Debit Card - MC Debit Seminol/CHATGPT SUBSCRIPTION SAN FRANCISC CADate 02/04/24 0 4035267699 0 5734Card 1231,20.0,,Posted,1272.68,2024-02-05,20.0,Recurring Withdrawal Debit Card - MC Debit Seminol/CHATGPT SUBSCRIPTION SAN FRANCISC CADate 05/04/24 0 4125659188 0 5734Card 1231,20.0
2/5/2024,,Withdrawal POS #000000795274/IC* INSTACART*159 WWW.INSTACART.COM/ SANFRANCISCO CACard 1231,3.0,,Posted,1292.68,2024-02-05,3.0,Withdrawal POS #000000795671/IC* INSTACART*159 WWW.INSTACART.COM/ SANFRANCISCO CACard 2801,3.0
2/5/2024,,Withdrawal ACH Watson Realty Co/TYPE: WEB PMTS ID: 9000321157CO: Watson Realty CoNAME: Steven chaplinskiEntry Class Code: WEB,1079.0,,Posted,1295.68,2024-02-05,1079.0,Withdrawal ACH Watson Realty Co/TYPE: WEB PMTS ID: 9000321157CO: Watson Realty CoEntry Class Code: WEB,1079.0
2/5/2024,,"Withdrawal ACH AppFolio, Inc. F/TYPE: WEB PMTS ID: 9001406550CO: AppFolio, Inc. FNAME: Steven chaplinskiEntry Class Code: WEB",2.49,,Posted,2374.68,2024-02-05,2.49,"Withdrawal ACH AppFolio, Inc. F/TYPE: WEB PMTS ID: 9001406550

CO: AppFolio, Inc. F

NAME: Steven chaplinskiEntry Class Code: WEB",2.49
2/4/2024,,Recurring Withdrawal Debit Card - MC Debit Seminol/INVIDEO INC COUNTRY OF S DEDate 02/02/24 0 4033532725 0 5734Card 1231,10.0,,Posted,2377.17,2024-02-04,10.0,Recurring Withdrawal Debit Card - MC Debit Seminol/INVIDEO INC COUNTRY OF S DEDate 12/09/24 0 4344808122 0 5734Card 1231,10.0
2/4/2024,,Withdrawal Debit Card MC Debit Seminol/DOCSIUM.COM SANTA CLARA CADate 02/02/24 0 4033532724 0 5734Card 1231,10.0,,Posted,2387.17,2024-02-04,10.0,Recurring Withdrawal Debit Card - MC Debit Seminol/DOCSIUM.COM SANTA CLARA CADate 07/02/24 0 4184077595 1 5734Card 1231,10.0
2/4/2024,,Withdrawal Debit Card MC Debit Seminol/CHIPOTLE ONLINE CHIPOTLE.COM CADate 02/04/24 0 4035900306 0 5814Card 1231,32.75,,Posted,2397.17,2024-02-04,32.75,Withdrawal Debit Card MC Debit Seminol/CHIPOTLE ONLINE CHIPOTLE.COM CADate 05/14/24 0 4135921741 0 5814Card 1231,32.56
2/4/2024,,Recurring Withdrawal Debit Card - MC Debit Seminol/APPLE.COM/BILL 866-712-7753 CADate 02/03/24 0 4034901682 1 5818Card 1231,2.99,,Posted,2429.92,2024-02-04,2.99,Recurring Withdrawal Debit Card - MC Debit Seminol/APPLE.COM/BILL 866-712-7753 CADate 04/13/24 0 4104933092 1 5818Card 1231,2.99
2/4/2024,,Withdrawal Debit Card MC Debit Seminol/COX GAINESVILLE COMM 800-234-3993 FLDate 02/03/24 0 4034928536 0 4899Card 1231,76.13,,Posted,2432.91,2024-02-04,76.13,Withdrawal Debit Card MC Debit Seminol/COX GAINESVILLE COMM 800-234-3993 FLDate 12/04/24 0 4339376311 0 4899Card 1231,76.13
2/4/2024,,"Withdrawal Bill Payment #000000776451/Adobe Park Avenue,345 San Jose CACard 1231",29.99,,Posted,2509.04,2024-02-04,29.99,"Withdrawal Bill Payment #000000352498/Adobe Park Avenue,345 San Jose CACard 1247",29.99
2/3/2024,,Withdrawal Bill Payment #000000317514/GRU EZ PAY 301 SE 4TH AVE US GAINESVILLEFLCard 1231,211.5,,Posted,2539.03,2024-02-03,211.5,Withdrawal Bill Payment #000000253521/GRU EZ PAY 301 SE 4TH AVE US GAINESVILLEFLCard 1231,211.5
2/2/2024,,Withdrawal POS #000000028242/SUNOCO 8002212501 4234 SW 20TH AVEGAINESVILLE FLCard 1231,36.53,,Posted,2750.53,2024-02-02,36.53,Withdrawal POS #000000028242/SUNOCO 8002212501 4234 SW 20TH AVEGAINESVILLE FLCard 1231,36.53
2/2/2024,,Withdrawal Bill Payment #000010087462/PAYPAL *SPOTIFYUSAI 2211 North FirstStreet San Jose CACard 1231,6.82,,Posted,2787.06,2024-02-02,6.82,Withdrawal Bill Payment #050211031354/PAYPAL *SPOTIFYUSAI 2211 North FirstStreet San Jose CACard 1231,6.82
2/1/2024,,Withdrawal Debit Card MC Debit Seminol/IC* INSTACART*159 SAN FRANCISC CADate 02/01/24 0 4032880893 0 5411Card 1231,54.75,,Posted,2793.88,2024-02-01,54.75,Withdrawal Debit Card MC Debit Seminol/IC* INSTACART*159 SAN FRANCISC CADate 02/23/24 0 4054872144 0 5411Card 1231,54.75
2/1/2024,,Withdrawal POS #000000795959/IC* INSTACART*159 WWW.INSTACART.COM/ SANFRANCISCO CACard 1231,5.0,,Posted,2848.63,2024-02-01,5.0,Withdrawal POS #000000795671/IC* INSTACART*159 WWW.INSTACART.COM/ SANFRANCISCO CACard 2801,5.0
1/29/2024,,Recurring Withdrawal Debit Card - MC Debit Seminol/APPLE.COM/BILL 866-712-7753 CADate 01/29/24 0 4029763045 0 5818Card 1231,2.99,,Posted,53.63,2024-01-29,2.99,Recurring Withdrawal Debit Card - MC Debit Seminol/APPLE.COM/BILL 866-712-7753 CADate 01/08/24 0 4008756344 0 5818Card 2801,2.99
1/28/2024,,Withdrawal Debit Card MC Debit Seminol/RUNWAY NEWARK DEDate 01/26/24 0 4026573341 0 5734Card 1231,10.0,,Posted,56.62,2024-01-28,10.0,Withdrawal Debit Card MC Debit Seminol/RUNWAY NEWARK DEDate 01/26/24 0 4026573341 0 5734Card 1231,10.0
1/28/2024,,"Withdrawal Debit Card MC Debit Seminol/AIPRM, CORP. WILMINGTON DEDate 01/26/24 0 4026718596 1 5734Card 1231",9.71,,Posted,66.62,2024-01-28,9.71,"Withdrawal Debit Card MC Debit Seminol/AIPRM, CORP. WILMINGTON DEDate 01/26/24 0 4026718596 1 5734Card 1231",9.71
1/28/2024,,Recurring Withdrawal Debit Card - MC Debit Seminol/SHOPIFY* 214299651 ELK GROVE VI ILDate 01/26/24 0 4026855967 1 5734Card 1231,1.0,,Posted,76.33,2024-01-28,1.0,Recurring Withdrawal Debit Card - MC Debit Seminol/SHOPIFY* 209984801 ELK GROVE VI ILDate 12/26/23 0 3360264224 0 5734Card 2801,1.0
1/28/2024,,Withdrawal Debit Card MC Debit Seminol/VIDIQ SAN FRANCISC CADate 01/26/24 0 4026717498 1 5734Card 1231,10.0,,Posted,77.33,2024-01-28,10.0,Withdrawal Debit Card MC Debit Seminol/OPENAI SAN FRANCISC CADate 02/16/24 0 4047896474 1 5734Card 1231,10.0
1/28/2024,,Recurring Withdrawal Debit Card - MC Debit Seminol/FS *ADOBE SANTA BARBAR CADate 01/27/24 0 4027835930 0 5734Card 1231,0.95,,Posted,87.33,2024-01-28,0.95,Recurring Withdrawal Debit Card - MC Debit Seminol/FS *CONTEXTSFORMAC SANTA BARBAR CADate 02/16/24 0 4047893711 1 5734Card 1231,0.95
1/28/2024,,Recurring Withdrawal Debit Card - MC Debit Seminol/APPLE.COM/BILL 866-712-7753 CADate 01/28/24 0 4028896141 0 5818Card 1231,4.99,,Posted,88.28,2024-01-28,4.99,Recurring Withdrawal Debit Card - MC Debit Seminol/APPLE.COM/BILL 866-712-7753 CADate 01/08/24 0 4008756344 0 5818Card 2801,4.99
1/27/2024,,Withdrawal POS #000000330624/SUNOCO 8002212501 4234 SW 20TH AVEGAINESVILLE FLCard 1231,39.21,,Posted,93.27,2024-01-27,39.21,Withdrawal POS #000000028242/SUNOCO 8002212501 4234 SW 20TH AVEGAINESVILLE FLCard 1231,39.21
1/26/2024,,Withdrawal Bill Payment #000000737187/EIG*HOSTGATOR.COM WEB*HOSTGATOR.COMBURLINGTON MACard 1231,15.99,,Posted,132.48,2024-01-26,15.99,Withdrawal Bill Payment #000000737187/EIG*HOSTGATOR.COM WEB*HOSTGATOR.COMBURLINGTON MACard 1231,15.99
1/26/2024,,Withdrawal POS #000000000001/IC* INSTACART*159 WWW.INSTACART.COM/ SANFRANCISCO CACard 1231,5.0,,Posted,148.47,2024-01-26,5.0,Withdrawal POS #000000803033/IC* INSTACART*159 WWW.INSTACART.COM/ SANFRANCISCO CACard 1231,5.0
1/26/2024,,Withdrawal POS #000000772467/IC* INSTACART*159 WWW.INSTACART.COM/ SANFRANCISCO CACard 1231,83.79,,Posted,153.47,2024-01-26,83.79,Withdrawal POS #000000795671/IC* INSTACART*159 WWW.INSTACART.COM/ SANFRANCISCO CACard 2801,83.79
1/25/2024,,Withdrawal POS #000000778591/SUNOCO 8002212501 4234 SW 20TH AVEGAINESVILLE FLCard 1231,30.08,,Posted,237.26,2024-01-25,30.08,Withdrawal POS #000000778591/SUNOCO 8002212501 4234 SW 20TH AVEGAINESVILLE FLCard 1231,30.39
1/23/2024,,Withdrawal POS #000000735703/SUNOCO 8002212501 4234 SW 20TH AVEGAINESVILLE FLCard 1231,15.35,,Posted,67.34,2024-01-23,15.35,Withdrawal POS #000000235720/SUNOCO 8002212501 4234 SW 20TH AVEGAINESVILLE FLCard 1231,15.135
1/22/2024,,Recurring Withdrawal Debit Card - MC Debit Seminol/RUNWAYML PRO PLAN NEWARK DEDate 01/22/24 0 4022751687 0 5734Card 1231,15.0,,Posted,82.69,2024-01-22,15.0,Recurring Withdrawal Debit Card - MC Debit Seminol/RUNWAY STANDARD PLAN NEWARK DEDate 12/15/24 0 4350745942 1 5734Card 1231,15.0
1/22/2024,,Recurring Withdrawal Debit Card - MC Debit Seminol/APPLE.COM/BILL 866-712-7753 CADate 01/21/24 0 4021893834 0 5818Card 1231,42.98,,Posted,97.69,2024-01-22,42.98,Recurring Withdrawal Debit Card - MC Debit Seminol/APPLE.COM/BILL 866-712-7753 CADate 01/08/24 0 4008756344 0 5818Card 2801,42.98
1/22/2024,,Withdrawal Debit Card MC Debit Seminol/LYFT 2 RIDES 01-20 8558659553 CADate 01/21/24 0 4021891955 0 4121Card 1231,21.14,,Posted,140.67,2024-01-22,21.14,Withdrawal Debit Card MC Debit Seminol/LYFT 2 RIDES 02-13 8558659553 CADate 02/14/24 0 4045828699 0 4121Card 1231,21.14
1/21/2024,,Withdrawal Debit Card MC Debit Seminol/CANVA* I04036-26173350 CAMDEN DEDate 01/20/24 0 4020778238 0 7221Card 1231,12.99,,Posted,161.81,2024-01-21,12.99,Withdrawal Debit Card MC Debit Seminol/CANVA* I04036-26173350 CAMDEN DEDate 01/20/24 0 4020778238 0 7221Card 1231,12.99
1/21/2024,,Withdrawal POS #000000806756/IC* INSTACART*159 WWW.INSTACART.COM/ SANFRANCISCO CACard 1231,3.0,,Posted,174.8,2024-01-21,3.0,Withdrawal POS #000000795671/IC* INSTACART*159 WWW.INSTACART.COM/ SANFRANCISCO CACard 2801,3.0
1/21/2024,,Withdrawal POS #000000782726/IC* INSTACART*159 WWW.INSTACART.COM/ SANFRANCISCO CACard 1231,65.09,,Posted,177.8,2024-01-21,65.09,Withdrawal POS #000000795671/IC* INSTACART*159 WWW.INSTACART.COM/ SANFRANCISCO CACard 2801,65.09
1/21/2024,,Withdrawal POS #000000000119/CIRCLE K # 26146 3525 GAINESVILLE FLCard 1231,32.07,,Posted,242.89,2024-01-21,32.07,Withdrawal POS #000010941641/CIRCLE K # 26146 3525 GAINESVILLE FLCard 1231,32.305
1/20/2024,,Withdrawal POS #000006039863/GOOGLE *YouTubePremium 1600 AmphitheatreParkw Mountain View CACard 1231,15.92,,Posted,74.96,2024-01-20,15.92,"Withdrawal POS #000020312090/GOOGLE *YouTubePremium 1600 Amphitheatre

Parkw Mountain View CA

Card 1247",15.92
1/19/2024,,Withdrawal Debit Card MC Debit Seminol/WALGREENS #5024 GAINESVILLE FLDate 01/18/24 0 4018883934 0 5912Card 1231,15.0,,Posted,90.88,2024-01-19,15.0,Withdrawal Debit Card MC Debit Seminol/WALGREENS #5024 GAINESVILLE FLDate 04/14/24 0 4105827629 0 5912Card 1231,15.0
1/18/2024,,Withdrawal POS #000020839973/SUNOCO 80022125 GAINESVILLE GAINESVILLECard 1231,36.53,,Posted,105.88,2024-01-18,36.53,Withdrawal POS #000020839973/SUNOCO 80022125 GAINESVILLE GAINESVILLECard 1231,36.53
1/16/2024,,Withdrawal POS #000000000000/IC* INSTACART*159 WWW.INSTACART.COM/ SANFRANCISCO CACard 1231,3.0,,Posted,136.11,2024-01-16,3.0,Withdrawal POS #000000803033/IC* INSTACART*159 WWW.INSTACART.COM/ SANFRANCISCO CACard 1231,3.0
1/16/2024,,Withdrawal POS #000000000071/IC* INSTACART*159 WWW.INSTACART.COM/ SANFRANCISCO CACard 1231,59.11,,Posted,139.11,2024-01-16,59.11,Withdrawal POS #000000795671/IC* INSTACART*159 WWW.INSTACART.COM/ SANFRANCISCO CACard 2801,59.11
1/16/2024,,Withdrawal POS #000020836462/SUNOCO 80022125 GAINESVILLE GAINESVILLECard 1231,10.0,,Posted,198.22,2024-01-16,10.0,Withdrawal POS #000020839973/SUNOCO 80022125 GAINESVILLE GAINESVILLECard 1231,10.0
1/15/2024,,Withdrawal POS #000020834526/SUNOCO 80022125 GAINESVILLE GAINESVILLECard 1231,36.53,,Posted,208.22,2024-01-15,36.53,Withdrawal POS #000020839973/SUNOCO 80022125 GAINESVILLE GAINESVILLECard 1231,36.53
1/14/2024,,Withdrawal POS #000000792113/IC* INSTACART*159 WWW.INSTACART.COM/ SANFRANCISCO CACard 1231,3.0,,Posted,244.75,2024-01-14,3.0,Withdrawal POS #000000795671/IC* INSTACART*159 WWW.INSTACART.COM/ SANFRANCISCO CACard 2801,3.0
1/14/2024,,Withdrawal POS #000000783971/IC* INSTACART*159 WWW.INSTACART.COM/ SANFRANCISCO CACard 1231,62.0,,Posted,247.75,2024-01-14,62.0,Withdrawal POS #000000795671/IC* INSTACART*159 WWW.INSTACART.COM/ SANFRANCISCO CACard 2801,62.0
1/14/2024,,Withdrawal POS #000000000017/CIRCLE K # 06782 5237 GAINESVILLE FLCard 1231,31.96,,Posted,309.75,2024-01-14,31.96,Withdrawal POS #000000882351/CIRCLE K # 06782 GAINESVILLE FLCard 1140,31.96
1/12/2024,,Withdrawal Debit Card MC Debit Seminol/MIDJOURNEY INC. SOUTH SAN FR CADate 01/11/24 0 4011746894 0 5734Card 1231,30.0,,Posted,341.71,2024-01-12,30.0,Withdrawal Debit Card MC Debit Seminol/MIDJOURNEY INC. SOUTH SAN FR CADate 10/16/23 0 3289666656 0 5734Card 2801,30.0
1/11/2024,,Withdrawal POS #000000000113/CIRCLE K # 26162 7302 GAINESVILLE FLCard 1231,28.32,,Posted,371.71,2024-01-11,28.32,Withdrawal POS #000010941641/CIRCLE K # 26146 3525 GAINESVILLE FLCard 1231,28.605
1/11/2024,,Withdrawal Debit Card Fee/MASTERCARD ISSUER CROSS-BORDER FEEDate 01/10/24 0 4010873277 0 8999Card 2801,0.57,,Posted,400.03,2024-01-11,0.57,Withdrawal Debit Card Fee/MASTERCARD ISSUER CROSS-BORDER FEEDate 03/01/25 0 5060117430 2 5967Card 1247,0.15333333333333332
1/11/2024,,Withdrawal Debit Card MC Debit Seminol/MERCADOPAGO*SUPERBUPER CAP.FEDERAL AVDate 01/10/24 0 4010873277 0 8999Card 2801,71.46,,Posted,400.6,2024-01-11,71.46,Withdrawal Debit Card MC Debit Seminol/MERCADOPAGO*SUPERBUPER CAP.FEDERAL AVDate 01/10/24 0 4010873277 0 8999Card 2801,71.46
1/11/2024,,Withdrawal Debit Card Fee/MASTERCARD ISSUER CROSS-BORDER FEEDate 01/10/24 0 4010868194 0 5571Card 2801,0.4,,Posted,472.06,2024-01-11,0.4,Withdrawal Debit Card Fee/MASTERCARD ISSUER CROSS-BORDER FEEDate 04/19/21 0 1109184122 1 7311Card 2801,0.1281818181818182
1/11/2024,,Withdrawal Debit Card MC Debit Seminol/HAULMER*VENTA DE MALL SANTIAGO CLDate 01/10/24 0 4010868194 0 5571Card 2801,50.21,,Posted,472.46,2024-01-11,50.21,Withdrawal Debit Card MC Debit Seminol/HAULMER*VENTA DE MALL SANTIAGO CLDate 01/10/24 0 4010868194 0 5571Card 2801,50.21
1/11/2024,,Withdrawal ACH KLARNA/TYPE: E4F7Z8C ID: 0514670203 CO: KLARNANAME: steven chaplinskiEntry Class Code: WEB,66.92,,Posted,522.67,2024-01-11,66.92,Withdrawal ACH KLARNA/TYPE: E4F7Z8C ID: 0514670203 CO: KLARNANAME: steven chaplinskiEntry Class Code: WEB,66.92
1/9/2024,,Recurring Withdrawal Debit Card - MC Debit Seminol/KDP AUTOMATION LAS VEGAS NVDate 01/09/24 0 4009846213 0 7392Card 2801,14.99,,Posted,570.04,2024-01-09,14.99,Recurring Withdrawal Debit Card - MC Debit Seminol/KDP AUTOMATION LAS VEGAS NVDate 01/09/24 0 4009846213 0 7392Card 2801,14.99
1/9/2024,,Recurring Withdrawal Debit Card - MC Debit Seminol/OPENAI SAN FRANCISC CADate 01/08/24 0 4008760800 0 5734Card 2801,5.83,,Posted,585.03,2024-01-09,5.83,Recurring Withdrawal Debit Card - MC Debit Seminol/VIDIQ SAN FRANCISC CADate 12/23/23 0 3357950683 0 5734Card 2801,5.83
1/9/2024,,Withdrawal Debit Card MC Debit Seminol/PAYPAL *PHOTOPEA 4029357733 CADate 01/08/24 0 4008760242 0 5734Card 2801,8.8,,Posted,590.86,2024-01-09,8.8,Withdrawal Debit Card MC Debit Seminol/PAYPAL *PHOTOPEA 4029357733 CADate 01/08/24 0 4008760242 0 5734Card 2801,8.8
1/9/2024,,Recurring Withdrawal Debit Card - MC Debit Seminol/MYDESIGNS.IO LAS VEGAS NVDate 01/08/24 0 4008793270 0 5734Card 2801,16.76,,Posted,599.66,2024-01-09,16.76,Withdrawal Debit Card MC Debit Seminol/MYDESIGNS.IO LAS VEGAS NVDate 01/07/24 0 4007751481 0 5734Card 2801,16.380000000000003
1/9/2024,,Withdrawal Debit Card MC Debit Seminol/ETSY.COM*AIAVATAR BROOKLYN NYDate 01/08/24 0 4008758895 0 5699Card 2801,11.55,,Posted,616.42,2024-01-09,11.55,Withdrawal Debit Card MC Debit Seminol/ETSY.COM*AIAVATAR BROOKLYN NYDate 01/08/24 0 4008758895 0 5699Card 2801,11.55
1/9/2024,,Recurring Withdrawal Debit Card - MC Debit Seminol/ETSY.COM*AIAVATAR BROOKLYN NYDate 01/08/24 0 4008758894 0 5699Card 2801,14.97,,Posted,627.97,2024-01-09,14.97,Recurring Withdrawal Debit Card - MC Debit Seminol/ETSY.COM*AIAVATAR BROOKLYN NYDate 10/01/23 0 3274789186 1 5970Card 2801,14.52
1/9/2024,,Recurring Withdrawal Debit Card - MC Debit Seminol/AMAZON PRIME*RT0NZ30U0 AMZN.COM/BIL WADate 01/08/24 0 4008298648 0 5968Card 2801,15.13,,Posted,642.94,2024-01-09,15.13,Recurring Withdrawal Debit Card - MC Debit Seminol/AMAZON PRIME*QP8EE86P3 AMZN.COM/BIL WADate 07/04/23 0 3185799509 0 5968Card 2801,15.13
1/9/2024,,Recurring Withdrawal Debit Card - MC Debit Seminol/APPLE.COM/BILL 866-712-7753 CADate 01/08/24 0 4008756344 0 5818Card 2801,2.99,,Posted,658.07,2024-01-09,2.99,Recurring Withdrawal Debit Card - MC Debit Seminol/APPLE.COM/BILL 866-712-7753 CADate 01/08/24 0 4008756344 0 5818Card 2801,2.99
1/9/2024,,Withdrawal POS #000000000001/AMAZON.COM*TK5HF56S1 SEATTLE WACard 2801,36.99,,Posted,661.06,2024-01-09,36.99,Withdrawal POS #000000630901/AMAZON.COM*ZA2053S23 SEATTLE WACard 2801,36.99
1/8/2024,,Recurring Withdrawal Debit Card Fee/MASTERCARD ISSUER CROSS-BORDER FEEDate 01/08/24 0 4008859029 0 5734Card 2801,0.24,,Posted,698.05,2024-01-08,0.24,Recurring Withdrawal Debit Card Fee/MASTERCARD ISSUER CROSS-BORDER FEEDate 01/06/24 0 4006875269 0 5815Card 2801,0.1366666666666667
1/8/2024,,Recurring Withdrawal Debit Card - MC Debit Seminol/ALURA SUBSCRIPTION OSLO DUDate 01/08/24 0 4008859029 0 5734Card 2801,29.99,,Posted,698.29,2024-01-08,29.99,Recurring Withdrawal Debit Card - MC Debit Seminol/ALURA SUBSCRIPTION OSLO DUDate 01/08/24 0 4008859029 0 5734Card 2801,29.99
1/8/2024,,Withdrawal Debit Card MC Debit Seminol/PRINTIFY.COM WILMINGTON DEDate 01/07/24 0 4007751687 0 7333Card 2801,26.85,,Posted,728.28,2024-01-08,26.85,Withdrawal Debit Card MC Debit Seminol/PRINTIFY.COM WILMINGTON DEDate 03/19/24 0 4079795188 0 7333Card 1231,26.85
1/8/2024,,Withdrawal Debit Card MC Debit Seminol/MYDESIGNS.IO LAS VEGAS NVDate 01/07/24 0 4007751481 0 5734Card 2801,50.0,,Posted,755.13,2024-01-08,50.0,Withdrawal Debit Card MC Debit Seminol/MYDESIGNS.IO LAS VEGAS NVDate 01/07/24 0 4007751481 0 5734Card 2801,50.0
1/8/2024,,Withdrawal Debit Card Fee/MASTERCARD ISSUER CROSS-BORDER FEEDate 01/07/24 0 4007255515 0 5734Card 2801,0.07,,Posted,805.13,2024-01-08,0.07,Withdrawal Debit Card Fee/MASTERCARD ISSUER CROSS-BORDER FEEDate 12/25/22 0 2359739765 0 5734Card 2801,0.16428571428571428
1/8/2024,,Withdrawal Debit Card MC Debit Seminol/IDEOGRAM.AI TORONTO ONDate 01/07/24 0 4007255515 0 5734Card 2801,8.38,,Posted,805.2,2024-01-08,8.38,Withdrawal Debit Card MC Debit Seminol/IDEOGRAM.AI TORONTO ONDate 04/15/24 0 4106835174 0 5734Card 1231,8.190000000000001
1/8/2024,,Withdrawal Debit Card MC Debit Seminol/ETSY.COM*AIAVATAR BROOKLYN NYDate 01/07/24 0 4007750413 0 5699Card 2801,19.55,,Posted,813.58,2024-01-08,19.55,Withdrawal Debit Card MC Debit Seminol/ETSY.COM*AIAVATAR BROOKLYN NYDate 01/08/24 0 4008758895 0 5699Card 2801,19.55
1/8/2024,,Withdrawal POS #000000000026/INSTACART*159 WWW.INSTACART.COM/ SANFRANCISCO CACard 2801,81.9,,Posted,833.13,2024-01-08,81.9,Withdrawal POS #000000000003/INSTACART*159 WWW.INSTACART.COM/ SANFRANCISCO CACard 1231,81.9
1/7/2024,,Withdrawal POS #000020838579/SUNOCO 80022125 GAINESVILLE GAINESVILLECard 2801,36.53,,Posted,915.03,2024-01-07,36.53,Withdrawal POS #000020839973/SUNOCO 80022125 GAINESVILLE GAINESVILLECard 1231,36.53
1/7/2024,,Recurring Withdrawal Debit Card - MC Debit Seminol/D-ID STUDIO WILMINGTON DEDate 01/06/24 0 4006082355 1 7399Card 2801,49.0,,Posted,951.56,2024-01-07,49.0,Recurring Withdrawal Debit Card - MC Debit Seminol/D-ID STUDIO WILMINGTON DEDate 10/13/24 0 4287011811 1 7399Card 1231,49.0
1/7/2024,,Recurring Withdrawal Debit Card - MC Debit Seminol/LINKTREE* LINKTREE DOVER DEDate 01/05/24 0 4005830282 1 5734Card 2801,14.99,,Posted,1000.56,2024-01-07,14.99,Recurring Withdrawal Debit Card - MC Debit Seminol/LINKTREE* LINKTREE DOVER DEDate 04/16/24 0 4107289275 0 7399Card 1231,14.99
1/7/2024,,Recurring Withdrawal Debit Card Fee/MASTERCARD ISSUER CROSS-BORDER FEEDate 01/06/24 0 4006875269 0 5815Card 2801,0.31,,Posted,1015.55,2024-01-07,0.31,Recurring Withdrawal Debit Card Fee/MASTERCARD ISSUER CROSS-BORDER FEEDate 01/06/24 0 4006875269 0 5815Card 2801,0.1366666666666667
1/7/2024,,Recurring Withdrawal Debit Card - MC Debit Seminol/PLAY.HT BANGALORE BEDate 01/06/24 0 4006875269 0 5815Card 2801,39.0,,Posted,1015.86,2024-01-07,39.0,Recurring Withdrawal Debit Card - MC Debit Seminol/PLAY.HT BANGALORE BEDate 01/06/24 0 4006875269 0 5815Card 2801,39.0
1/7/2024,,Recurring Withdrawal Debit Card - MC Debit Seminol/ELEVENLABS.IO NEW YORK NYDate 01/07/24 0 4007080576 1 5734Card 2801,5.0,,Posted,1054.86,2024-01-07,5.0,Withdrawal Debit Card MC Debit Seminol/ELEVENLABS.IO NEW YORK NYDate 10/07/23 0 3280076314 2 5734Card 2801,5.0
1/7/2024,,"Recurring Withdrawal Debit Card - MC Debit Seminol/MARMALEAD, LLC 4079065736 FLDate 01/05/24 0 4005822541 1 5045Card 2801",19.0,,Posted,1059.86,2024-01-07,19.0,"Recurring Withdrawal Debit Card - MC Debit Seminol/MARMALEAD, LLC 4079065736 FLDate 01/05/24 0 4005822541 1 5045Card 2801",19.0
1/6/2024,,Recurring Withdrawal Bill Payment - #000000166582/NETFLIX COM LOS GATOS CACard 2801,13.2,,Posted,1078.86,2024-01-06,13.2,Recurring Withdrawal Bill Payment - #000006911729/NETFLIX COM LOS GATOS CACard 2801,13.504999999999999
1/5/2024,,Recurring Withdrawal Debit Card - MC Debit Seminol/CHATGPT SUBSCRIPTION SAN FRANCISC CADate 01/04/24 0 4004307990 0 5734Card 2801,20.0,,Posted,1092.06,2024-01-05,20.0,Recurring Withdrawal Debit Card - MC Debit Seminol/CHATGPT SUBSCRIPTION SAN FRANCISC CADate 05/04/24 0 4125659188 0 5734Card 1231,20.0
1/5/2024,,Recurring Withdrawal Debit Card - MC Debit Seminol/WWW.EVERBEE.IO SANTEE CADate 01/05/24 0 4005834841 0 5734Card 2801,29.99,,Posted,1112.06,2024-01-05,29.99,Recurring Withdrawal Debit Card - MC Debit Seminol/WWW.EVERBEE.IO SANTEE CADate 01/05/24 0 4005834841 0 5734Card 2801,29.99
1/5/2024,,Recurring Withdrawal Debit Card - MC Debit Seminol/DISNEY PLUS 8889057888 CADate 01/04/24 0 4004768661 0 4899Card 2801,16.11,,Posted,1142.05,2024-01-05,16.11,Recurring Withdrawal Debit Card - MC Debit Seminol/DISNEY PLUS 8889057888 CADate 10/02/24 0 4276239357 1 4899Card 1231,16.11
1/5/2024,,Withdrawal Debit Card MC Debit Seminol/MAIL.COM 005802235076- PHILADELPHIA PADate 01/04/24 0 4004909282 0 4816Card 2801,14.95,,Posted,1158.16,2024-01-05,14.95,Withdrawal Debit Card MC Debit Seminol/MAIL.COM 005802235076- PHILADELPHIA PADate 01/04/24 0 4004909282 0 4816Card 2801,14.95
1/5/2024,,Recurring Withdrawal Debit Card - MC Debit Seminol/ADOBE *STOCK 4085366000 CADate 01/04/24 0 4004903002 0 5734Card 2801,29.99,,Posted,1173.11,2024-01-05,29.99,Recurring Withdrawal Debit Card - MC Debit Seminol/ADOBE *STOCK 4085366000 CADate 01/04/24 0 4004903002 0 5734Card 2801,29.99
1/4/2024,,Recurring Withdrawal Debit Card - MC Debit Seminol/MINDRENDERS.COM LAPEER MIDate 01/04/24 0 4004883312 0 5734Card 2801,5.0,,Posted,1203.1,2024-01-04,5.0,Recurring Withdrawal Debit Card - MC Debit Seminol/MINDRENDERS.COM LAPEER MIDate 01/04/24 0 4004883312 0 5734Card 2801,5.0
1/4/2024,,Withdrawal Debit Card MC Debit Seminol/IONOS INC. CHESTERBROOK PADate 01/03/24 0 4003951251 0 4816Card 2801,1.0,,Posted,1208.1,2024-01-04,1.0,Withdrawal Debit Card MC Debit Seminol/IONOS INC. CHESTERBROOK PADate 12/29/24 0 4364954464 0 4816Card 1231,0.8400000000000001
1/4/2024,,Recurring Withdrawal Debit Card - MC Debit Seminol/APPLE.COM/BILL CUPERTINO CADate 01/03/24 0 4003843327 0 5735Card 2801,2.99,,Posted,1209.1,2024-01-04,2.99,Withdrawal Debit Card MC Debit Seminol/APPLE.COM/BILL CUPERTINO CADate 08/18/23 0 3230028421 2 5735Card 2801,2.99
1/4/2024,,Recurring Withdrawal Debit Card - MC Debit Seminol/ADOBE *CREATIVE CLOUD 4085366000 CADate 01/03/24 0 4003945121 0 5734Card 2801,19.99,,Posted,1212.09,2024-01-04,19.99,Recurring Withdrawal Debit Card - MC Debit Seminol/ADOBE *CREATIVE CLOUD 4085366000 CADate 12/03/23 0 3337999974 0 5734Card 2801,19.99
1/4/2024,,Withdrawal ACH FLUENT-Gainesvil/TYPE: PAYMENT ID: 1371804719CO: FLUENT-GainesvilNAME: steven chaplinskiEntry Class Code: WEB,52.0,,Posted,1232.08,2024-01-04,52.0,Withdrawal ACH FLUENT-Gainesvil/TYPE: PAYMENT ID: 1371804719CO: FLUENT-GainesvilNAME: steven chaplinski,51.75
1/3/2024,,Recurring Withdrawal Debit Card - MC Debit Seminol/PARAMOUNT+ SAN FRANCISC CADate 01/02/24 0 4002821550 0 4899Card 2801,13.81,,Posted,1284.08,2024-01-03,13.81,Recurring Withdrawal Debit Card - MC Debit Seminol/PARAMOUNT+ SAN FRANCISC CADate 01/02/24 0 4002821550 0 4899Card 2801,13.81
1/3/2024,,Recurring Withdrawal Debit Card Fee/MASTERCARD ISSUER CROSS-BORDER FEEDate 01/02/24 0 4002821343 0 7399Card 2801,0.07,,Posted,1297.89,2024-01-03,0.07,Recurring Withdrawal Debit Card Fee/MASTERCARD ISSUER CROSS-BORDER FEEDate 05/14/23 0 3134938310 0 8299Card 2801,0.0925
1/3/2024,,Recurring Withdrawal Debit Card - MC Debit Seminol/CREATIVE FABRICA AMSTERDAM NHDate 01/02/24 0 4002821343 0 7399Card 2801,9.0,,Posted,1297.96,2024-01-03,9.0,Recurring Withdrawal Debit Card - MC Debit Seminol/CREATIVE FABRICA AMSTERDAM NHDate 10/03/24 0 4277044624 1 7399Card 1231,9.0
1/2/2024,,Withdrawal POS #010210787460/PAYPAL *SPOTIFYUSAI 2211 North FirstStreet San Jose CACard 2801,6.82,,Posted,1301.62,2024-01-02,6.82,Withdrawal POS #010210787460/PAYPAL *SPOTIFYUSAI 2211 North FirstStreet San Jose CACard 2801,6.82
1/2/2024,,Withdrawal POS #000000966158/SUNOCO 8002212501 4234 SW 20TH AVEGAINESVILLE FLCard 2801,34.56,,Posted,1308.44,2024-01-02,34.56,Withdrawal POS #000000955321/SUNOCO 8002212501 4234 SW 20TH AVEGAINESVILLE FLCard 2801,34.56
1/2/2024,,Withdrawal POS #000012002801/WALGREENS 3455 SW ARCH GAINESVILLE FLCard 2801,20.38,,Posted,1343.0,2024-01-02,20.38,Withdrawal POS #000012002801/WALGREENS 3455 SW ARCH GAINESVILLE FLCard 2801,20.755
1/2/2024,,Recurring Withdrawal Debit Card - MC Debit Seminol/NAME-CHEAP.COM* NNMBEK PHOENIX AZDate 01/01/24 0 4001676508 0 7372Card 2801,10.46,,Posted,1363.38,2024-01-02,10.46,Recurring Withdrawal Debit Card - MC Debit Seminol/NAME-CHEAP.COM* NNMBEK PHOENIX AZDate 01/01/24 0 4001676508 0 7372Card 2801,10.46
1/2/2024,,Recurring Withdrawal Debit Card - MC Debit Seminol/WPDEVELOPER MILTON DEDate 01/02/24 0 4002616374 0 7372Card 2801,39.0,,Posted,1373.84,2024-01-02,39.0,Recurring Withdrawal Debit Card - MC Debit Seminol/WPDEVELOPER MILTON DEDate 01/02/24 0 4002616374 0 7372Card 2801,39.0
1/2/2024,,Recurring Withdrawal Debit Card - MC Debit Seminol/PADDLE.NET* KAIBER AI ASTORIA NYDate 01/01/24 0 4001675678 0 5817Card 2801,15.0,,Posted,1412.84,2024-01-02,15.0,Recurring Withdrawal Debit Card - MC Debit Seminol/PADDLE.NET* LEONARDOAI ASTORIA NYDate 12/16/24 0 4351323834 0 5817Card 1231,15.0
1/2/2024,,Withdrawal Debit Card MC Debit Seminol/PRINTIFY.COM WILMINGTON DEDate 01/01/24 0 4001649319 0 7333Card 2801,11.21,,Posted,1427.84,2024-01-02,11.21,Withdrawal Debit Card MC Debit Seminol/PRINTIFY.COM WILMINGTON DEDate 03/19/24 0 4079795188 0 7333Card 1231,11.21
1/2/2024,,Recurring Withdrawal Debit Card - MC Debit Seminol/FS *ADOBE SANTA BARBAR CADate 01/01/24 0 4001674859 0 5734Card 2801,9.99,,Posted,1439.05,2024-01-02,9.99,Recurring Withdrawal Debit Card - MC Debit Seminol/FS *ADOBE SANTA BARBAR CADate 12/24/24 0 4359034647 1 5734Card 1231,9.99
1/2/2024,,Withdrawal Debit Card MC Debit Seminol/CHIPOTLE ONLINE CHIPOTLE.COM CADate 01/02/24 0 4002615532 0 5814Card 2801,45.0,,Posted,1449.04,2024-01-02,45.0,Withdrawal Debit Card MC Debit Seminol/CHIPOTLE ONLINE CHIPOTLE.COM CADate 05/14/24 0 4135921741 0 5814Card 1231,45.0
1/2/2024,,Recurring Withdrawal Debit Card - MC Debit Seminol/ADOBE *PS CREATIVE CL 4085366000 CADate 01/01/24 0 4001644620 0 5734Card 2801,22.99,,Posted,1494.04,2024-01-02,22.99,Recurring Withdrawal Debit Card - MC Debit Seminol/ADOBE *STOCK 4085366000 CADate 01/04/24 0 4004903002 0 5734Card 2801,22.99
1/2/2024,,Withdrawal ACH Watson Realty Co/TYPE: WEB PMTS ID: 9000321157CO: Watson Realty CoNAME: Steven chaplinskiEntry Class Code: WEB,1079.0,,Posted,1517.03,2024-01-02,1079.0,Withdrawal ACH Watson Realty Co/TYPE: WEB PMTS ID: 9000321157CO: Watson Realty CoEntry Class Code: WEB,1079.0
1/2/2024,,"Withdrawal ACH AppFolio, Inc. F/TYPE: WEB PMTS ID: 9001406550CO: AppFolio, Inc. FNAME: Steven chaplinskiEntry Class Code: WEB",2.49,,Posted,2596.03,2024-01-02,2.49,"Withdrawal ACH AppFolio, Inc. F/TYPE: WEB PMTS ID: 9001406550

CO: AppFolio, Inc. F

NAME: Steven chaplinskiEntry Class Code: WEB",2.49
1/1/2024,,Withdrawal Debit Card MC Debit Seminol/INTERNET MARKETING SOL PARKERSBURG WVDate 12/31/23 0 3365856927 0 7392Card 2801,37.0,,Posted,2598.52,2024-01-01,37.0,Withdrawal Debit Card MC Debit Seminol/INTERNET MARKETING SOL PARKERSBURG WVDate 12/31/23 0 3365856927 0 7392Card 2801,37.0
1/1/2024,,Recurring Withdrawal Debit Card - MC Debit Seminol/LEMSQZY* KWESTIFY SALT LAKE CI UTDate 12/31/23 0 3365856866 0 5734Card 2801,12.0,,Posted,2635.52,2024-01-01,12.0,Recurring Withdrawal Debit Card - MC Debit Seminol/LEMSQZY* KWESTIFY SALT LAKE CI UTDate 12/31/23 0 3365856866 0 5734Card 2801,12.0
1/1/2024,,Withdrawal Debit Card MC Debit Seminol/INTERNET MARKETING SOL PARKERSBURG WVDate 12/31/23 0 3365227002 0 7392Card 2801,12.0,,Posted,2647.52,2024-01-01,12.0,Withdrawal Debit Card MC Debit Seminol/INTERNET MARKETING SOL PARKERSBURG WVDate 12/31/23 0 3365856927 0 7392Card 2801,12.0
1/1/2024,,"Withdrawal Debit Card MC Debit Seminol/PIXEL ML, INC. LAS VEGAS NVDate 12/31/23 0 3365226971 0 5734Card 2801",9.0,,Posted,2659.52,2024-01-01,9.0,"Withdrawal Debit Card MC Debit Seminol/PIXEL ML, INC. LAS VEGAS NVDate 12/31/23 0 3365226971 0 5734Card 2801",9.0
1/1/2024,,Withdrawal Debit Card Fee/MASTERCARD ISSUER CROSS-BORDER FEEDate 01/01/24 0 4001856471 0 5734Card 2801,0.12,,Posted,2668.52,2024-01-01,0.12,Withdrawal Debit Card Fee/MASTERCARD ISSUER CROSS-BORDER FEEDate 04/19/21 0 1109184122 1 7311Card 2801,0.1281818181818182
1/1/2024,,Withdrawal Debit Card MC Debit Seminol/HOSTINGER.COM LARNAKA CYDate 01/01/24 0 4001856471 0 5734Card 2801,14.98,,Posted,2668.64,2024-01-01,14.98,Withdrawal Debit Card MC Debit Seminol/HOSTINGER.COM LARNAKA CYDate 01/01/24 0 4001856471 0 5734Card 2801,14.98
1/1/2024,,Recurring Withdrawal Debit Card - MC Debit Seminol/MYDESIGNS - PRO - MON LAS VEGAS NVDate 01/01/24 0 4001780983 0 5734Card 2801,29.99,,Posted,2683.62,2024-01-01,29.99,Withdrawal Debit Card MC Debit Seminol/MYDESIGNS - PRO - MON LAS VEGAS NVDate 09/01/23 0 3244164229 1 5734Card 2801,29.99
1/1/2024,,Recurring Withdrawal Debit Card Fee/MASTERCARD ISSUER CROSS-BORDER FEEDate 12/31/23 0 3365740203 0 5734Card 2801,0.2,,Posted,2713.61,2024-01-01,0.2,Recurring Withdrawal Debit Card Fee/MASTERCARD ISSUER CROSS-BORDER FEEDate 12/31/23 0 3365740203 0 5734Card 2801,0.175
1/1/2024,,Recurring Withdrawal Debit Card - MC Debit Seminol/MERCHDOMINATOR.COM LONDON LNDate 12/31/23 0 3365740203 0 5734Card 2801,24.5,,Posted,2713.81,2024-01-01,24.5,Recurring Withdrawal Debit Card - MC Debit Seminol/MERCHDOMINATOR.COM LONDON LNDate 12/31/23 0 3365740203 0 5734Card 2801,24.5
1/1/2024,,Recurring Withdrawal Debit Card - MC Debit Seminol/ETSY.COM*AIAVATAR BROOKLYN NYDate 01/01/24 0 4001780812 0 5970Card 2801,21.2,,Posted,2738.31,2024-01-01,21.2,Recurring Withdrawal Debit Card - MC Debit Seminol/ETSY.COM*AIAVATAR BROOKLYN NYDate 10/01/23 0 3274789186 1 5970Card 2801,21.2
1/1/2024,,Withdrawal Debit Card MC Debit Seminol/ETSY.COM*AIAVATAR BROOKLYN NYDate 01/01/24 0 4001780748 0 5699Card 2801,14.07,,Posted,2759.51,2024-01-01,14.07,Recurring Withdrawal Debit Card - MC Debit Seminol/ETSY.COM*AIAVATAR BROOKLYN NYDate 10/01/23 0 3274789186 1 5970Card 2801,14.52
1/1/2024,,Withdrawal Debit Card MC Debit Seminol/GRU/EZ-PAY WEB PYMT 352-334-3434 FLDate 12/31/23 0 3365848981 0 4900Card 2801,149.11,,Posted,2773.58,2024-01-01,149.11,Withdrawal Debit Card MC Debit Seminol/GRU/EZ-PAY WEB PYMT 352-334-3434 FLDate 12/05/24 0 4340279271 0 4900Card 1231,149.11
1/1/2024,,Withdrawal POS #000000890165/SUNOCO 8002212501 4234 SW 20TH AVEGAINESVILLE FLCard 2801,29.5,,Posted,2922.69,2024-01-01,29.5,Withdrawal POS #000000955321/SUNOCO 8002212501 4234 SW 20TH AVEGAINESVILLE FLCard 2801,29.5
12/31/2023,,Recurring Withdrawal Debit Card Fee/MASTERCARD ISSUER CROSS-BORDER FEEDate 12/29/23 0 3363663127 1 5734Card 2801,0.24,,Posted,2862.19,2023-12-31,0.24,Recurring Withdrawal Debit Card Fee/MASTERCARD ISSUER CROSS-BORDER FEEDate 11/02/23 0 3306889171 0 7399Card 2801,0.185
12/31/2023,,Recurring Withdrawal Debit Card - MC Debit Seminol/KITTL.COM BERLIN BEDate 12/29/23 0 3363663127 1 5734Card 2801,30.0,,Posted,2862.43,2023-12-31,30.0,Recurring Withdrawal Debit Card - MC Debit Seminol/KITTL.COM BERLIN BEDate 12/29/23 0 3363663127 1 5734Card 2801,30.0
12/31/2023,,Recurring Withdrawal Debit Card Fee/MASTERCARD ISSUER CROSS-BORDER FEEDate 12/29/23 0 3363662310 1 5734Card 2801,0.06,,Posted,2892.43,2023-12-31,0.06,Recurring Withdrawal Debit Card Fee/MASTERCARD ISSUER CROSS-BORDER FEEDate 12/11/21 0 1345316936 1 5817Card 2801,0.08666666666666667
12/31/2023,,Recurring Withdrawal Debit Card - MC Debit Seminol/IDEOGRAM.AI TORONTO ONDate 12/29/23 0 3363662310 1 5734Card 2801,8.0,,Posted,2892.49,2023-12-31,8.0,Recurring Withdrawal Debit Card - MC Debit Seminol/IDEOGRAM AI TORONTO ONDate 12/17/24 0 4352700468 1 5734Card 1231,8.0
12/31/2023,,Withdrawal Debit Card MC Debit Seminol/PLAYSTATIONNETWORK SAN MATEO CADate 12/31/23 0 3365872496 0 5816Card 2801,89.99,,Posted,2900.49,2023-12-31,89.99,Withdrawal Debit Card MC Debit Seminol/PLAYSTATIONNETWORK SAN MATEO CADate 12/31/23 0 3365872496 0 5816Card 2801,89.985
12/31/2023,,Withdrawal Debit Card MC Debit Seminol/ETSY.COM*AIAVATAR BROOKLYN NYDate 12/31/23 0 3365776697 0 5699Card 2801,2.5,,Posted,2990.48,2023-12-31,2.5,Recurring Withdrawal Debit Card - MC Debit Seminol/ETSY.COM*AIAVATAR BROOKLYN NYDate 10/01/23 0 3274789186 1 5970Card 2801,2.8600000000000003
12/31/2023,,Withdrawal Debit Card MC Debit Seminol/COX GAINESVILLE COMM 800-234-3993 FLDate 12/30/23 0 3364773034 0 4899Card 2801,81.13,,Posted,2992.98,2023-12-31,81.13,Withdrawal Debit Card MC Debit Seminol/COX GAINESVILLE COMM 800-234-3993 FLDate 12/04/24 0 4339376311 0 4899Card 1231,81.13
12/30/2023,,Withdrawal POS #000000000004/INSTACART*159 WWW.INSTACART.COM/ SANFRANCISCO CACard 2801,134.45,,Posted,3074.11,2023-12-30,134.45,Withdrawal POS #000000000003/INSTACART*159 WWW.INSTACART.COM/ SANFRANCISCO CACard 1231,134.45
12/29/2023,,Recurring Withdrawal Debit Card Fee/MASTERCARD ISSUER CROSS-BORDER FEEDate 12/28/23 0 3362846037 0 5734Card 2801,0.08,,Posted,408.56,2023-12-29,0.08,Withdrawal Debit Card Fee/MASTERCARD ISSUER CROSS-BORDER FEEDate 12/25/22 0 2359739765 0 5734Card 2801,0.16428571428571428
12/29/2023,,Recurring Withdrawal Debit Card - MC Debit Seminol/TRACEJOURNEY DARMSTADT BEDate 12/28/23 0 3362846037 0 5734Card 2801,10.0,,Posted,408.64,2023-12-29,10.0,Recurring Withdrawal Debit Card - MC Debit Seminol/TRACEJOURNEY DARMSTADT BEDate 12/28/23 0 3362846037 0 5734Card 2801,10.0
12/29/2023,,Recurring Withdrawal Debit Card Fee/MASTERCARD ISSUER CROSS-BORDER FEEDate 12/29/23 0 3363914191 0 5734Card 2801,0.13,,Posted,418.64,2023-12-29,0.13,Recurring Withdrawal Debit Card Fee/MASTERCARD ISSUER CROSS-BORDER FEEDate 10/25/23 0 3298820645 0 5734Card 2801,0.12
12/29/2023,,Recurring Withdrawal Debit Card - MC Debit Seminol/VANCEAI CENTRAL HODate 12/29/23 0 3363914191 0 5734Card 2801,15.9,,Posted,418.77,2023-12-29,15.9,Recurring Withdrawal Debit Card - MC Debit Seminol/VANCEAI CENTRAL HODate 06/15/24 0 4167922806 1 5734Card 1231,15.9
12/28/2023,,Recurring Withdrawal Debit Card Fee/MASTERCARD ISSUER CROSS-BORDER FEEDate 12/28/23 0 3362741008 0 5734Card 2801,0.16,,Posted,434.67,2023-12-28,0.16,Recurring Withdrawal Debit Card Fee/MASTERCARD ISSUER CROSS-BORDER FEEDate 06/11/22 0 2162900620 0 5734Card 2801,0.07500000000000001
12/28/2023,,Recurring Withdrawal Debit Card - MC Debit Seminol/ETSYHUNT TECH SINGAPORE SGDate 12/28/23 0 3362741008 0 5734Card 2801,19.99,,Posted,434.83,2023-12-28,19.99,Recurring Withdrawal Debit Card - MC Debit Seminol/ETSYHUNT* TRIAL OVER SINGAPORE SGDate 10/27/23 0 3300915753 1 5734Card 2801,19.99
12/27/2023,,Withdrawal Debit Card MC Debit Seminol/IONOS INC. CHESTERBROOK PADate 12/26/23 0 3360761872 0 4816Card 2801,16.0,,Posted,454.82,2023-12-27,16.0,Withdrawal Debit Card MC Debit Seminol/IONOS INC. CHESTERBROOK PADate 12/29/24 0 4364954464 0 4816Card 1231,16.0
12/27/2023,,Withdrawal ACH KLARNA/TYPE: E4F7Z8C ID: 0514670203 CO: KLARNANAME: steven chaplinskiEntry Class Code: WEB,66.92,,Posted,470.82,2023-12-27,66.92,Withdrawal ACH KLARNA/TYPE: E4F7Z8C ID: 0514670203 CO: KLARNANAME: steven chaplinskiEntry Class Code: WEB,66.92
12/26/2023,,Withdrawal Debit Card MC Debit Seminol/WWW.DARBEE.IO MOUNT PROSPE ILDate 12/25/23 0 3359421946 0 5734Card 2801,8.0,,Posted,537.74,2023-12-26,8.0,Withdrawal Debit Card MC Debit Seminol/WWW.DARBEE.IO MOUNT PROSPE ILDate 12/25/23 0 3359421946 0 5734Card 2801,8.0
12/26/2023,,Recurring Withdrawal Debit Card - MC Debit Seminol/SHOPIFY* 209984801 ELK GROVE VI ILDate 12/26/23 0 3360264224 0 5734Card 2801,1.0,,Posted,545.74,2023-12-26,1.0,Recurring Withdrawal Debit Card - MC Debit Seminol/SHOPIFY* 209984801 ELK GROVE VI ILDate 12/26/23 0 3360264224 0 5734Card 2801,1.0
12/26/2023,,Withdrawal Debit Card MC Debit Seminol/PADDLE.NET* REBRANDY ASTORIA NYDate 12/25/23 0 3359421538 0 5817Card 2801,10.99,,Posted,546.74,2023-12-26,10.99,Withdrawal Debit Card MC Debit Seminol/PADDLE.NET* REBRANDY ASTORIA NYDate 12/25/23 0 3359421538 0 5817Card 2801,10.99
12/25/2023,,Withdrawal POS #000000677826/WAWA 5323 4322 SW ARCHER RD GAINESVILLECard 2801,30.52,,Posted,557.73,2023-12-25,30.52,Withdrawal POS #000000677826/WAWA 5323 4322 SW ARCHER RD GAINESVILLECard 2801,30.52
12/25/2023,,Recurring Withdrawal Debit Card - MC Debit Seminol/QUILLBOT OAK BROOK ILDate 12/25/23 0 3359752154 0 5734Card 2801,19.95,,Posted,588.25,2023-12-25,19.95,Recurring Withdrawal Debit Card - MC Debit Seminol/QUILLBOT OAK BROOK ILDate 12/25/23 0 3359752154 0 5734Card 2801,19.95
12/25/2023,,Withdrawal Debit Card MC Debit Seminol/CHIPOTLE ONLINE CHIPOTLE.COM CADate 12/25/23 0 3359751543 0 5814Card 2801,13.19,,Posted,608.2,2023-12-25,13.19,Withdrawal Debit Card MC Debit Seminol/CHIPOTLE ONLINE CHIPOTLE.COM CADate 05/14/24 0 4135921741 0 5814Card 1231,13.19
12/24/2023,,Recurring Withdrawal Debit Card Fee/MASTERCARD ISSUER CROSS-BORDER FEEDate 12/24/23 0 3358055608 1 5734Card 2801,0.07,,Posted,621.39,2023-12-24,0.07,Recurring Withdrawal Debit Card Fee/MASTERCARD ISSUER CROSS-BORDER FEEDate 10/25/23 0 3298820645 0 5734Card 2801,0.12
12/24/2023,,Recurring Withdrawal Debit Card - MC Debit Seminol/DRIVE EXPLORER ADDON MADURAI TNDate 12/24/23 0 3358055608 1 5734Card 2801,9.0,,Posted,621.46,2023-12-24,9.0,Recurring Withdrawal Debit Card - MC Debit Seminol/DRIVE EXPLORER ADDON MADURAI TNDate 12/24/23 0 3358055608 1 5734Card 2801,9.0
12/24/2023,,Withdrawal Debit Card MC Debit Seminol/MYDESIGNS.IO LAS VEGAS NVDate 12/23/23 0 3357067234 2 5734Card 2801,16.0,,Posted,630.46,2023-12-24,16.0,Withdrawal Debit Card MC Debit Seminol/MYDESIGNS.IO LAS VEGAS NVDate 01/07/24 0 4007751481 0 5734Card 2801,16.380000000000003
12/24/2023,,Recurring Withdrawal Debit Card - MC Debit Seminol/PADDLE.NET* BAVARIA2TM ASTORIA NYDate 12/22/23 0 3356595223 0 5817Card 2801,39.95,,Posted,646.46,2023-12-24,39.95,Recurring Withdrawal Debit Card - MC Debit Seminol/PADDLE.NET* BAVARIA2TM ASTORIA NYDate 12/22/23 0 3356595223 0 5817Card 2801,39.95
12/24/2023,,Withdrawal Debit Card MC Debit Seminol/MYDESIGNS.IO LAS VEGAS NVDate 12/22/23 0 3356016708 2 5734Card 2801,16.0,,Posted,686.41,2023-12-24,16.0,Withdrawal Debit Card MC Debit Seminol/MYDESIGNS.IO LAS VEGAS NVDate 01/07/24 0 4007751481 0 5734Card 2801,16.380000000000003
12/24/2023,,Recurring Withdrawal Debit Card - MC Debit Seminol/VIDIQ SAN FRANCISC CADate 12/23/23 0 3357950683 0 5734Card 2801,10.0,,Posted,702.41,2023-12-24,10.0,Recurring Withdrawal Debit Card - MC Debit Seminol/VIDIQ SAN FRANCISC CADate 12/23/23 0 3357950683 0 5734Card 2801,10.0
12/24/2023,,Recurring Withdrawal Debit Card Fee/MASTERCARD ISSUER CROSS-BORDER FEEDate 12/23/23 0 3357950389 0 5734Card 2801,0.04,,Posted,712.41,2023-12-24,0.04,Withdrawal Debit Card Fee/MASTERCARD ISSUER CROSS-BORDER FEEDate 12/25/22 0 2359739765 0 5734Card 2801,0.16428571428571428
12/24/2023,,Recurring Withdrawal Debit Card - MC Debit Seminol/IMAGINEAPI.DEV EDMONTON ABDate 12/23/23 0 3357950389 0 5734Card 2801,5.0,,Posted,712.45,2023-12-24,5.0,Recurring Withdrawal Debit Card - MC Debit Seminol/IMAGINEAPI.DEV EDMONTON ABDate 12/23/23 0 3357950389 0 5734Card 2801,5.0
12/24/2023,,Recurring Withdrawal Debit Card Fee/MASTERCARD ISSUER CROSS-BORDER FEEDate 12/22/23 0 3356066505 2 5734Card 2801,0.15,,Posted,717.45,2023-12-24,0.15,Recurring Withdrawal Debit Card Fee/MASTERCARD ISSUER CROSS-BORDER FEEDate 12/31/23 0 3365740203 0 5734Card 2801,0.175
12/24/2023,,Recurring Withdrawal Debit Card - MC Debit Seminol/AU UP ADACHIKU TODate 12/22/23 0 3356066505 2 5734Card 2801,19.0,,Posted,717.6,2023-12-24,19.0,Recurring Withdrawal Debit Card - MC Debit Seminol/AU UP ADACHIKU TODate 12/22/23 0 3356066505 2 5734Card 2801,19.0
12/24/2023,,Withdrawal Debit Card MC Debit Seminol/SAMSUNG ELECTRONICS RIDGEFIELD P NJDate 12/22/23 0 3356065481 2 5734Card 2801,15.99,,Posted,736.6,2023-12-24,15.99,Withdrawal Debit Card MC Debit Seminol/SAMSUNG ELECTRONICS RIDGEFIELD P NJDate 12/27/24 0 4362999827 1 5734Card 1231,16.49
12/24/2023,,Withdrawal POS #000000000015/CIRCLE K # 06782 5237 GAINESVILLE FLCard 2801,24.33,,Posted,752.59,2023-12-24,24.33,Withdrawal POS #000000001638/CIRCLE K # 06527 9404 GAINESVILLE FLCard 2801,24.33
12/23/2023,,Withdrawal POS #000002040482/GOOGLE *Google Storage 1600 AmphitheatreParkw Mountain View CACard 2801,1.99,,Posted,776.92,2023-12-23,1.99,Withdrawal POS #000002040482/GOOGLE *Google Storage 1600 AmphitheatreParkw Mountain View CACard 2801,1.99
12/22/2023,,Withdrawal POS #000000512490/SUNOCO 8002212501 4234 SW 20TH AVEGAINESVILLE FLCard 2801,38.1,,Posted,778.91,2023-12-22,38.1,Withdrawal POS #000000955321/SUNOCO 8002212501 4234 SW 20TH AVEGAINESVILLE FLCard 2801,38.1
12/22/2023,,Recurring Withdrawal Debit Card - MC Debit Seminol/SOCIETY6.COM SANTA MONICA CADate 12/22/23 0 3356093278 1 7333Card 2801,4.99,,Posted,817.01,2023-12-22,4.99,Recurring Withdrawal Debit Card - MC Debit Seminol/SOCIETY6.COM SANTA MONICA CADate 12/22/23 0 3356093278 1 7333Card 2801,4.99
12/22/2023,,"Recurring Withdrawal Debit Card - MC Debit Seminol/AIPRM, CORP. WILMINGTON DEDate 12/21/23 0 3355965402 0 5734Card 2801",9.0,,Posted,822.0,2023-12-22,9.0,"Recurring Withdrawal Debit Card - MC Debit Seminol/AIPRM, CORP. WILMINGTON DEDate 12/21/23 0 3355965402 0 5734Card 2801",9.355
12/22/2023,,Recurring Withdrawal Debit Card - MC Debit Seminol/PADDLE.NET* BAVARIA2TM ASTORIA NYDate 12/22/23 0 3356092061 1 5817Card 2801,19.95,,Posted,831.0,2023-12-22,19.95,Recurring Withdrawal Debit Card - MC Debit Seminol/PADDLE.NET* BAVARIA2TM ASTORIA NYDate 12/22/23 0 3356595223 0 5817Card 2801,19.95
12/22/2023,,Recurring Withdrawal Debit Card - MC Debit Seminol/PADDLE.NET* BAVARIA2TM ASTORIA NYDate 12/21/23 0 3355092060 1 5817Card 2801,49.95,,Posted,850.95,2023-12-22,49.95,Recurring Withdrawal Debit Card - MC Debit Seminol/PADDLE.NET* BAVARIA2TM ASTORIA NYDate 12/22/23 0 3356595223 0 5817Card 2801,49.95
12/22/2023,,Recurring Withdrawal Debit Card - MC Debit Seminol/WWW.MAKE.COM NEW YORK NYDate 12/21/23 0 3355964412 0 5734Card 2801,10.59,,Posted,900.9,2023-12-22,10.59,Recurring Withdrawal Debit Card - MC Debit Seminol/WWW.MAKE.COM NEW YORK NYDate 12/21/23 0 3355964412 0 5734Card 2801,10.59
12/22/2023,,Withdrawal Debit Card MC Debit Seminol/ETSY.COM*AIAVATAR BROOKLYN NYDate 12/22/23 0 3356021599 1 5970Card 2801,17.03,,Posted,911.49,2023-12-22,17.03,Recurring Withdrawal Debit Card - MC Debit Seminol/ETSY.COM*AIAVATAR BROOKLYN NYDate 10/01/23 0 3274789186 1 5970Card 2801,16.990000000000002
12/22/2023,,Withdrawal ACH FLUENT-Gainesvil/TYPE: PAYMENT ID: 1371804719CO: FLUENT-GainesvilNAME: steven chaplinskiEntry Class Code: WEB,140.4,,Posted,928.52,2023-12-22,140.4,Withdrawal ACH FLUENT-Gainesvil/TYPE: PAYMENT ID: 1371804719CO: FLUENT-GainesvilNAME: steven chaplinski,140.4
12/21/2023,,Recurring Withdrawal Debit Card - MC Debit Seminol/SUPERPOWER CHATGPT MIDDLETOWN DEDate 12/20/23 0 3354887306 0 5734Card 2801,15.19,,Posted,1068.92,2023-12-21,15.19,Recurring Withdrawal Debit Card - MC Debit Seminol/SUPERPOWER CHATGPT MIDDLETOWN DEDate 12/17/24 0 4352703539 1 5734Card 1231,15.094999999999999
12/21/2023,,Withdrawal Debit Card MC Debit Seminol/YVETTE GODET DMD PA GAINESVILLE FLDate 12/20/23 0 3354886410 0 8021Card 2801,90.0,,Posted,1084.11,2023-12-21,90.0,Withdrawal Debit Card MC Debit Seminol/YVETTE GODET DMD PA GAINESVILLE FLDate 12/20/23 0 3354886410 0 8021Card 2801,90.0
12/21/2023,,Recurring Withdrawal Debit Card - MC Debit Seminol/CANVA* I04005-37462786 CAMDEN DEDate 12/20/23 0 3354886372 0 7221Card 2801,12.99,,Posted,1174.11,2023-12-21,12.99,Recurring Withdrawal Debit Card - MC Debit Seminol/CANVA* I04005-37462786 CAMDEN DEDate 12/20/23 0 3354886372 0 7221Card 2801,12.99
12/21/2023,,Withdrawal Debit Card MC Debit Seminol/WALGREENS #9304 GAINESVILLE FLDate 12/20/23 0 3354958966 0 5912Card 2801,12.97,,Posted,1187.1,2023-12-21,12.97,Withdrawal Debit Card MC Debit Seminol/WALGREENS #9304 GAINESVILLE FLDate 12/20/23 0 3354958966 0 5912Card 2801,12.97
12/21/2023,,Withdrawal Debit Card MC Debit Seminol/WALGREENS #5024 GAINESVILLE FLDate 12/20/23 0 3354958934 0 5912Card 2801,15.0,,Posted,1200.07,2023-12-21,15.0,Withdrawal Debit Card MC Debit Seminol/WALGREENS #5024 GAINESVILLE FLDate 06/26/23 0 3177001861 1 5912Card 2801,15.0
12/20/2023,,Withdrawal POS #000000030009/PUBLIX 3930 SW ARCHER ROAD GAINESVILLECard 2801,179.55,,Posted,1125.07,2023-12-20,179.55,Withdrawal POS #000000753028/PUBLIX 3930 SW ARCHER ROAD GAINESVILLECard 1247,179.55
12/20/2023,,Withdrawal POS #000000546857/SUNOCO 8002212501 4234 SW 20TH AVEGAINESVILLE FLCard 2801,22.53,,Posted,1304.62,2023-12-20,22.53,Withdrawal POS #000000955321/SUNOCO 8002212501 4234 SW 20TH AVEGAINESVILLE FLCard 2801,22.569999999999997
12/20/2023,,Withdrawal POS #000003048219/GOOGLE *YouTubePremium 1600 AmphitheatreParkw Mountain View CACard 2801,15.92,,Posted,1327.15,2023-12-20,15.92,Withdrawal POS #000003285955/GOOGLE *YouTubePremium 1600 AmphitheatreParkw Mountain View CACard 2801,15.92
12/19/2023,,Withdrawal POS #000019162189/WALGREENS 2415 SW 75TH GAINESVILLE FLCard 2801,11.81,,Posted,1343.07,2023-12-19,11.81,Withdrawal POS #000015057686/WALGREENS 2415 SW 75TH GAINESVILLE FLCard 1231,11.355
12/19/2023,,Withdrawal POS #000000501588/SUNOCO 8002212501 4234 SW 20TH AVEGAINESVILLE FLCard 2801,20.68,,Posted,1354.88,2023-12-19,20.68,Withdrawal POS #000000550998/SUNOCO 8002212501 4234 SW 20TH AVEGAINESVILLE FLCard 2801,20.68
12/19/2023,,Recurring Withdrawal Debit Card - MC Debit Seminol/MYDESIGNS.IO LAS VEGAS NVDate 12/18/23 0 3352803630 0 5734Card 2801,26.04,,Posted,1375.56,2023-12-19,26.04,Recurring Withdrawal Debit Card - MC Debit Seminol/MYDESIGNS.IO LAS VEGAS NVDate 10/18/24 0 4292077676 2 5734Card 1231,26.04
12/19/2023,,Withdrawal POS #000000494960/SUNOCO 8002212501 4234 SW 20TH AVEGAINESVILLE FLCard 2801,30.81,,Posted,1401.6,2023-12-19,30.81,Withdrawal POS #000000899960/SUNOCO 8002212501 4234 SW 20TH AVEGAINESVILLE FLCard 2801,30.369999999999997
12/19/2023,,Withdrawal Bill Payment #000000478995/EIG*HOSTGATOR.COM WEB*HOSTGATOR.COMBURLINGTON MACard 2801,31.98,,Posted,1432.41,2023-12-19,31.98,Withdrawal Bill Payment #000000737187/EIG*HOSTGATOR.COM WEB*HOSTGATOR.COMBURLINGTON MACard 1231,31.98
12/18/2023,,Recurring Withdrawal Debit Card - MC Debit Seminol/TUBEBUDDYCOM 8668823239 CADate 12/17/23 0 3351973822 0 5734Card 2801,7.5,,Posted,1464.39,2023-12-18,7.5,Recurring Withdrawal Debit Card - MC Debit Seminol/TUBEBUDDYCOM* 8668823239 CADate 12/03/24 0 4338443995 0 5045Card 1231,7.5
12/17/2023,,Recurring Withdrawal Debit Card - MC Debit Seminol/HELLOCUSTOM REDDING CADate 12/16/23 0 3350121941 2 5734Card 2801,29.99,,Posted,1471.89,2023-12-17,29.99,Recurring Withdrawal Debit Card - MC Debit Seminol/HELLOCUSTOM REDDING CADate 12/16/23 0 3350121941 2 5734Card 2801,29.99
12/17/2023,,Withdrawal Debit Card MC Debit Seminol/WWW.VIVOPRINT.COM FREMONT CADate 12/15/23 0 3349081630 2 5399Card 2801,22.26,,Posted,1501.88,2023-12-17,22.26,Withdrawal Debit Card MC Debit Seminol/WWW.VIVOPRINT.COM FREMONT CADate 12/15/23 0 3349081630 2 5399Card 2801,22.26
12/16/2023,,Withdrawal POS #000000795671/IC* INSTACART*159 WWW.INSTACART.COM/ SANFRANCISCO CACard 2801,75.79,,Posted,1524.14,2023-12-16,75.79,Withdrawal POS #000000795671/IC* INSTACART*159 WWW.INSTACART.COM/ SANFRANCISCO CACard 2801,75.79
12/16/2023,,Withdrawal POS #000000776371/IC* INSTACART*159 WWW.INSTACART.COM/ SANFRANCISCO CACard 2801,5.0,,Posted,1599.93,2023-12-16,5.0,Withdrawal POS #000000795671/IC* INSTACART*159 WWW.INSTACART.COM/ SANFRANCISCO CACard 2801,5.0
12/16/2023,,Withdrawal POS #000000296387/SUNOCO 8002212501 4234 SW 20TH AVEGAINESVILLE FLCard 2801,21.91,,Posted,1604.93,2023-12-16,21.91,Withdrawal POS #000000866633/SUNOCO 8002212501 4234 SW 20TH AVEGAINESVILLE FLCard 2801,21.91
12/15/2023,,Withdrawal POS #000000291004/SUNOCO 8002212501 4234 SW 20TH AVEGAINESVILLE FLCard 2801,33.72,,Posted,1526.84,2023-12-15,33.72,Withdrawal POS #000000899960/SUNOCO 8002212501 4234 SW 20TH AVEGAINESVILLE FLCard 2801,33.849999999999994
12/14/2023,,Recurring Withdrawal Debit Card - MC Debit Seminol/APPLE.COM/BILL 866-712-7753 CADate 12/13/23 0 3347838871 0 5818Card 2801,39.99,,Posted,1560.56,2023-12-14,39.99,Recurring Withdrawal Debit Card - MC Debit Seminol/APPLE.COM/BILL 866-712-7753 CADate 12/13/23 0 3347838871 0 5818Card 2801,39.99
12/14/2023,,Withdrawal ACH KLARNA/TYPE: E4F7Z8C ID: 0514670203 CO: KLARNANAME: steven chaplinskiEntry Class Code: WEB,66.92,,Posted,1600.55,2023-12-14,66.92,Withdrawal ACH KLARNA/TYPE: E4F7Z8C ID: 0514670203 CO: KLARNANAME: steven chaplinskiEntry Class Code: WEB,66.92
12/13/2023,,Withdrawal Debit Card MC Debit Seminol/PLAYSTATIONNETWORK SAN MATEO CADate 12/12/23 0 3346849436 0 5816Card 2801,39.99,,Posted,1667.47,2023-12-13,39.99,Withdrawal Debit Card MC Debit Seminol/PLAYSTATIONNETWORK SAN MATEO CADate 12/31/23 0 3365872496 0 5816Card 2801,39.99
12/13/2023,,Recurring Withdrawal Debit Card - MC Debit Seminol/APPLE.COM/BILL 866-712-7753 CADate 12/13/23 0 3347983231 0 5818Card 2801,2.99,,Posted,1707.46,2023-12-13,2.99,Recurring Withdrawal Debit Card - MC Debit Seminol/APPLE.COM/BILL 866-712-7753 CADate 09/16/23 0 3259205559 2 5818Card 2801,2.99
12/13/2023,,Withdrawal ACH FLUENT-Gainesvil/TYPE: PAYMENT ID: 1371804719CO: FLUENT-GainesvilNAME: steven chaplinskiEntry Class Code: WEB,53.5,,Posted,1710.45,2023-12-13,53.5,Withdrawal ACH FLUENT-Gainesvil/TYPE: PAYMENT ID: 1371804719CO: FLUENT-GainesvilNAME: steven chaplinski,53.75
12/12/2023,,Recurring Withdrawal Debit Card - MC Debit Seminol/OPUS CLIP REDWOOD CITY CADate 12/11/23 0 3345860166 0 7372Card 2801,19.0,,Posted,1763.95,2023-12-12,19.0,Recurring Withdrawal Debit Card - MC Debit Seminol/OPUS CLIP REDWOOD CITY CADate 12/11/23 0 3345860166 0 7372Card 2801,19.0
12/12/2023,,Withdrawal Debit Card Fee/MASTERCARD ISSUER CROSS-BORDER FEEDate 12/12/23 0 3346905405 0 5734Card 2801,0.08,,Posted,1782.95,2023-12-12,0.08,Withdrawal Debit Card Fee/MASTERCARD ISSUER CROSS-BORDER FEEDate 12/25/22 0 2359739765 0 5734Card 2801,0.16428571428571428
12/12/2023,,Withdrawal Debit Card MC Debit Seminol/WWW.STABILITY.AI LONDON LNDate 12/12/23 0 3346905405 0 5734Card 2801,10.0,,Posted,1783.03,2023-12-12,10.0,Withdrawal Debit Card MC Debit Seminol/WWW.STABILITY.AI LONDON LNDate 12/12/23 0 3346905405 0 5734Card 2801,10.0
12/12/2023,,Withdrawal Debit Card MC Debit Seminol/SCRUBS CARWASH - GAINE GAINESVILLE FLDate 12/11/23 0 3345931229 0 7542Card 2801,5.75,,Posted,1793.03,2023-12-12,5.75,Withdrawal Debit Card MC Debit Seminol/SCRUBS CARWASH - GAINE GAINESVILLE FLDate 11/29/24 0 4334403825 2 7542Card 1231,5.875
12/11/2023,,Withdrawal POS #000000067493/PUBLIX 3930 SW ARCHER ROAD GAINESVILLECard 2801,108.61,,Posted,1798.78,2023-12-11,108.61,Withdrawal POS #000000753028/PUBLIX 3930 SW ARCHER ROAD GAINESVILLECard 1247,108.61
12/11/2023,,Recurring Withdrawal Debit Card - MC Debit Seminol/MIDJOURNEY INC. SOUTH SAN FR CADate 12/10/23 0 3344002786 1 5734Card 2801,30.0,,Posted,1907.39,2023-12-11,30.0,Withdrawal Debit Card MC Debit Seminol/MIDJOURNEY INC. SOUTH SAN FR CADate 10/16/23 0 3289666656 0 5734Card 2801,30.0
12/11/2023,,Withdrawal POS #000000074576/SUNOCO 8002212501 4234 SW 20TH AVEGAINESVILLE FLCard 2801,33.62,,Posted,1937.39,2023-12-11,33.62,Withdrawal POS #000000409276/SUNOCO 8002212501 4234 SW 20TH AVEGAINESVILLE FLCard 2801,33.62
12/10/2023,,Withdrawal Debit Card MC Debit Seminol/WALGREENS #9304 GAINESVILLE FLDate 12/08/23 0 3342073508 2 5912Card 2801,26.79,,Posted,1971.01,2023-12-10,26.79,Withdrawal Debit Card MC Debit Seminol/WALGREENS #9304 GAINESVILLE FLDate 12/20/23 0 3354958966 0 5912Card 2801,26.79
12/10/2023,,Withdrawal Debit Card MC Debit Seminol/AMAZON PRIME*PE3IN5Y03 AMZN.COM/BIL WADate 12/08/23 0 3342550116 0 5968Card 2801,15.15,,Posted,1997.8,2023-12-10,15.15,Withdrawal Debit Card MC Debit Seminol/AMAZON PRIME*PE3IN5Y03 AMZN.COM/BIL WADate 12/08/23 0 3342550116 0 5968Card 2801,15.14
12/8/2023,,Withdrawal POS #000000788111/PUBLIX 3100 SW 35TH BLVD GAINESVILLE FLCard 2801,58.29,,Posted,2012.95,2023-12-08,58.29,Withdrawal POS #000000058955/PUBLIX 3100 SW 35TH BLVD GAINESVILLE FLCard 2801,58.075
12/8/2023,,Recurring Withdrawal Debit Card Fee/MASTERCARD ISSUER CROSS-BORDER FEEDate 12/08/23 0 3342028707 1 5734Card 2801,0.24,,Posted,2071.24,2023-12-08,0.24,Recurring Withdrawal Debit Card Fee/MASTERCARD ISSUER CROSS-BORDER FEEDate 08/08/23 0 3220043177 1 7399Card 2801,0.156
12/8/2023,,Recurring Withdrawal Debit Card - MC Debit Seminol/ALURA SUBSCRIPTION OSLO DUDate 12/08/23 0 3342028707 1 5734Card 2801,29.99,,Posted,2071.48,2023-12-08,29.99,Recurring Withdrawal Debit Card - MC Debit Seminol/ALURA SUBSCRIPTION OSLO DUDate 01/08/24 0 4008859029 0 5734Card 2801,29.99
12/8/2023,,Recurring Withdrawal Debit Card - MC Debit Seminol/LASTPASS.COM MADate 12/07/23 0 3341331845 0 5968Card 2801,36.0,,Posted,2101.47,2023-12-08,36.0,Recurring Withdrawal Debit Card - MC Debit Seminol/LASTPASS.COM MADate 12/07/23 0 3341331845 0 5968Card 2801,36.0
12/7/2023,,Recurring Withdrawal Debit Card - MC Debit Seminol/D-ID STUDIO WILMINGTON DEDate 12/06/23 0 3340019761 1 7399Card 2801,49.0,,Posted,2137.47,2023-12-07,49.0,Recurring Withdrawal Debit Card - MC Debit Seminol/D-ID STUDIO WILMINGTON DEDate 10/13/24 0 4287011811 1 7399Card 1231,49.0
12/7/2023,,Recurring Withdrawal Debit Card - MC Debit Seminol/OPENAI SAN FRANCISC CADate 12/06/23 0 3340019724 1 5734Card 2801,0.63,,Posted,2186.47,2023-12-07,0.63,Recurring Withdrawal Debit Card - MC Debit Seminol/VIDIQ SAN FRANCISC CADate 12/23/23 0 3357950683 0 5734Card 2801,1.1
12/7/2023,,Recurring Withdrawal Debit Card Fee/MASTERCARD ISSUER CROSS-BORDER FEEDate 12/06/23 0 3340942652 0 5815Card 2801,0.31,,Posted,2187.1,2023-12-07,0.31,Withdrawal Debit Card Fee/MASTERCARD ISSUER CROSS-BORDER FEEDate 10/06/23 0 3279122045 2 5815Card 2801,0.20833333333333334
12/7/2023,,Recurring Withdrawal Debit Card - MC Debit Seminol/PLAY.HT BANGALORE BEDate 12/06/23 0 3340942652 0 5815Card 2801,39.0,,Posted,2187.41,2023-12-07,39.0,Withdrawal Debit Card MC Debit Seminol/PLAY.HT BANGALORE BEDate 10/06/23 0 3279122045 2 5815Card 2801,39.0
12/7/2023,,Recurring Withdrawal Debit Card - MC Debit Seminol/ELEVENLABS.IO NEW YORK NYDate 12/07/23 0 3341924592 0 5734Card 2801,5.0,,Posted,2226.41,2023-12-07,5.0,Withdrawal Debit Card MC Debit Seminol/ELEVENLABS.IO NEW YORK NYDate 10/07/23 0 3280076314 2 5734Card 2801,5.0
12/7/2023,,Recurring Withdrawal Debit Card - MC Debit Seminol/NETFLIX.COM CADate 12/06/23 0 3340936032 0 4899Card 2801,13.2,,Posted,2231.41,2023-12-07,13.2,Recurring Withdrawal Debit Card - MC Debit Seminol/NETFLIX.COM CADate 02/09/24 0 4040905249 0 4899Card 1231,13.2
12/6/2023,,Withdrawal Debit Card MC Debit Seminol/WWW.VIVOPRINT.COM FREMONT CADate 12/05/23 0 3339923190 0 5399Card 2801,18.97,,Posted,2244.61,2023-12-06,18.97,Withdrawal Debit Card MC Debit Seminol/WWW.VIVOPRINT.COM FREMONT CADate 12/15/23 0 3349081630 2 5399Card 2801,18.97
12/6/2023,,Recurring Withdrawal Debit Card Fee/MASTERCARD ISSUER CROSS-BORDER FEEDate 12/06/23 0 3340923092 0 5734Card 2801,0.12,,Posted,2263.58,2023-12-06,0.12,Recurring Withdrawal Debit Card Fee/MASTERCARD ISSUER CROSS-BORDER FEEDate 05/14/23 0 3134938310 0 8299Card 2801,0.0925
12/6/2023,,Recurring Withdrawal Debit Card - MC Debit Seminol/LINKTREE* LINKTREE COLLINGWOOD VIDate 12/06/23 0 3340923092 0 5734Card 2801,14.99,,Posted,2263.7,2023-12-06,14.99,Recurring Withdrawal Debit Card - MC Debit Seminol/LINKTREE* LINKTREE COLLINGWOOD VIDate 12/06/23 0 3340923092 0 5734Card 2801,14.99
12/6/2023,,Recurring Withdrawal Debit Card - MC Debit Seminol/APPLE.COM/BILL 866-712-7753 CADate 12/06/23 0 3340922343 0 5818Card 2801,5.98,,Posted,2278.69,2023-12-06,5.98,Recurring Withdrawal Debit Card - MC Debit Seminol/APPLE.COM/BILL 866-712-7753 CADate 09/16/23 0 3259205559 2 5818Card 2801,5.98
12/6/2023,,Recurring Withdrawal Debit Card - MC Debit Seminol/APPLE.COM/BILL 866-712-7753 CADate 12/06/23 0 3340921934 0 5818Card 2801,2.99,,Posted,2284.67,2023-12-06,2.99,Recurring Withdrawal Debit Card - MC Debit Seminol/APPLE.COM/BILL 866-712-7753 CADate 09/16/23 0 3259205559 2 5818Card 2801,2.99
12/6/2023,,Withdrawal Debit Card MC Debit Seminol/GRU/EZ-PAY WEB PYMT 352-334-3434 FLDate 12/05/23 0 3339324917 0 4900Card 2801,136.45,,Posted,2287.66,2023-12-06,136.45,Withdrawal Debit Card MC Debit Seminol/GRU/EZ-PAY WEB PYMT 352-334-3434 FLDate 12/05/24 0 4340279271 0 4900Card 1231,136.45
12/6/2023,,Withdrawal Debit Card MC Debit Seminol/COX GAINESVILLE COMM 800-234-3993 FLDate 12/05/23 0 3339324895 0 4899Card 2801,159.46,,Posted,2424.11,2023-12-06,159.46,Withdrawal Debit Card MC Debit Seminol/COX GAINESVILLE COMM 800-234-3993 FLDate 12/04/24 0 4339376311 0 4899Card 1231,159.46
12/6/2023,,"Recurring Withdrawal Debit Card - MC Debit Seminol/MARMALEAD, LLC 4079065736 FLDate 12/05/23 0 3339916108 0 5045Card 2801",19.0,,Posted,2583.57,2023-12-06,19.0,"Recurring Withdrawal Debit Card - MC Debit Seminol/MARMALEAD, LLC 4079065736 FLDate 01/05/24 0 4005822541 1 5045Card 2801",19.0
12/5/2023,,Withdrawal POS #000000914637/SUNOCO 8002212501 4234 SW 20TH AVEGAINESVILLE FLCard 2801,27.27,,Posted,2602.57,2023-12-05,27.27,Withdrawal POS #000000866633/SUNOCO 8002212501 4234 SW 20TH AVEGAINESVILLE FLCard 2801,27.27
12/5/2023,,Withdrawal POS #000000735733/PUBLIX 3315 W. UNIVERSITY AVE.FLCard 2801,51.71,,Posted,2629.84,2023-12-05,51.71,Withdrawal POS #000000749495/PUBLIX 3315 W. UNIVERSITY AVE.FLCard 1231,51.71
12/5/2023,,Recurring Withdrawal Debit Card - MC Debit Seminol/CHATGPT SUBSCRIPTION SAN FRANCISC CADate 12/04/23 0 3338320191 0 5734Card 2801,20.0,,Posted,2681.55,2023-12-05,20.0,Recurring Withdrawal Debit Card - MC Debit Seminol/CHATGPT SUBSCRIPTION SAN FRANCISC CADate 05/04/24 0 4125659188 0 5734Card 1231,20.0
12/5/2023,,Recurring Withdrawal Debit Card - MC Debit Seminol/WWW.EVERBEE.IO SANTEE CADate 12/05/23 0 3339857361 0 5734Card 2801,29.99,,Posted,2701.55,2023-12-05,29.99,Recurring Withdrawal Debit Card - MC Debit Seminol/WWW.EVERBEE.IO SANTEE CADate 01/05/24 0 4005834841 0 5734Card 2801,29.99
12/5/2023,,Recurring Withdrawal Debit Card - MC Debit Seminol/DISNEY PLUS 8889057888 CADate 12/04/23 0 3338792430 0 4899Card 2801,16.11,,Posted,2731.54,2023-12-05,16.11,Recurring Withdrawal Debit Card - MC Debit Seminol/DISNEY PLUS 8889057888 CADate 10/02/24 0 4276239357 1 4899Card 1231,16.11
12/5/2023,,Recurring Withdrawal Debit Card - MC Debit Seminol/ADOBE *STOCK 4085366000 CADate 12/04/23 0 3338964178 0 5734Card 2801,29.99,,Posted,2747.65,2023-12-05,29.99,Recurring Withdrawal Debit Card - MC Debit Seminol/ADOBE *CREATIVE CLOUD 4085366000 CADate 12/03/23 0 3337999974 0 5734Card 2801,29.99
12/4/2023,,Recurring Withdrawal Debit Card - MC Debit Seminol/ENVATO 61383766284 UTDate 12/03/23 0 3337000060 1 5815Card 2801,23.0,,Posted,2777.64,2023-12-04,23.0,Recurring Withdrawal Debit Card - MC Debit Seminol/ENVATO 61383766284 UTDate 12/03/23 0 3337000060 1 5815Card 2801,23.0
12/4/2023,,Recurring Withdrawal Debit Card - MC Debit Seminol/ADOBE *CREATIVE CLOUD 4085366000 CADate 12/03/23 0 3337999974 0 5734Card 2801,19.99,,Posted,2800.64,2023-12-04,19.99,Recurring Withdrawal Debit Card - MC Debit Seminol/ADOBE *CREATIVE CLOUD 4085366000 CADate 12/03/23 0 3337999974 0 5734Card 2801,19.99
12/4/2023,,Withdrawal ACH Watson Realty Co/TYPE: WEB PMTS ID: 9000321157CO: Watson Realty CoNAME: Steven chaplinskiEntry Class Code: WEB,1079.0,,Posted,2820.63,2023-12-04,1079.0,Withdrawal ACH Watson Realty Co/TYPE: WEB PMTS ID: 9000321157CO: Watson Realty CoEntry Class Code: WEB,1079.0
12/4/2023,,"Withdrawal ACH AppFolio, Inc. F/TYPE: WEB PMTS ID: 9001406550CO: AppFolio, Inc. FNAME: Steven chaplinskiEntry Class Code: WEB",2.49,,Posted,3899.63,2023-12-04,2.49,"Withdrawal ACH AppFolio, Inc. F/TYPE: WEB PMTS ID: 9001406550

CO: AppFolio, Inc. F

NAME: Steven chaplinskiEntry Class Code: WEB",2.49
12/3/2023,,Recurring Withdrawal Debit Card - MC Debit Seminol/PARAMOUNT+ SAN FRANCISC CADate 12/02/23 0 3336902908 0 4899Card 2801,13.81,,Posted,3902.11,2023-12-03,13.81,Recurring Withdrawal Debit Card - MC Debit Seminol/VIDIQ SAN FRANCISC CADate 12/23/23 0 3357950683 0 5734Card 2801,13.81
12/3/2023,,Recurring Withdrawal Debit Card Fee/MASTERCARD ISSUER CROSS-BORDER FEEDate 12/02/23 0 3336902692 0 7399Card 2801,0.07,,Posted,3915.92,2023-12-03,0.07,Recurring Withdrawal Debit Card Fee/MASTERCARD ISSUER CROSS-BORDER FEEDate 04/20/23 0 3110864064 0 7333Card 2801,0.15111111111111108
12/3/2023,,Recurring Withdrawal Debit Card - MC Debit Seminol/CREATIVE FABRICA AMSTERDAM NHDate 12/02/23 0 3336902692 0 7399Card 2801,9.0,,Posted,3915.99,2023-12-03,9.0,Recurring Withdrawal Debit Card - MC Debit Seminol/CREATIVE FABRICA AMSTERDAM NHDate 10/03/24 0 4277044624 1 7399Card 1231,9.0
12/3/2023,,Recurring Withdrawal Debit Card - MC Debit Seminol/KAIBER AI WILMINGTON DEDate 12/01/23 0 3335109742 2 5815Card 2801,15.0,,Posted,3924.99,2023-12-03,15.0,Recurring Withdrawal Debit Card - MC Debit Seminol/KAIBER AI WILMINGTON DEDate 08/30/23 0 3242340816 0 5815Card 2801,15.0
12/3/2023,,Recurring Withdrawal Debit Card - MC Debit Seminol/ETSY.COM*THEKREATUREFE BROOKLYN NYDate 12/02/23 0 3336050320 2 5970Card 2801,0.2,,Posted,3939.99,2023-12-03,0.2,Recurring Withdrawal Debit Card - MC Debit Seminol/ETSY.COM*THEKREATUREFE BROOKLYN NYDate 12/02/23 0 3336050320 2 5970Card 2801,0.2
12/3/2023,,Recurring Withdrawal Debit Card - MC Debit Seminol/ETSY.COM*FEATUREDKREAT BROOKLYN NYDate 12/02/23 0 3336050313 2 5970Card 2801,0.2,,Posted,3940.19,2023-12-03,0.2,Recurring Withdrawal Debit Card - MC Debit Seminol/ETSY.COM*THEKREATUREFE BROOKLYN NYDate 12/02/23 0 3336050320 2 5970Card 2801,0.2
12/3/2023,,Recurring Withdrawal Debit Card - MC Debit Seminol/FS *ADOBE SANTA BARBAR CADate 12/01/23 0 3335107710 2 5734Card 2801,9.99,,Posted,3940.39,2023-12-03,9.99,Recurring Withdrawal Debit Card - MC Debit Seminol/FS *ADOBE SANTA BARBAR CADate 12/24/24 0 4359034647 1 5734Card 1231,9.99
12/3/2023,,Recurring Withdrawal Debit Card - MC Debit Seminol/ADOBE *PS CREATIVE CL 4085366000 CADate 12/01/23 0 3335099237 2 5734Card 2801,22.99,,Posted,3950.38,2023-12-03,22.99,Recurring Withdrawal Debit Card - MC Debit Seminol/ADOBE *CREATIVE CLOUD 4085366000 CADate 12/03/23 0 3337999974 0 5734Card 2801,22.99
12/3/2023,,Withdrawal POS #000000000004/CIRCLE K # 06782 5237 GAINESVILLE FLCard 2801,27.97,,Posted,3973.37,2023-12-03,27.97,Withdrawal POS #000000000343/CIRCLE K # 06782 5237 GAINESVILLE FLCard 1247,27.97
12/1/2023,,Recurring Withdrawal Debit Card - MC Debit Seminol/SALESAMURAI SOFTWARE BOULDER CODate 12/01/23 0 3335918185 0 5734Card 2801,39.99,,Posted,4001.34,2023-12-01,39.99,Withdrawal Debit Card MC Debit Seminol/SALESAMURAI.IO SFTWARE BOULDER CODate 11/13/23 0 3317927273 0 5734Card 2801,39.99
12/1/2023,,Recurring Withdrawal Debit Card - MC Debit Seminol/MYDESIGNS - PRO - MON LAS VEGAS NVDate 12/01/23 0 3335916562 0 5734Card 2801,29.99,,Posted,4041.33,2023-12-01,29.99,Withdrawal Debit Card MC Debit Seminol/MYDESIGNS - PRO - MON LAS VEGAS NVDate 09/01/23 0 3244164229 1 5734Card 2801,29.99
12/1/2023,,Recurring Withdrawal Debit Card - MC Debit Seminol/ETSY.COM*AIAVATAR BROOKLYN NYDate 12/01/23 0 3335916254 0 5970Card 2801,37.84,,Posted,4071.32,2023-12-01,37.84,Recurring Withdrawal Debit Card - MC Debit Seminol/ETSY.COM*AIAVATAR BROOKLYN NYDate 10/01/23 0 3274789186 1 5970Card 2801,37.84
11/30/2023,,Withdrawal POS #000000673237/SUNOCO 8002212501 4234 SW 20TH AVEGAINESVILLE FLCard 2801,33.62,,Posted,4109.16,2023-11-30,33.62,Withdrawal POS #000000866633/SUNOCO 8002212501 4234 SW 20TH AVEGAINESVILLE FLCard 2801,33.245
11/30/2023,,Recurring Withdrawal Debit Card Fee/MASTERCARD ISSUER CROSS-BORDER FEEDate 11/29/23 0 3333836208 0 5734Card 2801,0.24,,Posted,4142.78,2023-11-30,0.24,Recurring Withdrawal Debit Card Fee/MASTERCARD ISSUER CROSS-BORDER FEEDate 04/20/23 0 3110864064 0 7333Card 2801,0.15111111111111108
11/30/2023,,Recurring Withdrawal Debit Card - MC Debit Seminol/KITTL.COM BERLIN BEDate 11/29/23 0 3333836208 0 5734Card 2801,30.0,,Posted,4143.02,2023-11-30,30.0,Recurring Withdrawal Debit Card - MC Debit Seminol/KITTL.COM BERLIN BEDate 12/29/23 0 3363663127 1 5734Card 2801,30.0
11/30/2023,,Withdrawal Debit Card MC Debit Seminol/AUTOMATEPOD CENTENNIAL CODate 11/30/23 0 3334861916 0 5815Card 2801,14.99,,Posted,4173.02,2023-11-30,14.99,Withdrawal Debit Card MC Debit Seminol/AUTOMATEPOD CENTENNIAL CODate 11/30/23 0 3334861916 0 5815Card 2801,14.99
11/30/2023,,Withdrawal Debit Card Fee/MASTERCARD ISSUER CROSS-BORDER FEEDate 11/29/23 0 3333835711 0 5734Card 2801,0.06,,Posted,4188.01,2023-11-30,0.06,Withdrawal Debit Card Fee/MASTERCARD ISSUER CROSS-BORDER FEEDate 12/25/22 0 2359739765 0 5734Card 2801,0.16428571428571428
11/30/2023,,Withdrawal Debit Card MC Debit Seminol/IDEOGRAM.AI TORONTO ONDate 11/29/23 0 3333835711 0 5734Card 2801,8.0,,Posted,4188.07,2023-11-30,8.0,Withdrawal Debit Card MC Debit Seminol/IDEOGRAM.AI TORONTO ONDate 04/15/24 0 4106835174 0 5734Card 1231,8.190000000000001
11/29/2023,,Withdrawal POS #000000805513/Instacart 50 Beal St Suite 600 SanFrancisco CACard 2801,5.0,,Posted,4196.07,2023-11-29,5.0,Withdrawal POS #000000805513/Instacart 50 Beal St Suite 600 SanFrancisco CACard 2801,5.0
11/29/2023,,Withdrawal POS #000000802668/Instacart 50 Beal St Suite 600 SanFrancisco CACard 2801,101.07,,Posted,4201.07,2023-11-29,101.07,Withdrawal POS #000000802668/Instacart 50 Beal St Suite 600 SanFrancisco CACard 2801,101.07
11/29/2023,,Withdrawal Debit Card MC Debit Seminol/KLARNA COLUMBUS OHDate 11/29/23 0 3333041255 1 5999Card 2801,66.92,,Posted,4302.14,2023-11-29,66.92,Withdrawal Debit Card MC Debit Seminol/KLARNA COLUMBUS OHDate 11/29/23 0 3333041255 1 5999Card 2801,66.92
11/29/2023,,Recurring Withdrawal Debit Card Fee/MASTERCARD ISSUER CROSS-BORDER FEEDate 11/28/23 0 3332825932 0 5734Card 2801,0.08,,Posted,4369.06,2023-11-29,0.08,Recurring Withdrawal Debit Card Fee/MASTERCARD ISSUER CROSS-BORDER FEEDate 08/08/23 0 3220043177 1 7399Card 2801,0.156
11/29/2023,,Recurring Withdrawal Debit Card - MC Debit Seminol/TRACEJOURNEY DARMSTADT BEDate 11/28/23 0 3332825932 0 5734Card 2801,10.0,,Posted,4369.14,2023-11-29,10.0,Recurring Withdrawal Debit Card - MC Debit Seminol/TRACEJOURNEY DARMSTADT BEDate 12/28/23 0 3362846037 0 5734Card 2801,10.0
11/29/2023,,Withdrawal Debit Card MC Debit Seminol/PAYPAL *PHOTOPEA 4029357733 CADate 11/28/23 0 3332041156 1 5734Card 2801,8.8,,Posted,4379.14,2023-11-29,8.8,Withdrawal Debit Card MC Debit Seminol/PAYPAL *PHOTOPEA 4029357733 CADate 01/08/24 0 4008760242 0 5734Card 2801,8.8
11/29/2023,,Recurring Withdrawal Debit Card Fee/MASTERCARD ISSUER CROSS-BORDER FEEDate 11/29/23 0 3333040670 1 5734Card 2801,0.13,,Posted,4387.94,2023-11-29,0.13,Recurring Withdrawal Debit Card Fee/MASTERCARD ISSUER CROSS-BORDER FEEDate 11/02/23 0 3306889171 0 7399Card 2801,0.185
11/29/2023,,Recurring Withdrawal Debit Card - MC Debit Seminol/VANCEAI CENTRAL HODate 11/29/23 0 3333040670 1 5734Card 2801,15.9,,Posted,4388.07,2023-11-29,15.9,Withdrawal Debit Card MC Debit Seminol/VANCEAI CENTRAL HODate 06/29/23 0 3180070895 1 5734Card 2801,15.9
11/29/2023,,Withdrawal POS #000000002769/AMAZON.COM*XR9VQ0EW3 SEATTLE WACard 2801,42.99,,Posted,4403.97,2023-11-29,42.99,Withdrawal POS #000000002769/AMAZON.COM*XR9VQ0EW3 SEATTLE WACard 2801,42.99
11/29/2023,,Withdrawal POS #000000353089/AMAZON.COM*D84KU4CA3 SEATTLE WACard 2801,47.26,,Posted,4446.96,2023-11-29,47.26,Withdrawal POS #000000736780/AMAZON.COM*U78AZ3Q63 SEATTLE WACard 2801,47.26
11/28/2023,,Recurring Withdrawal Debit Card Fee/MASTERCARD ISSUER CROSS-BORDER FEEDate 11/28/23 0 3332875963 0 5734Card 2801,0.16,,Posted,1694.22,2023-11-28,0.16,Recurring Withdrawal Debit Card Fee/MASTERCARD ISSUER CROSS-BORDER FEEDate 10/25/23 0 3298820645 0 5734Card 2801,0.12
11/28/2023,,Recurring Withdrawal Debit Card - MC Debit Seminol/ETSYHUNT TECH SINGAPORE SGDate 11/28/23 0 3332875963 0 5734Card 2801,19.99,,Posted,1694.38,2023-11-28,19.99,Recurring Withdrawal Debit Card - MC Debit Seminol/ETSYHUNT* TRIAL OVER SINGAPORE SGDate 10/27/23 0 3300915753 1 5734Card 2801,19.99
11/28/2023,,Withdrawal POS #000007355341/PAYPAL *MYDESIGNS 2211 North FirstSan Jose CACard 2801,10.0,,Posted,1714.37,2023-11-28,10.0,Withdrawal POS #000007355341/PAYPAL *MYDESIGNS 2211 North FirstSan Jose CACard 2801,10.0
11/27/2023,,Withdrawal POS #000000573781/SUNOCO 8002212501 4234 SW 20TH AVEGAINESVILLE FLCard 2801,30.81,,Posted,1724.37,2023-11-27,30.81,Withdrawal POS #000000955321/SUNOCO 8002212501 4234 SW 20TH AVEGAINESVILLE FLCard 2801,30.81
11/27/2023,,Withdrawal Debit Card MC Debit Seminol/IONOS INC. CHESTERBROOK PADate 11/26/23 0 3330927871 0 4816Card 2801,16.0,,Posted,1755.18,2023-11-27,16.0,Withdrawal Debit Card MC Debit Seminol/IONOS INC. CHESTERBROOK PADate 12/29/24 0 4364954464 0 4816Card 1231,16.0
11/26/2023,,Recurring Withdrawal Debit Card - MC Debit Seminol/QUILLBOT OAK BROOK ILDate 11/25/23 0 3329941398 1 5734Card 2801,19.95,,Posted,1771.18,2023-11-26,19.95,Recurring Withdrawal Debit Card - MC Debit Seminol/QUILLBOT OAK BROOK ILDate 12/25/23 0 3359752154 0 5734Card 2801,19.95
11/24/2023,,Recurring Withdrawal Debit Card Fee/MASTERCARD ISSUER CROSS-BORDER FEEDate 11/24/23 0 3328385142 0 5734Card 2801,0.07,,Posted,1791.13,2023-11-24,0.07,Recurring Withdrawal Debit Card Fee/MASTERCARD ISSUER CROSS-BORDER FEEDate 05/14/23 0 3134938310 0 8299Card 2801,0.0925
11/24/2023,,Recurring Withdrawal Debit Card - MC Debit Seminol/DRIVE EXPLORER ADDON MADURAI TNDate 11/24/23 0 3328385142 0 5734Card 2801,9.0,,Posted,1791.2,2023-11-24,9.0,Recurring Withdrawal Debit Card - MC Debit Seminol/DRIVE EXPLORER ADDON MADURAI TNDate 12/24/23 0 3358055608 1 5734Card 2801,9.0
11/24/2023,,Recurring Withdrawal Debit Card - MC Debit Seminol/VIDIQ SAN FRANCISC CADate 11/23/23 0 3327711049 0 5734Card 2801,10.0,,Posted,1800.2,2023-11-24,10.0,Recurring Withdrawal Debit Card - MC Debit Seminol/VIDIQ SAN FRANCISC CADate 12/23/23 0 3357950683 0 5734Card 2801,10.0
11/24/2023,,Withdrawal ACH FLUENT-Gainesvil/TYPE: PAYMENT ID: 1371804719CO: FLUENT-GainesvilNAME: steven chaplinskiEntry Class Code: WEB,72.5,,Posted,1810.2,2023-11-24,72.5,Withdrawal ACH FLUENT-Gainesvil/TYPE: PAYMENT ID: 1371804719CO: FLUENT-GainesvilNAME: steven chaplinski,72.75
11/24/2023,,Withdrawal ACH FLUENT-Gainesvil/TYPE: PAYMENT ID: 1371804719CO: FLUENT-GainesvilNAME: steven chaplinskiEntry Class Code: WEB,21.5,,Posted,1882.7,2023-11-24,21.5,Withdrawal ACH FLUENT-Gainesvil/TYPE: PAYMENT ID: 1371804719CO: FLUENT-GainesvilNAME: steven chaplinski,21.5
11/23/2023,,Withdrawal Debit Card MC Debit Seminol/SAMSUNG ELECTRONICS RIDGEFIELD P NJDate 11/22/23 0 3326003035 1 5734Card 2801,15.99,,Posted,1904.2,2023-11-23,15.99,Withdrawal Debit Card MC Debit Seminol/SAMSUNG ELECTRONICS RIDGEFIELD P NJDate 12/27/24 0 4362999827 1 5734Card 1231,16.49
11/23/2023,,Withdrawal POS #000002209394/GOOGLE *Google Storage 1600 AmphitheatreParkw Mountain View CACard 2801,1.99,,Posted,1920.19,2023-11-23,1.99,Withdrawal POS #000002040482/GOOGLE *Google Storage 1600 AmphitheatreParkw Mountain View CACard 2801,1.99
11/22/2023,,Withdrawal POS #000000000107/CIRCLE K # 26146 3525 GAINESVILLE FLCard 2801,24.43,,Posted,1922.18,2023-11-22,24.43,Withdrawal POS #000000000558/CIRCLE K # 26146 3525 GAINESVILLE FLCard 2801,23.830000000000002
11/22/2023,,Withdrawal Debit Card MC Debit Seminol/PLAYSTATIONNETWORK SAN MATEO CADate 11/21/23 0 3325828415 0 5816Card 2801,89.98,,Posted,1946.61,2023-11-22,89.98,Withdrawal Debit Card MC Debit Seminol/PLAYSTATIONNETWORK SAN MATEO CADate 12/31/23 0 3365872496 0 5816Card 2801,89.985
11/22/2023,,Withdrawal Debit Card MC Debit Seminol/WALGREENS #5024 GAINESVILLE FLDate 11/21/23 0 3325008637 1 5912Card 2801,15.0,,Posted,2036.59,2023-11-22,15.0,Withdrawal Debit Card MC Debit Seminol/WALGREENS #5024 GAINESVILLE FLDate 06/26/23 0 3177001861 1 5912Card 2801,15.0
11/22/2023,,Withdrawal POS #000000804692/Instacart 50 Beal St Suite 600 SanFrancisco CACard 2801,5.0,,Posted,2051.59,2023-11-22,5.0,Withdrawal POS #000000782097/Instacart 50 Beal St Suite 600 SanFrancisco CACard 2801,5.0
11/22/2023,,Withdrawal POS #000000774433/Instacart 50 Beal St Suite 600 SanFrancisco CACard 2801,105.0,,Posted,2056.59,2023-11-22,105.0,Withdrawal POS #000000784940/Instacart 50 Beal St Suite 600 SanFrancisco CACard 2801,105.0
11/22/2023,,Withdrawal POS #000000806691/Instacart 50 Beal St Suite 600 SanFrancisco CACard 2801,1.39,,Posted,2161.59,2023-11-22,1.39,Withdrawal POS #000000782097/Instacart 50 Beal St Suite 600 SanFrancisco CACard 2801,1.6949999999999998
11/21/2023,,Recurring Withdrawal Debit Card - MC Debit Seminol/CANVA* I03975-36248096 CAMDEN DEDate 11/20/23 0 3324792194 0 7221Card 2801,12.99,,Posted,2162.98,2023-11-21,12.99,Recurring Withdrawal Debit Card - MC Debit Seminol/CANVA* I03914-38299904 CAMDEN DEDate 09/23/23 0 3266003765 1 7221Card 2801,12.99
11/20/2023,,Withdrawal POS #000000773136/Instacart 50 Beal St Suite 600 SanFrancisco CACard 2801,3.0,,Posted,2175.97,2023-11-20,3.0,Withdrawal POS #000000773008/Instacart 50 Beal St Suite 600 SanFrancisco CACard 1231,3.0
11/20/2023,,Withdrawal POS #000000782796/Instacart 50 Beal St Suite 600 SanFrancisco CACard 2801,121.64,,Posted,2178.97,2023-11-20,121.64,Withdrawal POS #000000782097/Instacart 50 Beal St Suite 600 SanFrancisco CACard 2801,121.64
11/20/2023,,Withdrawal POS #000000238444/SUNOCO 8002212501 4234 SW 20TH AVEGAINESVILLE FLCard 2801,37.26,,Posted,2300.61,2023-11-20,37.26,Withdrawal POS #000000238444/SUNOCO 8002212501 4234 SW 20TH AVEGAINESVILLE FLCard 2801,37.26
11/20/2023,,Recurring Withdrawal Debit Card - MC Debit Seminol/WEB*HOSTGATOR.COM BURLINGTON MADate 11/18/23 0 3322020816 1 4816Card 2801,31.98,,Posted,2337.87,2023-11-20,31.98,Recurring Withdrawal Debit Card - MC Debit Seminol/WEB*HOSTGATOR.COM BURLINGTON MADate 11/18/23 0 3322020816 1 4816Card 2801,31.98
11/20/2023,,Withdrawal POS #000003240708/GOOGLE *YouTubePremium 1600 AmphitheatreParkw Mountain View CACard 2801,15.92,,Posted,2369.85,2023-11-20,15.92,Withdrawal POS #000003285955/GOOGLE *YouTubePremium 1600 AmphitheatreParkw Mountain View CACard 2801,15.92
11/19/2023,,Recurring Withdrawal Debit Card - MC Debit Seminol/TUBEBUDDYCOM 8668823239 CADate 11/17/23 0 3321078733 2 5734Card 2801,7.5,,Posted,2385.77,2023-11-19,7.5,Recurring Withdrawal Debit Card - MC Debit Seminol/TUBEBUDDYCOM* 8668823239 CADate 12/03/24 0 4338443995 0 5045Card 1231,7.5
11/19/2023,,Withdrawal POS #000000177815/SUNOCO 8002212501 4234 SW 20TH AVEGAINESVILLE FLCard 2801,37.26,,Posted,2393.27,2023-11-19,37.26,Withdrawal POS #000000177815/SUNOCO 8002212501 4234 SW 20TH AVEGAINESVILLE FLCard 2801,37.26
11/17/2023,,Withdrawal POS #000000802383/Instacart 50 Beal St Suite 600 SanFrancisco CACard 2801,5.0,,Posted,2430.53,2023-11-17,5.0,Withdrawal POS #000000802668/Instacart 50 Beal St Suite 600 SanFrancisco CACard 2801,5.0
11/17/2023,,Withdrawal POS #000000783938/Instacart 50 Beal St Suite 600 SanFrancisco CACard 2801,82.44,,Posted,2435.53,2023-11-17,82.44,Withdrawal POS #000000782097/Instacart 50 Beal St Suite 600 SanFrancisco CACard 2801,82.44
11/17/2023,,Recurring Withdrawal Debit Card - MC Debit Seminol/MIDJOURNEY INC. SOUTH SAN FR CADate 11/16/23 0 3320923293 0 5734Card 2801,10.0,,Posted,2517.97,2023-11-17,10.0,Withdrawal Debit Card MC Debit Seminol/MIDJOURNEY INC. SOUTH SAN FR CADate 10/16/23 0 3289666656 0 5734Card 2801,10.0
11/15/2023,,Withdrawal POS #000000068021/SUNOCO 8002212501 4234 SW 20TH AVEGAINESVILLE FLCard 2801,35.75,,Posted,2527.97,2023-11-15,35.75,Withdrawal POS #000000899960/SUNOCO 8002212501 4234 SW 20TH AVEGAINESVILLE FLCard 2801,35.58
11/15/2023,,Withdrawal POS #000000742821/PUBLIX 4115 NW 16TH BLVD GAINESVILLE FLCard 2801,77.12,,Posted,2563.72,2023-11-15,77.12,Withdrawal POS #000000742821/PUBLIX 4115 NW 16TH BLVD GAINESVILLE FLCard 2801,77.12
11/14/2023,,Withdrawal POS #000000772752/Instacart 50 Beal St Suite 600 SanFrancisco CACard 2801,5.0,,Posted,2640.84,2023-11-14,5.0,Withdrawal POS #000000772752/Instacart 50 Beal St Suite 600 SanFrancisco CACard 2801,5.0
11/14/2023,,Withdrawal POS #000000773467/Instacart 50 Beal St Suite 600 SanFrancisco CACard 2801,119.32,,Posted,2645.84,2023-11-14,119.32,Withdrawal POS #000000772752/Instacart 50 Beal St Suite 600 SanFrancisco CACard 2801,119.32
11/14/2023,,Withdrawal Debit Card MC Debit Seminol/COX GAINESVILLE COMM 800-234-3993 FLDate 11/13/23 0 3317253019 0 4899Card 2801,75.04,,Posted,2757.95,2023-11-14,75.04,Withdrawal Debit Card MC Debit Seminol/COX GAINESVILLE COMM 800-234-3993 FLDate 12/04/24 0 4339376311 0 4899Card 1231,75.04
11/14/2023,,Recurring Withdrawal Debit Card - MC Debit Seminol/APPLE.COM/BILL 866-712-7753 CADate 11/13/23 0 3317730551 0 5818Card 2801,42.98,,Posted,2832.99,2023-11-14,42.98,Recurring Withdrawal Debit Card - MC Debit Seminol/APPLE.COM/BILL 866-712-7753 CADate 09/16/23 0 3259205559 2 5818Card 2801,42.98
11/14/2023,,Withdrawal Debit Card MC Debit Seminol/MIRACLE MADE 2015640522 NYDate 11/13/23 0 3317729103 0 5719Card 2801,161.48,,Posted,2875.97,2023-11-14,161.48,Withdrawal Debit Card MC Debit Seminol/MIRACLE MADE 2015640522 NYDate 11/13/23 0 3317729103 0 5719Card 2801,161.48
11/14/2023,,Withdrawal ACH FLUENT-Gainesvil/TYPE: PAYMENT ID: 1371804719CO: FLUENT-GainesvilNAME: stevenchaplinskiEntry Class Code: WEB,71.0,,Posted,3037.45,2023-11-14,71.0,Withdrawal ACH FLUENT-Gainesvil/TYPE: PAYMENT ID: 1371804719CO: FLUENT-GainesvilNAME: steven chaplinski,71.0
11/13/2023,,Withdrawal Debit Card MC Debit Seminol/SALESAMURAI.IO SFTWARE BOULDER CODate 11/13/23 0 3317927273 0 5734Card 2801,9.99,,Posted,3108.45,2023-11-13,9.99,Withdrawal Debit Card MC Debit Seminol/SALESAMURAI.IO SFTWARE BOULDER CODate 11/13/23 0 3317927273 0 5734Card 2801,9.99
11/13/2023,,Withdrawal Debit Card MC Debit Seminol/CANNAMD 855-4209170 FLDate 11/12/23 0 3316926888 0 8011Card 2801,195.0,,Posted,3118.44,2023-11-13,195.0,Withdrawal Debit Card MC Debit Seminol/CANNAMD 855-4209170 FLDate 12/19/24 0 4354703841 0 8011Card 1231,195.0
11/12/2023,,Withdrawal POS #000000000106/CIRCLE K # 26146 3525 GAINESVILLE FLCard 2801,27.9,,Posted,3313.44,2023-11-12,27.9,Withdrawal POS #000000000558/CIRCLE K # 26146 3525 GAINESVILLE FLCard 2801,27.534999999999997
11/12/2023,,Recurring Withdrawal Debit Card - MC Debit Seminol/MIDJOURNEY INC. SOUTH SAN FR CADate 11/10/23 0 3314793421 1 5734Card 2801,30.0,,Posted,3341.34,2023-11-12,30.0,Withdrawal Debit Card MC Debit Seminol/MIDJOURNEY INC. SOUTH SAN FR CADate 10/16/23 0 3289666656 0 5734Card 2801,30.0
11/12/2023,,Recurring Withdrawal Debit Card - MC Debit Seminol/OPUS CLIP REDWOOD CITY CADate 11/11/23 0 3315019448 1 7372Card 2801,19.0,,Posted,3371.34,2023-11-12,19.0,Recurring Withdrawal Debit Card - MC Debit Seminol/OPUS CLIP REDWOOD CITY CADate 12/11/23 0 3345860166 0 7372Card 2801,19.0
11/12/2023,,Withdrawal Debit Card MC Debit Seminol/WALGREENS #9304 GAINESVILLE FLDate 11/11/23 0 3315920550 0 5912Card 2801,8.16,,Posted,3390.34,2023-11-12,8.16,Withdrawal Debit Card MC Debit Seminol/WALGREENS #9304 GAINESVILLE FLDate 12/20/23 0 3354958966 0 5912Card 2801,8.16
11/11/2023,,Withdrawal POS #000000047875/PUBLIX 3930 SW ARCHER ROAD GAINESVILLECard 2801,52.21,,Posted,3398.5,2023-11-11,52.21,Withdrawal POS #000000753028/PUBLIX 3930 SW ARCHER ROAD GAINESVILLECard 1247,52.21
11/11/2023,,Withdrawal POS #000000741171/PUBLIX 3100 SW 35TH BLVD GAINESVILLE FLCard 2801,27.88,,Posted,3450.71,2023-11-11,27.88,Withdrawal POS #000000058955/PUBLIX 3100 SW 35TH BLVD GAINESVILLE FLCard 2801,27.88
11/10/2023,,Withdrawal Debit Card MC Debit Seminol/WALGREENS #5024 GAINESVILLE FLDate 11/09/23 0 3313912372 0 5912Card 2801,3.38,,Posted,3478.59,2023-11-10,3.38,Withdrawal Debit Card MC Debit Seminol/WALGREENS #5024 GAINESVILLE FLDate 06/26/23 0 3177001861 1 5912Card 2801,3.38
11/10/2023,,Withdrawal POS #000000796988/Instacart 50 Beal St Suite 600 SanFrancisco CACard 2801,5.0,,Posted,3481.97,2023-11-10,5.0,Withdrawal POS #000000792604/Instacart 50 Beal St Suite 600 SanFrancisco CACard 2801,5.415
11/10/2023,,Withdrawal POS #000000795742/Instacart 50 Beal St Suite 600 SanFrancisco CACard 2801,65.49,,Posted,3486.97,2023-11-10,65.49,Withdrawal POS #000000792604/Instacart 50 Beal St Suite 600 SanFrancisco CACard 2801,65.49
11/9/2023,,Withdrawal Debit Card MC Debit Seminol/AMAZON PRIME*VI6QQ5093 AMZN.COM/BIL WADate 11/08/23 0 3312939290 0 5968Card 2801,15.15,,Posted,3552.46,2023-11-09,15.15,Withdrawal Debit Card MC Debit Seminol/AMAZON PRIME*PE3IN5Y03 AMZN.COM/BIL WADate 12/08/23 0 3342550116 0 5968Card 2801,15.14
11/8/2023,,Recurring Withdrawal Debit Card - MC Debit Seminol/OPENAI SAN FRANCISC CADate 11/07/23 0 3311590641 0 5734Card 2801,1.57,,Posted,3567.61,2023-11-08,1.57,Recurring Withdrawal Debit Card - MC Debit Seminol/VIDIQ SAN FRANCISC CADate 12/23/23 0 3357950683 0 5734Card 2801,1.1
11/8/2023,,Withdrawal Debit Card MC Debit Seminol/MOVAVI.COM WILDWOOD MODate 11/07/23 0 3311216937 0 5734Card 2801,69.95,,Posted,3569.18,2023-11-08,69.95,Withdrawal Debit Card MC Debit Seminol/MOVAVI.COM WILDWOOD MODate 11/07/23 0 3311216937 0 5734Card 2801,69.95
11/7/2023,,Withdrawal POS #000000804016/Instacart 50 Beal St Suite 600 SanFrancisco CACard 2801,10.0,,Posted,3639.13,2023-11-07,10.0,Withdrawal POS #000000784940/Instacart 50 Beal St Suite 600 SanFrancisco CACard 2801,10.0
11/7/2023,,Withdrawal POS #000000784007/Instacart 50 Beal St Suite 600 SanFrancisco CACard 2801,87.37,,Posted,3649.13,2023-11-07,87.37,Withdrawal POS #000000782097/Instacart 50 Beal St Suite 600 SanFrancisco CACard 2801,87.37
11/7/2023,,Withdrawal POS #000000738427/WAWA 5325 2373 SW ARCHER ROADFLCard 2801,27.09,,Posted,3736.5,2023-11-07,27.09,Withdrawal POS #000000553411/WAWA 5325 2373 SW ARCHER ROADFLCard 1247,27.09
11/7/2023,,Recurring Withdrawal Debit Card - MC Debit Seminol/D-ID STUDIO WILMINGTON DEDate 11/06/23 0 3310886691 0 7399Card 2801,49.0,,Posted,3763.59,2023-11-07,49.0,Recurring Withdrawal Debit Card - MC Debit Seminol/D-ID STUDIO WILMINGTON DEDate 10/13/24 0 4287011811 1 7399Card 1231,49.0
11/7/2023,,Recurring Withdrawal Debit Card Fee/MASTERCARD ISSUER CROSS-BORDER FEEDate 11/06/23 0 3310695225 0 5815Card 2801,0.31,,Posted,3812.59,2023-11-07,0.31,Withdrawal Debit Card Fee/MASTERCARD ISSUER CROSS-BORDER FEEDate 10/06/23 0 3279122045 2 5815Card 2801,0.20833333333333334
11/7/2023,,Recurring Withdrawal Debit Card - MC Debit Seminol/PLAY.HT BANGALORE BEDate 11/06/23 0 3310695225 0 5815Card 2801,39.0,,Posted,3812.9,2023-11-07,39.0,Withdrawal Debit Card MC Debit Seminol/PLAY.HT BANGALORE BEDate 10/06/23 0 3279122045 2 5815Card 2801,39.0
11/7/2023,,Recurring Withdrawal Debit Card - MC Debit Seminol/ELEVENLABS.IO NEW YORK NYDate 11/07/23 0 3311836280 0 5734Card 2801,5.0,,Posted,3851.9,2023-11-07,5.0,Withdrawal Debit Card MC Debit Seminol/ELEVENLABS.IO NEW YORK NYDate 10/07/23 0 3280076314 2 5734Card 2801,5.0
11/6/2023,,Recurring Withdrawal Debit Card Fee/MASTERCARD ISSUER CROSS-BORDER FEEDate 11/06/23 0 3310145828 0 5734Card 2801,0.12,,Posted,3856.9,2023-11-06,0.12,Recurring Withdrawal Debit Card Fee/MASTERCARD ISSUER CROSS-BORDER FEEDate 09/07/23 0 3250971158 0 5734Card 2801,0.12
11/6/2023,,Recurring Withdrawal Debit Card - MC Debit Seminol/LINKTREE* LINKTREE COLLINGWOOD VIDate 11/06/23 0 3310145828 0 5734Card 2801,14.99,,Posted,3857.02,2023-11-06,14.99,Recurring Withdrawal Debit Card - MC Debit Seminol/LINKTREE* LINKTREE COLLINGWOOD VIDate 12/06/23 0 3340923092 0 5734Card 2801,14.99
11/6/2023,,"Recurring Withdrawal Debit Card - MC Debit Seminol/MARMALEAD, LLC 4079065736 FLDate 11/05/23 0 3309540300 1 5045Card 2801",19.0,,Posted,3872.01,2023-11-06,19.0,"Recurring Withdrawal Debit Card - MC Debit Seminol/MARMALEAD, LLC 4079065736 FLDate 01/05/24 0 4005822541 1 5045Card 2801",19.0
11/6/2023,,Recurring Withdrawal Bill Payment - #000000177618/NETFLIX COM LOS GATOS CACard 2801,11.0,,Posted,3891.01,2023-11-06,11.0,Recurring Withdrawal Bill Payment - #000006911729/NETFLIX COM LOS GATOS CACard 2801,10.99
11/5/2023,,Withdrawal POS #000000805076/Instacart 50 Beal St Suite 600 SanFrancisco CACard 2801,3.0,,Posted,3902.01,2023-11-05,3.0,Withdrawal POS #000000802668/Instacart 50 Beal St Suite 600 SanFrancisco CACard 2801,2.5
11/5/2023,,Withdrawal POS #000000782111/Instacart 50 Beal St Suite 600 SanFrancisco CACard 2801,103.52,,Posted,3905.01,2023-11-05,103.52,Withdrawal POS #000000782111/Instacart 50 Beal St Suite 600 SanFrancisco CACard 2801,103.52
11/5/2023,,Recurring Withdrawal Debit Card - MC Debit Seminol/CHATGPT SUBSCRIPTION SAN FRANCISC CADate 11/04/23 0 3308519868 0 5734Card 2801,20.0,,Posted,4008.53,2023-11-05,20.0,Recurring Withdrawal Debit Card - MC Debit Seminol/CHATGPT SUBSCRIPTION SAN FRANCISC CADate 05/04/24 0 4125659188 0 5734Card 1231,20.0
11/5/2023,,Recurring Withdrawal Debit Card - MC Debit Seminol/WWW.EVERBEE.IO SANTEE CADate 11/05/23 0 3309519436 0 5734Card 2801,29.99,,Posted,4028.53,2023-11-05,29.99,Recurring Withdrawal Debit Card - MC Debit Seminol/WWW.EVERBEE.IO SANTEE CADate 01/05/24 0 4005834841 0 5734Card 2801,29.99
11/5/2023,,Recurring Withdrawal Debit Card - MC Debit Seminol/DISNEY PLUS 8889057888 CADate 11/04/23 0 3308886681 0 4899Card 2801,16.11,,Posted,4058.52,2023-11-05,16.11,Recurring Withdrawal Debit Card - MC Debit Seminol/DISNEY PLUS 8889057888 CADate 10/02/24 0 4276239357 1 4899Card 1231,16.11
11/5/2023,,Recurring Withdrawal Debit Card - MC Debit Seminol/APPLE.COM/BILL 866-712-7753 CADate 11/03/23 0 3307866987 1 5818Card 2801,2.99,,Posted,4074.63,2023-11-05,2.99,Recurring Withdrawal Debit Card - MC Debit Seminol/APPLE.COM/BILL 866-712-7753 CADate 12/13/23 0 3347838871 0 5818Card 2801,2.99
11/5/2023,,Recurring Withdrawal Debit Card - MC Debit Seminol/APPLE.COM/BILL 866-712-7753 CADate 11/03/23 0 3307866985 1 5818Card 2801,2.99,,Posted,4077.62,2023-11-05,2.99,Recurring Withdrawal Debit Card - MC Debit Seminol/APPLE.COM/BILL 866-712-7753 CADate 12/13/23 0 3347838871 0 5818Card 2801,2.99
11/5/2023,,Recurring Withdrawal Debit Card - MC Debit Seminol/ADOBE INC. 4085366000 CADate 11/03/23 0 3307864674 1 5734Card 2801,19.99,,Posted,4080.61,2023-11-05,19.99,Recurring Withdrawal Debit Card - MC Debit Seminol/ADOBE *CREATIVE CLOUD 4085366000 CADate 12/03/23 0 3337999974 0 5734Card 2801,19.99
11/5/2023,,Recurring Withdrawal Debit Card - MC Debit Seminol/ADOBE INC. 4085366000 CADate 11/04/23 0 3308880510 0 5734Card 2801,29.99,,Posted,4100.6,2023-11-05,29.99,Recurring Withdrawal Debit Card - MC Debit Seminol/ADOBE *STOCK 4085366000 CADate 01/04/24 0 4004903002 0 5734Card 2801,29.99
11/3/2023,,Recurring Withdrawal Debit Card - MC Debit Seminol/PARAMOUNT+ SAN FRANCISC CADate 11/02/23 0 3306889322 0 4899Card 2801,13.81,,Posted,4130.59,2023-11-03,13.81,Recurring Withdrawal Debit Card - MC Debit Seminol/VIDIQ SAN FRANCISC CADate 12/23/23 0 3357950683 0 5734Card 2801,13.81
11/3/2023,,Recurring Withdrawal Debit Card Fee/MASTERCARD ISSUER CROSS-BORDER FEEDate 11/02/23 0 3306889171 0 7399Card 2801,0.07,,Posted,4144.4,2023-11-03,0.07,Recurring Withdrawal Debit Card Fee/MASTERCARD ISSUER CROSS-BORDER FEEDate 05/14/23 0 3134938310 0 8299Card 2801,0.0925
11/3/2023,,Recurring Withdrawal Debit Card - MC Debit Seminol/CREATIVE FABRICA AMSTERDAM NHDate 11/02/23 0 3306889171 0 7399Card 2801,9.0,,Posted,4144.47,2023-11-03,9.0,Recurring Withdrawal Debit Card - MC Debit Seminol/CREATIVE FABRICA AMSTERDAM NHDate 10/03/24 0 4277044624 1 7399Card 1231,9.0
11/2/2023,,Withdrawal POS #000000793257/Instacart 50 Beal St Suite 600 SanFrancisco CACard 2801,2.0,,Posted,1353.47,2023-11-02,2.0,Withdrawal POS #000000792604/Instacart 50 Beal St Suite 600 SanFrancisco CACard 2801,2.5
11/2/2023,,Withdrawal POS #000000804519/Instacart 50 Beal St Suite 600 SanFrancisco CACard 2801,71.83,,Posted,1355.47,2023-11-02,71.83,Withdrawal POS #000000784940/Instacart 50 Beal St Suite 600 SanFrancisco CACard 2801,71.83
11/2/2023,,Recurring Withdrawal Debit Card - MC Debit Seminol/KAIBER AI WILMINGTON DEDate 11/02/23 0 3306046960 1 5815Card 2801,15.0,,Posted,1402.31,2023-11-02,15.0,Recurring Withdrawal Debit Card - MC Debit Seminol/KAIBER AI WILMINGTON DEDate 08/30/23 0 3242340816 0 5815Card 2801,15.0
11/2/2023,,Withdrawal Debit Card MC Debit Seminol/GRU/EZ-PAY WEB PYMT 352-334-3434 FLDate 11/01/23 0 3305328053 0 4900Card 2801,164.04,,Posted,1417.31,2023-11-02,164.04,Withdrawal Debit Card MC Debit Seminol/GRU/EZ-PAY WEB PYMT 352-334-3434 FLDate 12/05/24 0 4340279271 0 4900Card 1231,164.04
11/2/2023,,Recurring Withdrawal Debit Card - MC Debit Seminol/ADOBE INC. 4085366000 CADate 11/02/23 0 3306885795 0 5734Card 2801,22.99,,Posted,1581.35,2023-11-02,22.99,Recurring Withdrawal Debit Card - MC Debit Seminol/ADOBE *STOCK 4085366000 CADate 01/04/24 0 4004903002 0 5734Card 2801,22.99
11/1/2023,,Withdrawal POS #000000592623/AMAZON.COM*SX78M3I43 SEATTLE WACard 2801,23.17,,Posted,1604.34,2023-11-01,23.17,Withdrawal POS #000000598647/AMAZON.COM*F565U8HW3 SEATTLE WACard 2801,23.42
11/1/2023,,Recurring Withdrawal Debit Card - MC Debit Seminol/D-ID STUDIO WILMINGTON DEDate 10/31/23 0 3304270877 0 7399Card 2801,20.0,,Posted,1627.51,2023-11-01,20.0,Recurring Withdrawal Debit Card - MC Debit Seminol/D-ID STUDIO WILMINGTON DEDate 10/13/24 0 4287011811 1 7399Card 1231,19.8
11/1/2023,,Recurring Withdrawal Debit Card - MC Debit Seminol/D-ID STUDIO WILMINGTON DEDate 10/31/23 0 3304692631 0 7399Card 2801,19.6,,Posted,1647.51,2023-11-01,19.6,Recurring Withdrawal Debit Card - MC Debit Seminol/D-ID STUDIO WILMINGTON DEDate 10/13/24 0 4287011811 1 7399Card 1231,19.8
11/1/2023,,Recurring Withdrawal Debit Card - MC Debit Seminol/D-ID STUDIO WILMINGTON DEDate 10/31/23 0 3304692630 0 7399Card 2801,1.7,,Posted,1667.11,2023-11-01,1.7,Recurring Withdrawal Debit Card - MC Debit Seminol/D-ID STUDIO WILMINGTON DEDate 10/13/24 0 4287011811 1 7399Card 1231,1.75
11/1/2023,,Recurring Withdrawal Debit Card - MC Debit Seminol/MYDESIGNS - PRO - MON LAS VEGAS NVDate 11/01/23 0 3305923961 0 5734Card 2801,29.99,,Posted,1668.81,2023-11-01,29.99,Withdrawal Debit Card MC Debit Seminol/MYDESIGNS - PRO - MON LAS VEGAS NVDate 09/01/23 0 3244164229 1 5734Card 2801,29.99
11/1/2023,,Recurring Withdrawal Debit Card - MC Debit Seminol/ETSY.COM*AIAVATAR BROOKLYN NYDate 11/01/23 0 3305923691 0 5970Card 2801,3.22,,Posted,1698.8,2023-11-01,3.22,Recurring Withdrawal Debit Card - MC Debit Seminol/ETSY.COM*AIAVATAR BROOKLYN NYDate 10/01/23 0 3274789186 1 5970Card 2801,2.8600000000000003
11/1/2023,,Withdrawal ACH Watson Realty Co/TYPE: WEB PMTS ID: 9000321157CO: Watson Realty CoNAME: Steven chaplinskiEntry Class Code: WEB,1079.0,,Posted,1702.02,2023-11-01,1079.0,Withdrawal ACH Watson Realty Co/TYPE: WEB PMTS ID: 9000321157CO: Watson Realty CoEntry Class Code: WEB,1079.0
11/1/2023,,"Withdrawal ACH AppFolio, Inc. F/TYPE: WEB PMTS ID: 9001406550CO: AppFolio, Inc. FNAME: Steven chaplinskiEntry Class Code: WEB",2.49,,Posted,2781.02,2023-11-01,2.49,"Withdrawal ACH AppFolio, Inc. F/TYPE: WEB PMTS ID: 9001406550

CO: AppFolio, Inc. F

NAME: Steven chaplinskiEntry Class Code: WEB",2.49
10/31/2023,,Withdrawal POS #000000437179/SUNOCO 8002212501 4234 SW 20TH AVEGAINESVILLE FLCard 2801,35.0,,Posted,2783.51,2023-10-31,35.0,Withdrawal POS #000000403720/SUNOCO 8002212501 4234 SW 20TH AVEGAINESVILLE FLCard 2801,35.0
10/31/2023,,Withdrawal Debit Card MC Debit Seminol/MOVAVI.COM WILDWOOD MODate 10/31/23 0 3304893922 0 5734Card 2801,59.95,,Posted,2818.51,2023-10-31,59.95,Withdrawal Debit Card MC Debit Seminol/MOVAVI.COM WILDWOOD MODate 11/07/23 0 3311216937 0 5734Card 2801,59.95
10/31/2023,,Withdrawal POS #000000792483/Instacart 50 Beal St Suite 600 SanFrancisco CACard 2801,2.0,,Posted,78.46,2023-10-31,2.0,Withdrawal POS #000000792604/Instacart 50 Beal St Suite 600 SanFrancisco CACard 2801,2.5
10/31/2023,,Withdrawal POS #000000806130/Instacart 50 Beal St Suite 600 SanFrancisco CACard 2801,49.92,,Posted,80.46,2023-10-31,49.92,Withdrawal POS #000000802668/Instacart 50 Beal St Suite 600 SanFrancisco CACard 2801,50.325
10/30/2023,,Withdrawal ACH FLUENT-Gainesvil/TYPE: PAYMENT ID: 1371804719CO: FLUENT-GainesvilNAME: steven chaplinskiEntry Class Code: WEB,32.0,,Posted,130.38,2023-10-30,32.0,Withdrawal ACH FLUENT-Gainesvil/TYPE: PAYMENT ID: 1371804719CO: FLUENT-GainesvilNAME: steven chaplinski,32.5
10/29/2023,,Recurring Withdrawal Debit Card Fee/MASTERCARD ISSUER CROSS-BORDER FEEDate 10/27/23 0 3300915753 1 5734Card 2801,0.16,,Posted,162.38,2023-10-29,0.16,Recurring Withdrawal Debit Card Fee/MASTERCARD ISSUER CROSS-BORDER FEEDate 08/08/23 0 3220043177 1 7399Card 2801,0.156
10/29/2023,,Recurring Withdrawal Debit Card - MC Debit Seminol/ETSYHUNT* TRIAL OVER SINGAPORE SGDate 10/27/23 0 3300915753 1 5734Card 2801,19.99,,Posted,162.54,2023-10-29,19.99,Recurring Withdrawal Debit Card - MC Debit Seminol/ETSYHUNT* TRIAL OVER SINGAPORE SGDate 10/27/23 0 3300915753 1 5734Card 2801,19.99
10/29/2023,,Withdrawal Debit Card MC Debit Seminol/CIRCLE K # 06782 GAINESVILLE FLDate 10/26/23 0 3299850285 1 5499Card 2801,30.29,,Posted,182.53,2023-10-29,30.29,Withdrawal Debit Card MC Debit Seminol/CIRCLE K # 26146 GAINESVILLE FLDate 07/28/23 0 3209802364 1 5541Card 2801,29.81
10/29/2023,,Recurring Withdrawal Debit Card - MC Debit Seminol/APPLE.COM/BILL 866-712-7753 CADate 10/27/23 0 3300913011 1 5818Card 2801,15.99,,Posted,212.82,2023-10-29,15.99,Recurring Withdrawal Debit Card - MC Debit Seminol/APPLE.COM/BILL 866-712-7753 CADate 09/16/23 0 3259205559 2 5818Card 2801,15.99
10/29/2023,,Recurring Withdrawal Debit Card - MC Debit Seminol/ADOBE INC. 4085366000 CADate 10/27/23 0 3300910616 1 5734Card 2801,29.99,,Posted,228.81,2023-10-29,29.99,Recurring Withdrawal Debit Card - MC Debit Seminol/ADOBE *STOCK 4085366000 CADate 01/04/24 0 4004903002 0 5734Card 2801,29.99
10/28/2023,,Withdrawal POS #000000784940/Instacart 50 Beal St Suite 600 SanFrancisco CACard 2801,3.0,,Posted,58.8,2023-10-28,3.0,Withdrawal POS #000000784940/Instacart 50 Beal St Suite 600 SanFrancisco CACard 2801,3.0
10/28/2023,,Withdrawal POS #000000785372/Instacart 50 Beal St Suite 600 SanFrancisco CACard 2801,57.06,,Posted,61.8,2023-10-28,57.06,Withdrawal POS #000000782111/Instacart 50 Beal St Suite 600 SanFrancisco CACard 2801,57.06
10/27/2023,,Withdrawal Debit Card MC Debit Seminol/PADDLE.NET* LEONARDOAI ASTORIA NYDate 10/26/23 0 3299263117 0 5817Card 2801,9.0,,Posted,118.86,2023-10-27,9.0,Withdrawal Debit Card MC Debit Seminol/PADDLE.NET* LEONARDOAI ASTORIA NYDate 10/26/23 0 3299263117 0 5817Card 2801,9.0
10/27/2023,,Withdrawal Debit Card MC Debit Seminol/IONOS INC. CHESTERBROOK PADate 10/26/23 0 3299971722 0 4816Card 2801,12.0,,Posted,127.86,2023-10-27,12.0,Withdrawal Debit Card MC Debit Seminol/IONOS INC. CHESTERBROOK PADate 12/29/24 0 4364954464 0 4816Card 1231,12.0
10/27/2023,,Withdrawal POS #000000295264/SUNOCO 8002212501 4234 SW 20TH AVEGAINESVILLE FLCard 2801,17.92,,Posted,139.86,2023-10-27,17.92,Withdrawal POS #000000955321/SUNOCO 8002212501 4234 SW 20TH AVEGAINESVILLE FLCard 2801,17.705
10/26/2023,,Withdrawal Debit Card Fee/MASTERCARD ISSUER CROSS-BORDER FEEDate 10/26/23 0 3299890944 0 5815Card 2801,0.07,,Posted,157.78,2023-10-26,0.07,Withdrawal Debit Card Fee/MASTERCARD ISSUER CROSS-BORDER FEEDate 10/06/23 0 3279122045 2 5815Card 2801,0.20833333333333334
10/26/2023,,Withdrawal Debit Card MC Debit Seminol/VOICESTARS PARIS ILDate 10/26/23 0 3299890944 0 5815Card 2801,8.99,,Posted,157.85,2023-10-26,8.99,Withdrawal Debit Card MC Debit Seminol/VOICESTARS PARIS ILDate 10/26/23 0 3299890944 0 5815Card 2801,8.99
10/25/2023,,Recurring Withdrawal Debit Card - MC Debit Seminol/QUILLBOT OAK BROOK ILDate 10/25/23 0 3298900132 0 5734Card 2801,19.95,,Posted,166.84,2023-10-25,19.95,Recurring Withdrawal Debit Card - MC Debit Seminol/QUILLBOT OAK BROOK ILDate 12/25/23 0 3359752154 0 5734Card 2801,19.95
10/25/2023,,Recurring Withdrawal Debit Card - MC Debit Seminol/WEB*HOSTGATOR.COM BURLINGTON MADate 10/24/23 0 3297898879 0 4816Card 2801,15.99,,Posted,186.79,2023-10-25,15.99,Recurring Withdrawal Debit Card - MC Debit Seminol/WEB*HOSTGATOR.COM BURLINGTON MADate 11/18/23 0 3322020816 1 4816Card 2801,15.99
10/25/2023,,Recurring Withdrawal Debit Card Fee/MASTERCARD ISSUER CROSS-BORDER FEEDate 10/25/23 0 3298820645 0 5734Card 2801,0.01,,Posted,202.78,2023-10-25,0.01,Recurring Withdrawal Debit Card Fee/MASTERCARD ISSUER CROSS-BORDER FEEDate 04/20/23 0 3110864064 0 7333Card 2801,0.15111111111111108
10/25/2023,,Recurring Withdrawal Debit Card - MC Debit Seminol/ETSYHUNT TECH SINGAPORE SGDate 10/25/23 0 3298820645 0 5734Card 2801,1.0,,Posted,202.79,2023-10-25,1.0,Recurring Withdrawal Debit Card - MC Debit Seminol/ETSYHUNT* TRIAL OVER SINGAPORE SGDate 10/27/23 0 3300915753 1 5734Card 2801,1.0
10/24/2023,,Recurring Withdrawal Debit Card Fee/MASTERCARD ISSUER CROSS-BORDER FEEDate 10/24/23 0 3297846350 0 5734Card 2801,0.07,,Posted,203.79,2023-10-24,0.07,Recurring Withdrawal Debit Card Fee/MASTERCARD ISSUER CROSS-BORDER FEEDate 04/20/23 0 3110864064 0 7333Card 2801,0.15111111111111108
10/24/2023,,Recurring Withdrawal Debit Card - MC Debit Seminol/DRIVE EXPLORER ADDON MADURAI TNDate 10/24/23 0 3297846350 0 5734Card 2801,9.0,,Posted,203.86,2023-10-24,9.0,Recurring Withdrawal Debit Card - MC Debit Seminol/DRIVE EXPLORER ADDON MADURAI TNDate 12/24/23 0 3358055608 1 5734Card 2801,9.0
10/24/2023,,Recurring Withdrawal Debit Card - MC Debit Seminol/VIDIQ SAN FRANCISC CADate 10/23/23 0 3296829691 0 5734Card 2801,10.0,,Posted,212.86,2023-10-24,10.0,Recurring Withdrawal Debit Card - MC Debit Seminol/VIDIQ SAN FRANCISC CADate 12/23/23 0 3357950683 0 5734Card 2801,10.0
10/24/2023,,Withdrawal Debit Card MC Debit Seminol/ARCHER ANIMAL HOSPITAL ARCHER FLDate 10/23/23 0 3296327463 0 0742Card 2801,351.13,,Posted,222.86,2023-10-24,351.13,Withdrawal Debit Card MC Debit Seminol/ARCHER ANIMAL HOSPITAL ARCHER FLDate 11/25/24 0 4330350737 0 0742Card 1231,351.13
10/24/2023,,Recurring Withdrawal Debit Card - MC Debit Seminol/WEB*HOSTGATOR.COM BURLINGTON MADate 10/23/23 0 3296829048 0 4816Card 2801,15.99,,Posted,573.99,2023-10-24,15.99,Recurring Withdrawal Debit Card - MC Debit Seminol/WEB*HOSTGATOR.COM BURLINGTON MADate 11/18/23 0 3322020816 1 4816Card 2801,15.99
10/24/2023,,Withdrawal Debit Card MC Debit Seminol/WALGREENS #5024 GAINESVILLE FLDate 10/23/23 0 3296842064 0 5912Card 2801,15.0,,Posted,589.98,2023-10-24,15.0,Withdrawal Debit Card MC Debit Seminol/WALGREENS #5024 GAINESVILLE FLDate 06/26/23 0 3177001861 1 5912Card 2801,15.0
10/23/2023,,Withdrawal POS #000000802327/Instacart 50 Beal St Suite 600 SanFrancisco CACard 2801,3.0,,Posted,79.98,2023-10-23,3.0,Withdrawal POS #000000802668/Instacart 50 Beal St Suite 600 SanFrancisco CACard 2801,2.5
10/23/2023,,Withdrawal POS #000000772536/Instacart 50 Beal St Suite 600 SanFrancisco CACard 2801,73.34,,Posted,82.98,2023-10-23,73.34,Withdrawal POS #000000772752/Instacart 50 Beal St Suite 600 SanFrancisco CACard 2801,72.94
10/23/2023,,Withdrawal POS #000003091116/GOOGLE *Google Storage 1600 AmphitheatreParkw Mountain View CACard 2801,1.99,,Posted,156.32,2023-10-23,1.99,Withdrawal POS #000002040482/GOOGLE *Google Storage 1600 AmphitheatreParkw Mountain View CACard 2801,1.99
10/22/2023,,Recurring Withdrawal Debit Card - MC Debit Seminol/CANVA* I03944-36326674 CAMDEN DEDate 10/20/23 0 3293031248 1 7221Card 2801,12.99,,Posted,158.31,2023-10-22,12.99,Recurring Withdrawal Debit Card - MC Debit Seminol/CANVA* I03914-38299904 CAMDEN DEDate 09/23/23 0 3266003765 1 7221Card 2801,12.99
10/20/2023,,Recurring Withdrawal Debit Card Fee/MASTERCARD ISSUER CROSS-BORDER FEEDate 10/20/23 0 3293815850 0 5734Card 2801,0.1,,Posted,171.3,2023-10-20,0.1,Recurring Withdrawal Debit Card Fee/MASTERCARD ISSUER CROSS-BORDER FEEDate 04/20/23 0 3110864064 0 7333Card 2801,0.15111111111111108
10/20/2023,,Recurring Withdrawal Debit Card - MC Debit Seminol/SHINYWHITEBOX.COM WELLINGTON NZDate 10/20/23 0 3293815850 0 5734Card 2801,12.0,,Posted,171.4,2023-10-20,12.0,Recurring Withdrawal Debit Card - MC Debit Seminol/SHINYWHITEBOX.COM WELLINGTON NZDate 10/20/23 0 3293815850 0 5734Card 2801,12.0
10/20/2023,,Withdrawal POS #000003087192/GOOGLE *YouTubePremium 1600 AmphitheatreParkw Mountain View CACard 2801,15.92,,Posted,183.4,2023-10-20,15.92,Withdrawal POS #000003285955/GOOGLE *YouTubePremium 1600 AmphitheatreParkw Mountain View CACard 2801,15.92
10/19/2023,,Withdrawal ACH FLUENT-Gainesvil/TYPE: PAYMENT ID: 1371804719CO: FLUENT-GainesvilNAME: steven chaplinskiEntry Class Code: WEB,164.64,,Posted,199.32,2023-10-19,164.64,Withdrawal ACH FLUENT-Gainesvil/TYPE: PAYMENT ID: 1371804719CO: FLUENT-GainesvilNAME: steven chaplinski,164.64
10/18/2023,,Recurring Withdrawal Debit Card - MC Debit Seminol/D-ID STUDIO WILMINGTON DEDate 10/17/23 0 3290979156 0 7399Card 2801,1.8,,Posted,351.01,2023-10-18,1.8,Recurring Withdrawal Debit Card - MC Debit Seminol/D-ID STUDIO WILMINGTON DEDate 10/13/24 0 4287011811 1 7399Card 1231,1.75
10/18/2023,,Recurring Withdrawal Debit Card - MC Debit Seminol/WEB*HOSTGATOR.COM BURLINGTON MADate 10/17/23 0 3290976504 0 4816Card 2801,12.95,,Posted,352.81,2023-10-18,12.95,Recurring Withdrawal Debit Card - MC Debit Seminol/WEB*HOSTGATOR.COM BURLINGTON MADate 11/18/23 0 3322020816 1 4816Card 2801,12.95
10/17/2023,,Withdrawal POS #000000058955/PUBLIX 3100 SW 35TH BLVD GAINESVILLE FLCard 2801,61.04,,Posted,365.76,2023-10-17,61.04,Withdrawal POS #000000036956/PUBLIX 5801 SW 75TH ST GAINESVILLE FLCard 2801,61.04
10/17/2023,,Withdrawal POS #000000000073/CIRCLE K # 26146 3525 GAINESVILLE FLCard 2801,30.3,,Posted,426.8,2023-10-17,30.3,Withdrawal POS #000000000558/CIRCLE K # 26146 3525 GAINESVILLE FLCard 2801,30.225
10/17/2023,,Withdrawal POS #000000829953/AMAZON.COM*TP0VL4K22 SEATTLE WACard 2801,25.04,,Posted,457.1,2023-10-17,25.04,Withdrawal POS #000000829953/AMAZON.COM*TP0VL4K22 SEATTLE WACard 2801,25.04
10/17/2023,,Withdrawal Debit Card MC Debit Seminol/MIDJOURNEY INC. SOUTH SAN FR CADate 10/16/23 0 3289666656 0 5734Card 2801,10.0,,Posted,182.14,2023-10-17,10.0,Withdrawal Debit Card MC Debit Seminol/MIDJOURNEY INC. SOUTH SAN FR CADate 10/16/23 0 3289666656 0 5734Card 2801,10.0
10/17/2023,,Recurring Withdrawal Debit Card - MC Debit Seminol/TUBEBUDDYCOM 8668823239 CADate 10/17/23 0 3290995005 1 5045Card 2801,7.5,,Posted,192.14,2023-10-17,7.5,Recurring Withdrawal Debit Card - MC Debit Seminol/TUBEBUDDYCOM* 8668823239 CADate 12/03/24 0 4338443995 0 5045Card 1231,7.5
10/17/2023,,Recurring Withdrawal Debit Card - MC Debit Seminol/TUBEBUDDYCOM 8668823239 CADate 10/17/23 0 3290995004 1 5045Card 2801,7.5,,Posted,199.64,2023-10-17,7.5,Recurring Withdrawal Debit Card - MC Debit Seminol/TUBEBUDDYCOM* 8668823239 CADate 12/03/24 0 4338443995 0 5045Card 1231,7.5
10/13/2023,,Withdrawal POS #000000688068/SUNOCO 8002212501 4234 SW 20TH AVEGAINESVILLE FLCard 2801,31.79,,Posted,207.14,2023-10-13,31.79,Withdrawal POS #000000866633/SUNOCO 8002212501 4234 SW 20TH AVEGAINESVILLE FLCard 2801,31.79
10/12/2023,,Withdrawal Debit Card MC Debit Seminol/OPUS CLIP REDWOOD CITY CADate 10/11/23 0 3284328119 0 7372Card 2801,19.0,,Posted,238.93,2023-10-12,19.0,Recurring Withdrawal Debit Card - MC Debit Seminol/OPUS CLIP REDWOOD CITY CADate 12/11/23 0 3345860166 0 7372Card 2801,19.0
10/11/2023,,Recurring Withdrawal Debit Card - MC Debit Seminol/MIDJOURNEY INC. SOUTH SAN FR CADate 10/10/23 0 3283868204 0 5734Card 2801,30.0,,Posted,257.93,2023-10-11,30.0,Withdrawal Debit Card MC Debit Seminol/MIDJOURNEY INC. SOUTH SAN FR CADate 10/16/23 0 3289666656 0 5734Card 2801,30.0
10/11/2023,,Withdrawal Debit Card MC Debit Seminol/PUBLIX #1784 GAINESVILLE FLDate 10/10/23 0 3283933280 0 5411Card 2801,100.9,,Posted,287.93,2023-10-11,100.9,Withdrawal Debit Card MC Debit Seminol/PUBLIX #1784 GAINESVILLE FLDate 10/10/23 0 3283933280 0 5411Card 2801,100.9
10/11/2023,,Withdrawal Debit Card MC Debit Seminol/WALGREENS #9304 GAINESVILLE FLDate 10/10/23 0 3283862910 0 5912Card 2801,6.96,,Posted,388.83,2023-10-11,6.96,Withdrawal Debit Card MC Debit Seminol/PUBLIX #1784 GAINESVILLE FLDate 10/10/23 0 3283933280 0 5411Card 2801,6.96
10/11/2023,,Recurring Withdrawal Debit Card - MC Debit Seminol/APPLE.COM/BILL 866-712-7753 CADate 10/11/23 0 3284928845 0 5818Card 2801,18.98,,Posted,395.79,2023-10-11,18.98,Recurring Withdrawal Debit Card - MC Debit Seminol/APPLE.COM/BILL 866-712-7753 CADate 09/16/23 0 3259205559 2 5818Card 2801,18.975
10/10/2023,,Withdrawal POS #000011460214/WALGREENS 3455 SW ARCH GAINESVILLE FLCard 2801,21.13,,Posted,414.77,2023-10-10,21.13,Withdrawal POS #000012002801/WALGREENS 3455 SW ARCH GAINESVILLE FLCard 2801,20.755
10/10/2023,,Withdrawal POS #000000792062/Instacart 50 Beal St Suite 600 SanFrancisco CACard 2801,3.0,,Posted,435.9,2023-10-10,3.0,Withdrawal POS #000000792604/Instacart 50 Beal St Suite 600 SanFrancisco CACard 2801,2.5
10/10/2023,,Withdrawal POS #000000792297/Instacart 50 Beal St Suite 600 SanFrancisco CACard 2801,60.92,,Posted,438.9,2023-10-10,60.92,Withdrawal POS #000000782097/Instacart 50 Beal St Suite 600 SanFrancisco CACard 2801,60.92
10/9/2023,,Withdrawal Debit Card MC Debit Seminol/AMAZON PRIME*TE7E41GQ0 AMZN.COM/BIL WADate 10/08/23 0 3281257359 0 5968Card 2801,15.13,,Posted,499.82,2023-10-09,15.13,Withdrawal Debit Card MC Debit Seminol/AMAZON PRIME*PE3IN5Y03 AMZN.COM/BIL WADate 12/08/23 0 3342550116 0 5968Card 2801,15.14
10/9/2023,,Withdrawal POS #000000000009/AMAZON.COM*TE99A7580 SEATTLE WACard 2801,24.21,,Posted,514.95,2023-10-09,24.21,Withdrawal POS #000000000023/AMAZON.COM*AU8ER6ZT3 SEATTLE WACard 2801,23.810000000000002
10/8/2023,,Recurring Withdrawal Debit Card - MC Debit Seminol/D-ID STUDIO WILMINGTON DEDate 10/06/23 0 3279683480 1 7399Card 2801,5.9,,Posted,539.16,2023-10-08,5.9,Recurring Withdrawal Debit Card - MC Debit Seminol/D-ID STUDIO WILMINGTON DEDate 10/13/24 0 4287011811 1 7399Card 1231,5.9
10/8/2023,,Withdrawal Debit Card Fee/MASTERCARD ISSUER CROSS-BORDER FEEDate 10/06/23 0 3279122045 2 5815Card 2801,0.31,,Posted,545.06,2023-10-08,0.31,Withdrawal Debit Card Fee/MASTERCARD ISSUER CROSS-BORDER FEEDate 10/06/23 0 3279122045 2 5815Card 2801,0.20833333333333334
10/8/2023,,Withdrawal Debit Card MC Debit Seminol/PLAY.HT BANGALORE BEDate 10/06/23 0 3279122045 2 5815Card 2801,39.0,,Posted,545.37,2023-10-08,39.0,Withdrawal Debit Card MC Debit Seminol/PLAY.HT BANGALORE BEDate 10/06/23 0 3279122045 2 5815Card 2801,39.0
10/8/2023,,Withdrawal Debit Card MC Debit Seminol/ELEVENLABS.IO NEW YORK NYDate 10/07/23 0 3280076314 2 5734Card 2801,1.0,,Posted,584.37,2023-10-08,1.0,Withdrawal Debit Card MC Debit Seminol/ELEVENLABS.IO NEW YORK NYDate 10/07/23 0 3280076314 2 5734Card 2801,1.0
10/8/2023,,Withdrawal Debit Card MC Debit Seminol/SAMSUNG ELECTRONICS RIDGEFIELD P NJDate 10/06/23 0 3279680685 1 5734Card 2801,15.99,,Posted,585.37,2023-10-08,15.99,Withdrawal Debit Card MC Debit Seminol/SAMSUNG ELECTRONICS RIDGEFIELD P NJDate 12/27/24 0 4362999827 1 5734Card 1231,16.49
10/6/2023,,Withdrawal POS #000000000000/AMAZON.COM*TE9JX40H2 SEATTLE WACard 2801,119.97,,Posted,601.36,2023-10-06,119.97,Withdrawal POS #000000000000/AMAZON.COM*V40RU1143 SEATTLE WACard 2801,119.97
10/6/2023,,Recurring Withdrawal Debit Card Fee/MASTERCARD ISSUER CROSS-BORDER FEEDate 10/06/23 0 3279875670 0 5734Card 2801,0.12,,Posted,721.33,2023-10-06,0.12,Recurring Withdrawal Debit Card Fee/MASTERCARD ISSUER CROSS-BORDER FEEDate 04/20/23 0 3110864064 0 7333Card 2801,0.15111111111111108
10/6/2023,,Recurring Withdrawal Debit Card - MC Debit Seminol/LINKTREE* LINKTREE COLLINGWOOD VIDate 10/06/23 0 3279875670 0 5734Card 2801,14.99,,Posted,721.45,2023-10-06,14.99,Recurring Withdrawal Debit Card - MC Debit Seminol/LINKTREE* LINKTREE COLLINGWOOD VIDate 12/06/23 0 3340923092 0 5734Card 2801,14.99
10/6/2023,,"Recurring Withdrawal Debit Card - MC Debit Seminol/MARMALEAD, LLC 4079065736 FLDate 10/05/23 0 3278869693 0 5045Card 2801",19.0,,Posted,736.44,2023-10-06,19.0,"Recurring Withdrawal Debit Card - MC Debit Seminol/MARMALEAD, LLC 4079065736 FLDate 01/05/24 0 4005822541 1 5045Card 2801",19.0
10/6/2023,,Recurring Withdrawal Bill Payment - #000000033416/NETFLIX COM LOS GATOS CACard 2801,11.0,,Posted,755.44,2023-10-06,11.0,Recurring Withdrawal Bill Payment - #000006911729/NETFLIX COM LOS GATOS CACard 2801,10.99
10/5/2023,,Recurring Withdrawal Debit Card - MC Debit Seminol/CHATGPT SUBSCRIPTION SAN FRANCISC CADate 10/04/23 0 3277321921 0 5734Card 2801,20.0,,Posted,646.44,2023-10-05,20.0,Recurring Withdrawal Debit Card - MC Debit Seminol/CHATGPT SUBSCRIPTION SAN FRANCISC CADate 05/04/24 0 4125659188 0 5734Card 1231,20.0
10/5/2023,,Recurring Withdrawal Debit Card - MC Debit Seminol/WWW.EVERBEE.IO SANTEE CADate 10/05/23 0 3278907060 0 5734Card 2801,29.99,,Posted,666.44,2023-10-05,29.99,Recurring Withdrawal Debit Card - MC Debit Seminol/WWW.EVERBEE.IO SANTEE CADate 01/05/24 0 4005834841 0 5734Card 2801,29.99
10/5/2023,,Recurring Withdrawal Debit Card - MC Debit Seminol/DISNEY PLUS 8889057888 CADate 10/04/23 0 3277775987 0 4899Card 2801,12.66,,Posted,696.43,2023-10-05,12.66,Recurring Withdrawal Debit Card - MC Debit Seminol/DISNEY PLUS 8889057888 CADate 10/02/24 0 4276239357 1 4899Card 1231,12.66
10/5/2023,,Recurring Withdrawal Debit Card - MC Debit Seminol/ADOBE *STOCK 4085366000 CADate 10/04/23 0 3277900612 0 5734Card 2801,29.99,,Posted,709.09,2023-10-05,29.99,Recurring Withdrawal Debit Card - MC Debit Seminol/ADOBE *CREATIVE CLOUD 4085366000 CADate 12/03/23 0 3337999974 0 5734Card 2801,29.99
10/5/2023,,Withdrawal POS #000000802629/Instacart 50 Beal St Suite 600 SanFrancisco CACard 2801,54.44,,Posted,739.08,2023-10-05,54.44,Withdrawal POS #000000802668/Instacart 50 Beal St Suite 600 SanFrancisco CACard 2801,54.44
10/4/2023,,Withdrawal POS #000000338994/SUNOCO 8002212501 4234 SW 20TH AVEGAINESVILLE FLCard 2801,34.36,,Posted,793.52,2023-10-04,34.36,Withdrawal POS #000000866633/SUNOCO 8002212501 4234 SW 20TH AVEGAINESVILLE FLCard 2801,34.68
10/4/2023,,Recurring Withdrawal Debit Card - MC Debit Seminol/APPLE.COM/BILL 866-712-7753 CADate 10/03/23 0 3276827222 0 5818Card 2801,2.99,,Posted,827.88,2023-10-04,2.99,Recurring Withdrawal Debit Card - MC Debit Seminol/APPLE.COM/BILL 866-712-7753 CADate 09/16/23 0 3259205559 2 5818Card 2801,2.99
10/4/2023,,Recurring Withdrawal Debit Card - MC Debit Seminol/APPLE.COM/BILL 866-712-7753 CADate 10/03/23 0 3276827221 0 5818Card 2801,2.99,,Posted,830.87,2023-10-04,2.99,Recurring Withdrawal Debit Card - MC Debit Seminol/APPLE.COM/BILL 866-712-7753 CADate 09/16/23 0 3259205559 2 5818Card 2801,2.99
10/3/2023,,Recurring Withdrawal Debit Card - MC Debit Seminol/PARAMOUNT+ SAN FRANCISC CADate 10/02/23 0 3275860755 0 4899Card 2801,13.81,,Posted,833.86,2023-10-03,13.81,Recurring Withdrawal Debit Card - MC Debit Seminol/PARAMOUNT+ SAN FRANCISC CADate 01/02/24 0 4002821550 0 4899Card 2801,13.81
10/3/2023,,Recurring Withdrawal Debit Card Fee/MASTERCARD ISSUER CROSS-BORDER FEEDate 10/02/23 0 3275860604 0 7399Card 2801,0.47,,Posted,847.67,2023-10-03,0.47,Recurring Withdrawal Debit Card Fee/MASTERCARD ISSUER CROSS-BORDER FEEDate 04/20/23 0 3110864064 0 7333Card 2801,0.15111111111111108
10/3/2023,,Recurring Withdrawal Debit Card - MC Debit Seminol/CREATIVE FABRICA AMSTERDAM NHDate 10/02/23 0 3275860604 0 7399Card 2801,59.16,,Posted,848.14,2023-10-03,59.16,Recurring Withdrawal Debit Card - MC Debit Seminol/CREATIVE FABRICA AMSTERDAM NHDate 10/03/24 0 4277044624 1 7399Card 1231,59.16
10/3/2023,,Withdrawal Debit Card Fee/MASTERCARD ISSUER CROSS-BORDER FEEDate 10/02/23 0 3275860600 0 5815Card 2801,0.31,,Posted,907.3,2023-10-03,0.31,Withdrawal Debit Card Fee/MASTERCARD ISSUER CROSS-BORDER FEEDate 10/06/23 0 3279122045 2 5815Card 2801,0.20833333333333334
10/3/2023,,Withdrawal Debit Card MC Debit Seminol/PLAY.HT BANGALORE BEDate 10/02/23 0 3275860600 0 5815Card 2801,39.0,,Posted,907.61,2023-10-03,39.0,Withdrawal Debit Card MC Debit Seminol/PLAY.HT BANGALORE BEDate 10/06/23 0 3279122045 2 5815Card 2801,39.0
10/3/2023,,Withdrawal Debit Card MC Debit Seminol/GRU/EZ-PAY WEB PYMT 352-334-3434 FLDate 10/02/23 0 3275297532 0 4900Card 2801,175.52,,Posted,946.61,2023-10-03,175.52,Withdrawal Debit Card MC Debit Seminol/GRU/EZ-PAY WEB PYMT 352-334-3434 FLDate 12/05/24 0 4340279271 0 4900Card 1231,175.52
10/3/2023,,Withdrawal Debit Card MC Debit Seminol/COX GAINESVILLE COMM 800-234-3993 FLDate 10/02/23 0 3275855008 0 4899Card 2801,111.39,,Posted,1122.13,2023-10-03,111.39,Withdrawal Debit Card MC Debit Seminol/COX GAINESVILLE COMM 800-234-3993 FLDate 12/04/24 0 4339376311 0 4899Card 1231,111.39
10/2/2023,,Withdrawal POS #000000782690/Instacart 50 Beal St Suite 600 SanFrancisco CACard 2801,2.0,,Posted,1233.52,2023-10-02,2.0,Withdrawal POS #000000782097/Instacart 50 Beal St Suite 600 SanFrancisco CACard 2801,1.6949999999999998
10/2/2023,,Withdrawal POS #000000802532/Instacart 50 Beal St Suite 600 SanFrancisco CACard 2801,72.59,,Posted,1235.52,2023-10-02,72.59,Withdrawal POS #000000802668/Instacart 50 Beal St Suite 600 SanFrancisco CACard 2801,72.59
10/2/2023,,Recurring Withdrawal Debit Card - MC Debit Seminol/MYDESIGNS - PRO - MON LAS VEGAS NVDate 10/01/23 0 3274789338 1 5734Card 2801,29.99,,Posted,1308.11,2023-10-02,29.99,Withdrawal Debit Card MC Debit Seminol/MYDESIGNS - PRO - MON LAS VEGAS NVDate 09/01/23 0 3244164229 1 5734Card 2801,29.99
10/2/2023,,Recurring Withdrawal Debit Card - MC Debit Seminol/KAIBER AI WILMINGTON DEDate 10/01/23 0 3274908200 0 5815Card 2801,15.0,,Posted,1338.1,2023-10-02,15.0,Recurring Withdrawal Debit Card - MC Debit Seminol/KAIBER AI WILMINGTON DEDate 08/30/23 0 3242340816 0 5815Card 2801,15.0
10/2/2023,,Recurring Withdrawal Debit Card - MC Debit Seminol/ETSY.COM*AIAVATAR BROOKLYN NYDate 10/01/23 0 3274789186 1 5970Card 2801,16.95,,Posted,1353.1,2023-10-02,16.95,Recurring Withdrawal Debit Card - MC Debit Seminol/ETSY.COM*AIAVATAR BROOKLYN NYDate 10/01/23 0 3274789186 1 5970Card 2801,16.990000000000002
10/2/2023,,Withdrawal ACH Watson Realty Co/TYPE: WEB PMTS ID: 9000321157CO: Watson Realty CoNAME: Steven chaplinskiEntry Class Code: WEB,1079.0,,Posted,1370.05,2023-10-02,1079.0,Withdrawal ACH Watson Realty Co/TYPE: WEB PMTS ID: 9000321157CO: Watson Realty CoEntry Class Code: WEB,1079.0
10/2/2023,,"Withdrawal ACH AppFolio, Inc. F/TYPE: WEB PMTS ID: 9001406550CO: AppFolio, Inc. FNAME: Steven chaplinskiEntry Class Code: WEB",2.49,,Posted,2449.05,2023-10-02,2.49,"Withdrawal ACH AppFolio, Inc. F/TYPE: WEB PMTS ID: 9001406550

CO: AppFolio, Inc. F

NAME: Steven chaplinskiEntry Class Code: WEB",2.49
9/30/2023,,Withdrawal Debit Card MC Debit Seminol/PHR*SIMEDHEALTHLLC GAINESVILLE FLDate 09/29/23 0 3272984653 0 8011Card 2801,45.0,,Posted,2451.54,2023-09-30,45.0,Withdrawal Debit Card MC Debit Seminol/PHR*SIMEDHEALTHLLC GAINESVILLE FLDate 09/29/23 0 3272984653 0 8011Card 2801,45.0
9/29/2023,,Withdrawal POS #000000126446/SUNOCO 8002212501 4234 SW 20TH AVEGAINESVILLE FLCard 2801,35.0,,Posted,2496.54,2023-09-29,35.0,Withdrawal POS #000000866633/SUNOCO 8002212501 4234 SW 20TH AVEGAINESVILLE FLCard 2801,34.68
9/29/2023,,Recurring Withdrawal Debit Card - MC Debit Seminol/IC* INSTACART*SUBSCRIP SAN FRANCISC CADate 09/28/23 0 3271996294 0 5411Card 2801,49.0,,Posted,2531.54,2023-09-29,49.0,Recurring Withdrawal Debit Card - MC Debit Seminol/IC* INSTACART*SUBSCRIP SAN FRANCISC CADate 11/30/24 0 4335692546 1 5411Card 1231,49.0
9/29/2023,,Withdrawal Debit Card MC Debit Seminol/PHR*SIMEDHEALTHLLC GAINESVILLE FLDate 09/28/23 0 3271994911 0 8011Card 2801,45.0,,Posted,2580.54,2023-09-29,45.0,Withdrawal Debit Card MC Debit Seminol/PHR*SIMEDHEALTHLLC GAINESVILLE FLDate 09/29/23 0 3272984653 0 8011Card 2801,45.0
9/29/2023,,Withdrawal Debit Card MC Debit Seminol/WALGREENS #9304 GAINESVILLE FLDate 09/28/23 0 3271906334 0 5912Card 2801,5.07,,Posted,2625.54,2023-09-29,5.07,Withdrawal Debit Card MC Debit Seminol/WALGREENS #5024 GAINESVILLE FLDate 06/26/23 0 3177001861 1 5912Card 2801,5.07
9/29/2023,,Withdrawal Debit Card MC Debit Seminol/WALGREENS #9304 GAINESVILLE FLDate 09/28/23 0 3271906333 0 5912Card 2801,19.93,,Posted,2630.61,2023-09-29,19.93,Withdrawal Debit Card MC Debit Seminol/WALGREENS #5024 GAINESVILLE FLDate 06/26/23 0 3177001861 1 5912Card 2801,19.96
9/29/2023,,Withdrawal ACH FLUENT-Gainesvil/TYPE: PAYMENT ID: 1371804719CO: FLUENT-GainesvilEntry Class Code: PPD,5.0,,Posted,2650.54,2023-09-29,5.0,Withdrawal ACH FLUENT-Gainesvil/TYPE: PAYMENT ID: 1371804719CO: FLUENT-GainesvilEntry Class Code: PPD,5.0
9/29/2023,,Withdrawal POS #000000792104/Instacart 50 Beal St Suite 600 SanFrancisco CACard 2801,2.0,,Posted,2655.54,2023-09-29,2.0,Withdrawal POS #000000792604/Instacart 50 Beal St Suite 600 SanFrancisco CACard 2801,2.5
9/29/2023,,Withdrawal POS #000000802523/Instacart 50 Beal St Suite 600 SanFrancisco CACard 2801,50.73,,Posted,2657.54,2023-09-29,50.73,Withdrawal POS #000000802668/Instacart 50 Beal St Suite 600 SanFrancisco CACard 2801,50.325
9/28/2023,,Withdrawal POS #000013684735/CIRCLE K # 26146 3525 GAINESVILLE FLCard 2801,20.0,,Posted,2708.27,2023-09-28,20.0,Withdrawal POS #000010941641/CIRCLE K # 26146 3525 GAINESVILLE FLCard 1231,20.0
9/28/2023,,Withdrawal POS #000000759224/AMAZON.COM*T10N02X21 SEATTLE WACard 2801,31.82,,Posted,2728.27,2023-09-28,31.82,Withdrawal POS #000000626675/AMAZON.COM*1F8259P12 SEATTLE WACard 2801,31.94
9/28/2023,,Withdrawal POS #000000076873/SUNOCO 8002212501 4234 SW 20TH AVEGAINESVILLE FLCard 2801,28.55,,Posted,2760.09,2023-09-28,28.55,Withdrawal POS #000000866633/SUNOCO 8002212501 4234 SW 20TH AVEGAINESVILLE FLCard 2801,28.55
9/28/2023,,Recurring Withdrawal Debit Card - MC Debit Seminol/ADOBE *CREATIVE CLOUD 4085366000 CADate 09/27/23 0 3270848511 0 5734Card 2801,29.99,,Posted,2788.64,2023-09-28,29.99,Recurring Withdrawal Debit Card MC Debit/ADOBE *CREATIVE CLOUD 4085366000 CADate 04/27/23 0 3117844835 0 5734Card 2801,29.99
9/27/2023,,Withdrawal POS #000000046634/SUNOCO 8002212501 4234 SW 20TH AVEGAINESVILLE FLCard 2801,17.49,,Posted,18.63,2023-09-27,17.49,Withdrawal POS #000000866633/SUNOCO 8002212501 4234 SW 20TH AVEGAINESVILLE FLCard 2801,17.49
9/26/2023,,Withdrawal POS #000000078132/SUNOCO 8002212501 4234 SW 20TH AVEGAINESVILLE FLCard 2801,17.49,,Posted,36.12,2023-09-26,17.49,Withdrawal POS #000000866633/SUNOCO 8002212501 4234 SW 20TH AVEGAINESVILLE FLCard 2801,17.49
9/25/2023,,Withdrawal POS #000000792501/Instacart 50 Beal St Suite 600 SanFrancisco CACard 2801,3.0,,Posted,53.61,2023-09-25,3.0,Withdrawal POS #000000792604/Instacart 50 Beal St Suite 600 SanFrancisco CACard 2801,2.5
9/25/2023,,Withdrawal POS #000000782865/Instacart 50 Beal St Suite 600 SanFrancisco CACard 2801,61.03,,Posted,56.61,2023-09-25,61.03,Withdrawal POS #000000782111/Instacart 50 Beal St Suite 600 SanFrancisco CACard 2801,61.03
9/24/2023,,Withdrawal Courtesy Pay Fee,35.0,,Posted,-57.36,2023-09-24,35.0,Withdrawal Courtesy Pay Fee,35.0
9/24/2023,,Withdrawal POS #000000938024/SUNOCO 8002212501 4234 SW 20TH AVEGAINESVILLE FLCard 2801,17.49,,Posted,-22.36,2023-09-24,17.49,Withdrawal POS #000000955321/SUNOCO 8002212501 4234 SW 20TH AVEGAINESVILLE FLCard 2801,17.705
9/24/2023,,Withdrawal POS #000014322053/WALGREENS 2415 SW 75TH GAINESVILLE FLCard 2801,15.0,,Posted,-4.87,2023-09-24,15.0,Withdrawal POS #000014264526/WALGREENS 2415 SW GAINESVILLE FLCard 2801,15.0
9/24/2023,,Recurring Withdrawal Debit Card - MC Debit Seminol/CANVA* I03914-38299904 CAMDEN DEDate 09/23/23 0 3266003765 1 7221Card 2801,12.99,,Posted,10.13,2023-09-24,12.99,Recurring Withdrawal Debit Card - MC Debit Seminol/CANVA* I03914-38299904 CAMDEN DEDate 09/23/23 0 3266003765 1 7221Card 2801,12.99
9/24/2023,,Recurring Withdrawal Debit Card - MC Debit Seminol/VIDIQ SAN FRANCISC CADate 09/23/23 0 3266003554 1 5734Card 2801,10.0,,Posted,23.12,2023-09-24,10.0,Recurring Withdrawal Debit Card - MC Debit Seminol/VIDIQ SAN FRANCISC CADate 12/23/23 0 3357950683 0 5734Card 2801,10.0
9/24/2023,,Recurring Withdrawal Debit Card - MC Debit Seminol/ETSY.COM - AIAVATAR BROOKLYN NYDate 09/24/23 0 3267006030 1 5699Card 2801,33.29,,Posted,33.12,2023-09-24,33.29,Recurring Withdrawal Debit Card - MC Debit Seminol/ETSY.COM - AIAVATAR BROOKLYN NYDate 09/24/23 0 3267006030 1 5699Card 2801,33.29
9/23/2023,,Withdrawal POS #000000920351/AMAZON.COM*T18RP5V32 SEATTLE WACard 2801,22.88,,Posted,66.41,2023-09-23,22.88,Withdrawal POS #000000990788/AMAZON.COM*215VY1SG1 SEATTLE WACard 2801,23.03
9/23/2023,,Withdrawal POS #000000895586/SUNOCO 8002212501 4234 SW 20TH AVEGAINESVILLE FLCard 2801,17.49,,Posted,89.29,2023-09-23,17.49,Withdrawal POS #000000955321/SUNOCO 8002212501 4234 SW 20TH AVEGAINESVILLE FLCard 2801,17.705
9/23/2023,,Withdrawal POS #000003340288/GOOGLE *Google Storage 1600 AmphitheatreParkw Mountain View CACard 2801,1.99,,Posted,106.78,2023-09-23,1.99,Withdrawal POS #000002040482/GOOGLE *Google Storage 1600 AmphitheatreParkw Mountain View CACard 2801,1.99
9/22/2023,,Withdrawal POS #000000772390/Instacart 50 Beal St Suite 600 SanFrancisco CACard 2801,3.0,,Posted,108.77,2023-09-22,3.0,Withdrawal POS #000000784940/Instacart 50 Beal St Suite 600 SanFrancisco CACard 2801,3.0
9/22/2023,,Withdrawal POS #000000792964/Instacart 50 Beal St Suite 600 SanFrancisco CACard 2801,62.38,,Posted,111.77,2023-09-22,62.38,Withdrawal POS #000000792604/Instacart 50 Beal St Suite 600 SanFrancisco CACard 2801,62.38
9/21/2023,,Withdrawal POS #000000772238/Instacart 50 Beal St Suite 600 SanFrancisco CACard 2801,57.89,,Posted,174.15,2023-09-21,57.89,Withdrawal POS #000000772752/Instacart 50 Beal St Suite 600 SanFrancisco CACard 2801,57.89
9/20/2023,,Withdrawal POS #000000765409/SUNOCO 8002212501 4234 SW 20TH AVEGAINESVILLE FLCard 2801,28.55,,Posted,232.04,2023-09-20,28.55,Withdrawal POS #000000639499/SUNOCO 8002212501 4234 SW 20TH AVEGAINESVILLE FLCard 2801,28.32
9/20/2023,,Withdrawal POS #000003320828/GOOGLE *YouTubePremium 1600 AmphitheatreParkw Mountain View CACard 2801,15.92,,Posted,10.59,2023-09-20,15.92,Withdrawal POS #000003285955/GOOGLE *YouTubePremium 1600 AmphitheatreParkw Mountain View CACard 2801,15.92
9/19/2023,,Withdrawal POS #000000689838/SUNOCO 8002212501 4234 SW 20TH AVEGAINESVILLE FLCard 2801,17.49,,Posted,26.51,2023-09-19,17.49,Withdrawal POS #000000866633/SUNOCO 8002212501 4234 SW 20TH AVEGAINESVILLE FLCard 2801,17.49
9/18/2023,,Withdrawal POS #000000655618/SUNOCO 8002212501 4234 SW 20TH AVEGAINESVILLE FLCard 2801,17.49,,Posted,44.0,2023-09-18,17.49,Withdrawal POS #000000955321/SUNOCO 8002212501 4234 SW 20TH AVEGAINESVILLE FLCard 2801,17.705
9/18/2023,,Withdrawal Debit Card MC Debit Seminol/PRINTIFY.COM WILMINGTON DEDate 09/17/23 0 3260843086 0 7333Card 2801,23.04,,Posted,61.49,2023-09-18,23.04,Withdrawal Debit Card MC Debit Seminol/PRINTIFY.COM WILMINGTON DEDate 03/19/24 0 4079795188 0 7333Card 1231,23.04
9/18/2023,,Withdrawal Debit Card MC Debit Seminol/PRINTIFY.COM WILMINGTON DEDate 09/17/23 0 3260843085 0 7333Card 2801,33.04,,Posted,84.53,2023-09-18,33.04,Withdrawal Debit Card MC Debit Seminol/PRINTIFY.COM WILMINGTON DEDate 03/19/24 0 4079795188 0 7333Card 1231,33.04
9/17/2023,,Withdrawal POS #000000792176/Instacart 50 Beal St Suite 600 SanFrancisco CACard 2801,49.13,,Posted,117.57,2023-09-17,49.13,Withdrawal POS #000000792604/Instacart 50 Beal St Suite 600 SanFrancisco CACard 2801,49.13
9/17/2023,,Recurring Withdrawal Debit Card - MC Debit Seminol/PLAYERAUCTIONS 800-342-0768 DEDate 09/17/23 0 3260060094 1 5816Card 2801,38.6,,Posted,166.7,2023-09-17,38.6,Recurring Withdrawal Debit Card - MC Debit Seminol/PLAYERAUCTIONS 800-342-0768 DEDate 09/17/23 0 3260060094 1 5816Card 2801,38.6
9/17/2023,,Withdrawal Debit Card MC Debit Seminol/WALGREENS #5024 GAINESVILLE FLDate 09/16/23 0 3259059724 1 5912Card 2801,8.16,,Posted,205.3,2023-09-17,8.16,Withdrawal Debit Card MC Debit Seminol/WALGREENS #5024 GAINESVILLE FLDate 06/26/23 0 3177001861 1 5912Card 2801,8.16
9/17/2023,,Recurring Withdrawal Debit Card - MC Debit Seminol/APPLE.COM/BILL 866-712-7753 CADate 09/16/23 0 3259205559 2 5818Card 2801,18.98,,Posted,213.46,2023-09-17,18.98,Recurring Withdrawal Debit Card - MC Debit Seminol/APPLE.COM/BILL 866-712-7753 CADate 09/16/23 0 3259205559 2 5818Card 2801,18.975
9/15/2023,,Recurring Withdrawal Debit Card - MC Debit Seminol/WEB*BLUEHOST.COM PROVO UTDate 09/14/23 0 3257921184 0 5968Card 2801,20.99,,Posted,67.57,2023-09-15,20.99,Recurring Withdrawal Debit Card - MC Debit Seminol/WEB*BLUEHOST.COM PROVO UTDate 09/14/23 0 3257921184 0 5968Card 2801,20.99
9/15/2023,,Withdrawal POS #000000802091/Instacart 50 Beal St Suite 600 SanFrancisco CACard 2801,3.0,,Posted,88.56,2023-09-15,3.0,Withdrawal POS #000000782097/Instacart 50 Beal St Suite 600 SanFrancisco CACard 2801,3.0
9/15/2023,,Withdrawal POS #000000802049/Instacart 50 Beal St Suite 600 SanFrancisco CACard 2801,63.95,,Posted,91.56,2023-09-15,63.95,Withdrawal POS #000000782097/Instacart 50 Beal St Suite 600 SanFrancisco CACard 2801,63.95
9/14/2023,,Recurring Withdrawal Debit Card - MC Debit Seminol/WEB*BLUEHOST.COM PROVO UTDate 09/13/23 0 3256906037 0 5968Card 2801,143.88,,Posted,155.51,2023-09-14,143.88,Recurring Withdrawal Debit Card - MC Debit Seminol/WEB*BLUEHOST.COM PROVO UTDate 09/14/23 0 3257921184 0 5968Card 2801,143.88
9/14/2023,,Withdrawal Debit Card MC Debit Seminol/CIRCLE K # 06782 GAINESVILLE FLDate 09/12/23 0 3255899974 0 5499Card 2801,26.23,,Posted,299.39,2023-09-14,26.23,Withdrawal Debit Card MC Debit Seminol/CIRCLE K # 06782 GAINESVILLE FLDate 09/08/24 0 4252889868 0 5499Card 1231,26.23
9/13/2023,,Withdrawal POS #000000023432/AMAZON.COM*TR0QF4EI1 SEATTLE WACard 2801,18.12,,Posted,325.62,2023-09-13,18.12,Withdrawal POS #000000019465/AMAZON.COM*1U6B04IO0 SEATTLE WACard 2801,18.12
9/12/2023,,Withdrawal POS #000000792554/Instacart 50 Beal St Suite 600 SanFrancisco CACard 2801,74.1,,Posted,343.74,2023-09-12,74.1,Withdrawal POS #000000792604/Instacart 50 Beal St Suite 600 SanFrancisco CACard 2801,74.1
9/12/2023,,Recurring Withdrawal Debit Card - MC Debit Seminol/QUILLBOT OAK BROOK ILDate 09/11/23 0 3254733194 0 5734Card 2801,19.95,,Posted,417.84,2023-09-12,19.95,Recurring Withdrawal Debit Card - MC Debit Seminol/QUILLBOT OAK BROOK ILDate 12/25/23 0 3359752154 0 5734Card 2801,19.95
9/12/2023,,Withdrawal POS #000005013671/PAYPAL *PRINTIFY 2211 North First StreetSan Jose CACard 2801,10.0,,Posted,437.79,2023-09-12,10.0,Withdrawal POS #000005013671/PAYPAL *PRINTIFY 2211 North First StreetSan Jose CACard 2801,10.0
9/11/2023,,Withdrawal ACH CAPITAL ONE/TYPE: ONLINE PMT ID: 9279744391CO: CAPITAL ONE NAME: STEVEN CHAPLINSKIEntry Class Code: WEB,26.0,,Posted,430.95,2023-09-11,26.0,Withdrawal ACH CAPITAL ONE/TYPE: ONLINE PMT ID: 9279744391CO: CAPITAL ONE NAME: STEVEN CHAPLINSKIEntry Class Code: WEB,25.5
9/11/2023,,Recurring Withdrawal Debit Card - MC Debit Seminol/MIDJOURNEY INC. SOUTH SAN FR CADate 09/10/23 0 3253006510 1 5734Card 2801,30.0,,Posted,456.95,2023-09-11,30.0,Withdrawal Debit Card MC Debit Seminol/MIDJOURNEY INC. SOUTH SAN FR CADate 10/16/23 0 3289666656 0 5734Card 2801,30.0
9/10/2023,,Recurring Withdrawal Debit Card - MC Debit Seminol/MIDJOURNEY INC. SOUTH SAN FR CADate 09/08/23 0 3251850724 1 5734Card 2801,30.0,,Posted,486.95,2023-09-10,30.0,Withdrawal Debit Card MC Debit Seminol/MIDJOURNEY INC. SOUTH SAN FR CADate 10/16/23 0 3289666656 0 5734Card 2801,30.0
9/10/2023,,Recurring Withdrawal Debit Card - MC Debit Seminol/WEB*HOSTGATOR.COM BURLINGTON MADate 09/08/23 0 3251838693 1 4816Card 2801,21.99,,Posted,516.95,2023-09-10,21.99,Recurring Withdrawal Debit Card - MC Debit Seminol/WEB*HOSTGATOR.COM BURLINGTON MADate 11/18/23 0 3322020816 1 4816Card 2801,21.99
9/10/2023,,Withdrawal Debit Card MC Debit Seminol/AMAZON PRIME*TR9UL8ZP0 AMZN.COM/BIL WADate 09/08/23 0 3251834805 1 5968Card 2801,15.13,,Posted,538.94,2023-09-10,15.13,Withdrawal Debit Card MC Debit Seminol/AMAZON PRIME*PE3IN5Y03 AMZN.COM/BIL WADate 12/08/23 0 3342550116 0 5968Card 2801,15.14
9/8/2023,,Recurring Withdrawal Debit Card Fee/MASTERCARD ISSUER CROSS-BORDER FEEDate 09/07/23 0 3250971158 0 5734Card 2801,0.24,,Posted,554.07,2023-09-08,0.24,Recurring Withdrawal Debit Card Fee/MASTERCARD ISSUER CROSS-BORDER FEEDate 04/20/23 0 3110864064 0 7333Card 2801,0.15111111111111108
9/8/2023,,Recurring Withdrawal Debit Card - MC Debit Seminol/ALURA SUBSCRIPTION OSLO DUDate 09/07/23 0 3250971158 0 5734Card 2801,29.99,,Posted,554.31,2023-09-08,29.99,Recurring Withdrawal Debit Card - MC Debit Seminol/ALURA SUBSCRIPTION OSLO DUDate 01/08/24 0 4008859029 0 5734Card 2801,29.99
9/8/2023,,Withdrawal POS #000096296533/FAST TRACK #200 GAINESVILLE FLCard 2801,27.56,,Posted,584.3,2023-09-08,27.56,Withdrawal POS #000096296533/FAST TRACK #200 GAINESVILLE FLCard 2801,27.52
9/7/2023,,Withdrawal POS #000000772425/Instacart 50 Beal St Suite 600 SanFrancisco CACard 2801,5.0,,Posted,611.86,2023-09-07,5.0,Withdrawal POS #000000772752/Instacart 50 Beal St Suite 600 SanFrancisco CACard 2801,5.0
9/7/2023,,Withdrawal POS #000000772319/Instacart 50 Beal St Suite 600 SanFrancisco CACard 2801,78.72,,Posted,616.86,2023-09-07,78.72,Withdrawal POS #000000782111/Instacart 50 Beal St Suite 600 SanFrancisco CACard 2801,78.72
9/7/2023,,Recurring Withdrawal Debit Card - MC Debit Seminol/SALESAMURAI.IO SFTWARE BOULDER CODate 09/07/23 0 3250945464 0 5734Card 2801,9.99,,Posted,695.58,2023-09-07,9.99,Withdrawal Debit Card MC Debit Seminol/SALESAMURAI.IO SFTWARE BOULDER CODate 11/13/23 0 3317927273 0 5734Card 2801,9.99
9/6/2023,,Recurring Withdrawal Debit Card Fee/MASTERCARD ISSUER CROSS-BORDER FEEDate 09/06/23 0 3249708425 0 5734Card 2801,0.12,,Posted,705.57,2023-09-06,0.12,Recurring Withdrawal Debit Card Fee/MASTERCARD ISSUER CROSS-BORDER FEEDate 04/20/23 0 3110864064 0 7333Card 2801,0.15111111111111108
9/6/2023,,Recurring Withdrawal Debit Card - MC Debit Seminol/LINKTREE* LINKTREE COLLINGWOOD VIDate 09/06/23 0 3249708425 0 5734Card 2801,14.99,,Posted,705.69,2023-09-06,14.99,Recurring Withdrawal Debit Card - MC Debit Seminol/LINKTREE* LINKTREE COLLINGWOOD VIDate 12/06/23 0 3340923092 0 5734Card 2801,14.99
9/6/2023,,"Recurring Withdrawal Debit Card - MC Debit Seminol/MARMALEAD, LLC 4079065736 FLDate 09/05/23 0 3248703827 0 5045Card 2801",19.0,,Posted,720.68,2023-09-06,19.0,"Recurring Withdrawal Debit Card - MC Debit Seminol/MARMALEAD, LLC 4079065736 FLDate 01/05/24 0 4005822541 1 5045Card 2801",19.0
9/6/2023,,Recurring Withdrawal Bill Payment - #000000330342/Netflix.com NETFLIX.COM LOS GATOS CACard 2801,11.0,,Posted,739.68,2023-09-06,11.0,Recurring Withdrawal Bill Payment - #000000864701/Netflix.com NETFLIX.COM LOS GATOS CACard 1231,11.0
9/5/2023,,Recurring Withdrawal Debit Card - MC Debit Seminol/WWW.EVERBEE.IO SANTEE CADate 09/05/23 0 3248777430 0 5734Card 2801,6.0,,Posted,750.68,2023-09-05,6.0,Recurring Withdrawal Debit Card - MC Debit Seminol/WWW.EVERBEE.IO SANTEE CADate 01/05/24 0 4005834841 0 5734Card 2801,6.0
9/5/2023,,Recurring Withdrawal Debit Card - MC Debit Seminol/DISNEY PLUS 8889057888 CADate 09/04/23 0 3247706318 0 4899Card 2801,12.66,,Posted,756.68,2023-09-05,12.66,Recurring Withdrawal Debit Card - MC Debit Seminol/DISNEY PLUS 8889057888 CADate 10/02/24 0 4276239357 1 4899Card 1231,12.66
9/5/2023,,Recurring Withdrawal Debit Card - MC Debit Seminol/ADOBE *STOCK 4085366000 CADate 09/04/23 0 3247815159 0 5734Card 2801,29.99,,Posted,769.34,2023-09-05,29.99,Recurring Withdrawal Debit Card MC Debit/ADOBE *STOCK 4085366000 CADate 06/04/23 0 3155943134 0 5734Card 2801,29.99
9/5/2023,,Withdrawal ACH Watson Realty Co/TYPE: WEB PMTS ID: 9000321157CO: Watson Realty CoNAME: Steven chaplinskiEntry Class Code: WEB,1079.0,,Posted,799.33,2023-09-05,1079.0,Withdrawal ACH Watson Realty Co/TYPE: WEB PMTS ID: 9000321157CO: Watson Realty CoEntry Class Code: WEB,1079.0
9/5/2023,,Withdrawal ACH FLUENT-Gainesvil/TYPE: PAYMENT ID: 1371804719CO: FLUENT-GainesvilEntry Class Code: PPD,83.0,,Posted,1878.33,2023-09-05,83.0,Withdrawal ACH FLUENT-Gainesvil/TYPE: PAYMENT ID: 1371804719CO: FLUENT-GainesvilEntry Class Code: PPD,83.0
9/5/2023,,"Withdrawal ACH AppFolio, Inc. F/TYPE: WEB PMTS ID: 9001406550CO: AppFolio, Inc. FNAME: Steven chaplinskiEntry Class Code: WEB",2.49,,Posted,1961.33,2023-09-05,2.49,"Withdrawal ACH AppFolio, Inc. F/TYPE: WEB PMTS ID: 9001406550

CO: AppFolio, Inc. F

NAME: Steven chaplinskiEntry Class Code: WEB",2.49
9/4/2023,,Recurring Withdrawal Debit Card - MC Debit Seminol/CHATGPT SUBSCRIPTION SAN FRANCISC CADate 09/03/23 0 3246038633 1 5734Card 2801,20.0,,Posted,1963.82,2023-09-04,20.0,Recurring Withdrawal Debit Card - MC Debit Seminol/CHATGPT SUBSCRIPTION SAN FRANCISC CADate 05/04/24 0 4125659188 0 5734Card 1231,20.0
9/4/2023,,Recurring Withdrawal Debit Card - MC Debit Seminol/APPLE.COM/BILL 866-712-7753 CADate 09/03/23 0 3246843033 0 5818Card 2801,2.99,,Posted,1983.82,2023-09-04,2.99,Recurring Withdrawal Debit Card - MC Debit Seminol/APPLE.COM/BILL 866-712-7753 CADate 09/16/23 0 3259205559 2 5818Card 2801,2.99
9/4/2023,,Recurring Withdrawal Debit Card - MC Debit Seminol/APPLE.COM/BILL 866-712-7753 CADate 09/03/23 0 3246843032 0 5818Card 2801,2.99,,Posted,1986.81,2023-09-04,2.99,Recurring Withdrawal Debit Card - MC Debit Seminol/APPLE.COM/BILL 866-712-7753 CADate 09/16/23 0 3259205559 2 5818Card 2801,2.99
9/3/2023,,Withdrawal POS #000000010502/CIRCLE K # 26146 3525 GAINESVILLE FLCard 2801,27.72,,Posted,1989.8,2023-09-03,27.72,Withdrawal POS #000000000558/CIRCLE K # 26146 3525 GAINESVILLE FLCard 2801,27.534999999999997
9/3/2023,,Withdrawal POS #000000777017/PUBLIX 3100 SW 35TH BLVD GAINESVILLE FLCard 2801,52.69,,Posted,2017.52,2023-09-03,52.69,Withdrawal POS #000000058955/PUBLIX 3100 SW 35TH BLVD GAINESVILLE FLCard 2801,52.69
9/3/2023,,Withdrawal Debit Card MC Debit Seminol/SESAME CARE - HEALTH MIAMI FLDate 09/01/23 0 3244024909 2 8099Card 2801,40.0,,Posted,2070.21,2023-09-03,40.0,Withdrawal Debit Card MC Debit Seminol/SESAME CARE - HEALTH MIAMI FLDate 09/01/23 0 3244024909 2 8099Card 2801,40.0
9/3/2023,,Recurring Withdrawal Debit Card - MC Debit Seminol/PARAMOUNT+ SAN FRANCISC CADate 09/02/23 0 3245001222 1 4899Card 2801,13.81,,Posted,2110.21,2023-09-03,13.81,Recurring Withdrawal Debit Card - MC Debit Seminol/PARAMOUNT+ SAN FRANCISC CADate 01/02/24 0 4002821550 0 4899Card 2801,13.81
9/3/2023,,Withdrawal Debit Card MC Debit Seminol/WALGREENS #5024 GAINESVILLE FLDate 09/02/23 0 3245975396 0 5912Card 2801,11.74,,Posted,2124.02,2023-09-03,11.74,Withdrawal Debit Card MC Debit Seminol/WALGREENS #5024 GAINESVILLE FLDate 06/26/23 0 3177001861 1 5912Card 2801,11.275
9/3/2023,,Withdrawal Debit Card MC Debit Seminol/GRU/EZ-PAY WEB PYMT 352-334-3434 FLDate 09/01/23 0 3244541676 0 4900Card 2801,168.55,,Posted,2135.76,2023-09-03,168.55,Withdrawal Debit Card MC Debit Seminol/GRU/EZ-PAY WEB PYMT 352-334-3434 FLDate 12/05/24 0 4340279271 0 4900Card 1231,168.55
9/3/2023,,Withdrawal Debit Card MC Debit Seminol/COX GAINESVILLE COMM 800-234-3993 FLDate 09/01/23 0 3244017480 2 4899Card 2801,125.03,,Posted,2304.31,2023-09-03,125.03,Withdrawal Debit Card MC Debit Seminol/COX GAINESVILLE COMM 800-234-3993 FLDate 12/04/24 0 4339376311 0 4899Card 1231,125.03
9/2/2023,,Withdrawal POS #000000935000/AMAZON.COM*TL49B6PZ2 SEATTLE WACard 2801,19.96,,Posted,2429.34,2023-09-02,19.96,Withdrawal POS #000000991850/AMAZON.COM*7Q29B9KF3 SEATTLE WACard 2801,20.18
9/2/2023,,Withdrawal POS #000000890020/SUNOCO 8002212501 4234 SW 20TH AVEGAINESVILLE FLCard 2801,35.41,,Posted,2449.3,2023-09-02,35.41,Withdrawal POS #000000899960/SUNOCO 8002212501 4234 SW 20TH AVEGAINESVILLE FLCard 2801,35.58
9/2/2023,,Withdrawal POS #000000005018/AMAZON.COM*TL5XF0NC0 SEATTLE WACard 2801,14.31,,Posted,2484.71,2023-09-02,14.31,Withdrawal POS #000000400824/AMAZON.COM*HC3O110O2 SEATTLE WACard 2801,14.47
9/1/2023,,Withdrawal POS #000000772372/Instacart 50 Beal St Suite 600 SanFrancisco CACard 2801,5.0,,Posted,2499.02,2023-09-01,5.0,Withdrawal POS #000000772752/Instacart 50 Beal St Suite 600 SanFrancisco CACard 2801,5.0
9/1/2023,,Withdrawal POS #000000792009/Instacart 50 Beal St Suite 600 SanFrancisco CACard 2801,56.97,,Posted,2504.02,2023-09-01,56.97,Withdrawal POS #000000782097/Instacart 50 Beal St Suite 600 SanFrancisco CACard 2801,56.739999999999995
9/1/2023,,Withdrawal Debit Card MC Debit Seminol/MYDESIGNS - PRO - MON LAS VEGAS NVDate 09/01/23 0 3244164229 1 5734Card 2801,29.99,,Posted,2560.99,2023-09-01,29.99,Withdrawal Debit Card MC Debit Seminol/MYDESIGNS - PRO - MON LAS VEGAS NVDate 09/01/23 0 3244164229 1 5734Card 2801,29.99
9/1/2023,,Recurring Withdrawal Debit Card - MC Debit Seminol/AIAVATAR BROOKLYN NYDate 09/01/23 0 3244163906 1 5970Card 2801,1.2,,Posted,2590.98,2023-09-01,1.2,Recurring Withdrawal Debit Card - MC Debit Seminol/ETSY.COM*AIAVATAR BROOKLYN NYDate 10/01/23 0 3274789186 1 5970Card 2801,1.2
9/1/2023,,Withdrawal POS #000096296875/FAST TRACK #200 GAINESVILLE FLCard 2801,45.61,,Posted,2592.18,2023-09-01,45.61,Withdrawal POS #000096296533/FAST TRACK #200 GAINESVILLE FLCard 2801,45.61
8/31/2023,,Recurring Withdrawal Debit Card - MC Debit Seminol/KAIBER AI WILMINGTON DEDate 08/30/23 0 3242340816 0 5815Card 2801,5.0,,Posted,37.79,2023-08-31,5.0,Recurring Withdrawal Debit Card - MC Debit Seminol/KAIBER AI WILMINGTON DEDate 08/30/23 0 3242340816 0 5815Card 2801,5.0
8/29/2023,,Recurring Withdrawal Debit Card Fee/MASTERCARD ISSUER CROSS-BORDER FEEDate 08/29/23 0 3241987657 0 5734Card 2801,0.13,,Posted,42.79,2023-08-29,0.13,Recurring Withdrawal Debit Card Fee/MASTERCARD ISSUER CROSS-BORDER FEEDate 04/20/23 0 3110864064 0 7333Card 2801,0.15111111111111108
8/29/2023,,Recurring Withdrawal Debit Card - MC Debit Seminol/VANCEAI CENTRAL HODate 08/29/23 0 3241987657 0 5734Card 2801,15.9,,Posted,42.92,2023-08-29,15.9,Withdrawal Debit Card MC Debit Seminol/VANCEAI CENTRAL HODate 06/29/23 0 3180070895 1 5734Card 2801,15.9
8/28/2023,,Recurring Withdrawal Debit Card - MC Debit Seminol/ADOBE *CREATIVE CLOUD 4085366000 CADate 08/27/23 0 3239947934 0 5734Card 2801,29.99,,Posted,58.82,2023-08-28,29.99,Recurring Withdrawal Debit Card - MC Debit Seminol/ADOBE *CREATIVE CLOUD 4085366000 CADate 12/03/23 0 3337999974 0 5734Card 2801,29.99
8/27/2023,,Recurring Withdrawal Debit Card - MC Debit Seminol/MIDJOURNEY INC. SOUTH SAN FR CADate 08/26/23 0 3238302720 1 5734Card 2801,4.0,,Posted,-11.19,2023-08-27,4.0,Withdrawal Debit Card MC Debit Seminol/MIDJOURNEY INC. SOUTH SAN FR CADate 10/16/23 0 3289666656 0 5734Card 2801,4.0
8/27/2023,,Recurring Withdrawal Debit Card - MC Debit Seminol/YVETTE GODET DMD PA GAINESVILLE FLDate 08/25/23 0 3237032877 1 8021Card 2801,46.0,,Posted,-7.19,2023-08-27,46.0,Withdrawal Debit Card MC Debit Seminol/YVETTE GODET DMD PA GAINESVILLE FLDate 12/20/23 0 3354886410 0 8021Card 2801,46.0
8/27/2023,,Withdrawal Transfer fee,8.0,,Posted,38.81,2023-08-27,8.0,Withdrawal Transfer fee,8.0
8/27/2023,,Withdrawal Debit Card MC Debit Seminol/WALGREENS #5024 GAINESVILLE FLDate 08/26/23 0 3238251787 1 5912Card 2801,15.0,,Posted,41.81,2023-08-27,15.0,Withdrawal Debit Card MC Debit Seminol/WALGREENS #5024 GAINESVILLE FLDate 06/26/23 0 3177001861 1 5912Card 2801,15.0
8/27/2023,,Withdrawal POS #000000782382/Instacart 50 Beal St Suite 600 SanFrancisco CACard 2801,5.0,,Posted,56.81,2023-08-27,5.0,Withdrawal POS #000000782111/Instacart 50 Beal St Suite 600 SanFrancisco CACard 2801,5.0
8/27/2023,,Withdrawal POS #000000792497/Instacart 50 Beal St Suite 600 SanFrancisco CACard 2801,71.52,,Posted,61.81,2023-08-27,71.52,Withdrawal POS #000000782097/Instacart 50 Beal St Suite 600 SanFrancisco CACard 2801,71.185
8/26/2023,,Withdrawal POS #000000513073/SUNOCO 8002212501 4234 SW 20TH AVEGAINESVILLE FLCard 2801,37.86,,Posted,133.33,2023-08-26,37.86,Withdrawal POS #000000866633/SUNOCO 8002212501 4234 SW 20TH AVEGAINESVILLE FLCard 2801,37.86
8/26/2023,,Withdrawal Home Banking Transfer - To Share 0000/Funds Transfer via Online,5.0,,Posted,171.19,2023-08-26,5.0,Withdrawal Home Banking Transfer - To Share 0000/Funds Transfer via Online,5.0
8/25/2023,,Withdrawal POS #000000452996/SUNOCO 8002212501 4234 SW 20TH AVEGAINESVILLE FLCard 2801,33.98,,Posted,26.19,2023-08-25,33.98,Withdrawal POS #000000899960/SUNOCO 8002212501 4234 SW 20TH AVEGAINESVILLE FLCard 2801,33.849999999999994
8/24/2023,,Withdrawal POS #000000782733/Instacart 50 Beal St Suite 600 SanFrancisco CACard 2801,5.0,,Posted,60.17,2023-08-24,5.0,Withdrawal POS #000000782097/Instacart 50 Beal St Suite 600 SanFrancisco CACard 2801,5.0
8/24/2023,,Withdrawal POS #000000782712/Instacart 50 Beal St Suite 600 SanFrancisco CACard 2801,70.85,,Posted,65.17,2023-08-24,70.85,Withdrawal POS #000000782097/Instacart 50 Beal St Suite 600 SanFrancisco CACard 2801,71.185
8/24/2023,,Recurring Withdrawal Debit Card - MC Debit Seminol/VIDIQ PRO SAN FRANCISC CADate 08/23/23 0 3235876504 0 5734Card 2801,10.0,,Posted,136.02,2023-08-24,10.0,Recurring Withdrawal Debit Card - MC Debit Seminol/VIDIQ SAN FRANCISC CADate 12/23/23 0 3357950683 0 5734Card 2801,10.0
8/23/2023,,Withdrawal ACH FLUENT-Gainesvil/TYPE: PAYMENT ID: 1371804719CO: FLUENT-GainesvilEntry Class Code: PPD,45.0,,Posted,-3.98,2023-08-23,45.0,Withdrawal ACH FLUENT-Gainesvil/TYPE: PAYMENT ID: 1371804719CO: FLUENT-GainesvilEntry Class Code: PPD,45.0
8/23/2023,,Withdrawal Transfer fee,8.0,,Posted,41.02,2023-08-23,8.0,Withdrawal Transfer fee,8.0
8/23/2023,,Withdrawal POS #000003099853/GOOGLE *Google Storage 1600 AmphitheatreParkw Mountain View CACard 2801,1.99,,Posted,43.17,2023-08-23,1.99,Withdrawal POS #000002040482/GOOGLE *Google Storage 1600 AmphitheatreParkw Mountain View CACard 2801,1.99
8/23/2023,,Withdrawal POS #000000772787/Instacart 50 Beal St Suite 600 SanFrancisco CACard 2801,5.0,,Posted,45.16,2023-08-23,5.0,Withdrawal POS #000000772752/Instacart 50 Beal St Suite 600 SanFrancisco CACard 2801,5.0
8/23/2023,,Withdrawal POS #000000792009/Instacart 50 Beal St Suite 600 SanFrancisco CACard 2801,55.19,,Posted,50.16,2023-08-23,55.19,Withdrawal POS #000000782097/Instacart 50 Beal St Suite 600 SanFrancisco CACard 2801,55.19
8/22/2023,,Withdrawal Debit Card MC Debit Seminol/WALGREENS #5024 GAINESVILLE FLDate 08/21/23 0 3233007786 1 5912Card 2801,8.16,,Posted,105.35,2023-08-22,8.16,Withdrawal Debit Card MC Debit Seminol/WALGREENS #5024 GAINESVILLE FLDate 06/26/23 0 3177001861 1 5912Card 2801,8.16
8/21/2023,,Withdrawal Bill Payment #000002088135/PAYPAL *PYPL Payin4 2211 North FirstStreet San Jose CACard 2801,13.75,,Posted,113.51,2023-08-21,13.75,Withdrawal Bill Payment #000002088135/PAYPAL *PYPL Payin4 2211 North FirstStreet San Jose CACard 2801,13.780000000000001
8/21/2023,,Withdrawal POS #000000782601/Instacart 50 Beal St Suite 600 SanFrancisco CACard 2801,5.0,,Posted,127.26,2023-08-21,5.0,Withdrawal POS #000000782097/Instacart 50 Beal St Suite 600 SanFrancisco CACard 2801,5.0
8/21/2023,,Withdrawal POS #000000772667/Instacart 50 Beal St Suite 600 SanFrancisco CACard 2801,72.54,,Posted,132.26,2023-08-21,72.54,Withdrawal POS #000000772752/Instacart 50 Beal St Suite 600 SanFrancisco CACard 2801,72.94
8/21/2023,,Withdrawal POS #000000265255/SUNOCO 8002212501 4234 SW 20TH AVEGAINESVILLE FLCard 2801,32.22,,Posted,204.8,2023-08-21,32.22,Withdrawal POS #000000265255/SUNOCO 8002212501 4234 SW 20TH AVEGAINESVILLE FLCard 2801,32.545
8/21/2023,,Recurring Withdrawal Debit Card - MC Debit Seminol/CANVA* I03883-21590389 CAMDEN DEDate 08/20/23 0 3232977264 0 7221Card 2801,12.99,,Posted,237.02,2023-08-21,12.99,Recurring Withdrawal Debit Card - MC Debit Seminol/CANVA* I03914-38299904 CAMDEN DEDate 09/23/23 0 3266003765 1 7221Card 2801,12.99
8/20/2023,,Withdrawal POS #000000782885/Instacart 50 Beal St Suite 600 SanFrancisco CACard 2801,44.75,,Posted,50.01,2023-08-20,44.75,Withdrawal POS #000000782111/Instacart 50 Beal St Suite 600 SanFrancisco CACard 2801,44.845
8/20/2023,,Withdrawal Debit Card MC Debit Seminol/APPLE.COM/BILL CUPERTINO CADate 08/18/23 0 3230028421 2 5735Card 2801,2.99,,Posted,94.76,2023-08-20,2.99,Withdrawal Debit Card MC Debit Seminol/APPLE.COM/BILL CUPERTINO CADate 08/18/23 0 3230028421 2 5735Card 2801,2.99
8/20/2023,,Withdrawal POS #000003285955/GOOGLE *YouTubePremium 1600 AmphitheatreParkw Mountain View CACard 2801,13.64,,Posted,97.75,2023-08-20,13.64,Withdrawal POS #000003285955/GOOGLE *YouTubePremium 1600 AmphitheatreParkw Mountain View CACard 2801,13.629999999999999
8/19/2023,,Withdrawal POS #000000772216/Instacart 50 Beal St Suite 600 SanFrancisco CACard 2801,5.0,,Posted,111.39,2023-08-19,5.0,Withdrawal POS #000000782111/Instacart 50 Beal St Suite 600 SanFrancisco CACard 2801,5.0
8/19/2023,,Withdrawal POS #000000772311/Instacart 50 Beal St Suite 600 SanFrancisco CACard 2801,44.94,,Posted,116.39,2023-08-19,44.94,Withdrawal POS #000000782111/Instacart 50 Beal St Suite 600 SanFrancisco CACard 2801,44.845
8/18/2023,,Withdrawal POS #000000782947/Instacart 50 Beal St Suite 600 SanFrancisco CACard 2801,5.0,,Posted,161.33,2023-08-18,5.0,Withdrawal POS #000000782097/Instacart 50 Beal St Suite 600 SanFrancisco CACard 2801,5.0
8/18/2023,,Withdrawal POS #000000782232/Instacart 50 Beal St Suite 600 SanFrancisco CACard 2801,47.92,,Posted,166.33,2023-08-18,47.92,Withdrawal POS #000000782111/Instacart 50 Beal St Suite 600 SanFrancisco CACard 2801,47.92
8/18/2023,,Withdrawal POS #000000104876/SUNOCO 8002212501 4234 SW 20TH AVEGAINESVILLE FLCard 2801,21.16,,Posted,214.25,2023-08-18,21.16,Withdrawal POS #000000409276/SUNOCO 8002212501 4234 SW 20TH AVEGAINESVILLE FLCard 2801,21.16
8/17/2023,,Withdrawal POS #000000772845/Instacart 50 Beal St Suite 600 SanFrancisco CACard 2801,5.0,,Posted,235.41,2023-08-17,5.0,Withdrawal POS #000000772752/Instacart 50 Beal St Suite 600 SanFrancisco CACard 2801,5.0
8/17/2023,,Withdrawal POS #000000802826/Instacart 50 Beal St Suite 600 SanFrancisco CACard 2801,70.11,,Posted,240.41,2023-08-17,70.11,Withdrawal POS #000000802668/Instacart 50 Beal St Suite 600 SanFrancisco CACard 2801,70.11
8/17/2023,,Withdrawal POS #000000083324/SUNOCO 8002212501 4234 SW 20TH AVEGAINESVILLE FLCard 2801,31.79,,Posted,310.52,2023-08-17,31.79,Withdrawal POS #000000866633/SUNOCO 8002212501 4234 SW 20TH AVEGAINESVILLE FLCard 2801,31.79
8/16/2023,,Withdrawal POS #000000782893/Instacart 50 Beal St Suite 600 SanFrancisco CACard 2801,5.0,,Posted,92.31,2023-08-16,5.0,Withdrawal POS #000000782097/Instacart 50 Beal St Suite 600 SanFrancisco CACard 2801,5.0
8/16/2023,,Withdrawal POS #000000792627/Instacart 50 Beal St Suite 600 SanFrancisco CACard 2801,56.89,,Posted,97.31,2023-08-16,56.89,Withdrawal POS #000000792604/Instacart 50 Beal St Suite 600 SanFrancisco CACard 2801,56.89
8/16/2023,,Withdrawal POS #000000028432/SUNOCO 8002212501 4234 SW 20TH AVEGAINESVILLE FLCard 2801,17.51,,Posted,154.2,2023-08-16,17.51,Withdrawal POS #000000403720/SUNOCO 8002212501 4234 SW 20TH AVEGAINESVILLE FLCard 2801,17.51
8/14/2023,,Withdrawal POS #000000018892/PUBLIX 3315 W. UNIVERSITY AVE.FLCard 2801,86.46,,Posted,171.71,2023-08-14,86.46,Withdrawal POS #000000749495/PUBLIX 3315 W. UNIVERSITY AVE.FLCard 1231,86.46
8/13/2023,,Withdrawal POS #000000851822/SUNOCO 8002212501 4234 SW 20TH AVEGAINESVILLE FLCard 2801,31.79,,Posted,258.17,2023-08-13,31.79,Withdrawal POS #000000512490/SUNOCO 8002212501 4234 SW 20TH AVEGAINESVILLE FLCard 2801,31.79
8/12/2023,,Withdrawal POS #000000772900/Instacart 50 Beal St Suite 600 SanFrancisco CACard 2801,5.0,,Posted,289.96,2023-08-12,5.0,Withdrawal POS #000000773008/Instacart 50 Beal St Suite 600 SanFrancisco CACard 1231,5.0
8/12/2023,,Withdrawal POS #000000802571/Instacart 50 Beal St Suite 600 SanFrancisco CACard 2801,61.27,,Posted,294.96,2023-08-12,61.27,Withdrawal POS #000000805513/Instacart 50 Beal St Suite 600 SanFrancisco CACard 2801,61.27
8/11/2023,,Recurring Withdrawal Debit Card - MC Debit Seminol/MIDJOURNEY INC. SOUTH SAN FR CADate 08/10/23 0 3222981879 0 5734Card 2801,30.0,,Posted,356.23,2023-08-11,30.0,Withdrawal Debit Card MC Debit Seminol/MIDJOURNEY INC. SOUTH SAN FR CADate 10/16/23 0 3289666656 0 5734Card 2801,30.0
8/10/2023,,Withdrawal POS #000000751774/SUNOCO 8002212501 4234 SW 20TH AVEGAINESVILLE FLCard 2801,42.87,,Posted,386.23,2023-08-10,42.87,Withdrawal POS #000000437179/SUNOCO 8002212501 4234 SW 20TH AVEGAINESVILLE FLCard 2801,42.87
8/9/2023,,Recurring Withdrawal Debit Card - MC Debit Seminol/MIDJOURNEY INC. SOUTH SAN FR CADate 08/08/23 0 3220859759 0 5734Card 2801,30.0,,Posted,429.1,2023-08-09,30.0,Withdrawal Debit Card MC Debit Seminol/MIDJOURNEY INC. SOUTH SAN FR CADate 10/16/23 0 3289666656 0 5734Card 2801,30.0
8/9/2023,,Recurring Withdrawal Debit Card Fee/MASTERCARD ISSUER CROSS-BORDER FEEDate 08/08/23 0 3220043177 1 7399Card 2801,0.23,,Posted,459.1,2023-08-09,0.23,Recurring Withdrawal Debit Card Fee/MASTERCARD ISSUER CROSS-BORDER FEEDate 08/08/23 0 3220043177 1 7399Card 2801,0.156
8/9/2023,,Recurring Withdrawal Debit Card - MC Debit Seminol/CREATIVE FABRICA AMSTERDAM NHDate 08/08/23 0 3220043177 1 7399Card 2801,29.0,,Posted,459.33,2023-08-09,29.0,Recurring Withdrawal Debit Card - MC Debit Seminol/CREATIVE FABRICA AMSTERDAM NHDate 10/03/24 0 4277044624 1 7399Card 1231,29.0
8/9/2023,,Recurring Withdrawal Debit Card - MC Debit Seminol/WEB*HOSTGATOR.COM BURLINGTON MADate 08/08/23 0 3220041608 1 4816Card 2801,12.95,,Posted,488.33,2023-08-09,12.95,Recurring Withdrawal Debit Card - MC Debit Seminol/WEB*HOSTGATOR.COM BURLINGTON MADate 11/18/23 0 3322020816 1 4816Card 2801,12.95
8/9/2023,,Withdrawal Debit Card MC Debit Seminol/AMAZON PRIME*TA0BI59I2 AMZN.COM/BIL WADate 08/08/23 0 3220037222 1 5968Card 2801,15.13,,Posted,501.28,2023-08-09,15.13,Withdrawal Debit Card MC Debit Seminol/AMAZON PRIME*PE3IN5Y03 AMZN.COM/BIL WADate 12/08/23 0 3342550116 0 5968Card 2801,15.14
8/9/2023,,Withdrawal ACH CAPITAL ONE/TYPE: ONLINE PMT ID: 9279744391CO: CAPITAL ONE NAME: STEVEN CHAPLINSKIEntry Class Code: WEB,26.0,,Posted,516.41,2023-08-09,26.0,Withdrawal ACH CAPITAL ONE/TYPE: ONLINE PMT ID: 9279744391CO: CAPITAL ONE NAME: STEVEN CHAPLINSKIEntry Class Code: WEB,25.5
8/8/2023,,Withdrawal POS #000000792946/Instacart 50 Beal St Suite 600 SanFrancisco CACard 2801,5.0,,Posted,542.41,2023-08-08,5.0,Withdrawal POS #000000792604/Instacart 50 Beal St Suite 600 SanFrancisco CACard 2801,5.415
8/8/2023,,Withdrawal POS #000000802557/Instacart 50 Beal St Suite 600 SanFrancisco CACard 2801,56.0,,Posted,547.41,2023-08-08,56.0,Withdrawal POS #000000805513/Instacart 50 Beal St Suite 600 SanFrancisco CACard 2801,56.0
8/8/2023,,Recurring Withdrawal Debit Card Fee/MASTERCARD ISSUER CROSS-BORDER FEEDate 08/07/23 0 3219017867 1 5734Card 2801,0.24,,Posted,603.41,2023-08-08,0.24,Recurring Withdrawal Debit Card Fee/MASTERCARD ISSUER CROSS-BORDER FEEDate 08/08/23 0 3220043177 1 7399Card 2801,0.156
8/8/2023,,Recurring Withdrawal Debit Card - MC Debit Seminol/ALURA SUBSCRIPTION OSLO DUDate 08/07/23 0 3219017867 1 5734Card 2801,29.99,,Posted,603.65,2023-08-08,29.99,Recurring Withdrawal Debit Card - MC Debit Seminol/ALURA SUBSCRIPTION OSLO DUDate 01/08/24 0 4008859029 0 5734Card 2801,29.99
8/8/2023,,Withdrawal Debit Card MC Debit Seminol/B2P* FL OMMU MJ MED CA JACKSONVILLE FLDate 08/07/23 0 3219013208 1 9399Card 2801,77.75,,Posted,633.64,2023-08-08,77.75,Withdrawal Debit Card MC Debit Seminol/B2P* FL OMMU MJ MED CA JACKSONVILLE FLDate 07/10/24 0 4192863496 0 9399Card 1231,77.75
8/8/2023,,Withdrawal Debit Card MC Debit Seminol/UBER TRIP 8005928996 CADate 08/07/23 0 3219009537 1 4121Card 2801,26.94,,Posted,711.39,2023-08-08,26.94,Withdrawal Debit Card MC Debit Seminol/UBER TRIP 8005928996 CADate 08/07/23 0 3219009537 1 4121Card 2801,26.94
8/8/2023,,Withdrawal Debit Card MC Debit Seminol/UBER TRIP 8005928996 CADate 08/07/23 0 3219009531 1 4121Card 2801,16.97,,Posted,738.33,2023-08-08,16.97,Withdrawal Debit Card MC Debit Seminol/UBER TRIP 8005928996 CADate 08/07/23 0 3219009537 1 4121Card 2801,16.97
8/7/2023,,Withdrawal POS #000000772209/Instacart 50 Beal St Suite 600 SanFrancisco CACard 2801,101.21,,Posted,485.3,2023-08-07,101.21,Withdrawal POS #000000782097/Instacart 50 Beal St Suite 600 SanFrancisco CACard 2801,101.21
8/7/2023,,Recurring Withdrawal Debit Card - MC Debit Seminol/SALESAMURAI.IO SFTWARE BOULDER CODate 08/07/23 0 3219924706 0 5734Card 2801,9.99,,Posted,586.51,2023-08-07,9.99,Withdrawal Debit Card MC Debit Seminol/SALESAMURAI.IO SFTWARE BOULDER CODate 11/13/23 0 3317927273 0 5734Card 2801,9.99
8/6/2023,,Withdrawal Bill Payment #000001089739/PAYPAL *PYPL Payin4 2211 North FirstStreet San Jose CACard 2801,13.75,,Posted,596.5,2023-08-06,13.75,Withdrawal Bill Payment #000002088135/PAYPAL *PYPL Payin4 2211 North FirstStreet San Jose CACard 2801,13.780000000000001
8/6/2023,,Recurring Withdrawal Debit Card - MC Debit Seminol/WWW.EVERBEE.IO SANTEE CADate 08/05/23 0 3217038747 3 5734Card 2801,29.99,,Posted,610.25,2023-08-06,29.99,Recurring Withdrawal Debit Card - MC Debit Seminol/WWW.EVERBEE.IO SANTEE CADate 01/05/24 0 4005834841 0 5734Card 2801,29.99
8/6/2023,,Recurring Withdrawal Debit Card - MC Debit Seminol/DISNEY PLUS 8889057888 CADate 08/04/23 0 3216012011 2 4899Card 2801,12.66,,Posted,640.24,2023-08-06,12.66,Recurring Withdrawal Debit Card - MC Debit Seminol/DISNEY PLUS 8889057888 CADate 10/02/24 0 4276239357 1 4899Card 1231,12.66
8/6/2023,,Withdrawal Debit Card MC Debit Seminol/WALGREENS #5024 GAINESVILLE FLDate 08/04/23 0 3216030661 3 5912Card 2801,29.78,,Posted,652.9,2023-08-06,29.78,Withdrawal Debit Card MC Debit Seminol/WALGREENS #5024 GAINESVILLE FLDate 06/26/23 0 3177001861 1 5912Card 2801,29.78
8/6/2023,,Recurring Withdrawal Debit Card - MC Debit Seminol/APPLE.COM/BILL 866-712-7753 CADate 08/06/23 0 3218094412 1 5818Card 2801,15.99,,Posted,682.68,2023-08-06,15.99,Recurring Withdrawal Debit Card - MC Debit Seminol/APPLE.COM/BILL 866-712-7753 CADate 09/16/23 0 3259205559 2 5818Card 2801,15.99
8/6/2023,,Recurring Withdrawal Debit Card - MC Debit Seminol/ADOBE *STOCK 4085366000 CADate 08/04/23 0 3216007220 2 5734Card 2801,29.99,,Posted,698.67,2023-08-06,29.99,Recurring Withdrawal Debit Card - MC Debit Seminol/ADOBE *STOCK 4085366000 CADate 01/04/24 0 4004903002 0 5734Card 2801,29.99
8/6/2023,,"Recurring Withdrawal Debit Card - MC Debit Seminol/MARMALEAD, LLC 4079065736 FLDate 08/05/23 0 3217970394 0 5045Card 2801",19.0,,Posted,728.66,2023-08-06,19.0,"Recurring Withdrawal Debit Card - MC Debit Seminol/MARMALEAD, LLC 4079065736 FLDate 01/05/24 0 4005822541 1 5045Card 2801",19.0
8/6/2023,,Recurring Withdrawal Bill Payment - #000000410382/NETFLIX COM LOS GATOS CACard 2801,11.0,,Posted,747.66,2023-08-06,11.0,Recurring Withdrawal Bill Payment - #000006911729/NETFLIX COM LOS GATOS CACard 2801,10.99
8/4/2023,,Recurring Withdrawal Debit Card - MC Debit Seminol/MIDJOURNEY INC. SOUTH SAN FR CADate 08/04/23 0 3216198985 1 5734Card 2801,4.0,,Posted,758.66,2023-08-04,4.0,Withdrawal Debit Card MC Debit Seminol/MIDJOURNEY INC. SOUTH SAN FR CADate 10/16/23 0 3289666656 0 5734Card 2801,4.0
8/4/2023,,Recurring Withdrawal Debit Card - MC Debit Seminol/CHATGPT SUBSCRIPTION SAN FRANCISC CADate 08/04/23 0 3216122516 1 5734Card 2801,20.0,,Posted,762.66,2023-08-04,20.0,Recurring Withdrawal Debit Card - MC Debit Seminol/CHATGPT SUBSCRIPTION SAN FRANCISC CADate 05/04/24 0 4125659188 0 5734Card 1231,20.0
8/4/2023,,Withdrawal Debit Card MC Debit Seminol/PHR*SIMEDHEALTHLLC GAINESVILLE FLDate 08/03/23 0 3215120036 1 8011Card 2801,45.0,,Posted,782.66,2023-08-04,45.0,Withdrawal Debit Card MC Debit Seminol/PHR*SIMEDHEALTHLLC GAINESVILLE FLDate 09/29/23 0 3272984653 0 8011Card 2801,45.0
8/4/2023,,Withdrawal Debit Card MC Debit Seminol/WALGREENS #9304 GAINESVILLE FLDate 08/03/23 0 3215192531 1 5912Card 2801,32.91,,Posted,827.66,2023-08-04,32.91,Withdrawal Debit Card MC Debit Seminol/WALGREENS #5024 GAINESVILLE FLDate 06/26/23 0 3177001861 1 5912Card 2801,32.91
8/4/2023,,Recurring Withdrawal Debit Card - MC Debit Seminol/APPLE.COM/BILL 866-712-7753 CADate 08/03/23 0 3215905953 0 5818Card 2801,2.99,,Posted,860.57,2023-08-04,2.99,Recurring Withdrawal Debit Card - MC Debit Seminol/APPLE.COM/BILL 866-712-7753 CADate 09/16/23 0 3259205559 2 5818Card 2801,2.99
8/4/2023,,Recurring Withdrawal Debit Card - MC Debit Seminol/APPLE.COM/BILL 866-712-7753 CADate 08/03/23 0 3215905952 0 5818Card 2801,2.99,,Posted,863.56,2023-08-04,2.99,Recurring Withdrawal Debit Card - MC Debit Seminol/APPLE.COM/BILL 866-712-7753 CADate 09/16/23 0 3259205559 2 5818Card 2801,2.99
8/3/2023,,Withdrawal POS #000017155615/WALGREENS 3455 SW ARCH GAINESVILLE FLCard 2801,5.99,,Posted,866.55,2023-08-03,5.99,Withdrawal POS #000012002801/WALGREENS 3455 SW ARCH GAINESVILLE FLCard 2801,5.99
8/3/2023,,Recurring Withdrawal Debit Card - MC Debit Seminol/MIDJOURNEY INC. SOUTH SAN FR CADate 08/02/23 0 3214189525 1 5734Card 2801,8.0,,Posted,872.54,2023-08-03,8.0,Withdrawal Debit Card MC Debit Seminol/MIDJOURNEY INC. SOUTH SAN FR CADate 10/16/23 0 3289666656 0 5734Card 2801,8.0
8/3/2023,,Recurring Withdrawal Debit Card - MC Debit Seminol/PARAMOUNT+ SAN FRANCISC CADate 08/02/23 0 3214930352 0 4899Card 2801,13.81,,Posted,880.54,2023-08-03,13.81,Recurring Withdrawal Debit Card - MC Debit Seminol/PARAMOUNT+ SAN FRANCISC CADate 01/02/24 0 4002821550 0 4899Card 2801,13.81
8/3/2023,,Withdrawal Debit Card MC Debit Seminol/UBER TRIP 8005928996 CADate 08/02/23 0 3214923759 0 4121Card 2801,23.9,,Posted,894.35,2023-08-03,23.9,Withdrawal Debit Card MC Debit Seminol/UBER TRIP 8005928996 CADate 08/07/23 0 3219009537 1 4121Card 2801,23.9
8/2/2023,,Recurring Withdrawal Debit Card - MC Debit Seminol/ETSY INC SELLER FEES BROOKLYN NYDate 08/02/23 0 3214235855 1 7311Card 2801,0.2,,Posted,918.25,2023-08-02,0.2,Recurring Withdrawal Debit Card - MC Debit Seminol/ETSY INC SELLER FEES BROOKLYN NYDate 08/02/23 0 3214235855 1 7311Card 2801,0.2
8/2/2023,,Recurring Withdrawal Debit Card - MC Debit Seminol/ETSY INC SELLER FEES BROOKLYN NYDate 08/02/23 0 3214235853 1 7311Card 2801,0.2,,Posted,918.45,2023-08-02,0.2,Recurring Withdrawal Debit Card - MC Debit Seminol/ETSY INC SELLER FEES BROOKLYN NYDate 08/02/23 0 3214235855 1 7311Card 2801,0.2
8/2/2023,,Withdrawal Debit Card MC Debit Seminol/BOCA GAS STATION GAINESVILLE FLDate 08/01/23 0 3213233381 1 5541Card 2801,28.38,,Posted,918.65,2023-08-02,28.38,Withdrawal Debit Card MC Debit Seminol/BOCA GAS STATION GAINESVILLE FLDate 08/01/23 0 3213233381 1 5541Card 2801,28.38
8/2/2023,,Withdrawal POS #000000747649/PUBLIX 3315 W. UNIVERSITY AVE.FLCard 2801,137.28,,Posted,947.03,2023-08-02,137.28,Withdrawal POS #000000749495/PUBLIX 3315 W. UNIVERSITY AVE.FLCard 1231,137.28
8/2/2023,,Withdrawal POS #000000001537/CIRCLE K # 21303 2320 GAINESVILLE FLCard 2801,27.39,,Posted,1084.31,2023-08-02,27.39,Withdrawal POS #000000001537/CIRCLE K # 21303 2320 GAINESVILLE FLCard 2801,27.39
8/1/2023,,Recurring Withdrawal Debit Card - MC Debit Seminol/MIDJOURNEY INC. SOUTH SAN FR CADate 07/31/23 0 3212947111 0 5734Card 2801,8.0,,Posted,1111.7,2023-08-01,8.0,Withdrawal Debit Card MC Debit Seminol/MIDJOURNEY INC. SOUTH SAN FR CADate 10/16/23 0 3289666656 0 5734Card 2801,8.0
8/1/2023,,Recurring Withdrawal Debit Card - MC Debit Seminol/MIDJOURNEY INC. SOUTH SAN FR CADate 07/31/23 0 3212357840 0 5734Card 2801,4.0,,Posted,1119.7,2023-08-01,4.0,Withdrawal Debit Card MC Debit Seminol/MIDJOURNEY INC. SOUTH SAN FR CADate 10/16/23 0 3289666656 0 5734Card 2801,4.0
8/1/2023,,Recurring Withdrawal Debit Card - MC Debit Seminol/ETSY INC SELLER FEES BROOKLYN NYDate 08/01/23 0 3213088061 1 7311Card 2801,3.0,,Posted,1123.7,2023-08-01,3.0,Recurring Withdrawal Debit Card - MC Debit Seminol/ETSY INC SELLER FEES BROOKLYN NYDate 08/02/23 0 3214235855 1 7311Card 2801,3.0
8/1/2023,,Withdrawal Debit Card MC Debit Seminol/CIRCLE K # 06782 GAINESVILLE FLDate 07/31/23 0 3212940436 0 5541Card 2801,25.82,,Posted,1126.7,2023-08-01,25.82,Withdrawal Debit Card MC Debit Seminol/CIRCLE K # 26146 GAINESVILLE FLDate 07/28/23 0 3209802364 1 5541Card 2801,25.82
8/1/2023,,Withdrawal Debit Card MC Debit Seminol/GRU/EZ-PAY WEB PYMT 352-334-3434 FLDate 07/31/23 0 3212355876 0 4900Card 2801,225.05,,Posted,1152.52,2023-08-01,225.05,Withdrawal Debit Card MC Debit Seminol/GRU/EZ-PAY WEB PYMT 352-334-3434 FLDate 12/05/24 0 4340279271 0 4900Card 1231,225.05
8/1/2023,,Withdrawal Debit Card MC Debit Seminol/COX GAINESVILLE COMM 800-234-3993 FLDate 07/31/23 0 3212823057 0 4899Card 2801,125.03,,Posted,1377.57,2023-08-01,125.03,Withdrawal Debit Card MC Debit/COX GAINESVILLE COMM 800-234-3993 FLDate 05/31/23 0 3151812468 0 4899Card 2801,125.03
8/1/2023,,Withdrawal ACH Watson Realty Co/TYPE: WEB PMTS ID: 9000321157CO: Watson Realty CoNAME: Steven chaplinskiEntry Class Code: WEB,1079.0,,Posted,1502.6,2023-08-01,1079.0,Withdrawal ACH Watson Realty Co/TYPE: WEB PMTS ID: 9000321157CO: Watson Realty CoEntry Class Code: WEB,1079.0
8/1/2023,,Withdrawal ACH FLUENT-Gainesvil/TYPE: PAYMENT ID: 1371804719CO: FLUENT-GainesvilEntry Class Code: PPD,49.0,,Posted,2581.6,2023-08-01,49.0,Withdrawal ACH FLUENT-Gainesvil/TYPE: PAYMENT ID: 1371804719CO: FLUENT-GainesvilEntry Class Code: PPD,48.5
7/31/2023,,Recurring Withdrawal Debit Card - MC Debit Seminol/MIDJOURNEY INC. SOUTH SAN FR CADate 07/30/23 0 3211945515 0 5734Card 2801,8.0,,Posted,2630.6,2023-07-31,8.0,Withdrawal Debit Card MC Debit Seminol/MIDJOURNEY INC. SOUTH SAN FR CADate 10/16/23 0 3289666656 0 5734Card 2801,8.0
7/31/2023,,Recurring Withdrawal Debit Card - MC Debit Seminol/KAIBER AI WILMINGTON DEDate 07/30/23 0 3211262093 0 5815Card 2801,5.0,,Posted,2638.6,2023-07-31,5.0,Recurring Withdrawal Debit Card - MC Debit Seminol/KAIBER AI WILMINGTON DEDate 08/30/23 0 3242340816 0 5815Card 2801,5.0
7/30/2023,,Recurring Withdrawal Debit Card Fee/MASTERCARD ISSUER CROSS-BORDER FEEDate 07/29/23 0 3210810050 1 5734Card 2801,0.13,,Posted,43.6,2023-07-30,0.13,Recurring Withdrawal Debit Card Fee/MASTERCARD ISSUER CROSS-BORDER FEEDate 05/12/21 0 1132191600 1 7372Card 2801,0.09500000000000001
7/30/2023,,Recurring Withdrawal Debit Card - MC Debit Seminol/VANCEAI CENTRAL HODate 07/29/23 0 3210810050 1 5734Card 2801,15.9,,Posted,43.73,2023-07-30,15.9,Withdrawal Debit Card MC Debit Seminol/VANCEAI CENTRAL HODate 06/29/23 0 3180070895 1 5734Card 2801,15.9
7/30/2023,,Withdrawal Debit Card MC Debit Seminol/CIRCLE K # 26146 GAINESVILLE FLDate 07/28/23 0 3209802364 1 5541Card 2801,19.43,,Posted,59.63,2023-07-30,19.43,Withdrawal Debit Card MC Debit Seminol/CIRCLE K # 26146 GAINESVILLE FLDate 07/28/23 0 3209802364 1 5541Card 2801,19.43
7/30/2023,,Withdrawal POS #000000792783/Instacart 50 Beal St Suite 600 SanFrancisco CACard 2801,4.15,,Posted,79.06,2023-07-30,4.15,Withdrawal POS #000000796988/Instacart 50 Beal St Suite 600 SanFrancisco CACard 2801,4.575
7/30/2023,,Withdrawal POS #000000792995/Instacart 50 Beal St Suite 600 SanFrancisco CACard 2801,50.0,,Posted,83.21,2023-07-30,50.0,Withdrawal POS #000000796988/Instacart 50 Beal St Suite 600 SanFrancisco CACard 2801,50.0
7/28/2023,,Withdrawal Debit Card MC Debit Seminol/DISTANT FUTURE CORP SAN FRANCISC CADate 07/27/23 0 3208120284 1 5817Card 2801,29.95,,Posted,133.21,2023-07-28,29.95,Withdrawal Debit Card MC Debit Seminol/DISTANT FUTURE CORP SAN FRANCISC CADate 07/27/23 0 3208120284 1 5817Card 2801,29.95
7/28/2023,,Withdrawal Debit Card MC Debit Seminol/WALGREENS #5024 GAINESVILLE FLDate 07/27/23 0 3208143995 1 5912Card 2801,18.91,,Posted,163.16,2023-07-28,18.91,Withdrawal Debit Card MC Debit Seminol/WALGREENS #5024 GAINESVILLE FLDate 06/26/23 0 3177001861 1 5912Card 2801,18.91
7/28/2023,,Withdrawal Debit Card MC Debit Seminol/CIRCLE K # 06782 GAINESVILLE FLDate 07/26/23 0 3207111703 1 5499Card 2801,17.46,,Posted,182.07,2023-07-28,17.46,Withdrawal Debit Card MC Debit Seminol/CIRCLE K # 26146 GAINESVILLE FLDate 07/28/23 0 3209802364 1 5541Card 2801,17.9
7/28/2023,,Recurring Withdrawal Debit Card - MC Debit Seminol/ADOBE *CREATIVE CLOUD 4085366000 CADate 07/27/23 0 3208894437 0 5734Card 2801,29.99,,Posted,199.53,2023-07-28,29.99,Recurring Withdrawal Debit Card MC Debit/ADOBE *CREATIVE CLOUD 4085366000 CADate 04/27/23 0 3117844835 0 5734Card 2801,29.99
7/27/2023,,Withdrawal POS #000000937357/SUNOCO 8002212501 4234 SW 20TH AVEGAINESVILLE FLCard 2801,32.87,,Posted,29.52,2023-07-27,32.87,Withdrawal POS #000000437179/SUNOCO 8002212501 4234 SW 20TH AVEGAINESVILLE FLCard 2801,32.87
7/26/2023,,Withdrawal POS #000000772808/Instacart 50 Beal St Suite 600 SanFrancisco CACard 2801,5.0,,Posted,62.39,2023-07-26,5.0,Withdrawal POS #000000796988/Instacart 50 Beal St Suite 600 SanFrancisco CACard 2801,4.575
7/26/2023,,Withdrawal POS #000000782782/Instacart 50 Beal St Suite 600 SanFrancisco CACard 2801,49.28,,Posted,67.39,2023-07-26,49.28,Withdrawal POS #000000782097/Instacart 50 Beal St Suite 600 SanFrancisco CACard 2801,49.28
7/26/2023,,Withdrawal Debit Card MC Debit Seminol/EXXON FAST TRACK #200 GAINESVILLE FLDate 07/25/23 0 3206136870 1 5541Card 2801,16.23,,Posted,116.67,2023-07-26,16.23,Withdrawal Debit Card MC Debit Seminol/EXXON FAST TRACK #200 GAINESVILLE FLDate 07/25/23 0 3206136870 1 5541Card 2801,16.23
7/26/2023,,Withdrawal POS #000000634941/SUNOCO 8002212501 4234 SW 20TH AVEGAINESVILLE FLCard 2801,16.44,,Posted,132.9,2023-07-26,16.44,Withdrawal POS #000000639499/SUNOCO 8002212501 4234 SW 20TH AVEGAINESVILLE FLCard 2801,16.44
7/25/2023,,Withdrawal POS #000000792604/Instacart 50 Beal St Suite 600 SanFrancisco CACard 2801,5.83,,Posted,149.34,2023-07-25,5.83,Withdrawal POS #000000792604/Instacart 50 Beal St Suite 600 SanFrancisco CACard 2801,5.415
7/25/2023,,Withdrawal POS #000000772122/Instacart 50 Beal St Suite 600 SanFrancisco CACard 2801,71.56,,Posted,155.17,2023-07-25,71.56,Withdrawal POS #000000772752/Instacart 50 Beal St Suite 600 SanFrancisco CACard 2801,71.465
7/24/2023,,Withdrawal POS #000000814434/SUNOCO 8002212501 4234 SW 20TH AVEGAINESVILLE FLCard 2801,16.44,,Posted,26.73,2023-07-24,16.44,Withdrawal POS #000000046634/SUNOCO 8002212501 4234 SW 20TH AVEGAINESVILLE FLCard 2801,16.44
7/24/2023,,Recurring Withdrawal Debit Card - MC Debit Seminol/VIDIQ PRO SAN FRANCISC CADate 07/23/23 0 3204956369 0 5734Card 2801,10.0,,Posted,43.17,2023-07-24,10.0,Recurring Withdrawal Debit Card - MC Debit Seminol/VIDIQ SAN FRANCISC CADate 12/23/23 0 3357950683 0 5734Card 2801,10.0
7/23/2023,,Withdrawal POS #000003245378/GOOGLE *Google Storage 1600 AmphitheatreParkw Mountain View CACard 2801,1.99,,Posted,53.17,2023-07-23,1.99,Withdrawal POS #000002040482/GOOGLE *Google Storage 1600 AmphitheatreParkw Mountain View CACard 2801,1.99
7/22/2023,,Withdrawal POS #000000000008/AMAZON.COM*NT3PE5TH3 SEATTLE WACard 2801,12.69,,Posted,55.16,2023-07-22,12.69,Withdrawal POS #000000000023/AMAZON.COM*AU8ER6ZT3 SEATTLE WACard 2801,12.489999999999998
7/22/2023,,Withdrawal Bill Payment #000001057749/PAYPAL *PYPL Payin4 2211 North FirstStreet San Jose CACard 2801,13.75,,Posted,67.85,2023-07-22,13.75,Withdrawal Bill Payment #000002088135/PAYPAL *PYPL Payin4 2211 North FirstStreet San Jose CACard 2801,13.780000000000001
7/21/2023,,Recurring Withdrawal Debit Card - MC Debit Seminol/CANVA* I03852-21436246 CAMDEN DEDate 07/20/23 0 3201948972 0 7221Card 2801,12.99,,Posted,81.6,2023-07-21,12.99,Recurring Withdrawal Debit Card - MC Debit Seminol/CANVA* I03914-38299904 CAMDEN DEDate 09/23/23 0 3266003765 1 7221Card 2801,12.99
7/20/2023,,Withdrawal POS #000003365470/GOOGLE *YouTubePremium 1600 AmphitheatreParkw Mountain View CACard 2801,13.64,,Posted,94.59,2023-07-20,13.64,Withdrawal POS #000003285955/GOOGLE *YouTubePremium 1600 AmphitheatreParkw Mountain View CACard 2801,13.629999999999999
7/18/2023,,Recurring Withdrawal Debit Card - MC Debit Seminol/APPLE.COM/BILL 866-712-7753 CADate 07/18/23 0 3199086849 1 5818Card 2801,2.99,,Posted,108.23,2023-07-18,2.99,Recurring Withdrawal Debit Card - MC Debit Seminol/APPLE.COM/BILL 866-712-7753 CADate 09/16/23 0 3259205559 2 5818Card 2801,2.99
7/17/2023,,Withdrawal POS #000000008772/CIRCLE K # 26146 3525 GAINESVILLE FLCard 2801,27.47,,Posted,111.22,2023-07-17,27.47,Withdrawal POS #000000000558/CIRCLE K # 26146 3525 GAINESVILLE FLCard 2801,27.534999999999997
7/17/2023,,Withdrawal ATM Fee/EFT 3401 W University Ave Gainesville FLCard 2801,2.0,,Posted,138.69,2023-07-17,2.0,"Withdrawal ATM Fee/EFT 3401 W University Ave Gainesville FL

Card 1247",2.0
7/17/2023,,Withdrawal at ATM #000000977234/EFT 3401 W University Ave Gainesville FLCard 2801,83.0,,Posted,140.69,2023-07-17,83.0,"Withdrawal at ATM #000000776623/EFT 3401 W University Ave Gainesville FL

Card 1247",83.0
7/15/2023,,Withdrawal POS #000000363695/SUNOCO 8002212501 4234 SW 20TH AVEGAINESVILLE FLCard 2801,32.87,,Posted,223.69,2023-07-15,32.87,Withdrawal POS #000000639499/SUNOCO 8002212501 4234 SW 20TH AVEGAINESVILLE FLCard 2801,32.87
7/12/2023,,Withdrawal POS #000000802635/Instacart 50 Beal St Suite 600 SanFrancisco CACard 2801,5.0,,Posted,256.56,2023-07-12,5.0,Withdrawal POS #000000802668/Instacart 50 Beal St Suite 600 SanFrancisco CACard 2801,5.0
7/12/2023,,Withdrawal POS #000000782504/Instacart 50 Beal St Suite 600 SanFrancisco CACard 2801,56.51,,Posted,261.56,2023-07-12,56.51,Withdrawal POS #000000782097/Instacart 50 Beal St Suite 600 SanFrancisco CACard 2801,56.739999999999995
7/11/2023,,Withdrawal POS #000000215946/SUNOCO 8002212501 4234 SW 20TH AVEGAINESVILLE FLCard 2801,32.87,,Posted,118.07,2023-07-11,32.87,Withdrawal POS #000000219124/SUNOCO 8002212501 4234 SW 20TH AVEGAINESVILLE FLCard 2801,32.474999999999994
7/10/2023,,Withdrawal ACH CAPITAL ONE/TYPE: ONLINE PMT ID: 9279744391CO: CAPITAL ONE NAME: STEVEN CHAPLINSKIEntry Class Code: WEB,26.0,,Posted,150.94,2023-07-10,26.0,Withdrawal ACH CAPITAL ONE/TYPE: ONLINE PMT ID: 9279744391CO: CAPITAL ONE NAME: STEVEN CHAPLINSKIEntry Class Code: WEB,25.5
7/9/2023,,Recurring Withdrawal Debit Card - MC Debit Seminol/MIDJOURNEY INC. SOUTH SAN FR CADate 07/08/23 0 3189263519 0 5734Card 2801,30.0,,Posted,176.94,2023-07-09,30.0,Withdrawal Debit Card MC Debit Seminol/MIDJOURNEY INC. SOUTH SAN FR CADate 10/16/23 0 3289666656 0 5734Card 2801,30.0
7/9/2023,,Recurring Withdrawal Debit Card - MC Debit Seminol/WEB*HOSTGATOR.COM BURLINGTON MADate 07/08/23 0 3189966288 0 4816Card 2801,12.95,,Posted,206.94,2023-07-09,12.95,Recurring Withdrawal Debit Card - MC Debit Seminol/WEB*HOSTGATOR.COM BURLINGTON MADate 11/18/23 0 3322020816 1 4816Card 2801,12.95
7/9/2023,,Withdrawal Debit Card MC Debit Seminol/GOOGLE *COLAB CC GOOGLE.CO CADate 07/08/23 0 3189962202 0 7399Card 2801,9.99,,Posted,219.89,2023-07-09,9.99,Withdrawal Debit Card MC Debit Seminol/GOOGLE *COLAB CC GOOGLE.CO CADate 07/08/23 0 3189962202 0 7399Card 2801,9.99
7/9/2023,,Withdrawal Debit Card MC Debit Seminol/AMAZON PRIME*EI0RV58V3 AMZN.COM/BIL WADate 07/08/23 0 3189961984 0 5968Card 2801,15.13,,Posted,229.88,2023-07-09,15.13,Recurring Withdrawal Debit Card - MC Debit Seminol/AMAZON PRIME*QP8EE86P3 AMZN.COM/BIL WADate 07/04/23 0 3185799509 0 5968Card 2801,15.13
7/8/2023,,Withdrawal POS #000016231692/CASH APP*MIDJOURNEY INC SQUAREUP.COMSAN FRA CACard 2801,30.0,,Posted,245.01,2023-07-08,30.0,Withdrawal POS #000016231692/CASH APP*MIDJOURNEY INC SQUAREUP.COMSAN FRA CACard 2801,30.0
7/7/2023,,Withdrawal POS #000000971405/SUNOCO 8002212501 4234 SW 20TH AVEGAINESVILLE FLCard 2801,32.87,,Posted,262.11,2023-07-07,32.87,Withdrawal POS #000000219124/SUNOCO 8002212501 4234 SW 20TH AVEGAINESVILLE FLCard 2801,32.474999999999994
7/7/2023,,Withdrawal Debit Card MC Debit Seminol/SALESAMURAI.IO SFTWARE BOULDER CODate 07/06/23 0 3187119829 1 5734Card 2801,9.99,,Posted,294.98,2023-07-07,9.99,Withdrawal Debit Card MC Debit Seminol/SALESAMURAI.IO SFTWARE BOULDER CODate 11/13/23 0 3317927273 0 5734Card 2801,9.99
7/7/2023,,Recurring Withdrawal Debit Card - MC Debit Seminol/APPLE.COM/BILL 866-712-7753 CADate 07/06/23 0 3187931286 0 5818Card 2801,15.99,,Posted,304.97,2023-07-07,15.99,Recurring Withdrawal Debit Card - MC Debit Seminol/APPLE.COM/BILL 866-712-7753 CADate 09/16/23 0 3259205559 2 5818Card 2801,15.99
7/7/2023,,Withdrawal POS #070708407232/PAYPAL *PYPL Payin4 2211 North FirstStreet San Jose CACard 2801,13.75,,Posted,320.96,2023-07-07,13.75,Withdrawal POS #070708407232/PAYPAL *PYPL Payin4 2211 North FirstStreet San Jose CACard 2801,13.75
7/7/2023,,Withdrawal POS #000000772328/Instacart 50 Beal St Suite 600 SanFrancisco CACard 2801,5.0,,Posted,334.71,2023-07-07,5.0,Withdrawal POS #000000772752/Instacart 50 Beal St Suite 600 SanFrancisco CACard 2801,5.0
7/7/2023,,Withdrawal POS #000000802034/Instacart 50 Beal St Suite 600 SanFrancisco CACard 2801,80.19,,Posted,339.71,2023-07-07,80.19,Withdrawal POS #000000805513/Instacart 50 Beal St Suite 600 SanFrancisco CACard 2801,80.19
7/6/2023,,Withdrawal POS #000000002415/CIRCLE K # 26162 7302 GAINESVILLE FLCard 2801,17.47,,Posted,419.9,2023-07-06,17.47,Withdrawal POS #000000001638/CIRCLE K # 06527 9404 GAINESVILLE FLCard 2801,17.549999999999997
7/6/2023,,Withdrawal ATM Transaction,40.0,,Posted,437.37,2023-07-06,40.0,Withdrawal ATM Transaction,40.0
7/6/2023,,Withdrawal Debit Card MC Debit Seminol/DRI*ID.MYCOMMERCE.COM MINNETONKA MNDate 07/05/23 0 3186032383 1 5734Card 2801,22.8,,Posted,477.37,2023-07-06,22.8,Withdrawal Debit Card MC Debit Seminol/DRI*ID.MYCOMMERCE.COM MINNETONKA MNDate 07/05/23 0 3186032383 1 5734Card 2801,22.8
7/6/2023,,"Recurring Withdrawal Debit Card - MC Debit Seminol/MARMALEAD, LLC 4079065736 FLDate 07/05/23 0 3186769564 0 5045Card 2801",19.0,,Posted,500.17,2023-07-06,19.0,"Recurring Withdrawal Debit Card - MC Debit Seminol/MARMALEAD, LLC 4079065736 FLDate 01/05/24 0 4005822541 1 5045Card 2801",19.0
7/6/2023,,Recurring Withdrawal Bill Payment - #000000406426/NETFLIX COM LOS GATOS CACard 2801,11.0,,Posted,519.17,2023-07-06,11.0,Recurring Withdrawal Bill Payment - #000006911729/NETFLIX COM LOS GATOS CACard 2801,10.99
7/5/2023,,Recurring Withdrawal Debit Card - MC Debit Seminol/WWW.EVERBEE.IO SANTEE CADate 07/05/23 0 3186811005 0 5734Card 2801,29.99,,Posted,530.17,2023-07-05,29.99,Recurring Withdrawal Debit Card - MC Debit Seminol/WWW.EVERBEE.IO SANTEE CADate 01/05/24 0 4005834841 0 5734Card 2801,29.99
7/5/2023,,Withdrawal Debit Card MC Debit Seminol/PLAYSTATIONNETWORK SAN MATEO CADate 07/05/23 0 3186810835 0 5816Card 2801,29.99,,Posted,560.16,2023-07-05,29.99,Withdrawal Debit Card MC Debit Seminol/PLAYSTATIONNETWORK SAN MATEO CADate 12/31/23 0 3365872496 0 5816Card 2801,29.99
7/5/2023,,Recurring Withdrawal Debit Card - MC Debit Seminol/DISNEY PLUS 8889057888 CADate 07/04/23 0 3185801884 0 4899Card 2801,12.66,,Posted,590.15,2023-07-05,12.66,Recurring Withdrawal Debit Card - MC Debit Seminol/DISNEY PLUS 8889057888 CADate 10/02/24 0 4276239357 1 4899Card 1231,12.66
7/5/2023,,Recurring Withdrawal Debit Card - MC Debit Seminol/PLAYERAUCTIONS 800-342-0768 DEDate 07/04/23 0 3185800329 0 5816Card 2801,57.46,,Posted,602.81,2023-07-05,57.46,Recurring Withdrawal Debit Card - MC Debit Seminol/PLAYERAUCTIONS 800-342-0768 DEDate 09/17/23 0 3260060094 1 5816Card 2801,57.46
7/5/2023,,Recurring Withdrawal Debit Card - MC Debit Seminol/AMAZON PRIME*QP8EE86P3 AMZN.COM/BIL WADate 07/04/23 0 3185799509 0 5968Card 2801,15.15,,Posted,660.27,2023-07-05,15.15,Recurring Withdrawal Debit Card - MC Debit Seminol/AMAZON PRIME*QP8EE86P3 AMZN.COM/BIL WADate 07/04/23 0 3185799509 0 5968Card 2801,15.13
7/5/2023,,Recurring Withdrawal Debit Card - MC Debit Seminol/ADOBE *STOCK 4085366000 CADate 07/04/23 0 3185798080 0 5734Card 2801,29.99,,Posted,675.42,2023-07-05,29.99,Recurring Withdrawal Debit Card - MC Debit Seminol/ADOBE *CREATIVE CLOUD 4085366000 CADate 12/03/23 0 3337999974 0 5734Card 2801,29.99
7/5/2023,,Withdrawal ACH FLUENT-Gainesvil/TYPE: PAYMENT ID: 1371804719CO: FLUENT-GainesvilEntry Class Code: PPD,81.8,,Posted,705.41,2023-07-05,81.8,Withdrawal ACH FLUENT-Gainesvil/TYPE: PAYMENT ID: 1371804719CO: FLUENT-GainesvilEntry Class Code: PPD,81.8
7/5/2023,,Withdrawal ACH FLUENT-Gainesvil/TYPE: PAYMENT ID: 1371804719CO: FLUENT-GainesvilEntry Class Code: PPD,15.0,,Posted,787.21,2023-07-05,15.0,Withdrawal ACH FLUENT-Gainesvil/TYPE: PAYMENT ID: 1371804719CO: FLUENT-GainesvilEntry Class Code: PPD,15.0
7/4/2023,,Withdrawal POS #070409334948/PAYPAL *TARGETCORPO 2211 North FirstStreet San Jose CACard 2801,12.9,,Posted,802.21,2023-07-04,12.9,Withdrawal POS #070409334948/PAYPAL *TARGETCORPO 2211 North FirstStreet San Jose CACard 2801,12.9
7/4/2023,,Recurring Withdrawal Debit Card - MC Debit Seminol/CHATGPT SUBSCRIPTION SAN FRANCISC CADate 07/03/23 0 3184072640 1 5734Card 2801,20.0,,Posted,815.11,2023-07-04,20.0,Recurring Withdrawal Debit Card - MC Debit Seminol/CHATGPT SUBSCRIPTION SAN FRANCISC CADate 05/04/24 0 4125659188 0 5734Card 1231,20.0
7/4/2023,,Recurring Withdrawal Debit Card - MC Debit Seminol/APPLE.COM/BILL CUPERTINO CADate 07/03/23 0 3184067429 1 5735Card 2801,2.99,,Posted,835.11,2023-07-04,2.99,Withdrawal Debit Card MC Debit Seminol/APPLE.COM/BILL CUPERTINO CADate 08/18/23 0 3230028421 2 5735Card 2801,2.99
7/4/2023,,Recurring Withdrawal Debit Card - MC Debit Seminol/APPLE.COM/BILL 866-712-7753 CADate 07/04/23 0 3185066017 1 5818Card 2801,2.99,,Posted,838.1,2023-07-04,2.99,Recurring Withdrawal Debit Card - MC Debit Seminol/APPLE.COM/BILL 866-712-7753 CADate 09/16/23 0 3259205559 2 5818Card 2801,2.99
7/4/2023,,Withdrawal POS #000000802896/Instacart 50 Beal St Suite 600 SanFrancisco CACard 2801,5.0,,Posted,841.09,2023-07-04,5.0,Withdrawal POS #000000802668/Instacart 50 Beal St Suite 600 SanFrancisco CACard 2801,5.0
7/4/2023,,Withdrawal POS #000000782097/Instacart 50 Beal St Suite 600 SanFrancisco CACard 2801,94.94,,Posted,846.09,2023-07-04,94.94,Withdrawal POS #000000782097/Instacart 50 Beal St Suite 600 SanFrancisco CACard 2801,94.94
7/4/2023,,Withdrawal POS #000008031049/PAYPAL *HAVOCMARKET HAVOC 2211 NorthStreet San Jose CACard 2801,2.99,,Posted,941.03,2023-07-04,2.99,Withdrawal POS #000006228614/PAYPAL *HAVOCMARKET HAVOC 2211 NorthStreet San Jose CACard 1231,2.99
7/3/2023,,Withdrawal POS #000000626872/SUNOCO 8002212501 4234 SW 20TH AVEGAINESVILLE FLCard 2801,32.87,,Posted,944.02,2023-07-03,32.87,Withdrawal POS #000000265255/SUNOCO 8002212501 4234 SW 20TH AVEGAINESVILLE FLCard 2801,32.545
7/3/2023,,Recurring Withdrawal Debit Card - MC Debit Seminol/PARAMOUNT+ SAN FRANCISC CADate 07/02/23 0 3183995126 0 4899Card 2801,13.81,,Posted,976.89,2023-07-03,13.81,Recurring Withdrawal Debit Card - MC Debit Seminol/PARAMOUNT+ SAN FRANCISC CADate 01/02/24 0 4002821550 0 4899Card 2801,13.81
7/2/2023,,Recurring Withdrawal Debit Card - MC Debit Seminol/KAIBER AI WILMINGTON DEDate 06/30/23 0 3181776203 0 5815Card 2801,5.0,,Posted,990.7,2023-07-02,5.0,Recurring Withdrawal Debit Card - MC Debit Seminol/KAIBER AI WILMINGTON DEDate 08/30/23 0 3242340816 0 5815Card 2801,5.0
6/30/2023,,Withdrawal Debit Card Fee/MASTERCARD ISSUER CROSS-BORDER FEEDate 06/29/23 0 3180883261 0 5999Card 2801,0.04,,Posted,995.7,2023-06-30,0.04,Withdrawal Debit Card Fee/MASTERCARD ISSUER CROSS-BORDER FEEDate 10/06/23 0 3279122045 2 5815Card 2801,0.20833333333333334
6/30/2023,,Withdrawal Debit Card MC Debit Seminol/PAYPAL *PADDLE.NET 35314369001 GBDate 06/29/23 0 3180883261 0 5999Card 2801,4.99,,Posted,995.74,2023-06-30,4.99,Withdrawal Debit Card MC Debit Seminol/PAYPAL *PADDLE.NET 35314369001 GBDate 06/29/23 0 3180883261 0 5999Card 2801,4.99
6/30/2023,,Withdrawal Debit Card MC Debit Seminol/GRU/EZ-PAY WEB PYMT 352-334-3434 FLDate 06/29/23 0 3180354940 0 4900Card 2801,186.42,,Posted,1000.73,2023-06-30,186.42,Withdrawal Debit Card MC Debit Seminol/GRU/EZ-PAY WEB PYMT 352-334-3434 FLDate 12/05/24 0 4340279271 0 4900Card 1231,186.42
6/29/2023,,Withdrawal Bill Payment #000003355888/PAYPAL *MAX 2211 North First Street SanJose CACard 2801,18.41,,Posted,1187.15,2023-06-29,18.41,Withdrawal Bill Payment #000003355888/PAYPAL *MAX 2211 North First Street SanJose CACard 2801,18.41
6/29/2023,,Withdrawal Debit Card Fee/MASTERCARD ISSUER CROSS-BORDER FEEDate 06/29/23 0 3180070895 1 5734Card 2801,0.13,,Posted,1205.56,2023-06-29,0.13,Withdrawal Debit Card Fee/MASTERCARD ISSUER CROSS-BORDER FEEDate 04/19/21 0 1109184122 1 7311Card 2801,0.1281818181818182
6/29/2023,,Withdrawal Debit Card MC Debit Seminol/VANCEAI CENTRAL HODate 06/29/23 0 3180070895 1 5734Card 2801,15.9,,Posted,1205.69,2023-06-29,15.9,Withdrawal Debit Card MC Debit Seminol/VANCEAI CENTRAL HODate 06/29/23 0 3180070895 1 5734Card 2801,15.9
6/29/2023,,Recurring Withdrawal Debit Card - MC Debit Seminol/PLAYERAUCTIONS 800-342-0768 DEDate 06/29/23 0 3180080494 1 5816Card 2801,38.6,,Posted,1221.59,2023-06-29,38.6,Recurring Withdrawal Debit Card - MC Debit Seminol/PLAYERAUCTIONS 800-342-0768 DEDate 09/17/23 0 3260060094 1 5816Card 2801,38.6
6/29/2023,,Withdrawal Debit Card MC Debit Seminol/COX GAINESVILLE COMM 800-234-3993 FLDate 06/28/23 0 3179357082 0 4899Card 2801,125.03,,Posted,1260.19,2023-06-29,125.03,Withdrawal Debit Card MC Debit Seminol/COX GAINESVILLE COMM 800-234-3993 FLDate 12/04/24 0 4339376311 0 4899Card 1231,125.03
6/29/2023,,Withdrawal ACH Watson Realty Co/TYPE: WEB PMTS ID: 9000321157CO: Watson Realty CoNAME: Steven chaplinskiEntry Class Code: WEB,995.0,,Posted,1385.22,2023-06-29,995.0,Withdrawal ACH Watson Realty Co/TYPE: WEB PMTS ID: 9000321157CO: Watson Realty CoEntry Class Code: WEB,995.0
6/29/2023,,Withdrawal POS #000000792028/Instacart 50 Beal St Suite 600 SanFrancisco CACard 2801,5.0,,Posted,2380.22,2023-06-29,5.0,Withdrawal POS #000000792604/Instacart 50 Beal St Suite 600 SanFrancisco CACard 2801,5.415
6/29/2023,,Withdrawal POS #000000772324/Instacart 50 Beal St Suite 600 SanFrancisco CACard 2801,81.48,,Posted,2385.22,2023-06-29,81.48,Withdrawal POS #000000772752/Instacart 50 Beal St Suite 600 SanFrancisco CACard 2801,81.48
6/29/2023,,Withdrawal POS #000000362128/PLAYSTATION.COM US FOSTER CITY CACard 2801,99.99,,Posted,2466.7,2023-06-29,99.99,Withdrawal POS #000000362128/PLAYSTATION.COM US FOSTER CITY CACard 2801,99.99
6/28/2023,,Withdrawal POS #000000488417/SUNOCO 8002212501 4234 SW 20TH AVEGAINESVILLE FLCard 2801,34.98,,Posted,2566.69,2023-06-28,34.98,Withdrawal POS #000000437179/SUNOCO 8002212501 4234 SW 20TH AVEGAINESVILLE FLCard 2801,34.98
6/28/2023,,Recurring Withdrawal Debit Card - MC Debit Seminol/ADOBE *CREATIVE CLOUD 4085366000 CADate 06/27/23 0 3178852802 0 5734Card 2801,29.99,,Posted,1.67,2023-06-28,29.99,Recurring Withdrawal Debit Card MC Debit/ADOBE *CREATIVE CLOUD 4085366000 CADate 04/27/23 0 3117844835 0 5734Card 2801,29.99
6/27/2023,,Withdrawal Debit Card MC Debit Seminol/WALGREENS #5024 GAINESVILLE FLDate 06/26/23 0 3177001861 1 5912Card 2801,15.0,,Posted,31.66,2023-06-27,15.0,Withdrawal Debit Card MC Debit Seminol/WALGREENS #5024 GAINESVILLE FLDate 06/26/23 0 3177001861 1 5912Card 2801,15.0
6/26/2023,,Withdrawal POS #000000409276/SUNOCO 8002212501 4234 SW 20TH AVEGAINESVILLE FLCard 2801,28.55,,Posted,46.66,2023-06-26,28.55,Withdrawal POS #000000403720/SUNOCO 8002212501 4234 SW 20TH AVEGAINESVILLE FLCard 2801,28.32
6/26/2023,,Withdrawal POS #000011251276/WALGREENS 2415 SW 75TH GAINESVILLE FLCard 2801,5.28,,Posted,75.21,2023-06-26,5.28,Withdrawal POS #000014264526/WALGREENS 2415 SW GAINESVILLE FLCard 2801,4.78
6/25/2023,,Withdrawal POS #000000347643/SUNOCO 8002212501 4234 SW 20TH AVEGAINESVILLE FLCard 2801,35.2,,Posted,80.49,2023-06-25,35.2,Withdrawal POS #000000409276/SUNOCO 8002212501 4234 SW 20TH AVEGAINESVILLE FLCard 2801,35.2
6/25/2023,,Recurring Withdrawal Debit Card MC Debit/VIDIQ PRO SAN FRANCISC CADate 06/23/23 0 3174219633 1 5734Card 2801,10.0,,Posted,115.69,2023-06-25,10.0,Recurring Withdrawal Debit Card MC Debit/VIDIQ PRO SAN FRANCISC CADate 06/23/23 0 3174219633 1 5734Card 2801,10.0
6/25/2023,,Withdrawal Debit Card MC Debit/WALGREENS #5024 GAINESVILLE FLDate 06/23/23 0 3174465834 2 5912Card 2801,18.49,,Posted,125.69,2023-06-25,18.49,Withdrawal Debit Card MC Debit/WALGREENS #5024 GAINESVILLE FLDate 06/23/23 0 3174465834 2 5912Card 2801,18.49
6/24/2023,,Withdrawal POS #000000153618/PLAYSTATION.COM US FOSTER CITY CACard 2801,24.99,,Posted,144.18,2023-06-24,24.99,Withdrawal POS #000000362128/PLAYSTATION.COM US FOSTER CITY CACard 2801,24.99
6/23/2023,,Withdrawal POS #000000242084/SUNOCO 8002212501 4234 SW 20TH AVEGAINESVILLE FLCard 2801,23.3,,Posted,169.17,2023-06-23,23.3,Withdrawal POS #000000219124/SUNOCO 8002212501 4234 SW 20TH AVEGAINESVILLE FLCard 2801,23.02
6/23/2023,,Withdrawal ACH FLUENT-Gainesvil/TYPE: PAYMENT ID: 1371804719CO: FLUENT-GainesvilEntry Class Code: PPD,103.5,,Posted,192.47,2023-06-23,103.5,Withdrawal ACH FLUENT-Gainesvil/TYPE: PAYMENT ID: 1371804719CO: FLUENT-GainesvilEntry Class Code: PPD,103.0
6/23/2023,,Withdrawal POS #000003333814/GOOGLE *Google Storage 1600 AmphitheatreParkw Mountain View CACard 2801,1.99,,Posted,295.97,2023-06-23,1.99,Withdrawal POS #000002040482/GOOGLE *Google Storage 1600 AmphitheatreParkw Mountain View CACard 2801,1.99
6/22/2023,,Withdrawal POS #000000782615/Instacart 50 Beal St Suite 600 SanFrancisco CACard 2801,5.0,,Posted,297.96,2023-06-22,5.0,Withdrawal POS #000000782111/Instacart 50 Beal St Suite 600 SanFrancisco CACard 2801,5.0
6/22/2023,,Withdrawal POS #000000772154/Instacart 50 Beal St Suite 600 SanFrancisco CACard 2801,71.37,,Posted,302.96,2023-06-22,71.37,Withdrawal POS #000000772752/Instacart 50 Beal St Suite 600 SanFrancisco CACard 2801,71.465
6/21/2023,,Recurring Withdrawal Debit Card MC Debit/CANVA* I03822-21318506 CAMDEN DEDate 06/20/23 0 3171858479 0 7221Card 2801,12.99,,Posted,374.33,2023-06-21,12.99,Recurring Withdrawal Debit Card MC Debit/CANVA* I03822-21318506 CAMDEN DEDate 06/20/23 0 3171858479 0 7221Card 2801,12.99
6/21/2023,,Withdrawal POS #000000127849/SUNOCO 8002212501 4234 SW 20TH AVEGAINESVILLE FLCard 2801,27.5,,Posted,87.32,2023-06-21,27.5,Withdrawal POS #000000219124/SUNOCO 8002212501 4234 SW 20TH AVEGAINESVILLE FLCard 2801,27.5
6/20/2023,,Withdrawal POS #000003216179/GOOGLE *YouTubePremium 1600 AmphitheatreParkw Mountain View CACard 2801,13.64,,Posted,114.82,2023-06-20,13.64,Withdrawal POS #000003285955/GOOGLE *YouTubePremium 1600 AmphitheatreParkw Mountain View CACard 2801,13.629999999999999
6/20/2023,,Withdrawal POS #000000524315/AMAZON.COM*S65085A63 SEATTLE WACard 2801,23.09,,Posted,128.46,2023-06-20,23.09,Withdrawal POS #000000598647/AMAZON.COM*F565U8HW3 SEATTLE WACard 2801,23.42
6/20/2023,,Withdrawal POS #000000000002/AMAZON.COM*AW2X61683 SEATTLE WACard 2801,20.4,,Posted,151.55,2023-06-20,20.4,Withdrawal POS #000000000007/AMAZON.COM*2864R4HI1 SEATTLE WACard 1140,20.713333333333335
6/20/2023,,Withdrawal POS #000000059871/PUBLIX 3930 SW ARCHER ROAD GAINESVILLECard 2801,73.35,,Posted,171.95,2023-06-20,73.35,Withdrawal POS #000000753028/PUBLIX 3930 SW ARCHER ROAD GAINESVILLECard 1247,73.35
6/19/2023,,Withdrawal POS #000000013264/SUNOCO 8002212501 4234 SW 20TH AVEGAINESVILLE FLCard 2801,32.87,,Posted,245.3,2023-06-19,32.87,Withdrawal POS #000000219124/SUNOCO 8002212501 4234 SW 20TH AVEGAINESVILLE FLCard 2801,32.474999999999994
6/18/2023,,Recurring Withdrawal Debit Card MC Debit/APPLE.COM/BILL 866-712-7753 CADate 06/18/23 0 3169087519 1 5818Card 2801,2.99,,Posted,278.17,2023-06-18,2.99,Recurring Withdrawal Debit Card MC Debit/APPLE.COM/BILL 866-712-7753 CADate 06/18/23 0 3169087519 1 5818Card 2801,2.99
6/17/2023,,Withdrawal POS #000000802789/Instacart 50 Beal St Suite 600 SanFrancisco CACard 2801,60.7,,Posted,281.16,2023-06-17,60.7,Withdrawal POS #000000802668/Instacart 50 Beal St Suite 600 SanFrancisco CACard 2801,60.7
6/16/2023,,Withdrawal Debit Card MC Debit/EXXON FAST TRACK #200 GAINESVILLE FLDate 06/15/23 0 3166206451 1 5541Card 2801,25.45,,Posted,341.86,2023-06-16,25.45,Withdrawal Debit Card MC Debit/EXXON FAST TRACK #200 GAINESVILLE FLDate 06/15/23 0 3166206451 1 5541Card 2801,25.45
6/16/2023,,Withdrawal POS #000000088222/PUBLIX 3930 SW ARCHER ROAD GAINESVILLECard 2801,60.36,,Posted,367.31,2023-06-16,60.36,Withdrawal POS #000000753028/PUBLIX 3930 SW ARCHER ROAD GAINESVILLECard 1247,60.36
6/11/2023,,Withdrawal POS #000000000008/AMAZON.COM*ND2SO9E83 SEATTLE WACard 2801,14.91,,Posted,427.67,2023-06-11,14.91,Withdrawal POS #000000000023/AMAZON.COM*AU8ER6ZT3 SEATTLE WACard 2801,14.91
6/11/2023,,Withdrawal POS #000096293505/FAST TRACK #200 GAINESVILLE FLCard 2801,26.12,,Posted,442.58,2023-06-11,26.12,Withdrawal POS #000096296533/FAST TRACK #200 GAINESVILLE FLCard 2801,26.12
6/11/2023,,Withdrawal POS #000000047112/PUBLIX 3930 SW ARCHER ROAD GAINESVILLECard 2801,65.67,,Posted,468.7,2023-06-11,65.67,Withdrawal POS #000000753028/PUBLIX 3930 SW ARCHER ROAD GAINESVILLECard 1247,65.67
6/9/2023,,Withdrawal POS #000000476031/SUNOCO 8002212501 4234 SW 20TH AVEGAINESVILLE FLCard 2801,28.55,,Posted,534.37,2023-06-09,28.55,Withdrawal POS #000000403720/SUNOCO 8002212501 4234 SW 20TH AVEGAINESVILLE FLCard 2801,28.32
6/9/2023,,Recurring Withdrawal Debit Card MC Debit/WEB*HOSTGATOR.COM BURLINGTON MADate 06/08/23 0 3159061206 1 4816Card 2801,12.95,,Posted,562.92,2023-06-09,12.95,Recurring Withdrawal Debit Card MC Debit/WEB*HOSTGATOR.COM BURLINGTON MADate 06/08/23 0 3159061206 1 4816Card 2801,12.95
6/8/2023,,Recurring Withdrawal Debit Card MC Debit/MIDJOURNEY INC. SOUTH SAN FR CADate 06/07/23 0 3158865788 0 5734Card 2801,30.0,,Posted,575.87,2023-06-08,30.0,Recurring Withdrawal Debit Card MC Debit/MIDJOURNEY INC. SOUTH SAN FR CADate 06/07/23 0 3158865788 0 5734Card 2801,30.0
6/7/2023,,Withdrawal ACH FLUENT-Gainesvil/TYPE: PAYMENT ID: 1371804719CO: FLUENT-GainesvilEntry Class Code: PPD,64.0,,Posted,605.87,2023-06-07,64.0,Withdrawal ACH FLUENT-Gainesvil/TYPE: PAYMENT ID: 1371804719CO: FLUENT-GainesvilEntry Class Code: PPD,63.6
6/6/2023,,Recurring Withdrawal Debit Card MC Debit/APPLE.COM/BILL 866-712-7753 CADate 06/06/23 0 3157022514 1 5818Card 2801,15.99,,Posted,669.87,2023-06-06,15.99,Recurring Withdrawal Debit Card MC Debit/APPLE.COM/BILL 866-712-7753 CADate 06/18/23 0 3169087519 1 5818Card 2801,15.99
6/6/2023,,Recurring Withdrawal Bill Payment - #000000020916/NETFLIX COM LOS GATOS CACard 2801,11.0,,Posted,685.86,2023-06-06,11.0,Recurring Withdrawal Bill Payment - #000006911729/NETFLIX COM LOS GATOS CACard 2801,10.99
6/6/2023,,Withdrawal POS #000000000009/AMAZON.COM*SC6LS1M63 SEATTLE WACard 2801,10.19,,Posted,696.86,2023-06-06,10.19,Withdrawal POS #000000000000/AMAZON.COM*V40RU1143 SEATTLE WACard 2801,10.44
6/6/2023,,Withdrawal POS #000000000002/AMAZON.COM*N067J03N3 SEATTLE WACard 2801,23.41,,Posted,707.05,2023-06-06,23.41,Withdrawal POS #000000000023/AMAZON.COM*AU8ER6ZT3 SEATTLE WACard 2801,23.810000000000002
6/6/2023,,Withdrawal POS #000000957633/AMAZON.COM*EP2505QZ3 SEATTLE WACard 2801,21.93,,Posted,730.46,2023-06-06,21.93,Withdrawal POS #000000598647/AMAZON.COM*F565U8HW3 SEATTLE WACard 2801,21.93
6/6/2023,,Withdrawal POS #000000960323/AMAZON.COM*T45738AZ3 SEATTLE WACard 2801,16.98,,Posted,752.39,2023-06-06,16.98,Withdrawal POS #000000598647/AMAZON.COM*F565U8HW3 SEATTLE WACard 2801,16.546666666666667
6/6/2023,,Withdrawal POS #000000957627/AMAZON.COM*ZY9484853 SEATTLE WACard 2801,10.19,,Posted,769.37,2023-06-06,10.19,Withdrawal POS #000000598647/AMAZON.COM*F565U8HW3 SEATTLE WACard 2801,10.37
6/6/2023,,Withdrawal POS #000000010636/CIRCLE K # 26146 3525 GAINESVILLE FLCard 2801,30.63,,Posted,779.56,2023-06-06,30.63,Withdrawal POS #000000003339/CIRCLE K # 26146 3525 GAINESVILLE FLCard 2801,30.35
6/5/2023,,Withdrawal POS #000000000000/AMAZON.COM*9H8K93WL3 SEATTLE WACard 2801,21.5,,Posted,810.19,2023-06-05,21.5,Withdrawal POS #000000000000/AMAZON.COM*V40RU1143 SEATTLE WACard 2801,21.5
6/5/2023,,Withdrawal Debit Card MC Debit/DISNEY PLUS 8889057888 CADate 06/04/23 0 3155948064 0 4899Card 2801,12.66,,Posted,831.69,2023-06-05,12.66,Withdrawal Debit Card MC Debit/DISNEY PLUS 8889057888 CADate 06/04/23 0 3155948064 0 4899Card 2801,12.66
6/5/2023,,Recurring Withdrawal Debit Card MC Debit/ADOBE *STOCK 4085366000 CADate 06/04/23 0 3155943134 0 5734Card 2801,29.99,,Posted,844.35,2023-06-05,29.99,Recurring Withdrawal Debit Card MC Debit/ADOBE *STOCK 4085366000 CADate 06/04/23 0 3155943134 0 5734Card 2801,29.99
6/4/2023,,Withdrawal POS #000000802305/Instacart 50 Beal St Suite 600 SanFrancisco CACard 2801,73.58,,Posted,874.34,2023-06-04,73.58,Withdrawal POS #000000805513/Instacart 50 Beal St Suite 600 SanFrancisco CACard 2801,73.58
6/4/2023,,Recurring Withdrawal Debit Card MC Debit/PARAMOUNT+ SAN FRANCISC CADate 06/02/23 0 3153147659 1 4899Card 2801,13.81,,Posted,947.92,2023-06-04,13.81,Recurring Withdrawal Debit Card MC Debit/PARAMOUNT+ SAN FRANCISC CADate 06/02/23 0 3153147659 1 4899Card 2801,13.81
6/4/2023,,Recurring Withdrawal Debit Card MC Debit/PLAYERAUCTIONS 800-342-0768 DEDate 06/04/23 0 3155992645 1 5816Card 2801,55.88,,Posted,961.73,2023-06-04,55.88,Recurring Withdrawal Debit Card MC Debit/PLAYERAUCTIONS 800-342-0768 DEDate 06/04/23 0 3155992645 1 5816Card 2801,55.88
6/4/2023,,Recurring Withdrawal Debit Card MC Debit/APPLE.COM/BILL 866-712-7753 CADate 06/03/23 0 3154231741 1 5818Card 2801,2.99,,Posted,1017.61,2023-06-04,2.99,Recurring Withdrawal Debit Card MC Debit/APPLE.COM/BILL 866-712-7753 CADate 06/18/23 0 3169087519 1 5818Card 2801,2.99
6/4/2023,,Recurring Withdrawal Debit Card MC Debit/APPLE.COM/BILL 866-712-7753 CADate 06/03/23 0 3154231740 1 5818Card 2801,2.99,,Posted,1020.6,2023-06-04,2.99,Recurring Withdrawal Debit Card MC Debit/APPLE.COM/BILL 866-712-7753 CADate 06/18/23 0 3169087519 1 5818Card 2801,2.99
6/4/2023,,Withdrawal POS #000000172479/SUNOCO 8002212501 4234 SW 20TH AVEGAINESVILLE FLCard 2801,32.87,,Posted,1023.59,2023-06-04,32.87,Withdrawal POS #000000219124/SUNOCO 8002212501 4234 SW 20TH AVEGAINESVILLE FLCard 2801,32.474999999999994
6/3/2023,,Withdrawal POS #000000711433/AMAZON.COM*X31NO1LV3 SEATTLE WACard 2801,23.92,,Posted,1056.46,2023-06-03,23.92,Withdrawal POS #000000711433/AMAZON.COM*X31NO1LV3 SEATTLE WACard 2801,23.92
6/2/2023,,Withdrawal ACH FLUENT-Gainesvil/TYPE: PAYMENT ID: 1371804719CO: FLUENT-GainesvilEntry Class Code: PPD,63.2,,Posted,1080.38,2023-06-02,63.2,Withdrawal ACH FLUENT-Gainesvil/TYPE: PAYMENT ID: 1371804719CO: FLUENT-GainesvilEntry Class Code: PPD,63.6
6/1/2023,,Recurring Withdrawal Debit Card MC Debit/PLAYERAUCTIONS 800-342-0768 DEDate 05/31/23 0 3151335470 0 5816Card 2801,42.58,,Posted,1143.58,2023-06-01,42.58,Recurring Withdrawal Debit Card MC Debit/PLAYERAUCTIONS 800-342-0768 DEDate 06/04/23 0 3155992645 1 5816Card 2801,42.58
6/1/2023,,Withdrawal Debit Card MC Debit/GRU/EZ-PAY WEB PYMT 352-334-3434 FLDate 05/31/23 0 3151334916 0 4900Card 2801,143.84,,Posted,1186.16,2023-06-01,143.84,Withdrawal Debit Card MC Debit/GRU/EZ-PAY WEB PYMT 352-334-3434 FLDate 11/01/21 0 1305577800 0 4900Card 2801,143.84
6/1/2023,,Withdrawal Debit Card MC Debit/COX GAINESVILLE COMM 800-234-3993 FLDate 05/31/23 0 3151812468 0 4899Card 2801,125.03,,Posted,1330.0,2023-06-01,125.03,Withdrawal Debit Card MC Debit/COX GAINESVILLE COMM 800-234-3993 FLDate 05/31/23 0 3151812468 0 4899Card 2801,125.03
6/1/2023,,Withdrawal ACH Watson Realty Co/TYPE: WEB PMTS ID: 9000321157CO: Watson Realty CoNAME: Steven chaplinskiEntry Class Code: WEB,1045.0,,Posted,1455.03,2023-06-01,1045.0,Withdrawal ACH Watson Realty Co/TYPE: WEB PMTS ID: 9000321157CO: Watson Realty CoEntry Class Code: WEB,1045.0
6/1/2023,,Withdrawal POS #000000214108/AMAZON.COM*SX6AJ5UE3 SEATTLE WACard 2801,24.0,,Posted,2500.03,2023-06-01,24.0,Withdrawal POS #000000598647/AMAZON.COM*F565U8HW3 SEATTLE WACard 2801,23.42
6/1/2023,,Withdrawal POS #000000802369/Instacart 50 Beal St Suite 600 SanFrancisco CACard 2801,2.0,,Posted,2524.03,2023-06-01,2.0,Withdrawal POS #000000802668/Instacart 50 Beal St Suite 600 SanFrancisco CACard 2801,2.5
6/1/2023,,Withdrawal POS #000000802939/Instacart 50 Beal St Suite 600 SanFrancisco CACard 2801,99.81,,Posted,2526.03,2023-06-01,99.81,Withdrawal POS #000000805513/Instacart 50 Beal St Suite 600 SanFrancisco CACard 2801,99.81
5/31/2023,,Withdrawal POS #000000621670/SUNOCO 8002212501 4234 SW 20TH AVEGAINESVILLE FLCard 2801,56.52,,Posted,2606.84,2023-05-31,56.52,Withdrawal POS #000000260400/SUNOCO 8002212501 4234 SW 20TH AVEGAINESVILLE FLCard 2801,56.52
5/29/2023,,Withdrawal POS #000000524971/SUNOCO 8002212501 4234 SW 20TH AVEGAINESVILLE FLCard 2801,24.13,,Posted,18.27,2023-05-29,24.13,Withdrawal POS #000000955321/SUNOCO 8002212501 4234 SW 20TH AVEGAINESVILLE FLCard 2801,23.975
5/28/2023,,Withdrawal Debit Card MC Debit/WALGREENS #5024 GAINESVILLE FLDate 05/26/23 0 3146498831 2 5912Card 2801,35.99,,Posted,3.4,2023-05-28,35.99,Withdrawal Debit Card MC Debit/WALGREENS #5024 GAINESVILLE FLDate 06/23/23 0 3174465834 2 5912Card 2801,35.99
5/28/2023,,Withdrawal Debit Card MC Debit/CIRCLE K # 06782 GAINESVILLE FLDate 05/26/23 0 3146939363 0 5499Card 2801,17.3,,Posted,39.39,2023-05-28,17.3,Withdrawal Debit Card MC Debit/CIRCLE K # 06782 GAINESVILLE FLDate 05/26/23 0 3146939363 0 5499Card 2801,17.3
5/28/2023,,"Recurring Withdrawal Debit Card MC Debit/MARMALEAD, LLC 4079065736 FLDate 05/26/23 0 3146966475 1 5045Card 2801",19.0,,Posted,56.69,2023-05-28,19.0,"Recurring Withdrawal Debit Card MC Debit/MARMALEAD, LLC 4079065736 FLDate 05/26/23 0 3146966475 1 5045Card 2801",19.0
5/28/2023,,Recurring Withdrawal Debit Card MC Debit/ADOBE *CREATIVE CLOUD 4085366000 CADate 05/27/23 0 3147959637 0 5734Card 2801,29.99,,Posted,75.69,2023-05-28,29.99,Recurring Withdrawal Debit Card MC Debit/ADOBE *CREATIVE CLOUD 4085366000 CADate 04/27/23 0 3117844835 0 5734Card 2801,29.99
5/26/2023,,Withdrawal POS #000000718669/AMAZON.COM*NY38Y1WA3 SEATTLE WACard 2801,27.54,,Posted,105.68,2023-05-26,27.54,Withdrawal POS #000000472169/AMAZON.COM*UY7Z21W73 SEATTLE WACard 1140,27.765
5/25/2023,,Recurring Withdrawal Debit Card Fee/MASTERCARD ISSUER CROSS-BORDER FEEDate 05/25/23 0 3145842155 0 5734Card 2801,0.08,,Posted,133.22,2023-05-25,0.08,Recurring Withdrawal Debit Card Fee/MASTERCARD ISSUER CROSS-BORDER FEEDate 04/20/23 0 3110864064 0 7333Card 2801,0.15111111111111108
5/25/2023,,Recurring Withdrawal Debit Card MC Debit/SP NIGHTCAFE AI ART MARRICKVILLE NSDate 05/25/23 0 3145842155 0 5734Card 2801,9.99,,Posted,133.3,2023-05-25,9.99,Recurring Withdrawal Debit Card MC Debit/SP NIGHTCAFE AI ART MARRICKVILLE NSDate 05/25/23 0 3145842155 0 5734Card 2801,9.99
5/24/2023,,Withdrawal POS #000096296101/FAST TRACK #200 GAINESVILLE FLCard 2801,24.93,,Posted,143.29,2023-05-24,24.93,Withdrawal POS #000096296533/FAST TRACK #200 GAINESVILLE FLCard 2801,24.93
5/24/2023,,Withdrawal POS #000000056302/PUBLIX 3930 SW ARCHER ROAD GAINESVILLECard 2801,92.46,,Posted,168.22,2023-05-24,92.46,Withdrawal POS #000000753028/PUBLIX 3930 SW ARCHER ROAD GAINESVILLECard 1247,92.46
5/24/2023,,Recurring Withdrawal Debit Card MC Debit/VIDIQ PRO SAN FRANCISC CADate 05/23/23 0 3143843222 0 5734Card 2801,10.0,,Posted,260.68,2023-05-24,10.0,Recurring Withdrawal Debit Card MC Debit/VIDIQ PRO SAN FRANCISC CADate 06/23/23 0 3174219633 1 5734Card 2801,10.0
5/24/2023,,Withdrawal ACH FLUENT-Gainesvil/TYPE: PAYMENT ID: 1371804719CO: FLUENT-GainesvilEntry Class Code: PPD,70.9,,Posted,70.68,2023-05-24,70.9,Withdrawal ACH FLUENT-Gainesvil/TYPE: PAYMENT ID: 1371804719CO: FLUENT-GainesvilEntry Class Code: PPD,70.9
5/23/2023,,Withdrawal POS #000000000000/AMAZON.COM*5R3AK5KB3 SEATTLE WACard 2801,27.54,,Posted,141.58,2023-05-23,27.54,Withdrawal POS #000000000000/AMAZON.COM*V40RU1143 SEATTLE WACard 2801,27.54
5/23/2023,,Withdrawal POS #000003381642/GOOGLE *Google Storage 1600 AmphitheatreParkw Mountain View CACard 2801,1.99,,Posted,169.12,2023-05-23,1.99,Withdrawal POS #000002040482/GOOGLE *Google Storage 1600 AmphitheatreParkw Mountain View CACard 2801,1.99
5/22/2023,,Withdrawal POS #000096296751/FAST TRACK #200 GAINESVILLE FLCard 2801,19.55,,Posted,171.11,2023-05-22,19.55,Withdrawal POS #000096296533/FAST TRACK #200 GAINESVILLE FLCard 2801,19.486666666666665
5/22/2023,,Withdrawal POS #000000044582/PUBLIX 3930 SW ARCHER ROAD GAINESVILLECard 2801,49.07,,Posted,190.66,2023-05-22,49.07,Withdrawal POS #000000753028/PUBLIX 3930 SW ARCHER ROAD GAINESVILLECard 1247,49.07
5/22/2023,,Withdrawal POS #000000004110/CIRCLE K # 26146 3525 GAINESVILLE FLCard 2801,7.07,,Posted,239.73,2023-05-22,7.07,Withdrawal POS #000000000558/CIRCLE K # 26146 3525 GAINESVILLE FLCard 2801,7.07
5/22/2023,,Withdrawal POS #000000737762/PUBLIX 3315 W. UNIVERSITY AVE.FLCard 2801,45.69,,Posted,246.8,2023-05-22,45.69,Withdrawal POS #000000749495/PUBLIX 3315 W. UNIVERSITY AVE.FLCard 1231,45.69
5/22/2023,,Withdrawal Debit Card MC Debit/PIZZA HUT 27918 GAINESVILLE FLDate 05/20/23 0 3140936778 0 5812Card 2801,40.0,,Posted,292.49,2023-05-22,40.0,Withdrawal Debit Card MC Debit/PIZZA HUT 27918 GAINESVILLE FLDate 05/20/23 0 3140936778 0 5812Card 2801,40.60666666666666
5/21/2023,,Recurring Withdrawal Debit Card MC Debit/CANVA* I03791-14478190 CAMDEN DEDate 05/20/23 0 3140925062 0 7221Card 2801,12.99,,Posted,132.49,2023-05-21,12.99,Recurring Withdrawal Debit Card MC Debit/CANVA* I03822-21318506 CAMDEN DEDate 06/20/23 0 3171858479 0 7221Card 2801,12.99
5/20/2023,,Withdrawal POS #000003319884/GOOGLE *YouTubePremium 1600 AmphitheatreParkw Mountain View CACard 2801,13.64,,Posted,45.48,2023-05-20,13.64,Withdrawal POS #000003285955/GOOGLE *YouTubePremium 1600 AmphitheatreParkw Mountain View CACard 2801,13.629999999999999
5/19/2023,,Withdrawal POS #000000405290/SUNOCO 8002212501 4234 SW 20TH AVEGAINESVILLE FLCard 2801,32.87,,Posted,59.12,2023-05-19,32.87,Withdrawal POS #000000403720/SUNOCO 8002212501 4234 SW 20TH AVEGAINESVILLE FLCard 2801,32.87
5/18/2023,,Recurring Withdrawal Debit Card MC Debit/APPLE.COM/BILL 866-712-7753 CADate 05/18/23 0 3138075089 1 5818Card 2801,2.99,,Posted,91.99,2023-05-18,2.99,Recurring Withdrawal Debit Card MC Debit/APPLE.COM/BILL 866-712-7753 CADate 06/18/23 0 3169087519 1 5818Card 2801,2.99
5/17/2023,,Withdrawal POS #000000000004/AMAZON.COM*G37H72YL3 SEATTLE WACard 2801,13.18,,Posted,94.98,2023-05-17,13.18,Withdrawal POS #000000000003/AMAZON.COM*1Z8447YO1 SEATTLE WACard 2801,12.719999999999999
5/17/2023,,Withdrawal POS #000000011560/CIRCLE K # 01313 4221 GAINESVILLE FLCard 2801,20.02,,Posted,108.16,2023-05-17,20.02,Withdrawal POS #000000011248/CIRCLE K # 23913 3424 GAINESVILLE FLCard 2801,19.68
5/16/2023,,Recurring Withdrawal Debit Card Fee/MASTERCARD ISSUER CROSS-BORDER FEEDate 05/15/23 0 3135870887 0 5734Card 2801,0.14,,Posted,128.18,2023-05-16,0.14,Recurring Withdrawal Debit Card Fee/MASTERCARD ISSUER CROSS-BORDER FEEDate 05/14/23 0 3134938310 0 8299Card 2801,0.0925
5/16/2023,,Recurring Withdrawal Debit Card MC Debit/SUBPALS8888819070 BADEN ONDate 05/15/23 0 3135870887 0 5734Card 2801,17.0,,Posted,128.32,2023-05-16,17.0,Recurring Withdrawal Debit Card MC Debit/SUBPALS8888819070 BADEN ONDate 05/15/23 0 3135870887 0 5734Card 2801,17.0
5/15/2023,,Recurring Withdrawal Debit Card Fee/MASTERCARD ISSUER CROSS-BORDER FEEDate 05/14/23 0 3134938310 0 8299Card 2801,0.04,,Posted,145.32,2023-05-15,0.04,Recurring Withdrawal Debit Card Fee/MASTERCARD ISSUER CROSS-BORDER FEEDate 05/14/23 0 3134938310 0 8299Card 2801,0.0925
5/15/2023,,Recurring Withdrawal Debit Card MC Debit/WWW.W3SCHOOLS.COM SANDNES DUDate 05/14/23 0 3134938310 0 8299Card 2801,4.99,,Posted,145.36,2023-05-15,4.99,Recurring Withdrawal Debit Card MC Debit/WWW.W3SCHOOLS.COM SANDNES DUDate 05/14/23 0 3134938310 0 8299Card 2801,4.99
5/14/2023,,Recurring Withdrawal Debit Card MC Debit/CHATGPT SUBSCRIPTION SAN FRANCISC CADate 05/12/23 0 3132943704 1 5734Card 2801,20.0,,Posted,150.35,2023-05-14,20.0,Recurring Withdrawal Debit Card MC Debit/CHATGPT SUBSCRIPTION SAN FRANCISC CADate 05/12/23 0 3132943704 1 5734Card 2801,20.0
5/14/2023,,Recurring Withdrawal Debit Card Fee/MASTERCARD ISSUER CROSS-BORDER FEEDate 05/12/23 0 3132437615 1 5734Card 2801,0.07,,Posted,170.35,2023-05-14,0.07,Recurring Withdrawal Debit Card Fee/MASTERCARD ISSUER CROSS-BORDER FEEDate 05/12/21 0 1132191600 1 7372Card 2801,0.09500000000000001
5/14/2023,,Recurring Withdrawal Debit Card MC Debit/DRIVE EXPLORER ADDON MADURAI TNDate 05/12/23 0 3132437615 1 5734Card 2801,9.0,,Posted,170.42,2023-05-14,9.0,Recurring Withdrawal Debit Card MC Debit/DRIVE EXPLORER ADDON MADURAI TNDate 05/12/23 0 3132437615 1 5734Card 2801,9.0
5/11/2023,,Withdrawal Debit Card MC Debit/ARCHER ANIMAL HOSPITAL ARCHER FLDate 05/10/23 0 3130327214 0 0742Card 2801,134.98,,Posted,179.42,2023-05-11,134.98,Withdrawal Debit Card MC Debit/ARCHER ANIMAL HOSPITAL ARCHER FLDate 05/10/23 0 3130327214 0 0742Card 2801,134.98
5/10/2023,,Withdrawal POS #000000363822/PLAYSTATION.COM US FOSTER CITY CACard 2801,59.99,,Posted,314.4,2023-05-10,59.99,Withdrawal POS #000000362128/PLAYSTATION.COM US FOSTER CITY CACard 2801,59.99
5/9/2023,,Withdrawal POS #000096293976/FAST TRACK #200 GAINESVILLE FLCard 2801,22.77,,Posted,374.39,2023-05-09,22.77,Withdrawal POS #000096296533/FAST TRACK #200 GAINESVILLE FLCard 2801,22.586666666666662
5/9/2023,,Withdrawal POS #000000065467/PUBLIX 3930 SW ARCHER ROAD GAINESVILLECard 2801,80.14,,Posted,397.16,2023-05-09,80.14,Withdrawal POS #000000753028/PUBLIX 3930 SW ARCHER ROAD GAINESVILLECard 1247,80.14
5/9/2023,,Withdrawal POS #000000781853/PUBLIX 3100 SW 35TH BLVD GAINESVILLE FLCard 2801,81.07,,Posted,477.3,2023-05-09,81.07,Withdrawal POS #000000058955/PUBLIX 3100 SW 35TH BLVD GAINESVILLE FLCard 2801,81.07
5/9/2023,,Recurring Withdrawal Debit Card Fee/MASTERCARD ISSUER CROSS-BORDER FEEDate 05/08/23 0 3128816170 0 5734Card 2801,0.14,,Posted,558.37,2023-05-09,0.14,Recurring Withdrawal Debit Card Fee/MASTERCARD ISSUER CROSS-BORDER FEEDate 04/20/23 0 3110864064 0 7333Card 2801,0.15111111111111108
5/9/2023,,Recurring Withdrawal Debit Card MC Debit/SUBPALS8888819070 BADEN ONDate 05/08/23 0 3128816170 0 5734Card 2801,17.0,,Posted,558.51,2023-05-09,17.0,Recurring Withdrawal Debit Card MC Debit/SUBPALS8888819070 BADEN ONDate 05/15/23 0 3135870887 0 5734Card 2801,17.0
5/9/2023,,Recurring Withdrawal Debit Card MC Debit/WEB*HOSTGATOR.COM BURLINGTON MADate 05/08/23 0 3128979219 0 4816Card 2801,12.95,,Posted,575.51,2023-05-09,12.95,Recurring Withdrawal Debit Card MC Debit/WEB*HOSTGATOR.COM BURLINGTON MADate 06/08/23 0 3159061206 1 4816Card 2801,12.95
5/9/2023,,Withdrawal ACH FLUENT-Gainesvil/TYPE: PAYMENT ID: 1371804719CO: FLUENT-GainesvilEntry Class Code: PPD,92.0,,Posted,588.46,2023-05-09,92.0,Withdrawal ACH FLUENT-Gainesvil/TYPE: PAYMENT ID: 1371804719CO: FLUENT-GainesvilEntry Class Code: PPD,91.505
5/8/2023,,Withdrawal POS #000000233071/AMAZON.COM*DU6086F03 SEATTLE WACard 2801,12.52,,Posted,680.46,2023-05-08,12.52,Withdrawal POS #000000736780/AMAZON.COM*U78AZ3Q63 SEATTLE WACard 2801,12.52
5/8/2023,,Withdrawal POS #000000230713/AMAZON.COM*6N8HF6DJ3 SEATTLE WACard 2801,12.52,,Posted,692.98,2023-05-08,12.52,Withdrawal POS #000000598647/AMAZON.COM*F565U8HW3 SEATTLE WACard 2801,12.52
5/8/2023,,Recurring Withdrawal Debit Card MC Debit/MIDJOURNEY INC. SOUTH SAN FR CADate 05/07/23 0 3127950086 0 5734Card 2801,30.0,,Posted,705.5,2023-05-08,30.0,Recurring Withdrawal Debit Card MC Debit/MIDJOURNEY INC. SOUTH SAN FR CADate 06/07/23 0 3158865788 0 5734Card 2801,30.0
5/7/2023,,Withdrawal POS #000000421007/AMAZON.COM*Q77YK4D53 SEATTLE WACard 2801,23.09,,Posted,735.5,2023-05-07,23.09,Withdrawal POS #000000259511/AMAZON.COM*2776K9KH0 SEATTLE WACard 2801,23.09
5/7/2023,,Recurring Withdrawal Debit Card MC Debit/QUILLBOT OAK BROOK ILDate 05/05/23 0 3125730860 0 5734Card 2801,19.95,,Posted,758.59,2023-05-07,19.95,Recurring Withdrawal Debit Card MC Debit/QUILLBOT OAK BROOK ILDate 05/05/23 0 3125730860 0 5734Card 2801,19.95
5/7/2023,,Recurring Withdrawal Debit Card MC Debit/PLAYERAUCTIONS 800-342-0768 DEDate 05/05/23 0 3125817713 1 5816Card 2801,60.6,,Posted,778.54,2023-05-07,60.6,Recurring Withdrawal Debit Card MC Debit/PLAYERAUCTIONS 800-342-0768 DEDate 06/04/23 0 3155992645 1 5816Card 2801,60.6
5/7/2023,,Recurring Withdrawal Debit Card MC Debit/APPLE.COM/BILL 866-712-7753 CADate 05/06/23 0 3126467249 2 5818Card 2801,17.82,,Posted,839.14,2023-05-07,17.82,Recurring Withdrawal Debit Card MC Debit/APPLE.COM/BILL 866-712-7753 CADate 06/18/23 0 3169087519 1 5818Card 2801,17.82
5/6/2023,,Withdrawal POS #000000011600/CIRCLE K # 26146 3525 GAINESVILLE FLCard 2801,23.55,,Posted,856.96,2023-05-06,23.55,Withdrawal POS #000000000558/CIRCLE K # 26146 3525 GAINESVILLE FLCard 2801,23.830000000000002
5/6/2023,,Withdrawal POS #000000746376/PUBLIX 3100 SW 35TH BLVD GAINESVILLE FLCard 2801,48.78,,Posted,880.51,2023-05-06,48.78,Withdrawal POS #000000058955/PUBLIX 3100 SW 35TH BLVD GAINESVILLE FLCard 2801,48.35
5/6/2023,,Recurring Withdrawal Bill Payment - #000000355261/NETFLIX COM LOS GATOS CACard 2801,11.0,,Posted,929.29,2023-05-06,11.0,Recurring Withdrawal Bill Payment - #000006911729/NETFLIX COM LOS GATOS CACard 2801,10.99
5/6/2023,,Withdrawal POS #000000000008/AMAZON.COM*YC20F1ZU3 SEATTLE WACard 2801,26.16,,Posted,940.29,2023-05-06,26.16,Withdrawal POS #000000000003/AMAZON.COM*1Z8447YO1 SEATTLE WACard 2801,26.16
5/6/2023,,Withdrawal POS #000000143034/AMAZON.COM*GM4422Z53 SEATTLE WACard 2801,20.64,,Posted,966.45,2023-05-06,20.64,Withdrawal POS #000000247445/AMAZON.COM*A42ZY7OC3 SEATTLE WACard 2801,20.64
5/5/2023,,Recurring Withdrawal Debit Card MC Debit/ADOBE *STOCK 4085366000 CADate 05/04/23 0 3124734629 0 5734Card 2801,29.99,,Posted,987.09,2023-05-05,29.99,Recurring Withdrawal Debit Card MC Debit/ADOBE *STOCK 4085366000 CADate 06/04/23 0 3155943134 0 5734Card 2801,29.99
5/5/2023,,Withdrawal POS #000000322211/AMAZON.COM*K83SN0S13 SEATTLE WACard 2801,20.4,,Posted,1017.08,2023-05-05,20.4,Withdrawal POS #000000259511/AMAZON.COM*2776K9KH0 SEATTLE WACard 2801,20.4
5/5/2023,,Withdrawal POS #000000000000/AMAZON PAYMENTS SEATTLE WACard 2801,21.82,,Posted,1037.48,2023-05-05,21.82,Withdrawal POS #000000000000/AMAZON PAYMENTS SEATTLE WACard 2801,21.82
5/4/2023,,Withdrawal Debit Card MC Debit/KRATOM-K 888-8912895 NVDate 05/03/23 0 3123046755 1 5499Card 2801,19.64,,Posted,1059.3,2023-05-04,19.64,Withdrawal Debit Card MC Debit/KRATOM-K 888-8912895 NVDate 05/03/23 0 3123046755 1 5499Card 2801,19.64
5/4/2023,,Withdrawal Debit Card MC Debit/KRATOM-K 888-8912895 NVDate 05/03/23 0 3123046754 1 5499Card 2801,24.88,,Posted,1078.94,2023-05-04,24.88,Withdrawal Debit Card MC Debit/KRATOM-K 888-8912895 NVDate 05/03/23 0 3123046755 1 5499Card 2801,24.88
5/4/2023,,Withdrawal Debit Card MC Debit/YVETTE GODET DMD PA GAINESVILLE FLDate 05/03/23 0 3123864926 0 8011Card 2801,133.8,,Posted,1103.82,2023-05-04,133.8,Withdrawal Debit Card MC Debit/YVETTE GODET DMD PA GAINESVILLE FLDate 05/03/23 0 3123864926 0 8011Card 2801,133.8
5/4/2023,,Recurring Withdrawal Debit Card MC Debit/WEB*HOSTGATOR.COM BURLINGTON MADate 05/03/23 0 3123045013 1 4816Card 2801,60.01,,Posted,1237.62,2023-05-04,60.01,Recurring Withdrawal Debit Card MC Debit/WEB*HOSTGATOR.COM BURLINGTON MADate 06/08/23 0 3159061206 1 4816Card 2801,60.01
5/4/2023,,Withdrawal Debit Card MC Debit/WALGREENS #5024 GAINESVILLE FLDate 05/03/23 0 3123067040 1 5912Card 2801,37.4,,Posted,1297.63,2023-05-04,37.4,Withdrawal Debit Card MC Debit/WALGREENS #5024 GAINESVILLE FLDate 06/23/23 0 3174465834 2 5912Card 2801,37.4
5/3/2023,,Withdrawal POS #000000000477/CIRCLE K # 06782 5237 GAINESVILLE FLCard 2801,41.52,,Posted,1201.03,2023-05-03,41.52,Withdrawal POS #000000000343/CIRCLE K # 06782 5237 GAINESVILLE FLCard 1247,41.52
5/3/2023,,Withdrawal Debit Card MC Debit/PIZZA HUT 27918 GAINESVILLE FLDate 05/01/23 0 3121896652 0 5812Card 2801,40.84,,Posted,1242.55,2023-05-03,40.84,Withdrawal Debit Card MC Debit/PIZZA HUT 27918 GAINESVILLE FLDate 05/20/23 0 3140936778 0 5812Card 2801,40.60666666666666
5/3/2023,,Recurring Withdrawal Debit Card MC Debit/PARAMOUNT+ SAN FRANCISC CADate 05/02/23 0 3122896566 0 4899Card 2801,13.81,,Posted,1283.39,2023-05-03,13.81,Recurring Withdrawal Debit Card MC Debit/PARAMOUNT+ SAN FRANCISC CADate 06/02/23 0 3153147659 1 4899Card 2801,13.81
5/3/2023,,Recurring Withdrawal Debit Card MC Debit/APPLE.COM/BILL 866-712-7753 CADate 05/03/23 0 3123073296 1 5818Card 2801,2.99,,Posted,1297.2,2023-05-03,2.99,Recurring Withdrawal Debit Card MC Debit/APPLE.COM/BILL 866-712-7753 CADate 06/18/23 0 3169087519 1 5818Card 2801,2.99
5/2/2023,,Recurring Withdrawal Debit Card MC Debit/WEB*HOSTGATOR.COM BURLINGTON MADate 05/01/23 0 3121102563 1 4816Card 2801,0.42,,Posted,1300.19,2023-05-02,0.42,Recurring Withdrawal Debit Card MC Debit/WEB*HOSTGATOR.COM BURLINGTON MADate 06/08/23 0 3159061206 1 4816Card 2801,0.42
5/2/2023,,Withdrawal Debit Card MC Debit/GRU/EZ-PAY WEB PYMT 352-334-3434 FLDate 05/01/23 0 3121373269 0 4900Card 2801,175.09,,Posted,1300.61,2023-05-02,175.09,Withdrawal Debit Card MC Debit/GRU/EZ-PAY WEB PYMT 352-334-3434 FLDate 11/01/21 0 1305577800 0 4900Card 2801,174.66
5/2/2023,,Withdrawal Debit Card MC Debit/COX GAINESVILLE COMM 800-234-3993 FLDate 05/01/23 0 3121932105 0 4899Card 2801,125.03,,Posted,1475.7,2023-05-02,125.03,Withdrawal Debit Card MC Debit/COX GAINESVILLE COMM 800-234-3993 FLDate 05/31/23 0 3151812468 0 4899Card 2801,125.03
5/2/2023,,Withdrawal ACH Watson Realty Co/TYPE: WEB PMTS ID: 9000321157CO: Watson Realty CoNAME: Steven chaplinskiEntry Class Code: WEB,995.0,,Posted,1600.73,2023-05-02,995.0,Withdrawal ACH Watson Realty Co/TYPE: WEB PMTS ID: 9000321157CO: Watson Realty CoEntry Class Code: WEB,995.0
5/2/2023,,Withdrawal ACH FLUENT-Gainesvil/TYPE: PAYMENT ID: 1371804719CO: FLUENT-GainesvilEntry Class Code: PPD,93.2,,Posted,2595.73,2023-05-02,93.2,Withdrawal ACH FLUENT-Gainesvil/TYPE: PAYMENT ID: 1371804719CO: FLUENT-GainesvilEntry Class Code: PPD,93.2
5/1/2023,,Withdrawal POS #000000853317/AMAZON.COM*HM8GC4P91 SEATTLE WACard 2801,74.08,,Posted,2688.93,2023-05-01,74.08,Withdrawal POS #000000853317/AMAZON.COM*HM8GC4P91 SEATTLE WACard 2801,74.08
4/30/2023,,Withdrawal Debit Card MC Debit/SAMSUNG ELECTRONICS RIDGEFIELD P NJDate 04/30/23 0 3120042497 1 5734Card 2801,15.99,,Posted,2763.01,2023-04-30,15.99,Withdrawal Debit Card MC Debit/SAMSUNG ELECTRONICS RIDGEFIELD P NJDate 04/30/23 0 3120042497 1 5734Card 2801,15.99
4/30/2023,,Recurring Withdrawal Debit Card MC Debit/APPLE.COM/BILL 866-712-7753 CADate 04/28/23 0 3118955995 1 5818Card 2801,2.99,,Posted,2779.0,2023-04-30,2.99,Recurring Withdrawal Debit Card MC Debit/APPLE.COM/BILL 866-712-7753 CADate 06/18/23 0 3169087519 1 5818Card 2801,2.99
4/30/2023,,Withdrawal POS #000000020527/CIRCLE K # 26146 3525 GAINESVILLE FLCard 2801,23.51,,Posted,2781.99,2023-04-30,23.51,Withdrawal POS #000000000558/CIRCLE K # 26146 3525 GAINESVILLE FLCard 2801,23.830000000000002
4/28/2023,,Withdrawal Debit Card MC Debit/PIZZA HUT 27918 GAINESVILLE FLDate 04/26/23 0 3116850573 0 5812Card 2801,40.98,,Posted,205.5,2023-04-28,40.98,Withdrawal Debit Card MC Debit/PIZZA HUT 27918 GAINESVILLE FLDate 05/20/23 0 3140936778 0 5812Card 2801,40.60666666666666
4/28/2023,,Withdrawal Debit Card MC Debit/PUBLIX #1312 GAINESVILLE FLDate 04/27/23 0 3117072013 1 5411Card 2801,71.15,,Posted,246.48,2023-04-28,71.15,Withdrawal Debit Card MC Debit/PUBLIX #680 GAINESVILLE FLDate 04/16/23 0 3106911969 0 5411Card 2801,71.15
4/28/2023,,Recurring Withdrawal Debit Card MC Debit/ADOBE *CREATIVE CLOUD 4085366000 CADate 04/27/23 0 3117844835 0 5734Card 2801,29.99,,Posted,317.63,2023-04-28,29.99,Recurring Withdrawal Debit Card MC Debit/ADOBE *CREATIVE CLOUD 4085366000 CADate 04/27/23 0 3117844835 0 5734Card 2801,29.99
4/27/2023,,Withdrawal POS #000000733873/PUBLIX 3930 SW ARCHER ROAD GAINESVILLECard 2801,22.36,,Posted,347.62,2023-04-27,22.36,Withdrawal POS #000000753028/PUBLIX 3930 SW ARCHER ROAD GAINESVILLECard 1247,22.665
4/27/2023,,Withdrawal POS #000000755101/WAWA 5325 2373 SW ARCHER ROADFLCard 2801,33.53,,Posted,69.98,2023-04-27,33.53,Withdrawal POS #000000553411/WAWA 5325 2373 SW ARCHER ROADFLCard 1247,33.900000000000006
4/27/2023,,Withdrawal POS #000058941600/WAWA 5325 2373 SW ARCHER ROADFLCard 2801,7.09,,Posted,103.51,2023-04-27,7.09,Withdrawal POS #000000553411/WAWA 5325 2373 SW ARCHER ROADFLCard 1247,7.5
4/27/2023,,"Recurring Withdrawal Debit Card MC Debit/MARMALEAD, LLC 4079065736 FLDate 04/26/23 0 3116865877 0 5045Card 2801",19.0,,Posted,110.6,2023-04-27,19.0,"Withdrawal Debit Card MC Debit/MARMALEAD, LLC 4079065736 FLDate 03/26/23 0 3085922801 0 5045Card 2801",19.0
4/26/2023,,Withdrawal POS #000000576572/AMAZON.COM*HF7S16U30 SEATTLE WACard 2801,60.03,,Posted,129.6,2023-04-26,60.03,Withdrawal POS #000000598647/AMAZON.COM*F565U8HW3 SEATTLE WACard 2801,60.03
4/26/2023,,Recurring Withdrawal Debit Card Fee/MASTERCARD ISSUER CROSS-BORDER FEEDate 04/26/23 0 3116321416 0 5734Card 2801,0.16,,Posted,89.63,2023-04-26,0.16,Recurring Withdrawal Debit Card Fee/MASTERCARD ISSUER CROSS-BORDER FEEDate 05/12/21 0 1132191600 1 7372Card 2801,0.09500000000000001
4/26/2023,,Recurring Withdrawal Debit Card MC Debit/VANCEAI CENTRAL HODate 04/26/23 0 3116321416 0 5734Card 2801,19.9,,Posted,89.79,2023-04-26,19.9,Recurring Withdrawal Debit Card MC Debit/VANCEAI CENTRAL HODate 04/26/23 0 3116321416 0 5734Card 2801,19.9
4/25/2023,,Recurring Withdrawal Debit Card Fee/MASTERCARD ISSUER CROSS-BORDER FEEDate 04/25/23 0 3115347529 0 5734Card 2801,0.08,,Posted,109.69,2023-04-25,0.08,Recurring Withdrawal Debit Card Fee/MASTERCARD ISSUER CROSS-BORDER FEEDate 04/20/23 0 3110864064 0 7333Card 2801,0.15111111111111108
4/25/2023,,Recurring Withdrawal Debit Card MC Debit/SP NIGHTCAFE AI ART MARRICKVILLE NSDate 04/25/23 0 3115347529 0 5734Card 2801,9.99,,Posted,109.77,2023-04-25,9.99,Withdrawal Debit Card MC Debit/SP NIGHTCAFE AI ART MARRICKVILLE NSDate 12/25/22 0 2359739765 0 5734Card 2801,9.99
4/24/2023,,Recurring Withdrawal Debit Card MC Debit/VIDIQ PRO SAN FRANCISC CADate 04/23/23 0 3113672486 0 5734Card 2801,10.0,,Posted,119.76,2023-04-24,10.0,Recurring Withdrawal Debit Card MC Debit/VIDIQ PRO SAN FRANCISC CADate 06/23/23 0 3174219633 1 5734Card 2801,10.0
4/24/2023,,Withdrawal POS #000000059732/AMAZON.COM*HF3681O32 SEATTLE WACard 2801,70.71,,Posted,129.76,2023-04-24,70.71,Withdrawal POS #000000598647/AMAZON.COM*F565U8HW3 SEATTLE WACard 2801,70.71
4/23/2023,,Withdrawal POS #000003101724/GOOGLE *Google Storage 1600 AmphitheatreParkw Mountain View CACard 2801,1.99,,Posted,200.47,2023-04-23,1.99,Withdrawal POS #000002040482/GOOGLE *Google Storage 1600 AmphitheatreParkw Mountain View CACard 2801,1.99
4/21/2023,,Recurring Withdrawal Debit Card Fee/MASTERCARD ISSUER CROSS-BORDER FEEDate 04/20/23 0 3110864064 0 7333Card 2801,0.1,,Posted,202.46,2023-04-21,0.1,Recurring Withdrawal Debit Card Fee/MASTERCARD ISSUER CROSS-BORDER FEEDate 04/20/23 0 3110864064 0 7333Card 2801,0.15111111111111108
4/21/2023,,Recurring Withdrawal Debit Card MC Debit/CANVA* 03761-18735695 SYDNEY AUDate 04/20/23 0 3110864064 0 7333Card 2801,12.99,,Posted,202.56,2023-04-21,12.99,Recurring Withdrawal Debit Card MC Debit/CANVA* 03761-18735695 SYDNEY AUDate 04/20/23 0 3110864064 0 7333Card 2801,12.99
4/21/2023,,Withdrawal POS #000000962967/AMAZON.COM*HF5T68O40 SEATTLE WACard 2801,20.4,,Posted,215.55,2023-04-21,20.4,Withdrawal POS #000000598647/AMAZON.COM*F565U8HW3 SEATTLE WACard 2801,20.89
4/20/2023,,Withdrawal POS #000000834697/SUNOCO 8002212501 4234 SW 20TH AVEGAINESVILLE FLCard 2801,32.87,,Posted,235.95,2023-04-20,32.87,Withdrawal POS #000000639499/SUNOCO 8002212501 4234 SW 20TH AVEGAINESVILLE FLCard 2801,32.87
4/20/2023,,Withdrawal Debit Card MC Debit/ETSY.COM - FUNKYFOXXST BROOKLYN NYDate 04/19/23 0 3109872544 0 5699Card 2801,3.21,,Posted,268.82,2023-04-20,3.21,Withdrawal Debit Card MC Debit/ETSY.COM - FUNKYFOXXST BROOKLYN NYDate 04/19/23 0 3109872544 0 5699Card 2801,3.21
4/20/2023,,Withdrawal POS #000003115333/GOOGLE *YouTubePremium 1600 AmphitheatreParkw Mountain View CACard 2801,13.64,,Posted,272.03,2023-04-20,13.64,Withdrawal POS #000003285955/GOOGLE *YouTubePremium 1600 AmphitheatreParkw Mountain View CACard 2801,13.629999999999999
4/19/2023,,Withdrawal Debit Card MC Debit/DRI*ID.MYCOMMERCE.COM MINNETONKA MNDate 04/18/23 0 3108341181 0 5732Card 2801,23.05,,Posted,85.67,2023-04-19,23.05,Withdrawal Debit Card MC Debit/DRI*ID.MYCOMMERCE.COM MINNETONKA MNDate 04/18/23 0 3108341181 0 5732Card 2801,23.05
4/19/2023,,Withdrawal POS #000000764726/SUNOCO 8002212501 4234 SW 20TH AVEGAINESVILLE FLCard 2801,36.52,,Posted,108.72,2023-04-19,36.52,Withdrawal POS #000000403720/SUNOCO 8002212501 4234 SW 20TH AVEGAINESVILLE FLCard 2801,36.52
4/18/2023,,Withdrawal ACH FLUENT-Gainesvil/TYPE: PAYMENT ID: 1371804719CO: FLUENT-GainesvilEntry Class Code: PPD,99.6,,Posted,145.24,2023-04-18,99.6,Withdrawal ACH FLUENT-Gainesvil/TYPE: PAYMENT ID: 1371804719CO: FLUENT-GainesvilEntry Class Code: PPD,99.6
4/17/2023,,Withdrawal Debit Card MC Debit/PUBLIX #680 GAINESVILLE FLDate 04/16/23 0 3106911969 0 5411Card 2801,62.63,,Posted,244.84,2023-04-17,62.63,Withdrawal Debit Card MC Debit/PUBLIX #680 GAINESVILLE FLDate 04/16/23 0 3106911969 0 5411Card 2801,62.63
4/16/2023,,Withdrawal POS #000000009656/CIRCLE K # 26146 3525 GAINESVILLE FLCard 2801,30.15,,Posted,307.47,2023-04-16,30.15,Withdrawal POS #000000000558/CIRCLE K # 26146 3525 GAINESVILLE FLCard 2801,30.225
4/16/2023,,Withdrawal Debit Card Fee/MASTERCARD ISSUER CROSS-BORDER FEEDate 04/14/23 0 3104333014 1 8299Card 2801,0.04,,Posted,137.62,2023-04-16,0.04,Withdrawal Debit Card Fee/MASTERCARD ISSUER CROSS-BORDER FEEDate 04/19/21 0 1109184122 1 7311Card 2801,0.1281818181818182
4/16/2023,,Withdrawal Debit Card MC Debit/WWW.W3SCHOOLS.COM SANDNES DUDate 04/14/23 0 3104333014 1 8299Card 2801,4.99,,Posted,137.66,2023-04-16,4.99,Recurring Withdrawal Debit Card MC Debit/WWW.W3SCHOOLS.COM SANDNES DUDate 05/14/23 0 3134938310 0 8299Card 2801,4.99
4/16/2023,,Recurring Withdrawal Debit Card MC Debit/WEB*HOSTGATOR.COM BURLINGTON MADate 04/14/23 0 3104457576 2 4816Card 2801,27.85,,Posted,142.65,2023-04-16,27.85,Recurring Withdrawal Debit Card MC Debit/WEB*HOSTGATOR.COM BURLINGTON MADate 06/08/23 0 3159061206 1 4816Card 2801,27.85
4/14/2023,,Withdrawal POS #000000188363/SUNOCO 8002212501 4234 SW 20TH AVEGAINESVILLE FLCard 2801,32.87,,Posted,170.5,2023-04-14,32.87,Withdrawal POS #000000866633/SUNOCO 8002212501 4234 SW 20TH AVEGAINESVILLE FLCard 2801,33.245
4/13/2023,,Recurring Withdrawal Debit Card MC Debit/CHATGPT SUBSCRIPTION SAN FRANCISC CADate 04/12/23 0 3102824632 0 5734Card 2801,20.0,,Posted,203.37,2023-04-13,20.0,Recurring Withdrawal Debit Card MC Debit/CHATGPT SUBSCRIPTION SAN FRANCISC CADate 05/12/23 0 3132943704 1 5734Card 2801,20.0
4/13/2023,,Recurring Withdrawal Debit Card Fee/MASTERCARD ISSUER CROSS-BORDER FEEDate 04/12/23 0 3102997706 0 5734Card 2801,0.07,,Posted,223.37,2023-04-13,0.07,Recurring Withdrawal Debit Card Fee/MASTERCARD ISSUER CROSS-BORDER FEEDate 04/20/23 0 3110864064 0 7333Card 2801,0.15111111111111108
4/13/2023,,Recurring Withdrawal Debit Card MC Debit/DRIVE EXPLORER ADDON MADURAI TNDate 04/12/23 0 3102997706 0 5734Card 2801,9.0,,Posted,223.44,2023-04-13,9.0,Recurring Withdrawal Debit Card MC Debit/DRIVE EXPLORER ADDON MADURAI TNDate 05/12/23 0 3132437615 1 5734Card 2801,9.0
4/10/2023,,Recurring Withdrawal Bill Payment - #000000016737/SIE PLAYST 2207 BRIDGEPOINTE PUS SANCACard 2801,17.99,,Posted,232.44,2023-04-10,17.99,Recurring Withdrawal Bill Payment - #000000016737/SIE PLAYST 2207 BRIDGEPOINTE PUS SANCACard 2801,17.99
4/10/2023,,Withdrawal ACH APPLECARD GSBANK/TYPE: PAYMENT ID: 9999999999CO: APPLECARD GSBANKNAME: Steven ChaplinskiEntry Class Code: WEB,93.0,,Posted,250.43,2023-04-10,93.0,Withdrawal ACH APPLECARD GSBANK/TYPE: PAYMENT ID: 9999999999CO: APPLECARD GSBANKNAME: Steven ChaplinskiEntry Class Code: WEB,93.0
4/10/2023,,Withdrawal POS #000000000001/AMAZON.COM*HJ0RS1CJ1 SEATTLE WACard 2801,12.26,,Posted,343.43,2023-04-10,12.26,Withdrawal POS #000000000003/AMAZON.COM*1Z8447YO1 SEATTLE WACard 2801,12.719999999999999
4/9/2023,,Recurring Withdrawal Debit Card MC Debit/MIDJOURNEY INC. SOUTH SAN FR CADate 04/07/23 0 3097803585 1 5734Card 2801,30.0,,Posted,355.69,2023-04-09,30.0,Recurring Withdrawal Debit Card MC Debit/MIDJOURNEY INC. SOUTH SAN FR CADate 06/07/23 0 3158865788 0 5734Card 2801,30.0
4/9/2023,,Withdrawal Debit Card MC Debit/CANNAMD 855-4209170 FLDate 04/07/23 0 3097109858 2 8011Card 2801,195.0,,Posted,385.69,2023-04-09,195.0,Withdrawal Debit Card MC Debit/CANNAMD 855-4209170 FLDate 04/07/23 0 3097109858 2 8011Card 2801,195.0
4/9/2023,,Withdrawal Debit Card MC Debit/PUBLIX #680 GAINESVILLE FLDate 04/07/23 0 3097298491 2 5411Card 2801,27.94,,Posted,580.69,2023-04-09,27.94,Withdrawal Debit Card MC Debit/PUBLIX #795 GAINESVILLE FLDate 03/07/22 0 2066965570 0 5411Card 2801,27.94
4/9/2023,,Withdrawal Debit Card MC Debit/PUBLIX #1784 GAINESVILLE FLDate 04/07/23 0 3097298395 2 5411Card 2801,74.12,,Posted,608.63,2023-04-09,74.12,Withdrawal Debit Card MC Debit/PUBLIX #680 GAINESVILLE FLDate 04/16/23 0 3106911969 0 5411Card 2801,74.12
4/9/2023,,Withdrawal Debit Card MC Debit/PUBLIX #1312 GAINESVILLE FLDate 04/07/23 0 3097298259 2 5411Card 2801,31.68,,Posted,682.75,2023-04-09,31.68,Withdrawal Debit Card MC Debit/PUBLIX #680 GAINESVILLE FLDate 04/16/23 0 3106911969 0 5411Card 2801,31.68
4/9/2023,,Withdrawal Debit Card MC Debit/ARCHER ANIMAL HOSPITAL ARCHER FLDate 04/07/23 0 3097620252 0 0742Card 2801,522.39,,Posted,714.43,2023-04-09,522.39,Withdrawal Debit Card MC Debit/ARCHER ANIMAL HOSPITAL ARCHER FLDate 05/10/23 0 3130327214 0 0742Card 2801,522.39
4/9/2023,,Recurring Withdrawal Debit Card MC Debit/APPLE.COM/BILL 866-712-7753 CADate 04/08/23 0 3098865383 0 5818Card 2801,2.99,,Posted,1236.82,2023-04-09,2.99,Recurring Withdrawal Debit Card MC Debit/APPLE.COM/BILL 866-712-7753 CADate 06/18/23 0 3169087519 1 5818Card 2801,2.99
4/9/2023,,Recurring Withdrawal Debit Card MC Debit/APPLE.COM/BILL 866-712-7753 CADate 04/08/23 0 3098865381 0 5818Card 2801,2.99,,Posted,1239.81,2023-04-09,2.99,Recurring Withdrawal Debit Card MC Debit/APPLE.COM/BILL 866-712-7753 CADate 06/18/23 0 3169087519 1 5818Card 2801,2.99
4/9/2023,,Recurring Withdrawal Debit Card MC Debit/APPLE.COM/BILL 866-712-7753 CADate 04/08/23 0 3098865380 0 5818Card 2801,2.99,,Posted,1242.8,2023-04-09,2.99,Recurring Withdrawal Debit Card MC Debit/APPLE.COM/BILL 866-712-7753 CADate 06/18/23 0 3169087519 1 5818Card 2801,2.99
4/9/2023,,Recurring Withdrawal Debit Card MC Debit/APPLE.COM/BILL 866-712-7753 CADate 04/08/23 0 3098865377 0 5818Card 2801,24.99,,Posted,1245.79,2023-04-09,24.99,Recurring Withdrawal Debit Card MC Debit/APPLE.COM/BILL 866-712-7753 CADate 06/18/23 0 3169087519 1 5818Card 2801,24.99
4/8/2023,,Withdrawal POS #000096294136/FAST TRACK #200 GAINESVILLE FLCard 2801,22.77,,Posted,1145.78,2023-04-08,22.77,Withdrawal POS #000096296533/FAST TRACK #200 GAINESVILLE FLCard 2801,22.586666666666662
4/7/2023,,Withdrawal Debit Card MC Debit/GUM.CO/CC* LASER EYE B SAN FRANCISC CADate 04/07/23 0 3097010256 1 5192Card 2801,10.0,,Posted,1168.55,2023-04-07,10.0,Withdrawal Debit Card MC Debit/GUM.CO/CC* LASER EYE B SAN FRANCISC CADate 04/07/23 0 3097010256 1 5192Card 2801,10.0
4/7/2023,,Withdrawal POS #000000726290/AMAZON.COM*HS7T42BW1 SEATTLE WACard 2801,20.4,,Posted,1178.55,2023-04-07,20.4,Withdrawal POS #000000991850/AMAZON.COM*7Q29B9KF3 SEATTLE WACard 2801,20.18
4/7/2023,,Withdrawal POS #000000485633/PLAYSTATIO 919 E HILLSDALE BLVUS FOSTERCITY CACard 2801,89.99,,Posted,1198.95,2023-04-07,89.99,Withdrawal POS #000000485633/PLAYSTATIO 919 E HILLSDALE BLVUS FOSTERCITY CACard 2801,89.99
4/6/2023,,Withdrawal POS #000000266687/SUNOCO 8002212501 4234 SW 20TH AVEGAINESVILLE FLCard 2801,32.87,,Posted,1288.94,2023-04-06,32.87,Withdrawal POS #000000866633/SUNOCO 8002212501 4234 SW 20TH AVEGAINESVILLE FLCard 2801,33.245
4/6/2023,,Recurring Withdrawal Debit Card MC Debit/QUILLBOT OAK BROOK ILDate 04/05/23 0 3095272019 0 5734Card 2801,19.95,,Posted,1321.81,2023-04-06,19.95,Recurring Withdrawal Debit Card MC Debit/QUILLBOT OAK BROOK ILDate 05/05/23 0 3125730860 0 5734Card 2801,19.95
4/6/2023,,Recurring Withdrawal Bill Payment - #000000850915/Netflix US 2A NETFLIX.COM LOS GATOS CACard 2801,11.0,,Posted,1341.76,2023-04-06,11.0,Recurring Withdrawal Bill Payment - #000000864701/Netflix.com NETFLIX.COM LOS GATOS CACard 1231,11.0
4/5/2023,,Withdrawal Debit Card MC Debit/PIZZA HUT 27918 3523739402 FLDate 04/03/23 0 3093832414 0 5812Card 2801,47.22,,Posted,1352.76,2023-04-05,47.22,Withdrawal Debit Card MC Debit/PIZZA HUT 27918 3523739402 FLDate 04/03/23 0 3093832414 0 5812Card 2801,47.22
4/5/2023,,Withdrawal Debit Card MC Debit/CIRCLE K # 06782 GAINESVILLE FLDate 04/03/23 0 3093021190 1 5499Card 2801,26.94,,Posted,1399.98,2023-04-05,26.94,Withdrawal Debit Card MC Debit/CIRCLE K # 06782 GAINESVILLE FLDate 05/26/23 0 3146939363 0 5499Card 2801,26.94
4/5/2023,,Recurring Withdrawal Debit Card MC Debit/ADOBE *STOCK 4085366000 CADate 04/04/23 0 3094826889 0 5734Card 2801,29.99,,Posted,1426.92,2023-04-05,29.99,Recurring Withdrawal Debit Card MC Debit/ADOBE *STOCK 4085366000 CADate 06/04/23 0 3155943134 0 5734Card 2801,29.99
4/5/2023,,Withdrawal ACH FLUENT-Gainesvil/TYPE: PAYMENT ID: 1371804719CO: FLUENT-GainesvilEntry Class Code: PPD,102.5,,Posted,1456.91,2023-04-05,102.5,Withdrawal ACH FLUENT-Gainesvil/TYPE: PAYMENT ID: 1371804719CO: FLUENT-GainesvilEntry Class Code: PPD,103.0
4/5/2023,,Withdrawal POS #000000378202/PLAYSTATION.COM US FOSTER CITY CACard 2801,24.99,,Posted,1559.41,2023-04-05,24.99,Withdrawal POS #000000362128/PLAYSTATION.COM US FOSTER CITY CACard 2801,24.99
4/4/2023,,Recurring Withdrawal Debit Card MC Debit/PLAYERAUCTIONS 800-342-0768 DEDate 04/04/23 0 3094023872 1 5816Card 2801,51.36,,Posted,1584.4,2023-04-04,51.36,Recurring Withdrawal Debit Card MC Debit/PLAYERAUCTIONS 800-342-0768 DEDate 06/04/23 0 3155992645 1 5816Card 2801,51.36
4/4/2023,,Recurring Withdrawal Debit Card MC Debit/PLAYERAUCTIONS 800-342-0768 DEDate 04/03/23 0 3093077614 1 5816Card 2801,48.87,,Posted,1635.76,2023-04-04,48.87,Recurring Withdrawal Debit Card MC Debit/PLAYERAUCTIONS 800-342-0768 DEDate 06/04/23 0 3155992645 1 5816Card 2801,48.87
4/4/2023,,Withdrawal Debit Card MC Debit/WALGREENS #5024 800-289-2273 FLDate 04/03/23 0 3093023575 1 5912Card 2801,27.97,,Posted,1684.63,2023-04-04,27.97,Withdrawal Debit Card MC Debit/WALGREENS #5024 800-289-2273 FLDate 04/03/23 0 3093023575 1 5912Card 2801,27.97
4/4/2023,,Withdrawal Debit Card MC Debit/GRU/EZ-PAY WEB PYMT 352-334-3434 FLDate 04/03/23 0 3093331542 0 4900Card 2801,170.66,,Posted,1712.6,2023-04-04,170.66,Withdrawal Debit Card MC Debit/GRU/EZ-PAY WEB PYMT 352-334-3434 FLDate 05/31/23 0 3151334916 0 4900Card 2801,170.66
4/4/2023,,Withdrawal ACH DISCOVER/TYPE: E-PAYMENT ID: 2510020270CO: DISCOVER NAME: CHAPLINSKI STEVENEntry Class Code: WEB,25.0,,Posted,1883.26,2023-04-04,25.0,Withdrawal ACH DISCOVER/TYPE: E-PAYMENT ID: 2510020270CO: DISCOVER NAME: CHAPLINSKI STEVENEntry Class Code: WEB,25.0
4/3/2023,,Withdrawal POS #000000281026/AMAZON.COM*HS0958FO1 SEATTLE WACard 2801,10.72,,Posted,1908.26,2023-04-03,10.72,Withdrawal POS #000000173052/AMAZON.COM*H21U27Y71 SEATTLE WACard 2801,10.536666666666667
4/3/2023,,Withdrawal POS #000000210513/AMAZON.COM*HS09S0PY0 SEATTLE WACard 2801,42.99,,Posted,1918.98,2023-04-03,42.99,Withdrawal POS #000000259511/AMAZON.COM*2776K9KH0 SEATTLE WACard 2801,42.99
4/3/2023,,Recurring Withdrawal Debit Card MC Debit/PARAMOUNT+ 8882745343 CADate 04/02/23 0 3092991731 0 4899Card 2801,13.81,,Posted,1561.97,2023-04-03,13.81,Recurring Withdrawal Debit Card MC Debit/PARAMOUNT+ 8882745343 CADate 04/02/23 0 3092991731 0 4899Card 2801,13.81
4/3/2023,,Withdrawal ACH Watson Realty Co/TYPE: WEB PMTS ID: 9000321157CO: Watson Realty CoNAME: Steven chaplinskiEntry Class Code: WEB,995.0,,Posted,1575.78,2023-04-03,995.0,Withdrawal ACH Watson Realty Co/TYPE: WEB PMTS ID: 9000321157CO: Watson Realty CoEntry Class Code: WEB,995.0
4/2/2023,,Withdrawal Debit Card MC Debit/COX GAINESVILLE COMM 800-234-3993 FLDate 04/02/23 0 3092722594 0 4899Card 2801,125.03,,Posted,2570.78,2023-04-02,125.03,Withdrawal Debit Card MC Debit/COX GAINESVILLE COMM 800-234-3993 FLDate 01/27/22 0 2027240681 1 4899Card 2801,124.995
4/2/2023,,Withdrawal Debit Card MC Debit/CIRCLE K # 06782 GAINESVILLE FLDate 03/30/23 0 3089415767 2 5499Card 2801,26.94,,Posted,2695.81,2023-04-02,26.94,Withdrawal Debit Card MC Debit/CIRCLE K # 06782 GAINESVILLE FLDate 05/26/23 0 3146939363 0 5499Card 2801,26.94
4/2/2023,,Recurring Withdrawal Debit Card MC Debit/CHEGG ORDER 8558681054 CADate 03/31/23 0 3090879254 1 5942Card 2801,15.95,,Posted,2722.75,2023-04-02,15.95,Recurring Withdrawal Debit Card MC Debit/CHEGG ORDER 8558681054 CADate 03/31/23 0 3090879254 1 5942Card 2801,15.95
4/2/2023,,Withdrawal POS #000000698438/AMAZON.COM*HY3F18532 SEATTLE WACard 2801,54.54,,Posted,2738.7,2023-04-02,54.54,Withdrawal POS #000000598647/AMAZON.COM*F565U8HW3 SEATTLE WACard 2801,54.54
3/31/2023,,Recurring Withdrawal Debit Card MC Debit/JASPER.AI ROLLINGWOOD TXDate 03/30/23 0 3089949341 0 7399Card 2801,59.0,,Posted,2793.24,2023-03-31,59.0,Recurring Withdrawal Debit Card MC Debit/JASPER.AI ROLLINGWOOD TXDate 03/30/23 0 3089949341 0 7399Card 2801,59.0
3/31/2023,,Withdrawal Debit Card MC Debit/WALGREENS #5024 800-289-2273 FLDate 03/30/23 0 3089029984 1 5912Card 2801,9.43,,Posted,2852.24,2023-03-31,9.43,Withdrawal Debit Card MC Debit/WALGREENS #5024 800-289-2273 FLDate 04/03/23 0 3093023575 1 5912Card 2801,9.43
3/31/2023,,Withdrawal POS #000000000005/AMAZON.COM*HY6Q875J1 SEATTLE WACard 2801,75.06,,Posted,2861.67,2023-03-31,75.06,Withdrawal POS #000000000003/AMAZON.COM*1Z8447YO1 SEATTLE WACard 2801,75.06
3/29/2023,,Withdrawal ACH FLUENT-Gainesvil/TYPE: PAYMENT ID: 1371804719CO: FLUENT-GainesvilEntry Class Code: PPD,61.2,,Posted,336.73,2023-03-29,61.2,Withdrawal ACH FLUENT-Gainesvil/TYPE: PAYMENT ID: 1371804719CO: FLUENT-GainesvilEntry Class Code: PPD,61.2
3/28/2023,,Withdrawal Debit Card MC Debit/WWW.CVS.COM 888-607-4287 RIDate 03/26/23 0 3085940730 0 5912Card 2801,9.85,,Posted,397.93,2023-03-28,9.85,Withdrawal Debit Card MC Debit/WWW.CVS.COM 888-607-4287 RIDate 03/26/23 0 3085940730 0 5912Card 2801,9.85
3/28/2023,,Recurring Withdrawal Debit Card MC Debit/ADOBE *CREATIVE CLOUD 4085366000 CADate 03/28/23 0 3087992284 0 5734Card 2801,29.99,,Posted,407.78,2023-03-28,29.99,Recurring Withdrawal Debit Card MC Debit/ADOBE *CREATIVE CLOUD 4085366000 CADate 04/27/23 0 3117844835 0 5734Card 2801,29.99
3/28/2023,,Withdrawal POS #000000015189/CIRCLE K # 26146 3525 GAINESVILLE FLCard 2801,27.05,,Posted,425.53,2023-03-28,27.05,Withdrawal POS #000000000558/CIRCLE K # 26146 3525 GAINESVILLE FLCard 2801,27.534999999999997
3/27/2023,,Withdrawal Debit Card Fee/MASTERCARD ISSUER CROSS-BORDER FEEDate 03/26/23 0 3085080672 1 7399Card 2801,0.23,,Posted,452.58,2023-03-27,0.23,Withdrawal Debit Card Fee/MASTERCARD ISSUER CROSS-BORDER FEEDate 10/06/23 0 3279122045 2 5815Card 2801,0.20833333333333334
3/27/2023,,Withdrawal Debit Card MC Debit/CREATIVE FABRICA AMSTERDAM NHDate 03/26/23 0 3085080672 1 7399Card 2801,29.0,,Posted,452.81,2023-03-27,29.0,Withdrawal Debit Card MC Debit/CREATIVE FABRICA AMSTERDAM NHDate 03/26/23 0 3085080672 1 7399Card 2801,29.0
3/27/2023,,Withdrawal Debit Card MC Debit/PUBLIX #1312 GAINESVILLE FLDate 03/26/23 0 3085901485 0 5411Card 2801,123.07,,Posted,481.81,2023-03-27,123.07,Withdrawal Debit Card MC Debit/PUBLIX #680 GAINESVILLE FLDate 04/16/23 0 3106911969 0 5411Card 2801,123.07
3/27/2023,,Withdrawal Debit Card MC Debit/SCRUBS CARWASH - GAINE GAINESVILLE FLDate 03/26/23 0 3085900969 0 7542Card 2801,4.0,,Posted,604.88,2023-03-27,4.0,Withdrawal Debit Card MC Debit/SCRUBS CARWASH - GAINE GAINESVILLE FLDate 03/26/23 0 3085900969 0 7542Card 2801,4.5
3/27/2023,,"Withdrawal Debit Card MC Debit/MARMALEAD, LLC 4079065736 FLDate 03/26/23 0 3085922801 0 5045Card 2801",19.0,,Posted,608.88,2023-03-27,19.0,"Withdrawal Debit Card MC Debit/MARMALEAD, LLC 4079065736 FLDate 03/26/23 0 3085922801 0 5045Card 2801",19.0
3/27/2023,,Withdrawal POS #000000744668/PUBLIX 3100 SW 35TH BLVD GAINESVILLE FLCard 2801,34.99,,Posted,478.38,2023-03-27,34.99,Withdrawal POS #000000058955/PUBLIX 3100 SW 35TH BLVD GAINESVILLE FLCard 2801,34.99
3/26/2023,,Withdrawal POS #000000340607/AMAZON.COM*HY48R1NK0 SEATTLE WACard 2801,20.08,,Posted,213.37,2023-03-26,20.08,Withdrawal POS #000000000873/AMAZON.COM*HI8SN2DS2 SEATTLE WACard 2801,20.2
3/26/2023,,Withdrawal POS #000000336133/AMAZON.COM*H70M05V42 SEATTLE WACard 2801,5.92,,Posted,233.45,2023-03-26,5.92,Withdrawal POS #000000853317/AMAZON.COM*HM8GC4P91 SEATTLE WACard 2801,5.92
3/26/2023,,Withdrawal POS #000000138395/AMAZON.COM*H712507Z1 SEATTLE WACard 2801,31.96,,Posted,239.37,2023-03-26,31.96,Withdrawal POS #000000991850/AMAZON.COM*7Q29B9KF3 SEATTLE WACard 2801,31.96
3/26/2023,,Withdrawal POS #000000135755/AMAZON.COM*H74ZC69O1 SEATTLE WACard 2801,24.44,,Posted,271.33,2023-03-26,24.44,Withdrawal POS #000000259511/AMAZON.COM*2776K9KH0 SEATTLE WACard 2801,24.44
3/26/2023,,Recurring Withdrawal Debit Card Fee/MASTERCARD ISSUER CROSS-BORDER FEEDate 03/25/23 0 3084851596 1 5734Card 2801,0.08,,Posted,295.77,2023-03-26,0.08,Recurring Withdrawal Debit Card Fee/MASTERCARD ISSUER CROSS-BORDER FEEDate 08/08/23 0 3220043177 1 7399Card 2801,0.156
3/26/2023,,Recurring Withdrawal Debit Card MC Debit/SP NIGHTCAFE AI ART MARRICKVILLE NSDate 03/25/23 0 3084851596 1 5734Card 2801,9.99,,Posted,295.85,2023-03-26,9.99,Recurring Withdrawal Debit Card MC Debit/SP NIGHTCAFE AI ART MARRICKVILLE NSDate 05/25/23 0 3145842155 0 5734Card 2801,9.99
3/26/2023,,Withdrawal Debit Card Fee/MASTERCARD ISSUER CROSS-BORDER FEEDate 03/26/23 0 3085241338 0 5734Card 2801,0.16,,Posted,305.84,2023-03-26,0.16,Withdrawal Debit Card Fee/MASTERCARD ISSUER CROSS-BORDER FEEDate 12/25/22 0 2359739765 0 5734Card 2801,0.16428571428571428
3/26/2023,,Withdrawal Debit Card MC Debit/VANCEAI CENTRAL HODate 03/26/23 0 3085241338 0 5734Card 2801,19.9,,Posted,306.0,2023-03-26,19.9,Recurring Withdrawal Debit Card MC Debit/VANCEAI CENTRAL HODate 04/26/23 0 3116321416 0 5734Card 2801,19.9
3/25/2023,,Withdrawal POS #000000000005/AMAZON.COM*HY2208FJ0 SEATTLE WACard 2801,38.69,,Posted,25.9,2023-03-25,38.69,Withdrawal POS #000000000873/AMAZON.COM*HI8SN2DS2 SEATTLE WACard 2801,38.69
3/25/2023,,Withdrawal POS #000000066272/SUNOCO 8002212501 4234 SW 20TH AVEGAINESVILLE FLCard 2801,32.87,,Posted,64.59,2023-03-25,32.87,Withdrawal POS #000000403720/SUNOCO 8002212501 4234 SW 20TH AVEGAINESVILLE FLCard 2801,32.87
3/25/2023,,Withdrawal Transfer fee,8.0,,Posted,97.46,2023-03-25,8.0,Withdrawal Transfer fee,8.0
3/24/2023,,Withdrawal Debit Card MC Debit/ERANK STOW OHDate 03/23/23 0 3082859656 0 7392Card 2801,5.99,,Posted,5.46,2023-03-24,5.99,Withdrawal Debit Card MC Debit/ERANK STOW OHDate 03/23/23 0 3082859656 0 7392Card 2801,5.99
3/24/2023,,Withdrawal Debit Card MC Debit/VIDIQ PRO SAN FRANCISC CADate 03/23/23 0 3082859575 0 5734Card 2801,10.0,,Posted,11.45,2023-03-24,10.0,Recurring Withdrawal Debit Card MC Debit/VIDIQ PRO SAN FRANCISC CADate 06/23/23 0 3174219633 1 5734Card 2801,10.0
3/24/2023,,Withdrawal ACH FLUENT-Gainesvil/TYPE: PAYMENT ID: 1371804719CO: FLUENT-GainesvilEntry Class Code: PPD,107.4,,Posted,21.45,2023-03-24,107.4,Withdrawal ACH FLUENT-Gainesvil/TYPE: PAYMENT ID: 1371804719CO: FLUENT-GainesvilEntry Class Code: PPD,107.4
3/24/2023,,Withdrawal POS #000000787829/AMAZON.COM*H72K264J2 SEATTLE WACard 2801,20.4,,Posted,128.85,2023-03-24,20.4,Withdrawal POS #000000736780/AMAZON.COM*U78AZ3Q63 SEATTLE WACard 2801,20.4
3/23/2023,,Recurring Withdrawal Debit Card Fee/MASTERCARD ISSUER CROSS-BORDER FEEDate 03/23/23 0 3082815708 0 7333Card 2801,0.1,,Posted,149.25,2023-03-23,0.1,Recurring Withdrawal Debit Card Fee/MASTERCARD ISSUER CROSS-BORDER FEEDate 04/20/23 0 3110864064 0 7333Card 2801,0.15111111111111108
3/23/2023,,Recurring Withdrawal Debit Card MC Debit/CANVA* 03730-17166918 SYDNEY AUDate 03/23/23 0 3082815708 0 7333Card 2801,12.99,,Posted,149.35,2023-03-23,12.99,Recurring Withdrawal Debit Card MC Debit/CANVA* 03730-17166918 SYDNEY AUDate 03/23/23 0 3082815708 0 7333Card 2801,12.99
3/23/2023,,Withdrawal POS #000003206129/GOOGLE *Google Storage 1600 AmphitheatreParkw Mountain View CACard 2801,1.99,,Posted,162.34,2023-03-23,1.99,Withdrawal POS #000002040482/GOOGLE *Google Storage 1600 AmphitheatreParkw Mountain View CACard 2801,1.99
3/23/2023,,Withdrawal POS #000000112986/AMAZON.COM*H754906V0 SEATTLE WACard 2801,40.82,,Posted,164.33,2023-03-23,40.82,Withdrawal POS #000000598647/AMAZON.COM*F565U8HW3 SEATTLE WACard 2801,40.82
3/23/2023,,Withdrawal ATM Fee/EFT 6419 W Newberry Rd Gainesville FLCard 2801,2.0,,Posted,205.15,2023-03-23,2.0,"Withdrawal ATM Fee/EFT 6419 W Newberry Rd Gainesville FL

Card 1247",2.0
3/23/2023,,Withdrawal at ATM #000000530088/EFT 6419 W Newberry Rd Gainesville FLCard 2801,113.0,,Posted,207.15,2023-03-23,113.0,"Withdrawal at ATM #000000785755/EFT 6419 W Newberry Rd Gainesville FL

Card 1247",113.0
3/22/2023,,Withdrawal POS #000000000000/AMAZON.COM*HC0GX27P2 SEATTLE WACard 2801,22.03,,Posted,320.15,2023-03-22,22.03,Withdrawal POS #000000000873/AMAZON.COM*HI8SN2DS2 SEATTLE WACard 2801,22.03
3/22/2023,,Withdrawal Debit Card Fee/MASTERCARD ISSUER CROSS-BORDER FEEDate 03/21/23 0 3080316690 0 4816Card 2801,0.48,,Posted,342.18,2023-03-22,0.48,Withdrawal Debit Card Fee/MASTERCARD ISSUER CROSS-BORDER FEEDate 10/06/23 0 3279122045 2 5815Card 2801,0.20833333333333334
3/22/2023,,Withdrawal Debit Card MC Debit/IMF CITY 17 CANT HKDate 03/21/23 0 3080316690 0 4816Card 2801,59.9,,Posted,342.66,2023-03-22,59.9,Withdrawal Debit Card MC Debit/IMF CITY 17 CANT HKDate 03/21/23 0 3080316690 0 4816Card 2801,59.9
3/22/2023,,Withdrawal ACH DISCOVER/TYPE: E-PAYMENT ID: 2510020270CO: DISCOVER NAME: CHAPLINSKI STEVENEntry Class Code: WEB,101.0,,Posted,402.56,2023-03-22,101.0,Withdrawal ACH DISCOVER/TYPE: E-PAYMENT ID: 2510020270CO: DISCOVER NAME: CHAPLINSKI STEVENEntry Class Code: WEB,100.5
3/22/2023,,Withdrawal POS #000000922364/SUNOCO 8002212501 4234 SW 20TH AVEGAINESVILLE FLCard 2801,32.87,,Posted,503.56,2023-03-22,32.87,Withdrawal POS #000000219124/SUNOCO 8002212501 4234 SW 20TH AVEGAINESVILLE FLCard 2801,32.474999999999994
3/22/2023,,Withdrawal POS #000000345359/AMAZON.COM*HC5H01692 SEATTLE WACard 2801,24.46,,Posted,536.43,2023-03-22,24.46,Withdrawal POS #000000853317/AMAZON.COM*HM8GC4P91 SEATTLE WACard 2801,24.46
3/20/2023,,Recurring Withdrawal Debit Card MC Debit/PRINTFUL INC. 86293473 CHARLOTTE NCDate 03/19/23 0 3078904027 0 5691Card 2801,6.19,,Posted,310.89,2023-03-20,6.19,Recurring Withdrawal Debit Card MC Debit/PRINTFUL INC. 86293473 CHARLOTTE NCDate 03/19/23 0 3078904027 0 5691Card 2801,6.19
3/20/2023,,Withdrawal ACH FLUENT-Gainesvil/TYPE: PAYMENT ID: 1371804719CO: FLUENT-GainesvilEntry Class Code: PPD,97.9,,Posted,317.08,2023-03-20,97.9,Withdrawal ACH FLUENT-Gainesvil/TYPE: PAYMENT ID: 1371804719CO: FLUENT-GainesvilEntry Class Code: PPD,97.9
3/20/2023,,Withdrawal POS #000003114546/GOOGLE *YouTubePremium 1600 AmphitheatreParkw Mountain View CACard 2801,13.64,,Posted,414.98,2023-03-20,13.64,Withdrawal POS #000003285955/GOOGLE *YouTubePremium 1600 AmphitheatreParkw Mountain View CACard 2801,13.629999999999999
3/19/2023,,Withdrawal POS #000000400824/AMAZON.COM*HC3O110O2 SEATTLE WACard 2801,25.8,,Posted,428.62,2023-03-19,25.8,Withdrawal POS #000000019465/AMAZON.COM*1U6B04IO0 SEATTLE WACard 2801,25.8
3/19/2023,,Recurring Withdrawal Debit Card MC Debit/ENVATO 61383766284 UTDate 03/19/23 0 3078360759 1 5815Card 2801,23.0,,Posted,454.42,2023-03-19,23.0,Recurring Withdrawal Debit Card MC Debit/ENVATO 61383766284 UTDate 03/19/23 0 3078360759 1 5815Card 2801,23.0
3/19/2023,,Withdrawal POS #000096294034/FAST TRACK #200 GAINESVILLE FLCard 2801,30.3,,Posted,477.42,2023-03-19,30.3,Withdrawal POS #000096296533/FAST TRACK #200 GAINESVILLE FLCard 2801,30.29
3/16/2023,,Withdrawal POS #000000006320/CIRCLE K # 26146 3525 GAINESVILLE FLCard 2801,16.77,,Posted,507.72,2023-03-16,16.77,Withdrawal POS #000000000558/CIRCLE K # 26146 3525 GAINESVILLE FLCard 2801,17.02
3/13/2023,,Recurring Withdrawal Debit Card MC Debit/SALESAMURAI.IO BOULDER CODate 03/12/23 0 3071028002 1 5734Card 2801,7.99,,Posted,524.49,2023-03-13,7.99,Recurring Withdrawal Debit Card MC Debit/SALESAMURAI.IO BOULDER CODate 03/12/23 0 3071028002 1 5734Card 2801,7.99
3/13/2023,,Recurring Withdrawal Debit Card MC Debit/CHATGPT SUBSCRIPTION SAN FRANCISC CADate 03/12/23 0 3071998456 0 5734Card 2801,20.0,,Posted,532.48,2023-03-13,20.0,Recurring Withdrawal Debit Card MC Debit/CHATGPT SUBSCRIPTION SAN FRANCISC CADate 05/12/23 0 3132943704 1 5734Card 2801,20.0
3/13/2023,,Recurring Withdrawal Debit Card Fee/MASTERCARD ISSUER CROSS-BORDER FEEDate 03/12/23 0 3071027471 1 5734Card 2801,0.07,,Posted,552.48,2023-03-13,0.07,Recurring Withdrawal Debit Card Fee/MASTERCARD ISSUER CROSS-BORDER FEEDate 05/12/21 0 1132191600 1 7372Card 2801,0.09500000000000001
3/13/2023,,Recurring Withdrawal Debit Card MC Debit/DRIVE EXPLORER ADDON MADURAI TNDate 03/12/23 0 3071027471 1 5734Card 2801,9.0,,Posted,552.55,2023-03-13,9.0,Recurring Withdrawal Debit Card MC Debit/DRIVE EXPLORER ADDON MADURAI TNDate 05/12/23 0 3132437615 1 5734Card 2801,9.0
3/12/2023,,Withdrawal POS #000000545175/SUNOCO 8002212501 4234 SW 20TH AVEGAINESVILLE FLCard 2801,32.87,,Posted,561.55,2023-03-12,32.87,Withdrawal POS #000000955321/SUNOCO 8002212501 4234 SW 20TH AVEGAINESVILLE FLCard 2801,32.87
3/12/2023,,Withdrawal POS #000000058553/AMAZON.COM*HG75N7YD0 SEATTLE WACard 2801,10.2,,Posted,594.42,2023-03-12,10.2,Withdrawal POS #000000259511/AMAZON.COM*2776K9KH0 SEATTLE WACard 2801,10.026666666666667
3/10/2023,,Withdrawal POS #000000763024/SUNOCO 8002212501 4234 SW 20TH AVEGAINESVILLE FLCard 2801,32.87,,Posted,604.62,2023-03-10,32.87,Withdrawal POS #000000639499/SUNOCO 8002212501 4234 SW 20TH AVEGAINESVILLE FLCard 2801,32.87
3/10/2023,,Recurring Withdrawal Bill Payment - #000000462424/SIE PLAYST 2207 BRIDGEPOINTE PUS SANCACard 2801,17.99,,Posted,637.49,2023-03-10,17.99,Recurring Withdrawal Bill Payment - #000000016737/SIE PLAYST 2207 BRIDGEPOINTE PUS SANCACard 2801,17.99
3/10/2023,,Withdrawal ACH PAYPAL/TYPE: INST XFER ID: PAYPALSI77CO: PAYPAL NAME: STEVEN CHAPLINSKIEntry Class Code: WEB,42.76,,Posted,655.48,2023-03-10,42.76,Withdrawal ACH PAYPAL/TYPE: INST XFER ID: PAYPALSI77CO: PAYPAL NAME: STEVEN CHAPLINSKIEntry Class Code: WEB,42.76
3/10/2023,,Withdrawal POS #000000000005/AMAZON.COM*H50716IP2 SEATTLE WACard 2801,73.36,,Posted,698.24,2023-03-10,73.36,Withdrawal POS #000000000003/AMAZON.COM*1Z8447YO1 SEATTLE WACard 2801,73.36
3/8/2023,,Withdrawal POS #000096291252/FAST TRACK #200 GAINESVILLE FLCard 2801,30.28,,Posted,771.6,2023-03-08,30.28,Withdrawal POS #000096296533/FAST TRACK #200 GAINESVILLE FLCard 2801,30.29
3/8/2023,,Withdrawal POS #000000381131/AMAZON.COM*H52KJ2612 SEATTLE WACard 2801,12.52,,Posted,801.88,2023-03-08,12.52,Withdrawal POS #000000173052/AMAZON.COM*H21U27Y71 SEATTLE WACard 2801,12.52
3/8/2023,,Recurring Withdrawal Debit Card MC Debit/TUBEBUDDYCOM* 8668823239 CADate 03/07/23 0 3066855966 0 5045Card 2801,86.4,,Posted,814.4,2023-03-08,86.4,Recurring Withdrawal Debit Card MC Debit/TUBEBUDDYCOM* 8668823239 CADate 03/07/23 0 3066855966 0 5045Card 2801,86.4
3/8/2023,,Withdrawal ACH FLUENT-Gainesvil/TYPE: PAYMENT ID: 1371804719CO: FLUENT-GainesvilEntry Class Code: PPD,156.0,,Posted,900.8,2023-03-08,156.0,Withdrawal ACH FLUENT-Gainesvil/TYPE: PAYMENT ID: 1371804719CO: FLUENT-GainesvilEntry Class Code: PPD,156.0
3/8/2023,,Withdrawal POS #000000038748/PLAYSTATIO 919 E HILLSDALE BLVUS FOSTERCITY CACard 2801,139.99,,Posted,1056.8,2023-03-08,139.99,Withdrawal POS #000000485633/PLAYSTATIO 919 E HILLSDALE BLVUS FOSTERCITY CACard 2801,139.99
3/7/2023,,Recurring Withdrawal Debit Card MC Debit/MIDJOURNEY INC. SOUTH SAN FR CADate 03/07/23 0 3066020945 1 5734Card 2801,30.0,,Posted,1196.79,2023-03-07,30.0,Recurring Withdrawal Debit Card MC Debit/MIDJOURNEY INC. SOUTH SAN FR CADate 06/07/23 0 3158865788 0 5734Card 2801,30.0
3/7/2023,,Recurring Withdrawal Debit Card MC Debit/PARAMOUNT+ 8882745343 CADate 03/06/23 0 3065832383 0 4899Card 2801,2.03,,Posted,1226.79,2023-03-07,2.03,Recurring Withdrawal Debit Card MC Debit/PARAMOUNT+ 8882745343 CADate 04/02/23 0 3092991731 0 4899Card 2801,2.03
3/7/2023,,Withdrawal Debit Card MC Debit/PARAMOUNT+ 8882745343 CADate 03/06/23 0 3065832382 0 4899Card 2801,11.5,,Posted,1228.82,2023-03-07,11.5,Recurring Withdrawal Debit Card MC Debit/PARAMOUNT+ 8882745343 CADate 04/02/23 0 3092991731 0 4899Card 2801,11.5
3/7/2023,,Withdrawal Debit Card Fee/MASTERCARD ISSUER CROSS-BORDER FEEDate 03/06/23 0 3065061180 1 5734Card 2801,0.32,,Posted,1240.32,2023-03-07,0.32,Withdrawal Debit Card Fee/MASTERCARD ISSUER CROSS-BORDER FEEDate 04/19/21 0 1109184122 1 7311Card 2801,0.1281818181818182
3/7/2023,,Withdrawal Debit Card MC Debit/EQMAC - BITGAPP LTD. LONDON LNDate 03/06/23 0 3065061180 1 5734Card 2801,40.0,,Posted,1240.64,2023-03-07,40.0,Withdrawal Debit Card MC Debit/EQMAC - BITGAPP LTD. LONDON LNDate 03/06/23 0 3065061180 1 5734Card 2801,40.0
3/7/2023,,Withdrawal Debit Card MC Debit/GRU/EZ-PAY WEB PYMT 352-334-3434 FLDate 03/06/23 0 3065368008 0 4900Card 2801,160.16,,Posted,1280.64,2023-03-07,160.16,Withdrawal Debit Card MC Debit/GRU/EZ-PAY WEB PYMT 352-334-3434 FLDate 11/01/21 0 1305577800 0 4900Card 2801,160.16
3/6/2023,,Withdrawal POS #000000006070/KOHLS 1242 3501 SW ARCHER RD GAINESVILLEFLCard 2801,13.96,,Posted,1394.6,2023-03-06,13.96,Withdrawal POS #000000006070/KOHLS 1242 3501 SW ARCHER RD GAINESVILLEFLCard 2801,13.96
3/6/2023,,Withdrawal POS #000000006841/CIRCLE K # 26146 3525 GAINESVILLE FLCard 2801,43.4,,Posted,1408.56,2023-03-06,43.4,Withdrawal POS #000000000558/CIRCLE K # 26146 3525 GAINESVILLE FLCard 2801,43.4
3/6/2023,,Withdrawal POS #000000766574/PUBLIX 3100 SW 35TH BLVD GAINESVILLE FLCard 2801,36.47,,Posted,1451.96,2023-03-06,36.47,Withdrawal POS #000000058955/PUBLIX 3100 SW 35TH BLVD GAINESVILLE FLCard 2801,36.47
3/6/2023,,Recurring Withdrawal Debit Card MC Debit/SESAME CARE - HEALTH MIAMI FLDate 03/05/23 0 3064037865 1 8099Card 2801,38.0,,Posted,1488.43,2023-03-06,38.0,Recurring Withdrawal Debit Card MC Debit/SESAME CARE - HEALTH MIAMI FLDate 03/05/23 0 3064037865 1 8099Card 2801,38.0
3/6/2023,,Withdrawal Debit Card MC Debit/QUILLBOT OAK BROOK ILDate 03/05/23 0 3064036552 1 5734Card 2801,19.95,,Posted,1526.43,2023-03-06,19.95,Recurring Withdrawal Debit Card MC Debit/QUILLBOT OAK BROOK ILDate 05/05/23 0 3125730860 0 5734Card 2801,19.95
3/6/2023,,Withdrawal Debit Card MC Debit/WALGREENS #5024 800-289-2273 FLDate 03/05/23 0 3064951835 0 5912Card 2801,15.0,,Posted,1546.38,2023-03-06,15.0,Withdrawal Debit Card MC Debit/WALGREENS #5024 800-289-2273 FLDate 04/03/23 0 3093023575 1 5912Card 2801,15.0
3/6/2023,,Withdrawal Debit Card MC Debit/COX GAINESVILLE COMM 800-234-3993 FLDate 03/05/23 0 3064030192 1 4899Card 2801,125.03,,Posted,1561.38,2023-03-06,125.03,Withdrawal Debit Card MC Debit/COX GAINESVILLE COMM 800-234-3993 FLDate 01/27/22 0 2027240681 1 4899Card 2801,124.995
3/6/2023,,Recurring Withdrawal Bill Payment - #000000250157/NETFLIX COM LOS GATOS CACard 2801,11.0,,Posted,1686.41,2023-03-06,11.0,Recurring Withdrawal Bill Payment - #000006911729/NETFLIX COM LOS GATOS CACard 2801,10.99
3/5/2023,,Withdrawal Debit Card MC Debit/PIZZA HUT 27918 3523739402 FLDate 03/03/23 0 3062954486 0 5812Card 2801,47.22,,Posted,1697.41,2023-03-05,47.22,Withdrawal Debit Card MC Debit/PIZZA HUT 27918 3523739402 FLDate 04/03/23 0 3093832414 0 5812Card 2801,47.22
3/5/2023,,Withdrawal Debit Card MC Debit/WALGREENS #5024 800-289-2273 FLDate 03/04/23 0 3063095080 1 5912Card 2801,26.55,,Posted,1744.63,2023-03-05,26.55,Withdrawal Debit Card MC Debit/WALGREENS #5024 800-289-2273 FLDate 04/03/23 0 3093023575 1 5912Card 2801,26.55
3/5/2023,,Recurring Withdrawal Debit Card MC Debit/ADOBE *STOCK 4085366000 CADate 03/04/23 0 3063953820 0 5734Card 2801,29.99,,Posted,1771.18,2023-03-05,29.99,Recurring Withdrawal Debit Card MC Debit/ADOBE *STOCK 4085366000 CADate 06/04/23 0 3155943134 0 5734Card 2801,29.99
3/4/2023,,Withdrawal POS #000000047929/PUBLIX 3100 SW 35TH BLVD GAINESVILLE FLCard 2801,47.92,,Posted,1801.17,2023-03-04,47.92,Withdrawal POS #000000058955/PUBLIX 3100 SW 35TH BLVD GAINESVILLE FLCard 2801,48.35
3/4/2023,,Withdrawal POS #000012000556/WALGREENS 2415 SW 75TH GAINESVILLE FLCard 2801,8.68,,Posted,1849.09,2023-03-04,8.68,Withdrawal POS #000014264526/WALGREENS 2415 SW GAINESVILLE FLCard 2801,8.620000000000001
3/2/2023,,Recurring Withdrawal Debit Card MC Debit/GOOGLE ADS7127436844 MOUNTAIN VIE CADate 03/01/23 0 3060855857 0 7311Card 2801,3.38,,Posted,1857.77,2023-03-02,3.38,Recurring Withdrawal Debit Card MC Debit/GOOGLE ADS7127436844 MOUNTAIN VIE CADate 03/01/23 0 3060855857 0 7311Card 2801,3.38
3/2/2023,,Withdrawal ACH Watson Realty Co/TYPE: WEB PMTS ID: 9000321157CO: Watson Realty CoNAME: Steven chaplinskiEntry Class Code: WEB,995.0,,Posted,1861.15,2023-03-02,995.0,Withdrawal ACH Watson Realty Co/TYPE: WEB PMTS ID: 9000321157CO: Watson Realty CoEntry Class Code: WEB,995.0
3/2/2023,,Withdrawal POS #000000675060/AMAZON.COM*H53JK91D0 SEATTLE WACard 2801,37.1,,Posted,2792.19,2023-03-02,37.1,Withdrawal POS #000000626675/AMAZON.COM*1F8259P12 SEATTLE WACard 2801,37.1
3/2/2023,,Withdrawal POS #000000675060/AMAZON.COM*H53JK91D0 SEATTLE WACard 2801,37.1,,Posted,2829.29,2023-03-02,37.1,Withdrawal POS #000000626675/AMAZON.COM*1F8259P12 SEATTLE WACard 2801,37.1
3/2/2023,,Withdrawal POS #000000000005/AMAZON.COM*H52J391X0 SEATTLE WACard 2801,26.86,,Posted,2866.39,2023-03-02,26.86,Withdrawal POS #000000400824/AMAZON.COM*HC3O110O2 SEATTLE WACard 2801,26.86
3/2/2023,,Withdrawal POS #000000000005/AMAZON.COM*H52J391X0 SEATTLE WACard 2801,26.86,,Posted,2893.25,2023-03-02,26.86,Withdrawal POS #000000400824/AMAZON.COM*HC3O110O2 SEATTLE WACard 2801,26.86
3/1/2023,,Withdrawal POS #000000320317/SUNOCO 8002212501 4234 SW 20TH AVEGAINESVILLE FLCard 2801,32.87,,Posted,2920.11,2023-03-01,32.87,Withdrawal POS #000000955321/SUNOCO 8002212501 4234 SW 20TH AVEGAINESVILLE FLCard 2801,32.87
3/1/2023,,Recurring Withdrawal Debit Card MC Debit/JASPER.AI ROLLINGWOOD TXDate 02/28/23 0 3059133816 1 7399Card 2801,59.0,,Posted,2952.98,2023-03-01,59.0,Recurring Withdrawal Debit Card MC Debit/JASPER.AI ROLLINGWOOD TXDate 03/30/23 0 3089949341 0 7399Card 2801,59.0
3/1/2023,,Recurring Withdrawal Debit Card MC Debit/CHEGG ORDER 8558681054 CADate 02/28/23 0 3059959357 0 5942Card 2801,15.95,,Posted,3011.98,2023-03-01,15.95,Recurring Withdrawal Debit Card MC Debit/CHEGG ORDER 8558681054 CADate 03/31/23 0 3090879254 1 5942Card 2801,15.95
3/1/2023,,Withdrawal POS #000000000009/AMAZON.COM*HD4IH3VM2 SEATTLE WACard 2801,10.2,,Posted,3027.93,2023-03-01,10.2,Withdrawal POS #000000000873/AMAZON.COM*HI8SN2DS2 SEATTLE WACard 2801,10.406666666666666
2/28/2023,,Recurring Withdrawal Debit Card MC Debit/ADOBE *CREATIVE CLOUD 4085366000 CADate 02/27/23 0 3058034263 1 5734Card 2801,19.99,,Posted,3038.13,2023-02-28,19.99,Recurring Withdrawal Debit Card MC Debit/ADOBE *CREATIVE CLOUD 4085366000 CADate 04/27/23 0 3117844835 0 5734Card 2801,19.99
2/26/2023,,Withdrawal POS #000000209567/SUNOCO 8002212501 4234 SW 20TH AVEGAINESVILLE FLCard 2801,30.71,,Posted,558.12,2023-02-26,30.71,Withdrawal POS #000000546857/SUNOCO 8002212501 4234 SW 20TH AVEGAINESVILLE FLCard 2801,30.71
2/26/2023,,Recurring Withdrawal Debit Card Fee/MASTERCARD ISSUER CROSS-BORDER FEEDate 02/25/23 0 3056274739 1 5734Card 2801,0.08,,Posted,588.83,2023-02-26,0.08,Recurring Withdrawal Debit Card Fee/MASTERCARD ISSUER CROSS-BORDER FEEDate 08/08/23 0 3220043177 1 7399Card 2801,0.156
2/26/2023,,Recurring Withdrawal Debit Card MC Debit/SP NIGHTCAFE AI ART MARRICKVILLE NSDate 02/25/23 0 3056274739 1 5734Card 2801,9.99,,Posted,588.91,2023-02-26,9.99,Recurring Withdrawal Debit Card MC Debit/SP NIGHTCAFE AI ART MARRICKVILLE NSDate 05/25/23 0 3145842155 0 5734Card 2801,9.99
2/26/2023,,Recurring Withdrawal Debit Card MC Debit/PLAYERAUCTIONS 800-342-0768 DEDate 02/25/23 0 3056809736 0 5816Card 2801,84.69,,Posted,598.9,2023-02-26,84.69,Recurring Withdrawal Debit Card MC Debit/PLAYERAUCTIONS 800-342-0768 DEDate 06/04/23 0 3155992645 1 5816Card 2801,84.69
2/22/2023,,Withdrawal Debit Card MC Debit/SCRUBS CARWASH - GAINE GAINESVILLE FLDate 02/21/23 0 3052004389 1 7542Card 2801,5.25,,Posted,183.59,2023-02-22,5.25,Withdrawal Debit Card MC Debit/SCRUBS CARWASH - GAINE GAINESVILLE FLDate 03/26/23 0 3085900969 0 7542Card 2801,5.25
2/22/2023,,Withdrawal POS #000096296743/FAST TRACK #200 GAINESVILLE FLCard 2801,22.77,,Posted,188.84,2023-02-22,22.77,Withdrawal POS #000096296533/FAST TRACK #200 GAINESVILLE FLCard 2801,22.586666666666662
2/22/2023,,Withdrawal POS #000000077624/PUBLIX 3930 SW ARCHER ROAD GAINESVILLECard 2801,152.94,,Posted,211.61,2023-02-22,152.94,Withdrawal POS #000000753028/PUBLIX 3930 SW ARCHER ROAD GAINESVILLECard 1247,152.94
2/21/2023,,Withdrawal ACH FLUENT-Gainesvil/TYPE: PAYMENT ID: 1371804719CO: FLUENT-GainesvilEntry Class Code: PPD,184.1,,Posted,364.55,2023-02-21,184.1,Withdrawal ACH FLUENT-Gainesvil/TYPE: PAYMENT ID: 1371804719CO: FLUENT-GainesvilEntry Class Code: PPD,184.1
2/21/2023,,Withdrawal ACH PAYPAL/TYPE: INST XFER ID: PAYPALSI77CO: PAYPAL NAME: STEVEN CHAPLINSKIEntry Class Code: WEB,149.5,,Posted,548.65,2023-02-21,149.5,Withdrawal ACH PAYPAL/TYPE: INST XFER ID: PAYPALSI77CO: PAYPAL NAME: STEVEN CHAPLINSKIEntry Class Code: WEB,149.61333333333334
2/20/2023,,Withdrawal POS #000000949163/AMAZON.COM*HP6O69Z32 SEATTLE WACard 2801,25.79,,Posted,698.15,2023-02-20,25.79,Withdrawal POS #000000991850/AMAZON.COM*7Q29B9KF3 SEATTLE WACard 2801,25.79
2/20/2023,,Withdrawal POS #000002021491/GOOGLE *YouTubePremium 1600 AmphitheatreParkw Mountain View CACard 2801,13.64,,Posted,723.94,2023-02-20,13.64,Withdrawal POS #000003285955/GOOGLE *YouTubePremium 1600 AmphitheatreParkw Mountain View CACard 2801,13.629999999999999
2/20/2023,,Withdrawal POS #000096292503/FAST TRACK #200 GAINESVILLE FLCard 2801,24.93,,Posted,737.58,2023-02-20,24.93,Withdrawal POS #000096296533/FAST TRACK #200 GAINESVILLE FLCard 2801,24.93
2/19/2023,,Recurring Withdrawal Debit Card MC Debit/ENVATO 61383766284 UTDate 02/19/23 0 3050084762 1 5815Card 2801,23.0,,Posted,762.51,2023-02-19,23.0,Recurring Withdrawal Debit Card MC Debit/ENVATO 61383766284 UTDate 03/19/23 0 3078360759 1 5815Card 2801,23.0
2/17/2023,,Withdrawal ACH PAYPAL/TYPE: INST XFER ID: PAYPALSI77CO: PAYPAL NAME: STEVEN CHAPLINSKIEntry Class Code: WEB,50.0,,Posted,785.51,2023-02-17,50.0,Withdrawal ACH PAYPAL/TYPE: INST XFER ID: PAYPALSI77CO: PAYPAL NAME: STEVEN CHAPLINSKIEntry Class Code: WEB,49.663333333333334
2/17/2023,,Withdrawal ACH PAYPAL/TYPE: INST XFER ID: PAYPALSI77CO: PAYPAL NAME: STEVEN CHAPLINSKIEntry Class Code: WEB,24.95,,Posted,835.51,2023-02-17,24.95,Withdrawal ACH PAYPAL/TYPE: INST XFER ID: PAYPALSI77CO: PAYPAL NAME: STEVEN CHAPLINSKIEntry Class Code: WEB,24.97
2/17/2023,,Withdrawal POS #000000204206/SUNOCO 8002212501 4234 SW 20TH AVEGAINESVILLE FLCard 2801,25.34,,Posted,860.46,2023-02-17,25.34,Withdrawal POS #000000403720/SUNOCO 8002212501 4234 SW 20TH AVEGAINESVILLE FLCard 2801,25.34
2/17/2023,,Withdrawal POS #000000053779/PUBLIX 3100 SW 35TH BLVD GAINESVILLE FLCard 2801,74.69,,Posted,885.8,2023-02-17,74.69,Withdrawal POS #000000036956/PUBLIX 5801 SW 75TH ST GAINESVILLE FLCard 2801,74.69
2/16/2023,,Withdrawal ACH PAYMENT FOR AMZ/TYPE: STORECARD ID: 9069872103CO: PAYMENT FOR AMZNAME: 6045781157416487Entry Class Code: WEB,55.0,,Posted,960.49,2023-02-16,55.0,Withdrawal ACH PAYMENT FOR AMZ/TYPE: STORECARD ID: 9069872103CO: PAYMENT FOR AMZNAME: 6045781157416487Entry Class Code: WEB,55.0
2/16/2023,,Withdrawal ACH PAYPAL/TYPE: INST XFER ID: PAYPALSI77CO: PAYPAL NAME: STEVEN CHAPLINSKIEntry Class Code: WEB,8.99,,Posted,1015.49,2023-02-16,8.99,Withdrawal ACH PAYPAL/TYPE: INST XFER ID: PAYPALSI77CO: PAYPAL NAME: STEVEN CHAPLINSKIEntry Class Code: WEB,9.015
2/16/2023,,Withdrawal POS #000000000007/AMAZON.COM*HE4KW8MP1 SEATTLE WACard 2801,81.33,,Posted,1024.48,2023-02-16,81.33,Withdrawal POS #000000000007/AMAZON.COM*2864R4HI1 SEATTLE WACard 1140,81.33
2/15/2023,,Recurring Withdrawal Debit Card MC Debit/PLAYERAUCTIONS 800-342-0768 DEDate 02/14/23 0 3045347652 0 5816Card 2801,38.56,,Posted,1105.81,2023-02-15,38.56,Recurring Withdrawal Debit Card MC Debit/PLAYERAUCTIONS 800-342-0768 DEDate 06/04/23 0 3155992645 1 5816Card 2801,38.56
2/15/2023,,Withdrawal POS #000000248548/AMAZON.COM*HP6YD2C00 SEATTLE WACard 2801,28.63,,Posted,1144.37,2023-02-15,28.63,Withdrawal POS #000000247445/AMAZON.COM*A42ZY7OC3 SEATTLE WACard 2801,28.63
2/15/2023,,Withdrawal POS #000000996169/SUNOCO 8002212501 4234 SW 20TH AVEGAINESVILLE FLCard 2801,25.34,,Posted,1173.0,2023-02-15,25.34,Withdrawal POS #000000899960/SUNOCO 8002212501 4234 SW 20TH AVEGAINESVILLE FLCard 2801,25.34
2/14/2023,,Withdrawal POS #000000000009/AMAZON.COM*HE1YT8T61 SEATTLE WACard 2801,10.2,,Posted,87.23,2023-02-14,10.2,Withdrawal POS #000000000007/AMAZON.COM*2864R4HI1 SEATTLE WACard 1140,10.17
2/13/2023,,Recurring Withdrawal Debit Card MC Debit/CHATGPT SUBSCRIPTION SAN FRANCISC CADate 02/12/23 0 3043740707 0 5734Card 2801,20.0,,Posted,97.43,2023-02-13,20.0,Recurring Withdrawal Debit Card MC Debit/CHATGPT SUBSCRIPTION SAN FRANCISC CADate 05/12/23 0 3132943704 1 5734Card 2801,20.0
2/13/2023,,Recurring Withdrawal Debit Card Fee/MASTERCARD ISSUER CROSS-BORDER FEEDate 02/12/23 0 3043066757 1 5734Card 2801,0.07,,Posted,117.43,2023-02-13,0.07,Recurring Withdrawal Debit Card Fee/MASTERCARD ISSUER CROSS-BORDER FEEDate 08/08/23 0 3220043177 1 7399Card 2801,0.156
2/13/2023,,Recurring Withdrawal Debit Card MC Debit/DRIVE EXPLORER ADDON MADURAI TNDate 02/12/23 0 3043066757 1 5734Card 2801,9.0,,Posted,117.5,2023-02-13,9.0,Recurring Withdrawal Debit Card MC Debit/DRIVE EXPLORER ADDON MADURAI TNDate 05/12/23 0 3132437615 1 5734Card 2801,9.0
2/13/2023,,Withdrawal ACH PAYPAL/TYPE: INST XFER ID: PAYPALSI77CO: PAYPAL NAME: STEVEN CHAPLINSKIEntry Class Code: WEB,17.99,,Posted,126.5,2023-02-13,17.99,Withdrawal ACH PAYPAL/TYPE: INST XFER ID: PAYPALSI77CO: PAYPAL NAME: STEVEN CHAPLINSKIEntry Class Code: WEB,17.3975
2/13/2023,,Withdrawal POS #000000135175/AMAZON.COM*HE18446F0 SEATTLE WACard 2801,58.92,,Posted,144.49,2023-02-13,58.92,Withdrawal POS #000000019465/AMAZON.COM*1U6B04IO0 SEATTLE WACard 2801,58.92
2/12/2023,,Withdrawal POS #000000910135/SUNOCO 8002212501 4234 SW 20TH AVEGAINESVILLE FLCard 2801,25.34,,Posted,203.41,2023-02-12,25.34,Withdrawal POS #000000177815/SUNOCO 8002212501 4234 SW 20TH AVEGAINESVILLE FLCard 2801,25.115000000000002
2/10/2023,,Withdrawal ACH ENVATO/CO: ENVATOTYPE: IAT PAYPAL ID: 770510487CEntry Class Code: IAT,39.0,,Posted,103.75,2023-02-10,39.0,Withdrawal ACH ENVATO/CO: ENVATOTYPE: IAT PAYPAL ID: 770510487CEntry Class Code: IAT,39.0
2/10/2023,,Withdrawal ACH FLUENT-Gainesvil/TYPE: PAYMENT ID: 1371804719CO: FLUENT-GainesvilEntry Class Code: PPD,84.4,,Posted,142.75,2023-02-10,84.4,Withdrawal ACH FLUENT-Gainesvil/TYPE: PAYMENT ID: 1371804719CO: FLUENT-GainesvilEntry Class Code: PPD,84.4
2/10/2023,,Withdrawal POS #000000513814/AMAZON.COM*6E9OG2F93 SEATTLE WACard 2801,10.72,,Posted,227.15,2023-02-10,10.72,Withdrawal POS #000000598647/AMAZON.COM*F565U8HW3 SEATTLE WACard 2801,10.37
2/10/2023,,Withdrawal POS #000000922564/AMAZON.COM*VJ71T1BJ3 SEATTLE WACard 2801,49.44,,Posted,237.87,2023-02-10,49.44,Withdrawal POS #000000991850/AMAZON.COM*7Q29B9KF3 SEATTLE WACard 2801,49.44
2/9/2023,,Withdrawal POS #000000036003/PUBLIX 3930 SW ARCHER ROAD GAINESVILLECard 2801,136.42,,Posted,287.31,2023-02-09,136.42,Withdrawal POS #000000753028/PUBLIX 3930 SW ARCHER ROAD GAINESVILLECard 1247,136.42
2/9/2023,,Withdrawal POS #000000069683/PUBLIX 5200 S W 34TH STREET GAINESVILLECard 2801,57.87,,Posted,423.73,2023-02-09,57.87,Withdrawal POS #000000069683/PUBLIX 5200 S W 34TH STREET GAINESVILLECard 2801,57.87
2/8/2023,,Withdrawal POS #000000011248/CIRCLE K # 23913 3424 GAINESVILLE FLCard 2801,20.25,,Posted,481.6,2023-02-08,20.25,Withdrawal POS #000000001638/CIRCLE K # 06527 9404 GAINESVILLE FLCard 2801,19.855
2/8/2023,,Withdrawal Debit Card MC Debit/MIDJOURNEY INC. SOUTH SAN FR CADate 02/07/23 0 3038831030 0 5734Card 2801,10.0,,Posted,501.85,2023-02-08,10.0,Recurring Withdrawal Debit Card MC Debit/MIDJOURNEY INC. SOUTH SAN FR CADate 06/07/23 0 3158865788 0 5734Card 2801,10.0
2/8/2023,,Withdrawal POS #000005221556/PAYPAL *VIDIQ 2211 North First StreetJose CACard 2801,10.0,,Posted,511.85,2023-02-08,10.0,Withdrawal POS #000005221556/PAYPAL *VIDIQ 2211 North First StreetJose CACard 2801,10.0
2/8/2023,,Withdrawal POS #000000000007/AMAZON.COM*6N0DO0XQ3 SEATTLE WACard 2801,322.49,,Posted,521.85,2023-02-08,322.49,Withdrawal POS #000000019465/AMAZON.COM*1U6B04IO0 SEATTLE WACard 2801,322.49
2/7/2023,,Withdrawal ACH BEST BUY/TYPE: PAYMENT ID: CITIGPUFDRCO: BEST BUYEntry Class Code: TEL,392.0,,Posted,844.34,2023-02-07,392.0,Withdrawal ACH BEST BUY/TYPE: PAYMENT ID: CITIGPUFDRCO: BEST BUYEntry Class Code: TEL,392.0
2/7/2023,,Withdrawal ACH BEST BUY/TYPE: PAYMENT ID: CITIGPUFDRCO: BEST BUYEntry Class Code: TEL,253.11,,Posted,1236.34,2023-02-07,253.11,Withdrawal ACH BEST BUY/TYPE: PAYMENT ID: CITIGPUFDRCO: BEST BUYEntry Class Code: TEL,253.11
2/7/2023,,Withdrawal POS #000000042691/FAST TRACK #200 3960 SW ARCHER RDGAINESVILLE FLCard 2801,25.45,,Posted,1489.45,2023-02-07,25.45,Withdrawal POS #000000418393/FAST TRACK #200 3960 SW ARCHER RDGAINESVILLE FLCard 2801,25.45
2/7/2023,,Withdrawal POS #000000052937/SUNOCO 8002212501 4234 SW 20TH AVEGAINESVILLE FLCard 2801,3.21,,Posted,1514.9,2023-02-07,3.21,Withdrawal POS #000000403720/SUNOCO 8002212501 4234 SW 20TH AVEGAINESVILLE FLCard 2801,3.21
2/6/2023,,Withdrawal POS #000000000000/AMAZON.COM*SB18C4QI3 SEATTLE WACard 2801,21.36,,Posted,1518.11,2023-02-06,21.36,Withdrawal POS #000000000007/AMAZON.COM*2864R4HI1 SEATTLE WACard 1140,20.713333333333335
2/6/2023,,Withdrawal POS #000000000000/AMAZON.COM*6D1U84VI3 SEATTLE WACard 2801,21.7,,Posted,1539.47,2023-02-06,21.7,Withdrawal POS #000000000007/AMAZON.COM*2864R4HI1 SEATTLE WACard 1140,21.7
2/6/2023,,Withdrawal ACH VERIFONE PAYMENT/CO: VERIFONE PAYMENTS B.V.TYPE: IAT PAYPAL ID: 770510487CEntry Class Code: IAT,139.95,,Posted,1561.17,2023-02-06,139.95,Withdrawal ACH VERIFONE PAYMENT/CO: VERIFONE PAYMENTS B.V.TYPE: IAT PAYPAL ID: 770510487CEntry Class Code: IAT,139.95
2/6/2023,,Withdrawal ACH PAYPAL/TYPE: INST XFER ID: PAYPALSI77CO: PAYPAL NAME: STEVEN CHAPLINSKIEntry Class Code: WEB,17.26,,Posted,1701.12,2023-02-06,17.26,Withdrawal ACH PAYPAL/TYPE: INST XFER ID: PAYPALSI77CO: PAYPAL NAME: STEVEN CHAPLINSKIEntry Class Code: WEB,17.3975
2/6/2023,,Withdrawal ACH PAYPAL/TYPE: INST XFER ID: PAYPALSI77CO: PAYPAL NAME: STEVEN CHAPLINSKIEntry Class Code: WEB,14.99,,Posted,1718.38,2023-02-06,14.99,Withdrawal ACH PAYPAL/TYPE: INST XFER ID: PAYPALSI77CO: PAYPAL NAME: STEVEN CHAPLINSKIEntry Class Code: WEB,14.948333333333332
2/6/2023,,Withdrawal ACH PAYPAL/TYPE: INST XFER ID: PAYPALSI77CO: PAYPAL NAME: STEVEN CHAPLINSKIEntry Class Code: WEB,5.69,,Posted,1733.37,2023-02-06,5.69,Withdrawal ACH PAYPAL/TYPE: INST XFER ID: PAYPALSI77CO: PAYPAL NAME: STEVEN CHAPLINSKIEntry Class Code: WEB,6.0875
2/6/2023,,Withdrawal ACH PAYPAL/TYPE: INST XFER ID: PAYPALSI77CO: PAYPAL NAME: STEVEN CHAPLINSKIEntry Class Code: WEB,2.99,,Posted,1739.06,2023-02-06,2.99,Withdrawal ACH PAYPAL/TYPE: INST XFER ID: PAYPALSI77CO: PAYPAL NAME: STEVEN CHAPLINSKIEntry Class Code: WEB,3.218
2/6/2023,,Recurring Withdrawal Bill Payment - #000000275192/NETFLIX COM LOS GATOS CACard 2801,11.0,,Posted,1742.05,2023-02-06,11.0,Recurring Withdrawal Bill Payment - #000006911729/NETFLIX COM LOS GATOS CACard 2801,10.99
2/5/2023,,Withdrawal Debit Card MC Debit/WALGREENS #5024 800-289-2273 FLDate 02/04/23 0 3035110401 1 5912Card 2801,85.45,,Posted,253.05,2023-02-05,85.45,Withdrawal Debit Card MC Debit/WALGREENS #5024 800-289-2273 FLDate 04/03/23 0 3093023575 1 5912Card 2801,85.45
2/5/2023,,Withdrawal Debit Card MC Debit/PRIME VIDEO *TD1QC2IU3 888-802-3080 WADate 02/04/23 0 3035915273 0 5818Card 2801,19.99,,Posted,338.5,2023-02-05,19.99,Withdrawal Debit Card MC Debit/PRIME VIDEO *TD1QC2IU3 888-802-3080 WADate 02/04/23 0 3035915273 0 5818Card 2801,19.99
2/5/2023,,Recurring Withdrawal Debit Card MC Debit/ADOBE *ADOBE 4085366000 CADate 02/05/23 0 3036107602 1 5734Card 2801,29.99,,Posted,358.49,2023-02-05,29.99,Recurring Withdrawal Debit Card MC Debit/ADOBE *STOCK 4085366000 CADate 06/04/23 0 3155943134 0 5734Card 2801,29.99
2/5/2023,,Withdrawal POS #000000972401/AMAZON.COM*FG8QU8T23 SEATTLE WACard 2801,27.06,,Posted,388.48,2023-02-05,27.06,Withdrawal POS #000000598647/AMAZON.COM*F565U8HW3 SEATTLE WACard 2801,27.06
2/5/2023,,Withdrawal POS #000000000000/AMAZON.COM*V40RU1143 SEATTLE WACard 2801,367.5,,Posted,415.54,2023-02-05,367.5,Withdrawal POS #000000000007/AMAZON.COM*2864R4HI1 SEATTLE WACard 1140,367.5
2/3/2023,,Withdrawal POS #000000001861/CIRCLE K # 26162 7302 GAINESVILLE FLCard 2801,20.25,,Posted,783.04,2023-02-03,20.25,Withdrawal POS #000000001638/CIRCLE K # 06527 9404 GAINESVILLE FLCard 2801,19.855
2/3/2023,,Withdrawal POS #000000000122/CIRCLE K # 26162 7302 GAINESVILLE FLCard 2801,20.18,,Posted,803.29,2023-02-03,20.18,Withdrawal POS #000000001638/CIRCLE K # 06527 9404 GAINESVILLE FLCard 2801,19.855
2/2/2023,,Withdrawal ACH PAYPAL/TYPE: INST XFER ID: PAYPALSI77CO: PAYPAL NAME: STEVEN CHAPLINSKIEntry Class Code: WEB,11.5,,Posted,823.47,2023-02-02,11.5,Withdrawal ACH PAYPAL/TYPE: INST XFER ID: PAYPALSI77CO: PAYPAL NAME: STEVEN CHAPLINSKIEntry Class Code: WEB,11.7425
2/1/2023,,Withdrawal POS #000000078298/PUBLIX 3315 W. UNIVERSITY AVE.FLCard 2801,65.13,,Posted,834.97,2023-02-01,65.13,Withdrawal POS #000000749495/PUBLIX 3315 W. UNIVERSITY AVE.FLCard 1231,65.13
2/1/2023,,Withdrawal Debit Card MC Debit/GRU/EZ-PAY WEB PYMT 352-334-3434 FLDate 01/31/23 0 3031924789 1 4900Card 2801,241.09,,Posted,900.1,2023-02-01,241.09,Withdrawal Debit Card MC Debit/GRU/EZ-PAY WEB PYMT 352-334-3434 FLDate 11/01/21 0 1305577800 0 4900Card 2801,241.09
2/1/2023,,Recurring Withdrawal Debit Card MC Debit/CHEGG ORDER 8558681054 CADate 01/31/23 0 3031924283 1 5942Card 2801,15.95,,Posted,1141.19,2023-02-01,15.95,Recurring Withdrawal Debit Card MC Debit/CHEGG ORDER 8558681054 CADate 03/31/23 0 3090879254 1 5942Card 2801,15.95
2/1/2023,,Withdrawal ACH CAPITAL ONE/TYPE: ONLINE PMT ID: 9279744391CO: CAPITAL ONE NAME: STEVEN CHAPLINSKIEntry Class Code: WEB,25.0,,Posted,1157.14,2023-02-01,25.0,Withdrawal ACH CAPITAL ONE/TYPE: ONLINE PMT ID: 9279744391CO: CAPITAL ONE NAME: STEVEN CHAPLINSKIEntry Class Code: WEB,25.5
2/1/2023,,Withdrawal ACH PAYPAL/TYPE: INST XFER ID: PAYPALSI77CO: PAYPAL NAME: STEVEN CHAPLINSKIEntry Class Code: WEB,149.99,,Posted,1182.14,2023-02-01,149.99,Withdrawal ACH PAYPAL/TYPE: INST XFER ID: PAYPALSI77CO: PAYPAL NAME: STEVEN CHAPLINSKIEntry Class Code: WEB,149.61333333333334
2/1/2023,,Withdrawal ACH PAYPAL/TYPE: INST XFER ID: PAYPALSI77CO: PAYPAL NAME: STEVEN CHAPLINSKIEntry Class Code: WEB,2.83,,Posted,1332.13,2023-02-01,2.83,Withdrawal ACH PAYPAL/TYPE: INST XFER ID: PAYPALSI77CO: PAYPAL NAME: STEVEN CHAPLINSKIEntry Class Code: WEB,2.3299999999999996
1/31/2023,,Withdrawal POS #000000853822/AMAZON.COM*WF14F7B53 SEATTLE WACard 2801,16.19,,Posted,1334.96,2023-01-31,16.19,Withdrawal POS #000000598647/AMAZON.COM*F565U8HW3 SEATTLE WACard 2801,16.546666666666667
1/31/2023,,Recurring Withdrawal Debit Card MC Debit/JASPER.AI ROLLINGWOOD TXDate 01/30/23 0 3030913449 0 7399Card 2801,59.0,,Posted,1351.15,2023-01-31,59.0,Recurring Withdrawal Debit Card MC Debit/JASPER.AI ROLLINGWOOD TXDate 03/30/23 0 3089949341 0 7399Card 2801,59.0
1/31/2023,,Withdrawal Debit Card MC Debit/COX GAINESVILLE COMM 800-234-3993 FLDate 01/31/23 0 3031894286 0 4899Card 2801,125.03,,Posted,1410.15,2023-01-31,125.03,Withdrawal Debit Card MC Debit/COX GAINESVILLE COMM 800-234-3993 FLDate 01/27/22 0 2027240681 1 4899Card 2801,124.995
1/31/2023,,Withdrawal ACH PADDLE.COM MARKE/CO: PADDLE.COM MARKET LIMITEDTYPE: IAT PAYPAL ID: 770510487CEntry Class Code: IAT,2.99,,Posted,1535.18,2023-01-31,2.99,Withdrawal ACH PADDLE.COM MARKE/CO: PADDLE.COM MARKET LIMITEDTYPE: IAT PAYPAL ID: 770510487CEntry Class Code: IAT,2.99
1/31/2023,,Withdrawal ACH Watson Realty Co/TYPE: WEB PMTS ID: 9000321157CO: Watson Realty CoNAME: Steven chaplinskiEntry Class Code: WEB,995.0,,Posted,538.17,2023-01-31,995.0,Withdrawal ACH Watson Realty Co/TYPE: WEB PMTS ID: 9000321157CO: Watson Realty CoEntry Class Code: WEB,995.0
1/31/2023,,Withdrawal POS #000000555799/AMAZON.COM*CX16X5MU3 SEATTLE WACard 2801,10.2,,Posted,1533.17,2023-01-31,10.2,Withdrawal POS #000000598647/AMAZON.COM*F565U8HW3 SEATTLE WACard 2801,10.37
1/31/2023,,Withdrawal POS #000000508955/AMAZON.COM*UA77K78R3 SEATTLE WACard 2801,37.6,,Posted,1543.37,2023-01-31,37.6,Withdrawal POS #000000598647/AMAZON.COM*F565U8HW3 SEATTLE WACard 2801,37.6
1/30/2023,,Withdrawal POS #000000178279/SUNOCO 8002212501 4234 SW 20TH AVEGAINESVILLE FLCard 2801,32.23,,Posted,1580.97,2023-01-30,32.23,Withdrawal POS #000000142991/SUNOCO 8002212501 4234 SW 20TH AVEGAINESVILLE FLCard 2801,32.23
1/30/2023,,Withdrawal ACH CAPITAL ONE/TYPE: ONLINE PMT ID: 9279744391CO: CAPITAL ONE NAME: STEVEN CHAPLINSKIEntry Class Code: WEB,191.0,,Posted,1613.2,2023-01-30,191.0,Withdrawal ACH CAPITAL ONE/TYPE: ONLINE PMT ID: 9279744391CO: CAPITAL ONE NAME: STEVEN CHAPLINSKIEntry Class Code: WEB,191.0
1/30/2023,,Withdrawal ACH APPLECARD GSBANK/TYPE: PAYMENT ID: 9999999999CO: APPLECARD GSBANKNAME: Steven ChaplinskiEntry Class Code: WEB,125.0,,Posted,1804.2,2023-01-30,125.0,Withdrawal ACH APPLECARD GSBANK/TYPE: PAYMENT ID: 9999999999CO: APPLECARD GSBANKNAME: Steven ChaplinskiEntry Class Code: WEB,125.0
1/30/2023,,Withdrawal ACH TARGET CARD SRVC/TYPE: BILL PAY ID: 5411721813CO: TARGET CARD SRVCNAME: S CHAPLINSKI TEntry Class Code: WEB,125.0,,Posted,1929.2,2023-01-30,125.0,Withdrawal ACH TARGET CARD SRVC/TYPE: BILL PAY ID: 5411721813CO: TARGET CARD SRVCNAME: S CHAPLINSKI TEntry Class Code: WEB,125.0
1/30/2023,,Withdrawal ACH DISCOVER/TYPE: E-PAYMENT ID: 2510020270CO: DISCOVER NAME: CHAPLINSKI STEVENEntry Class Code: WEB,97.52,,Posted,2054.2,2023-01-30,97.52,Withdrawal ACH DISCOVER/TYPE: E-PAYMENT ID: 2510020270CO: DISCOVER NAME: CHAPLINSKI STEVENEntry Class Code: WEB,97.52
1/30/2023,,Withdrawal ACH PAYPAL/TYPE: INST XFER ID: PAYPALSI77CO: PAYPAL NAME: STEVEN CHAPLINSKIEntry Class Code: WEB,14.99,,Posted,2151.72,2023-01-30,14.99,Withdrawal ACH PAYPAL/TYPE: INST XFER ID: PAYPALSI77CO: PAYPAL NAME: STEVEN CHAPLINSKIEntry Class Code: WEB,14.948333333333332
1/30/2023,,Withdrawal ACH PAYPAL/TYPE: INST XFER ID: PAYPALSI77CO: PAYPAL NAME: STEVEN CHAPLINSKIEntry Class Code: WEB,2.99,,Posted,2166.71,2023-01-30,2.99,Withdrawal ACH PAYPAL/TYPE: INST XFER ID: PAYPALSI77CO: PAYPAL NAME: STEVEN CHAPLINSKIEntry Class Code: WEB,3.218
1/29/2023,,Recurring Withdrawal Debit Card MC Debit/ADOBE *CREATIVE CLOUD 4085366000 CADate 01/27/23 0 3027321474 1 5734Card 2801,19.99,,Posted,2159.7,2023-01-29,19.99,Recurring Withdrawal Debit Card MC Debit/ADOBE *CREATIVE CLOUD 4085366000 CADate 04/27/23 0 3117844835 0 5734Card 2801,19.99
1/28/2023,,Withdrawal POS #000000000000/AMAZON.COM*NK97S60U3 SEATTLE WACard 2801,73.08,,Posted,2179.69,2023-01-28,73.08,Withdrawal POS #000000000000/AMAZON.COM*V40RU1143 SEATTLE WACard 2801,73.08
1/28/2023,,Withdrawal POS #000000286964/AMAZON.COM*D40II7Y03 SEATTLE WACard 2801,61.26,,Posted,2252.77,2023-01-28,61.26,Withdrawal POS #000000247445/AMAZON.COM*A42ZY7OC3 SEATTLE WACard 2801,61.26
1/27/2023,,Withdrawal ACH PAYPAL/TYPE: INST XFER ID: PAYPALSI77CO: PAYPAL NAME: STEVEN CHAPLINSKIEntry Class Code: WEB,99.99,,Posted,2297.78,2023-01-27,99.99,Withdrawal ACH PAYPAL/TYPE: INST XFER ID: PAYPALSI77CO: PAYPAL NAME: STEVEN CHAPLINSKIEntry Class Code: WEB,99.99
1/27/2023,,Withdrawal ACH PAYPAL/TYPE: INST XFER ID: PAYPALSI77CO: PAYPAL NAME: STEVEN CHAPLINSKIEntry Class Code: WEB,49.99,,Posted,2397.77,2023-01-27,49.99,Withdrawal ACH PAYPAL/TYPE: INST XFER ID: PAYPALSI77CO: PAYPAL NAME: STEVEN CHAPLINSKIEntry Class Code: WEB,49.663333333333334
1/27/2023,,Withdrawal ACH PAYPAL/TYPE: INST XFER ID: PAYPALSI77CO: PAYPAL NAME: STEVEN CHAPLINSKIEntry Class Code: WEB,2.99,,Posted,2447.76,2023-01-27,2.99,Withdrawal ACH PAYPAL/TYPE: INST XFER ID: PAYPALSI77CO: PAYPAL NAME: STEVEN CHAPLINSKIEntry Class Code: WEB,3.218
1/26/2023,,Withdrawal POS #000000000096/CIRCLE K # 26162 7302 GAINESVILLE FLCard 2801,19.39,,Posted,2450.75,2023-01-26,19.39,Withdrawal POS #000000001638/CIRCLE K # 06527 9404 GAINESVILLE FLCard 2801,19.855
1/26/2023,,Withdrawal POS #000000036956/PUBLIX 5801 SW 75TH ST GAINESVILLE FLCard 2801,41.9,,Posted,2470.14,2023-01-26,41.9,Withdrawal POS #000000036956/PUBLIX 5801 SW 75TH ST GAINESVILLE FLCard 2801,41.9
1/26/2023,,Withdrawal ACH PAYPAL/TYPE: INST XFER ID: PAYPALSI77CO: PAYPAL NAME: STEVEN CHAPLINSKIEntry Class Code: WEB,4.5,,Posted,2512.04,2023-01-26,4.5,Withdrawal ACH PAYPAL/TYPE: INST XFER ID: PAYPALSI77CO: PAYPAL NAME: STEVEN CHAPLINSKIEntry Class Code: WEB,4.96
1/25/2023,,Recurring Withdrawal Debit Card Fee/MASTERCARD ISSUER CROSS-BORDER FEEDate 01/25/23 0 3025796879 0 5734Card 2801,0.08,,Posted,2516.54,2023-01-25,0.08,Withdrawal Debit Card Fee/MASTERCARD ISSUER CROSS-BORDER FEEDate 12/25/22 0 2359739765 0 5734Card 2801,0.16428571428571428
1/25/2023,,Recurring Withdrawal Debit Card MC Debit/SP NIGHTCAFE AI ART MARRICKVILLE NSDate 01/25/23 0 3025796879 0 5734Card 2801,9.99,,Posted,2516.62,2023-01-25,9.99,Withdrawal Debit Card MC Debit/SP NIGHTCAFE AI ART MARRICKVILLE NSDate 12/25/22 0 2359739765 0 5734Card 2801,9.99
1/23/2023,,Withdrawal ACH CANVA PTY LIMITE/CO: CANVA PTY LIMITEDTYPE: IAT PAYPAL ID: 770510487CEntry Class Code: IAT,12.99,,Posted,26.61,2023-01-23,12.99,Withdrawal ACH CANVA PTY LIMITE/CO: CANVA PTY LIMITEDTYPE: IAT PAYPAL ID: 770510487CEntry Class Code: IAT,12.99
1/23/2023,,Withdrawal ACH PAYPAL/TYPE: INST XFER ID: PAYPALSI77CO: PAYPAL NAME: STEVEN CHAPLINSKIEntry Class Code: WEB,79.99,,Posted,39.6,2023-01-23,79.99,Withdrawal ACH PAYPAL/TYPE: INST XFER ID: PAYPALSI77CO: PAYPAL NAME: STEVEN CHAPLINSKIEntry Class Code: WEB,79.495
1/23/2023,,Withdrawal ACH PAYPAL/TYPE: INST XFER ID: PAYPALSI77CO: PAYPAL NAME: STEVEN CHAPLINSKIEntry Class Code: WEB,4.99,,Posted,119.59,2023-01-23,4.99,Withdrawal ACH PAYPAL/TYPE: INST XFER ID: PAYPALSI77CO: PAYPAL NAME: STEVEN CHAPLINSKIEntry Class Code: WEB,4.96
1/22/2023,,Withdrawal Debit Card MC Debit/PUBLIX #527 GAINESVILLE FLDate 01/20/23 0 3020078496 4 5411Card 2801,202.28,,Posted,124.58,2023-01-22,202.28,Withdrawal Debit Card MC Debit/PUBLIX #680 GAINESVILLE FLDate 04/16/23 0 3106911969 0 5411Card 2801,202.28
1/21/2023,,Withdrawal POS #000010067691/PAYPAL *QUILLBOT 2211 North First StreetSan Jose CACard 2801,19.95,,Posted,326.86,2023-01-21,19.95,Withdrawal POS #000005013671/PAYPAL *PRINTIFY 2211 North First StreetSan Jose CACard 2801,19.95
1/20/2023,,Withdrawal ATM Fee/EFT 6419 W Newberry Rd Gainesville FLCard 2801,2.0,,Posted,346.81,2023-01-20,2.0,"Withdrawal ATM Fee/EFT 6419 W Newberry Rd Gainesville FL

Card 1247",2.0
1/20/2023,,Withdrawal at ATM #000000473707/EFT 6419 W Newberry Rd Gainesville FLCard 2801,178.0,,Posted,348.81,2023-01-20,178.0,"Withdrawal at ATM #000000785755/EFT 6419 W Newberry Rd Gainesville FL

Card 1247",178.0
1/20/2023,,Withdrawal POS #000002069571/GOOGLE *YouTubePremium 1600 AmphitheatreParkw Mountain View CACard 2801,13.64,,Posted,126.81,2023-01-20,13.64,Withdrawal POS #000003285955/GOOGLE *YouTubePremium 1600 AmphitheatreParkw Mountain View CACard 2801,13.629999999999999
1/17/2023,,Withdrawal ACH FLUENT-Gainesvil/TYPE: PAYMENT ID: 1371804719CO: FLUENT-GainesvilEntry Class Code: PPD,48.0,,Posted,140.45,2023-01-17,48.0,Withdrawal ACH FLUENT-Gainesvil/TYPE: PAYMENT ID: 1371804719CO: FLUENT-GainesvilEntry Class Code: PPD,48.5
1/17/2023,,Withdrawal ACH PAYPAL/TYPE: INST XFER ID: PAYPALSI77CO: PAYPAL NAME: STEVEN CHAPLINSKIEntry Class Code: WEB,24.95,,Posted,188.45,2023-01-17,24.95,Withdrawal ACH PAYPAL/TYPE: INST XFER ID: PAYPALSI77CO: PAYPAL NAME: STEVEN CHAPLINSKIEntry Class Code: WEB,24.97
1/17/2023,,Withdrawal ACH PAYPAL/TYPE: INST XFER ID: PAYPALSI77CO: PAYPAL NAME: STEVEN CHAPLINSKIEntry Class Code: WEB,8.99,,Posted,213.4,2023-01-17,8.99,Withdrawal ACH PAYPAL/TYPE: INST XFER ID: PAYPALSI77CO: PAYPAL NAME: STEVEN CHAPLINSKIEntry Class Code: WEB,9.015
1/17/2023,,Withdrawal POS #000000174482/AMAZON.COM*XC5QI21R3 SEATTLE WACard 2801,10.2,,Posted,222.39,2023-01-17,10.2,Withdrawal POS #000000247445/AMAZON.COM*A42ZY7OC3 SEATTLE WACard 2801,10.475
1/15/2023,,Withdrawal Debit Card MC Debit/PUBLIX #735 GAINESVILLE FLDate 01/13/23 0 3013278962 2 5411Card 2801,103.83,,Posted,232.59,2023-01-15,103.83,Withdrawal Debit Card MC Debit/PUBLIX #680 GAINESVILLE FLDate 04/16/23 0 3106911969 0 5411Card 2801,103.83
1/13/2023,,Withdrawal POS #000000261616/FAST TRACK #200 3960 SW ARCHER RDGAINESVILLE FLCard 2801,28.14,,Posted,336.42,2023-01-13,28.14,Withdrawal POS #000000166784/FAST TRACK #200 3960 SW ARCHER RDGAINESVILLE FLCard 2801,28.14
1/12/2023,,Recurring Withdrawal Bill Payment - #000000233587/AFFIRM PAY YSM SAN FRANCISCO CACard 2801,16.25,,Posted,364.56,2023-01-12,16.25,Recurring Withdrawal Bill Payment - #000000233587/AFFIRM PAY YSM SAN FRANCISCO CACard 2801,16.25
1/12/2023,,Recurring Withdrawal Debit Card Fee/MASTERCARD ISSUER CROSS-BORDER FEEDate 01/11/23 0 3011789326 0 5734Card 2801,0.07,,Posted,380.81,2023-01-12,0.07,Recurring Withdrawal Debit Card Fee/MASTERCARD ISSUER CROSS-BORDER FEEDate 04/20/23 0 3110864064 0 7333Card 2801,0.15111111111111108
1/12/2023,,Recurring Withdrawal Debit Card MC Debit/PAYPAL *LINKTREEPTY 4029357733 AUDate 01/11/23 0 3011789326 0 5734Card 2801,9.0,,Posted,380.88,2023-01-12,9.0,Recurring Withdrawal Debit Card MC Debit/PAYPAL *LINKTREE 4029357733 AUDate 05/12/21 0 1132191600 1 7372Card 2801,9.0
1/11/2023,,Recurring Withdrawal Debit Card MC Debit/JASPER.AI ROLLINGWOOD TXDate 01/10/23 0 3010785541 0 7399Card 2801,20.0,,Posted,389.88,2023-01-11,20.0,Recurring Withdrawal Debit Card MC Debit/JASPER.AI ROLLINGWOOD TXDate 03/30/23 0 3089949341 0 7399Card 2801,20.0
1/11/2023,,Withdrawal ACH BRAINLY/CO: BRAINLYTYPE: IAT PAYPAL ID: 770510487CEntry Class Code: IAT,10.0,,Posted,409.88,2023-01-11,10.0,Withdrawal ACH BRAINLY/CO: BRAINLYTYPE: IAT PAYPAL ID: 770510487CEntry Class Code: IAT,10.0
1/11/2023,,Withdrawal ACH PAYPAL/TYPE: INST XFER ID: PAYPALSI77CO: PAYPAL NAME: STEVEN CHAPLINSKIEntry Class Code: WEB,9.99,,Posted,419.88,2023-01-11,9.99,Withdrawal ACH PAYPAL/TYPE: INST XFER ID: PAYPALSI77CO: PAYPAL NAME: STEVEN CHAPLINSKIEntry Class Code: WEB,10.093333333333334
1/11/2023,,Withdrawal ACH PAYPAL/TYPE: INST XFER ID: PAYPALSI77CO: PAYPAL NAME: STEVEN CHAPLINSKIEntry Class Code: WEB,1.0,,Posted,429.87,2023-01-11,1.0,Withdrawal ACH PAYPAL/TYPE: INST XFER ID: PAYPALSI77CO: PAYPAL NAME: STEVEN CHAPLINSKIEntry Class Code: WEB,1.11
1/10/2023,,Withdrawal ACH ENVATO/CO: ENVATOTYPE: IAT PAYPAL ID: 770510487CEntry Class Code: IAT,39.0,,Posted,430.87,2023-01-10,39.0,Withdrawal ACH ENVATO/CO: ENVATOTYPE: IAT PAYPAL ID: 770510487CEntry Class Code: IAT,39.0
1/10/2023,,Withdrawal POS #000000260400/SUNOCO 8002212501 4234 SW 20TH AVEGAINESVILLE FLCard 2801,29.85,,Posted,469.87,2023-01-10,29.85,Withdrawal POS #000000403720/SUNOCO 8002212501 4234 SW 20TH AVEGAINESVILLE FLCard 2801,29.85
1/9/2023,,Withdrawal ACH ENVATO/CO: ENVATOTYPE: IAT PAYPAL ID: 770510487CEntry Class Code: IAT,6.9,,Posted,499.72,2023-01-09,6.9,Withdrawal ACH ENVATO/CO: ENVATOTYPE: IAT PAYPAL ID: 770510487CEntry Class Code: IAT,6.9
1/8/2023,,Withdrawal Debit Card MC Debit/WALGREENS #5024 800-289-2273 FLDate 01/06/23 0 3006523704 2 5912Card 2801,63.05,,Posted,506.62,2023-01-08,63.05,Withdrawal Debit Card MC Debit/WALGREENS #5024 800-289-2273 FLDate 04/03/23 0 3093023575 1 5912Card 2801,63.05
1/8/2023,,"Withdrawal Debit Card MC Debit/MAIL.COM, 1&amp;1 MAM INC. CHESTERBROOK PADate 01/04/23 0 3004718222 0 4816Card 2801",14.95,,Posted,569.67,2023-01-08,14.95,"Withdrawal Debit Card MC Debit/MAIL.COM, 1&amp;1 MAM INC. CHESTERBROOK PADate 01/04/23 0 3004718222 0 4816Card 2801",14.95
1/8/2023,,Withdrawal POS #000005207059/PAYPAL *VIDIQ 2211 North First StreetJose CACard 2801,10.0,,Posted,584.62,2023-01-08,10.0,Withdrawal POS #000005221556/PAYPAL *VIDIQ 2211 North First StreetJose CACard 2801,10.0
1/7/2023,,Withdrawal POS #000000103980/SUNOCO 8002212501 4234 SW 20TH AVEGAINESVILLE FLCard 2801,19.11,,Posted,594.62,2023-01-07,19.11,Withdrawal POS #000000403720/SUNOCO 8002212501 4234 SW 20TH AVEGAINESVILLE FLCard 2801,19.11
1/7/2023,,Withdrawal POS #000000514080/SUNOCO 8002212501 4234 SW 20TH AVEGAINESVILLE FLCard 2801,15.0,,Posted,613.73,2023-01-07,15.0,Withdrawal POS #000000550998/SUNOCO 8002212501 4234 SW 20TH AVEGAINESVILLE FLCard 2801,15.0
1/6/2023,,Withdrawal ACH PAYPAL/TYPE: INST XFER ID: PAYPALSI77CO: PAYPAL NAME: STEVEN CHAPLINSKIEntry Class Code: WEB,5.69,,Posted,628.73,2023-01-06,5.69,Withdrawal ACH PAYPAL/TYPE: INST XFER ID: PAYPALSI77CO: PAYPAL NAME: STEVEN CHAPLINSKIEntry Class Code: WEB,6.0875
1/6/2023,,Recurring Withdrawal Bill Payment - #000000097375/NETFLIX COM LOS GATOS CACard 2801,11.0,,Posted,634.42,2023-01-06,11.0,Recurring Withdrawal Bill Payment - #000006911729/NETFLIX COM LOS GATOS CACard 2801,10.99
1/5/2023,,Withdrawal Debit Card MC Debit/PUBLIX #1784 GAINESVILLE FLDate 01/04/23 0 3004983001 0 5411Card 2801,129.08,,Posted,645.42,2023-01-05,129.08,Withdrawal Debit Card MC Debit/PUBLIX #680 GAINESVILLE FLDate 04/16/23 0 3106911969 0 5411Card 2801,129.08
1/5/2023,,Withdrawal Debit Card MC Debit/WALGREENS #5024 800-289-2273 FLDate 01/04/23 0 3004979683 0 5912Card 2801,9.43,,Posted,774.5,2023-01-05,9.43,Withdrawal Debit Card MC Debit/WALGREENS #5024 800-289-2273 FLDate 04/03/23 0 3093023575 1 5912Card 2801,9.43
1/5/2023,,Withdrawal ACH PAYPAL/TYPE: INST XFER ID: PAYPALSI77CO: PAYPAL NAME: STEVEN CHAPLINSKIEntry Class Code: WEB,17.26,,Posted,783.93,2023-01-05,17.26,Withdrawal ACH PAYPAL/TYPE: INST XFER ID: PAYPALSI77CO: PAYPAL NAME: STEVEN CHAPLINSKIEntry Class Code: WEB,17.3975
1/4/2023,,Withdrawal ACH PAYPAL/TYPE: INST XFER ID: PAYPALSI77CO: PAYPAL NAME: STEVEN CHAPLINSKIEntry Class Code: WEB,14.99,,Posted,801.19,2023-01-04,14.99,Withdrawal ACH PAYPAL/TYPE: INST XFER ID: PAYPALSI77CO: PAYPAL NAME: STEVEN CHAPLINSKIEntry Class Code: WEB,14.948333333333332
1/4/2023,,Withdrawal ACH PAYPAL/TYPE: INST XFER ID: PAYPALSI77CO: PAYPAL NAME: STEVEN CHAPLINSKIEntry Class Code: WEB,2.99,,Posted,816.18,2023-01-04,2.99,Withdrawal ACH PAYPAL/TYPE: INST XFER ID: PAYPALSI77CO: PAYPAL NAME: STEVEN CHAPLINSKIEntry Class Code: WEB,3.218
1/3/2023,,Withdrawal POS #000000000003/AMAZON.COM*ED0352XR3 SEATTLE WACard 2801,10.2,,Posted,819.17,2023-01-03,10.2,Withdrawal POS #000000000023/AMAZON.COM*AU8ER6ZT3 SEATTLE WACard 2801,10.4725
1/3/2023,,Withdrawal POS #000000297007/SUNOCO 8002212501 4234 SW 20TH AVEGAINESVILLE FLCard 2801,27.35,,Posted,829.37,2023-01-03,27.35,Withdrawal POS #000000260400/SUNOCO 8002212501 4234 SW 20TH AVEGAINESVILLE FLCard 2801,27.35
1/3/2023,,Withdrawal ACH PADDLE.COM MARKE/CO: PADDLE.COM MARKET LIMITEDTYPE: IAT PAYPAL ID: 770510487CEntry Class Code: IAT,69.0,,Posted,856.72,2023-01-03,69.0,Withdrawal ACH PADDLE.COM MARKE/CO: PADDLE.COM MARKET LIMITEDTYPE: IAT PAYPAL ID: 770510487CEntry Class Code: IAT,69.0
1/3/2023,,Withdrawal ACH PADDLE.COM MARKE/CO: PADDLE.COM MARKET LIMITEDTYPE: IAT PAYPAL ID: 770510487CEntry Class Code: IAT,2.99,,Posted,925.72,2023-01-03,2.99,Withdrawal ACH PADDLE.COM MARKE/CO: PADDLE.COM MARKET LIMITEDTYPE: IAT PAYPAL ID: 770510487CEntry Class Code: IAT,2.99
1/3/2023,,Withdrawal ACH FLUENT-Gainesvil/TYPE: PAYMENT ID: 1371804719CO: FLUENT-GainesvilEntry Class Code: PPD,80.1,,Posted,928.71,2023-01-03,80.1,Withdrawal ACH FLUENT-Gainesvil/TYPE: PAYMENT ID: 1371804719CO: FLUENT-GainesvilEntry Class Code: PPD,80.1
1/3/2023,,Withdrawal ACH PAYPAL/TYPE: INST XFER ID: PAYPALSI77CO: PAYPAL NAME: STEVEN CHAPLINSKIEntry Class Code: WEB,11.5,,Posted,1008.81,2023-01-03,11.5,Withdrawal ACH PAYPAL/TYPE: INST XFER ID: PAYPALSI77CO: PAYPAL NAME: STEVEN CHAPLINSKIEntry Class Code: WEB,11.7425
1/3/2023,,Withdrawal ACH PAYPAL/TYPE: INST XFER ID: PAYPALSI77CO: PAYPAL NAME: STEVEN CHAPLINSKIEntry Class Code: WEB,3.0,,Posted,1020.31,2023-01-03,3.0,Withdrawal ACH PAYPAL/TYPE: INST XFER ID: PAYPALSI77CO: PAYPAL NAME: STEVEN CHAPLINSKIEntry Class Code: WEB,3.218
1/2/2023,,Withdrawal Debit Card MC Debit/PUBLIX #680 GAINESVILLE FLDate 01/01/23 0 3001725148 0 5411Card 2801,44.96,,Posted,1023.31,2023-01-02,44.96,Withdrawal Debit Card MC Debit/PUBLIX #680 GAINESVILLE FLDate 12/18/22 0 2352007675 1 5411Card 2801,44.96
1/2/2023,,Withdrawal Debit Card MC Debit/PUBLIX #1312 GAINESVILLE FLDate 01/01/23 0 3001725047 0 5411Card 2801,88.01,,Posted,1068.27,2023-01-02,88.01,Withdrawal Debit Card MC Debit/PUBLIX #680 GAINESVILLE FLDate 04/16/23 0 3106911969 0 5411Card 2801,88.01
1/2/2023,,Recurring Withdrawal Debit Card MC Debit/CHEGG ORDER 8558681054 CADate 12/31/22 0 2365640452 1 5942Card 2801,15.95,,Posted,1156.28,2023-01-02,15.95,Recurring Withdrawal Debit Card MC Debit/CHEGG ORDER 8558681054 CADate 03/31/23 0 3090879254 1 5942Card 2801,15.95
1/1/2023,,Withdrawal POS #000000009136/CIRCLE K # 26146 3525 GAINESVILLE FLCard 2801,22.8,,Posted,1172.23,2023-01-01,22.8,Withdrawal POS #000000003339/CIRCLE K # 26146 3525 GAINESVILLE FLCard 2801,22.8
12/31/2022,,Recurring Withdrawal Debit Card MC Debit/JASPER.AI ROLLINGWOOD TXDate 12/30/22 0 2364331374 0 7399Card 2801,10.0,,Posted,1195.03,2022-12-31,10.0,Recurring Withdrawal Debit Card MC Debit/JASPER.AI ROLLINGWOOD TXDate 03/30/23 0 3089949341 0 7399Card 2801,10.0
12/31/2022,,Recurring Withdrawal Debit Card MC Debit/JASPER.AI ROLLINGWOOD TXDate 12/30/22 0 2364331373 0 7399Card 2801,49.0,,Posted,1205.03,2022-12-31,49.0,Recurring Withdrawal Debit Card MC Debit/JASPER.AI ROLLINGWOOD TXDate 03/30/23 0 3089949341 0 7399Card 2801,49.0
12/31/2022,,Withdrawal Debit Card MC Debit/ETSY INC SELLER FEES BROOKLYN NYDate 12/31/22 0 2365030004 1 7311Card 2801,0.2,,Posted,1254.03,2022-12-31,0.2,Withdrawal Debit Card MC Debit/ETSY INC SELLER FEES BROOKLYN NYDate 12/31/22 0 2365030004 1 7311Card 2801,0.2
12/29/2022,,Withdrawal Debit Card MC Debit/GRU/EZ-PAY WEB PYMT 352-334-3434 FLDate 12/28/22 0 2362352713 0 4900Card 2801,222.94,,Posted,1254.23,2022-12-29,222.94,Withdrawal Debit Card MC Debit/GRU/EZ-PAY WEB PYMT 352-334-3434 FLDate 11/01/21 0 1305577800 0 4900Card 2801,222.94
12/29/2022,,Withdrawal Debit Card MC Debit/COX GAINESVILLE COMM 800-234-3993 FLDate 12/28/22 0 2362822190 0 4899Card 2801,124.96,,Posted,1477.17,2022-12-29,124.96,Withdrawal Debit Card MC Debit/COX GAINESVILLE COMM 800-234-3993 FLDate 01/27/22 0 2027240681 1 4899Card 2801,124.995
12/29/2022,,Withdrawal ACH Watson Realty Co/TYPE: WEB PMTS ID: 9000321157CO: Watson Realty CoNAME: Steven chaplinskiEntry Class Code: WEB,995.0,,Posted,1602.13,2022-12-29,995.0,Withdrawal ACH Watson Realty Co/TYPE: WEB PMTS ID: 9000321157CO: Watson Realty CoEntry Class Code: WEB,995.0
12/29/2022,,Withdrawal ACH PAYPAL/TYPE: INST XFER ID: PAYPALSI77CO: PAYPAL NAME: STEVEN CHAPLINSKIEntry Class Code: WEB,2.99,,Posted,2597.13,2022-12-29,2.99,Withdrawal ACH PAYPAL/TYPE: INST XFER ID: PAYPALSI77CO: PAYPAL NAME: STEVEN CHAPLINSKIEntry Class Code: WEB,3.218
12/28/2022,,Recurring Withdrawal Debit Card MC Debit/ADOBE *CREATIVE CLOUD 4085366000 CADate 12/27/22 0 2361749868 0 5734Card 2801,19.99,,Posted,2600.12,2022-12-28,19.99,Recurring Withdrawal Debit Card MC Debit/ADOBE CREATIVE CLOUD 4085366000 CADate 09/28/22 0 2271807482 0 5734Card 2801,19.99
12/28/2022,,Withdrawal ACH PAYPAL/TYPE: INST XFER ID: PAYPALSI77CO: PAYPAL NAME: STEVEN CHAPLINSKIEntry Class Code: WEB,14.99,,Posted,120.11,2022-12-28,14.99,Withdrawal ACH PAYPAL/TYPE: INST XFER ID: PAYPALSI77CO: PAYPAL NAME: STEVEN CHAPLINSKIEntry Class Code: WEB,14.948333333333332
12/27/2022,,Withdrawal POS #000000594073/SUNOCO 8002212501 4234 SW 20TH AVEGAINESVILLE FLCard 2801,33.32,,Posted,135.1,2022-12-27,33.32,Withdrawal POS #000000392594/SUNOCO 8002212501 4234 SW 20TH AVEGAINESVILLE FLCard 2801,33.32
12/27/2022,,Withdrawal ACH FLUENT-Gainesvil/TYPE: PAYMENT ID: 1371804719CO: FLUENT-GainesvilEntry Class Code: PPD,111.0,,Posted,131.99,2022-12-27,111.0,Withdrawal ACH FLUENT-Gainesvil/TYPE: PAYMENT ID: 1371804719CO: FLUENT-GainesvilEntry Class Code: PPD,111.0
12/27/2022,,Withdrawal ACH PAYPAL/TYPE: INST XFER ID: PAYPALSI77CO: PAYPAL NAME: STEVEN CHAPLINSKIEntry Class Code: WEB,89.99,,Posted,242.99,2022-12-27,89.99,Withdrawal ACH PAYPAL/TYPE: INST XFER ID: PAYPALSI77CO: PAYPAL NAME: STEVEN CHAPLINSKIEntry Class Code: WEB,89.99
12/27/2022,,Withdrawal ACH AMZ_STORECRD_PMT/TYPE: PAYMENT ID: 9069872000CO: AMZ_STORECRD_PMTNAME: 6045781157416487Entry Class Code: WEB,37.0,,Posted,332.98,2022-12-27,37.0,Withdrawal ACH AMZ_STORECRD_PMT/TYPE: PAYMENT ID: 9069872000CO: AMZ_STORECRD_PMTNAME: 6045781157416487Entry Class Code: WEB,37.0
12/27/2022,,Withdrawal ACH PAYPAL/TYPE: INST XFER ID: PAYPALSI77CO: PAYPAL NAME: STEVEN CHAPLINSKIEntry Class Code: WEB,33.17,,Posted,369.98,2022-12-27,33.17,Withdrawal ACH PAYPAL/TYPE: INST XFER ID: PAYPALSI77CO: PAYPAL NAME: STEVEN CHAPLINSKIEntry Class Code: WEB,33.519999999999996
12/27/2022,,Withdrawal ACH PAYPAL/TYPE: INST XFER ID: PAYPALSI77CO: PAYPAL NAME: STEVEN CHAPLINSKIEntry Class Code: WEB,4.5,,Posted,403.15,2022-12-27,4.5,Withdrawal ACH PAYPAL/TYPE: INST XFER ID: PAYPALSI77CO: PAYPAL NAME: STEVEN CHAPLINSKIEntry Class Code: WEB,4.96
12/27/2022,,Withdrawal ACH PAYPAL/TYPE: INST XFER ID: PAYPALSI77CO: PAYPAL NAME: STEVEN CHAPLINSKIEntry Class Code: WEB,2.99,,Posted,407.65,2022-12-27,2.99,Withdrawal ACH PAYPAL/TYPE: INST XFER ID: PAYPALSI77CO: PAYPAL NAME: STEVEN CHAPLINSKIEntry Class Code: WEB,3.218
12/25/2022,,Withdrawal Debit Card Fee/MASTERCARD ISSUER CROSS-BORDER FEEDate 12/25/22 0 2359739765 0 5734Card 2801,0.08,,Posted,410.64,2022-12-25,0.08,Withdrawal Debit Card Fee/MASTERCARD ISSUER CROSS-BORDER FEEDate 12/25/22 0 2359739765 0 5734Card 2801,0.16428571428571428
12/25/2022,,Withdrawal Debit Card MC Debit/SP NIGHTCAFE AI ART MARRICKVILLE NSDate 12/25/22 0 2359739765 0 5734Card 2801,9.99,,Posted,410.72,2022-12-25,9.99,Withdrawal Debit Card MC Debit/SP NIGHTCAFE AI ART MARRICKVILLE NSDate 12/25/22 0 2359739765 0 5734Card 2801,9.99
12/23/2022,,Withdrawal POS #000000013317/CIRCLE K # 26162 7302 GAINESVILLE FLCard 2801,19.39,,Posted,420.71,2022-12-23,19.39,Withdrawal POS #000000000096/CIRCLE K # 26162 7302 GAINESVILLE FLCard 2801,19.39
12/20/2022,,Withdrawal Debit Card MC Debit/WALGREENS #5024 800-289-2273 FLDate 12/19/22 0 2353181854 1 5912Card 2801,12.26,,Posted,240.1,2022-12-20,12.26,Withdrawal Debit Card MC Debit/WALGREENS #5024 800-289-2273 FLDate 12/19/22 0 2353181854 1 5912Card 2801,12.26
12/20/2022,,Withdrawal ACH FLUENT-Gainesvil/TYPE: PAYMENT ID: 1371804719CO: FLUENT-GainesvilEntry Class Code: PPD,72.0,,Posted,252.36,2022-12-20,72.0,Withdrawal ACH FLUENT-Gainesvil/TYPE: PAYMENT ID: 1371804719CO: FLUENT-GainesvilEntry Class Code: PPD,72.0
12/20/2022,,Withdrawal ACH PAYPAL/TYPE: INST XFER ID: PAYPALSI77CO: PAYPAL NAME: STEVEN CHAPLINSKIEntry Class Code: WEB,12.63,,Posted,324.36,2022-12-20,12.63,Withdrawal ACH PAYPAL/TYPE: INST XFER ID: PAYPALSI77CO: PAYPAL NAME: STEVEN CHAPLINSKIEntry Class Code: WEB,12.88
12/20/2022,,Withdrawal POS #000002238379/GOOGLE *YouTubePremium 1600 AmphitheatreParkw Mountain View CACard 2801,13.62,,Posted,336.99,2022-12-20,13.62,Withdrawal POS #000003285955/GOOGLE *YouTubePremium 1600 AmphitheatreParkw Mountain View CACard 2801,13.629999999999999
12/20/2022,,Withdrawal POS #000000000071/AMAZON.COM*B98QW9ZM3 SEATTLE WACard 2801,10.15,,Posted,350.61,2022-12-20,10.15,Withdrawal POS #000000000023/AMAZON.COM*AU8ER6ZT3 SEATTLE WACard 2801,10.4725
12/19/2022,,Withdrawal Debit Card MC Debit/PUBLIX #680 GAINESVILLE FLDate 12/18/22 0 2352007675 1 5411Card 2801,39.52,,Posted,360.76,2022-12-19,39.52,Withdrawal Debit Card MC Debit/PUBLIX #680 GAINESVILLE FLDate 12/18/22 0 2352007675 1 5411Card 2801,39.52
12/19/2022,,Withdrawal ACH PAYPAL/TYPE: INST XFER ID: PAYPALSI77CO: PAYPAL NAME: STEVEN CHAPLINSKIEntry Class Code: WEB,24.95,,Posted,400.28,2022-12-19,24.95,Withdrawal ACH PAYPAL/TYPE: INST XFER ID: PAYPALSI77CO: PAYPAL NAME: STEVEN CHAPLINSKIEntry Class Code: WEB,24.97
12/18/2022,,Withdrawal POS #000000767942/PUBLIX 3930 SW ARCHER ROAD GAINESVILLECard 2801,28.92,,Posted,252.35,2022-12-18,28.92,Withdrawal POS #000000753028/PUBLIX 3930 SW ARCHER ROAD GAINESVILLECard 1247,28.92
12/18/2022,,Withdrawal Debit Card MC Debit/PIZZA HUT 27918 3523739402 FLDate 12/16/22 0 2350808582 1 5812Card 2801,32.37,,Posted,281.27,2022-12-18,32.37,Withdrawal Debit Card MC Debit/PIZZA HUT 27918 3523739402 FLDate 12/16/22 0 2350808582 1 5812Card 2801,32.614999999999995
12/16/2022,,Withdrawal ACH PAYPAL/TYPE: INST XFER ID: PAYPALSI77CO: PAYPAL NAME: STEVEN CHAPLINSKIEntry Class Code: WEB,8.99,,Posted,313.64,2022-12-16,8.99,Withdrawal ACH PAYPAL/TYPE: INST XFER ID: PAYPALSI77CO: PAYPAL NAME: STEVEN CHAPLINSKIEntry Class Code: WEB,9.015
12/15/2022,,Withdrawal POS #000000002373/CIRCLE K # 06782 5237 GAINESVILLE FLCard 2801,19.39,,Posted,322.63,2022-12-15,19.39,Withdrawal POS #000000882351/CIRCLE K # 06782 GAINESVILLE FLCard 1140,19.08
12/15/2022,,Withdrawal POS #000014159788/WALGREENS 2415 SW 75TH GAINESVILLE FLCard 2801,64.68,,Posted,342.02,2022-12-15,64.68,Withdrawal POS #000015057686/WALGREENS 2415 SW 75TH GAINESVILLE FLCard 1231,64.68
12/15/2022,,Withdrawal ACH VERIFONE PAYMENT/CO: VERIFONE PAYMENTS B.V.TYPE: IAT PAYPAL ID: 770510487CEntry Class Code: IAT,172.88,,Posted,406.7,2022-12-15,172.88,Withdrawal ACH VERIFONE PAYMENT/CO: VERIFONE PAYMENTS B.V.TYPE: IAT PAYPAL ID: 770510487CEntry Class Code: IAT,172.88
12/14/2022,,Withdrawal ACH APPLECARD GSBANK/TYPE: PAYMENT ID: 9999999999CO: APPLECARD GSBANKNAME: Steven ChaplinskiEntry Class Code: WEB,10.0,,Posted,579.58,2022-12-14,10.0,Withdrawal ACH APPLECARD GSBANK/TYPE: PAYMENT ID: 9999999999CO: APPLECARD GSBANKNAME: Steven ChaplinskiEntry Class Code: WEB,10.0
12/14/2022,,Withdrawal ACH CANVA PTY LIMITE/CO: CANVA PTY LIMITEDTYPE: IAT PAYPAL ID: 770510487CEntry Class Code: IAT,12.99,,Posted,589.58,2022-12-14,12.99,Withdrawal ACH CANVA PTY LIMITE/CO: CANVA PTY LIMITEDTYPE: IAT PAYPAL ID: 770510487CEntry Class Code: IAT,12.99
12/14/2022,,Withdrawal ACH PAYPAL/TYPE: INST XFER ID: PAYPALSI77CO: PAYPAL NAME: STEVEN CHAPLINSKIEntry Class Code: WEB,5.0,,Posted,602.57,2022-12-14,5.0,Withdrawal ACH PAYPAL/TYPE: INST XFER ID: PAYPALSI77CO: PAYPAL NAME: STEVEN CHAPLINSKIEntry Class Code: WEB,4.96
12/13/2022,,Withdrawal ACH COINBASE INC./TYPE: 8889087930 ID: 1327000623CO: COINBASE INC.NAME: STEVEN J CHAPLINSKIEntry Class Code: WEB,10.0,,Posted,607.57,2022-12-13,10.0,Withdrawal ACH COINBASE INC./TYPE: 8889087930 ID: 1327000623CO: COINBASE INC.NAME: STEVEN J CHAPLINSKIEntry Class Code: WEB,10.0
12/13/2022,,Withdrawal POS #000000297266/SUNOCO 8002212501 4234 SW 20TH AVEGAINESVILLE FLCard 2801,24.58,,Posted,617.57,2022-12-13,24.58,Withdrawal POS #000000219124/SUNOCO 8002212501 4234 SW 20TH AVEGAINESVILLE FLCard 2801,24.58
12/13/2022,,Withdrawal ACH FLUENT-Gainesvil/TYPE: PAYMENT ID: 1371804719CO: FLUENT-GainesvilEntry Class Code: PPD,105.0,,Posted,609.31,2022-12-13,105.0,Withdrawal ACH FLUENT-Gainesvil/TYPE: PAYMENT ID: 1371804719CO: FLUENT-GainesvilEntry Class Code: PPD,105.0
12/13/2022,,Withdrawal ACH COINBASE INC./TYPE: 8889087930 ID: 1327000623CO: COINBASE INC.NAME: STEVEN J CHAPLINSKIEntry Class Code: WEB,10.0,,Posted,714.31,2022-12-13,10.0,Withdrawal ACH COINBASE INC./TYPE: 8889087930 ID: 1327000623CO: COINBASE INC.NAME: STEVEN J CHAPLINSKIEntry Class Code: WEB,10.0
12/13/2022,,Withdrawal ACH COINBASE INC./TYPE: 8889087930 ID: 1327000623CO: COINBASE INC.NAME: STEVEN J CHAPLINSKIEntry Class Code: WEB,10.0,,Posted,724.31,2022-12-13,10.0,Withdrawal ACH COINBASE INC./TYPE: 8889087930 ID: 1327000623CO: COINBASE INC.NAME: STEVEN J CHAPLINSKIEntry Class Code: WEB,10.0
12/12/2022,,Recurring Withdrawal Debit Card Fee/MASTERCARD ISSUER CROSS-BORDER FEEDate 12/11/22 0 2345994966 0 5734Card 2801,0.07,,Posted,734.31,2022-12-12,0.07,Recurring Withdrawal Debit Card Fee/MASTERCARD ISSUER CROSS-BORDER FEEDate 05/12/21 0 1132191600 1 7372Card 2801,0.09500000000000001
12/12/2022,,Recurring Withdrawal Debit Card MC Debit/PAYPAL *LINKTREEPTY 4029357733 AUDate 12/11/22 0 2345994966 0 5734Card 2801,9.0,,Posted,734.38,2022-12-12,9.0,Recurring Withdrawal Debit Card MC Debit/PAYPAL *LINKTREE 4029357733 AUDate 05/12/21 0 1132191600 1 7372Card 2801,9.0
12/12/2022,,Withdrawal ACH APPLECARD GSBANK/TYPE: PAYMENT ID: 9999999999CO: APPLECARD GSBANKNAME: Steven ChaplinskiEntry Class Code: WEB,4.64,,Posted,743.38,2022-12-12,4.64,Withdrawal ACH APPLECARD GSBANK/TYPE: PAYMENT ID: 9999999999CO: APPLECARD GSBANKNAME: Steven ChaplinskiEntry Class Code: WEB,4.64
12/12/2022,,Withdrawal ACH ENVATO/CO: ENVATOTYPE: IAT PAYPAL ID: 770510487CEntry Class Code: IAT,39.0,,Posted,748.02,2022-12-12,39.0,Withdrawal ACH ENVATO/CO: ENVATOTYPE: IAT PAYPAL ID: 770510487CEntry Class Code: IAT,39.0
12/12/2022,,Withdrawal ACH BRAINLY/CO: BRAINLYTYPE: IAT PAYPAL ID: 770510487CEntry Class Code: IAT,10.0,,Posted,787.02,2022-12-12,10.0,Withdrawal ACH BRAINLY/CO: BRAINLYTYPE: IAT PAYPAL ID: 770510487CEntry Class Code: IAT,10.0
12/12/2022,,Withdrawal ACH TARGET CARD SRVC/TYPE: BILL PAY ID: T510215170CO: TARGET CARD SRVCNAME: 7S CH0000000APLINSKI TEntry Class Code: WEB,90.2,,Posted,797.02,2022-12-12,90.2,Withdrawal ACH TARGET CARD SRVC/TYPE: BILL PAY ID: 5411721813CO: TARGET CARD SRVCNAME: S CHAPLINSKI TEntry Class Code: WEB,90.2
12/12/2022,,Withdrawal ACH PAYPAL/TYPE: INST XFER ID: PAYPALSI77CO: PAYPAL NAME: STEVEN CHAPLINSKIEntry Class Code: WEB,9.99,,Posted,887.22,2022-12-12,9.99,Withdrawal ACH PAYPAL/TYPE: INST XFER ID: PAYPALSI77CO: PAYPAL NAME: STEVEN CHAPLINSKIEntry Class Code: WEB,10.093333333333334
12/11/2022,,Recurring Withdrawal Debit Card MC Debit/AFFIRM.COM PAYMENTS SAN FRANCISC CADate 12/10/22 0 2344036677 1 5999Card 2801,16.25,,Posted,897.21,2022-12-11,16.25,Recurring Withdrawal Debit Card MC Debit/AFFIRM.COM PAYMENTS SAN FRANCISC CADate 12/10/22 0 2344036677 1 5999Card 2801,16.25
12/11/2022,,Withdrawal Debit Card MC Debit/LASTPASS.COM MADate 12/09/22 0 2343819673 0 5968Card 2801,36.0,,Posted,913.46,2022-12-11,36.0,Withdrawal Debit Card MC Debit/LASTPASS.COM MADate 12/09/22 0 2343819673 0 5968Card 2801,36.0
12/10/2022,,Withdrawal POS #000000142991/SUNOCO 8002212501 4234 SW 20TH AVEGAINESVILLE FLCard 2801,26.73,,Posted,949.46,2022-12-10,26.73,Withdrawal POS #000000639499/SUNOCO 8002212501 4234 SW 20TH AVEGAINESVILLE FLCard 2801,26.73
12/9/2022,,Withdrawal Debit Card MC Debit/WALGREENS #5024 800-289-2273 FLDate 12/08/22 0 2342147730 1 5912Card 2801,7.42,,Posted,897.59,2022-12-09,7.42,Withdrawal Debit Card MC Debit/WALGREENS #5024 800-289-2273 FLDate 05/21/22 0 2141999930 0 5912Card 2801,7.42
12/8/2022,,Withdrawal POS #000000749592/PUBLIX 9200 NW 39TH AVE GAINESVILLE FLCard 2801,43.26,,Posted,905.01,2022-12-08,43.26,Withdrawal POS #000000749592/PUBLIX 9200 NW 39TH AVE GAINESVILLE FLCard 2801,43.26
12/8/2022,,Withdrawal Debit Card MC Debit/GATE 1445 Q80 GAINESVILLE FLDate 12/07/22 0 2341109713 1 5541Card 2801,33.23,,Posted,948.27,2022-12-08,33.23,Withdrawal Debit Card MC Debit/GATE 1445 Q80 GAINESVILLE FLDate 12/07/22 0 2341109713 1 5541Card 2801,33.23
12/8/2022,,Withdrawal POS #000005024823/PAYPAL *VIDIQ 2211 North First StreetJose CACard 2801,10.0,,Posted,981.5,2022-12-08,10.0,Withdrawal POS #000005221556/PAYPAL *VIDIQ 2211 North First StreetJose CACard 2801,10.0
12/6/2022,,Withdrawal Debit Card MC Debit/PUBLIX #680 GAINESVILLE FLDate 12/05/22 0 2339114199 1 5411Card 2801,48.09,,Posted,991.5,2022-12-06,48.09,Withdrawal Debit Card MC Debit/PUBLIX #1560 GAINESVILLE FLDate 09/04/21 0 1247836114 5 5411Card 2801,47.715
12/6/2022,,Withdrawal ACH PAYPAL/TYPE: INST XFER ID: PAYPALSI77CO: PAYPAL NAME: STEVEN CHAPLINSKIEntry Class Code: WEB,5.66,,Posted,1039.59,2022-12-06,5.66,Withdrawal ACH PAYPAL/TYPE: INST XFER ID: PAYPALSI77CO: PAYPAL NAME: STEVEN CHAPLINSKIEntry Class Code: WEB,6.0875
12/6/2022,,Withdrawal ACH PAYPAL/TYPE: INST XFER ID: PAYPALSI77CO: PAYPAL NAME: STEVEN CHAPLINSKIEntry Class Code: WEB,4.99,,Posted,1045.25,2022-12-06,4.99,Withdrawal ACH PAYPAL/TYPE: INST XFER ID: PAYPALSI77CO: PAYPAL NAME: STEVEN CHAPLINSKIEntry Class Code: WEB,4.96
12/6/2022,,Withdrawal POS #000000000006/AMAZON.COM*EX9514ED3 SEATTLE WACard 2801,10.15,,Posted,1050.24,2022-12-06,10.15,Withdrawal POS #000000000003/AMAZON.COM*1Z8447YO1 SEATTLE WACard 2801,10.15
12/6/2022,,Recurring Withdrawal Bill Payment - #000000471011/NETFLIX COM LOS GATOS CACard 2801,10.98,,Posted,1060.39,2022-12-06,10.98,Recurring Withdrawal Bill Payment - #000006911729/NETFLIX COM LOS GATOS CACard 2801,10.99
12/5/2022,,Withdrawal POS #000093424601/BP#8996613SUNRI GAINESVILLE FLCard 2801,30.98,,Posted,1071.37,2022-12-05,30.98,Withdrawal POS #000093424601/BP#8996613SUNRI GAINESVILLE FLCard 2801,30.98
12/5/2022,,Withdrawal ACH ENVATO/CO: ENVATOTYPE: IAT PAYPAL ID: 770510487CEntry Class Code: IAT,23.0,,Posted,1102.35,2022-12-05,23.0,Withdrawal ACH ENVATO/CO: ENVATOTYPE: IAT PAYPAL ID: 770510487CEntry Class Code: IAT,23.0
12/5/2022,,Withdrawal ACH Watson Realty Co/TYPE: WEB PMTS ID: 9000321157CO: Watson Realty CoNAME: Steven chaplinskiEntry Class Code: WEB,995.0,,Posted,1125.35,2022-12-05,995.0,Withdrawal ACH Watson Realty Co/TYPE: WEB PMTS ID: 9000321157CO: Watson Realty CoEntry Class Code: WEB,995.0
12/5/2022,,Withdrawal ACH PAYPAL/TYPE: INST XFER ID: PAYPALSI77CO: PAYPAL NAME: STEVEN CHAPLINSKIEntry Class Code: WEB,17.23,,Posted,2120.35,2022-12-05,17.23,Withdrawal ACH PAYPAL/TYPE: INST XFER ID: PAYPALSI77CO: PAYPAL NAME: STEVEN CHAPLINSKIEntry Class Code: WEB,17.3975
12/5/2022,,Withdrawal ACH PAYPAL/TYPE: INST XFER ID: PAYPALSI77CO: PAYPAL NAME: STEVEN CHAPLINSKIEntry Class Code: WEB,14.99,,Posted,2137.58,2022-12-05,14.99,Withdrawal ACH PAYPAL/TYPE: INST XFER ID: PAYPALSI77CO: PAYPAL NAME: STEVEN CHAPLINSKIEntry Class Code: WEB,14.948333333333332
12/5/2022,,Withdrawal ACH PAYPAL/TYPE: INST XFER ID: PAYPALSI77CO: PAYPAL NAME: STEVEN CHAPLINSKIEntry Class Code: WEB,2.99,,Posted,2152.57,2022-12-05,2.99,Withdrawal ACH PAYPAL/TYPE: INST XFER ID: PAYPALSI77CO: PAYPAL NAME: STEVEN CHAPLINSKIEntry Class Code: WEB,3.218
12/4/2022,,Recurring Withdrawal Debit Card MC Debit/PLAYERAUCTIONS 800-342-0768 DEDate 12/03/22 0 2337672541 0 7993Card 2801,70.99,,Posted,2155.56,2022-12-04,70.99,Recurring Withdrawal Debit Card MC Debit/PLAYERAUCTIONS 800-342-0768 DEDate 09/23/21 0 1266586911 1 7993Card 2801,70.99
12/2/2022,,Withdrawal ACH PAYPAL/TYPE: INST XFER ID: PAYPALSI77CO: PAYPAL NAME: STEVEN CHAPLINSKIEntry Class Code: WEB,11.48,,Posted,2226.55,2022-12-02,11.48,Withdrawal ACH PAYPAL/TYPE: INST XFER ID: PAYPALSI77CO: PAYPAL NAME: STEVEN CHAPLINSKIEntry Class Code: WEB,11.7425
12/1/2022,,Recurring Withdrawal Debit Card MC Debit/CHEGG ORDER 8558681054 CADate 11/30/22 0 2334889051 0 5942Card 2801,15.95,,Posted,2238.03,2022-12-01,15.95,Withdrawal Debit Card MC Debit/CHEGG ORDER 8558681054 CADate 09/01/22 0 2244077661 1 5942Card 2801,15.95
12/1/2022,,Withdrawal ACH PADDLE.COM MARKE/CO: PADDLE.COM MARKET LIMITEDTYPE: IAT PAYPAL ID: 770510487CEntry Class Code: IAT,2.99,,Posted,2253.98,2022-12-01,2.99,Withdrawal ACH PADDLE.COM MARKE/CO: PADDLE.COM MARKET LIMITEDTYPE: IAT PAYPAL ID: 770510487CEntry Class Code: IAT,2.99
12/1/2022,,Withdrawal POS #000000073914/PUBLIX 3930 SW ARCHER ROAD GAINESVILLECard 2801,127.63,,Posted,2256.97,2022-12-01,127.63,Withdrawal POS #000000753028/PUBLIX 3930 SW ARCHER ROAD GAINESVILLECard 1247,127.63
12/1/2022,,Withdrawal ACH PAYPAL/TYPE: INST XFER ID: PAYPALSI77CO: PAYPAL NAME: STEVEN CHAPLINSKIEntry Class Code: WEB,3.0,,Posted,2384.6,2022-12-01,3.0,Withdrawal ACH PAYPAL/TYPE: INST XFER ID: PAYPALSI77CO: PAYPAL NAME: STEVEN CHAPLINSKIEntry Class Code: WEB,3.218
11/30/2022,,Withdrawal Debit Card MC Debit/GAINESVILLE ORAL AND I GAINESVILLE FLDate 11/29/22 0 2333085865 1 8021Card 2801,284.2,,Posted,2387.6,2022-11-30,284.2,Withdrawal Debit Card MC Debit/GAINESVILLE ORAL AND I GAINESVILLE FLDate 11/29/22 0 2333085865 1 8021Card 2801,284.2
11/30/2022,,Withdrawal Debit Card MC Debit/GRU/EZ-PAY WEB PYMT 352-334-3434 FLDate 11/29/22 0 2333314423 0 4900Card 2801,174.23,,Posted,2671.8,2022-11-30,174.23,Withdrawal Debit Card MC Debit/GRU/EZ-PAY WEB PYMT 352-334-3434 FLDate 11/01/21 0 1305577800 0 4900Card 2801,174.66
11/30/2022,,Withdrawal Debit Card MC Debit/COX GAINESVILLE COMM 800-234-3993 FLDate 11/29/22 0 2333886169 0 4899Card 2801,124.96,,Posted,2846.03,2022-11-30,124.96,Withdrawal Debit Card MC Debit/COX GAINESVILLE COMM 800-234-3993 FLDate 01/27/22 0 2027240681 1 4899Card 2801,124.995
11/30/2022,,Withdrawal ACH DISCOVER/TYPE: E-PAYMENT ID: 2510020270CO: DISCOVER NAME: CHAPLINSKI STEVENEntry Class Code: WEB,34.0,,Posted,2690.99,2022-11-30,34.0,Withdrawal ACH DISCOVER/TYPE: E-PAYMENT ID: 2510020270CO: DISCOVER NAME: CHAPLINSKI STEVENEntry Class Code: WEB,33.5
11/29/2022,,Withdrawal ACH FLUENT-Gainesvil/TYPE: PAYMENT ID: 1371804719CO: FLUENT-GainesvilEntry Class Code: PPD,90.0,,Posted,26.74,2022-11-29,90.0,Withdrawal ACH FLUENT-Gainesvil/TYPE: PAYMENT ID: 1371804719CO: FLUENT-GainesvilEntry Class Code: PPD,90.0
11/29/2022,,Withdrawal ACH PAYPAL/TYPE: INST XFER ID: PAYPALSI77CO: PAYPAL NAME: STEVEN CHAPLINSKIEntry Class Code: WEB,2.99,,Posted,116.74,2022-11-29,2.99,Withdrawal ACH PAYPAL/TYPE: INST XFER ID: PAYPALSI77CO: PAYPAL NAME: STEVEN CHAPLINSKIEntry Class Code: WEB,3.218
11/28/2022,,Withdrawal Debit Card MC Debit/PUBLIX #680 GAINESVILLE FLDate 11/27/22 0 2331917962 0 5411Card 2801,92.23,,Posted,119.73,2022-11-28,92.23,Withdrawal Debit Card MC Debit/PUBLIX #795 GAINESVILLE FLDate 03/07/22 0 2066965570 0 5411Card 2801,92.23
11/28/2022,,Recurring Withdrawal Debit Card MC Debit/JASPER.AI ROLLINGWOOD TXDate 11/27/22 0 2331918341 0 7399Card 2801,29.0,,Posted,211.96,2022-11-28,29.0,Recurring Withdrawal Debit Card MC Debit/JASPER.AI ROLLINGWOOD TXDate 03/30/23 0 3089949341 0 7399Card 2801,29.0
11/28/2022,,Withdrawal Debit Card MC Debit/CIRCLE K # 26146 GAINESVILLE FLDate 11/27/22 0 2331080335 1 5541Card 2801,19.49,,Posted,240.96,2022-11-28,19.49,Withdrawal Debit Card MC Debit/CIRCLE K # 26146 GAINESVILLE FLDate 11/27/22 0 2331080335 1 5541Card 2801,19.49
11/28/2022,,Recurring Withdrawal Debit Card MC Debit/ADOBE *CREATIVE CLOUD 4085366000 CADate 11/27/22 0 2331079708 1 5734Card 2801,19.99,,Posted,260.45,2022-11-28,19.99,Recurring Withdrawal Debit Card MC Debit/ADOBE *CREATIVE CLOUD 4085366000 CADate 04/27/23 0 3117844835 0 5734Card 2801,19.99
11/28/2022,,Withdrawal ACH PAYPAL/TYPE: INST XFER ID: PAYPALSI77CO: PAYPAL NAME: STEVEN CHAPLINSKIEntry Class Code: WEB,29.99,,Posted,280.44,2022-11-28,29.99,Withdrawal ACH PAYPAL/TYPE: INST XFER ID: PAYPALSI77CO: PAYPAL NAME: STEVEN CHAPLINSKIEntry Class Code: WEB,29.99
11/28/2022,,Withdrawal ACH PAYPAL/TYPE: INST XFER ID: PAYPALSI77CO: PAYPAL NAME: STEVEN CHAPLINSKIEntry Class Code: WEB,14.99,,Posted,310.43,2022-11-28,14.99,Withdrawal ACH PAYPAL/TYPE: INST XFER ID: PAYPALSI77CO: PAYPAL NAME: STEVEN CHAPLINSKIEntry Class Code: WEB,14.948333333333332
11/28/2022,,Withdrawal ACH PAYPAL/TYPE: INST XFER ID: PAYPALSI77CO: PAYPAL NAME: STEVEN CHAPLINSKIEntry Class Code: WEB,4.5,,Posted,325.42,2022-11-28,4.5,Withdrawal ACH PAYPAL/TYPE: INST XFER ID: PAYPALSI77CO: PAYPAL NAME: STEVEN CHAPLINSKIEntry Class Code: WEB,4.96
11/28/2022,,Withdrawal ACH PAYPAL/TYPE: INST XFER ID: PAYPALSI77CO: PAYPAL NAME: STEVEN CHAPLINSKIEntry Class Code: WEB,2.99,,Posted,329.92,2022-11-28,2.99,Withdrawal ACH PAYPAL/TYPE: INST XFER ID: PAYPALSI77CO: PAYPAL NAME: STEVEN CHAPLINSKIEntry Class Code: WEB,3.218
11/27/2022,,Withdrawal POS #000000196178/AMAZON.COM*HZ05L0OS1 SEATTLE WACard 2801,23.18,,Posted,332.91,2022-11-27,23.18,Withdrawal POS #000000990788/AMAZON.COM*215VY1SG1 SEATTLE WACard 2801,23.03
11/25/2022,,Withdrawal POS #000000802128/SUNOCO 8002212501 4234 SW 20TH AVEGAINESVILLE FLCard 2801,32.08,,Posted,98.28,2022-11-25,32.08,Withdrawal POS #000000219124/SUNOCO 8002212501 4234 SW 20TH AVEGAINESVILLE FLCard 2801,32.474999999999994
11/25/2022,,Withdrawal ACH AMZ_STORECRD_PMT/TYPE: PAYMENT ID: 9069872000CO: AMZ_STORECRD_PMTNAME: 6045781157416487Entry Class Code: WEB,37.0,,Posted,55.36,2022-11-25,37.0,Withdrawal ACH AMZ_STORECRD_PMT/TYPE: PAYMENT ID: 9069872000CO: AMZ_STORECRD_PMTNAME: 6045781157416487Entry Class Code: WEB,37.0
11/24/2022,,Withdrawal Debit Card MC Debit/SESAME CARE - HEALTH MIAMI FLDate 11/23/22 0 2327908189 0 8099Card 2801,30.4,,Posted,92.36,2022-11-24,30.4,Withdrawal Debit Card MC Debit/SESAME CARE - HEALTH MIAMI FLDate 11/23/22 0 2327908189 0 8099Card 2801,30.4
11/24/2022,,Recurring Withdrawal Debit Card MC Debit/PLAYERAUCTIONS 800-342-0768 DEDate 11/24/22 0 2328315966 1 7993Card 2801,34.31,,Posted,122.76,2022-11-24,34.31,Recurring Withdrawal Debit Card MC Debit/PLAYERAUCTIONS 800-342-0768 DEDate 09/23/21 0 1266586911 1 7993Card 2801,34.31
11/24/2022,,Withdrawal Debit Card MC Debit/WALGREENS #5024 800-289-2273 FLDate 11/23/22 0 2327045498 1 5912Card 2801,10.27,,Posted,157.07,2022-11-24,10.27,Withdrawal Debit Card MC Debit/WALGREENS #5024 800-289-2273 FLDate 08/26/22 0 2238277635 2 5912Card 2801,10.27
11/23/2022,,Withdrawal Debit Card MC Debit/PUBLIX #1312 GAINESVILLE FLDate 11/22/22 0 2326197102 1 5411Card 2801,69.38,,Posted,167.34,2022-11-23,69.38,Withdrawal Debit Card MC Debit/PUBLIX #1312 GAINESVILLE FLDate 12/24/21 0 1358678113 1 5411Card 2801,69.38
11/23/2022,,Withdrawal POS #000000475170/AMAZON.COM*HI6FA2YH2 SEATTLE WACard 2801,10.68,,Posted,236.72,2022-11-23,10.68,Withdrawal POS #000000247445/AMAZON.COM*A42ZY7OC3 SEATTLE WACard 2801,10.475
11/22/2022,,Withdrawal POS #000000174475/SUNOCO 8002212501 4234 SW 20TH AVEGAINESVILLE FLCard 2801,21.38,,Posted,247.4,2022-11-22,21.38,Withdrawal POS #000000177815/SUNOCO 8002212501 4234 SW 20TH AVEGAINESVILLE FLCard 2801,21.38
11/22/2022,,Withdrawal ACH FLUENT-Gainesvil/TYPE: PAYMENT ID: 1371804719CO: FLUENT-GainesvilEntry Class Code: PPD,91.01,,Posted,118.78,2022-11-22,91.01,Withdrawal ACH FLUENT-Gainesvil/TYPE: PAYMENT ID: 1371804719CO: FLUENT-GainesvilEntry Class Code: PPD,91.505
11/22/2022,,Withdrawal POS #000000000873/AMAZON.COM*HI8SN2DS2 SEATTLE WACard 2801,10.15,,Posted,209.79,2022-11-22,10.15,Withdrawal POS #000000000873/AMAZON.COM*HI8SN2DS2 SEATTLE WACard 2801,10.406666666666666
11/21/2022,,Withdrawal Debit Card MC Debit/WALGREENS #5024 800-289-2273 FLDate 11/20/22 0 2324948463 0 5912Card 2801,3.91,,Posted,219.94,2022-11-21,3.91,Withdrawal Debit Card MC Debit/WALGREENS #5024 800-289-2273 FLDate 05/21/22 0 2141999930 0 5912Card 2801,3.81
11/21/2022,,Withdrawal ACH PAYPAL/TYPE: INST XFER ID: PAYPALSI77CO: PAYPAL NAME: STEVEN CHAPLINSKIEntry Class Code: WEB,9.18,,Posted,223.85,2022-11-21,9.18,Withdrawal ACH PAYPAL/TYPE: INST XFER ID: PAYPALSI77CO: PAYPAL NAME: STEVEN CHAPLINSKIEntry Class Code: WEB,9.015
11/20/2022,,Withdrawal POS #000000003339/CIRCLE K # 26146 3525 GAINESVILLE FLCard 2801,19.49,,Posted,233.03,2022-11-20,19.49,Withdrawal POS #000000003339/CIRCLE K # 26146 3525 GAINESVILLE FLCard 2801,19.49
11/20/2022,,Withdrawal POS #000002394786/GOOGLE *YouTubePremium 1600 AmphitheatreParkw Mountain View CACard 2801,13.62,,Posted,252.52,2022-11-20,13.62,Withdrawal POS #000003285955/GOOGLE *YouTubePremium 1600 AmphitheatreParkw Mountain View CACard 2801,13.629999999999999
11/18/2022,,Recurring Withdrawal Debit Card MC Debit/PLAYERAUCTIONS 800-342-0768 DEDate 11/17/22 0 2321371857 0 7993Card 2801,63.74,,Posted,266.14,2022-11-18,63.74,Recurring Withdrawal Debit Card MC Debit/PLAYERAUCTIONS 800-342-0768 DEDate 11/17/22 0 2321371857 0 7993Card 2801,63.74
11/18/2022,,Withdrawal ACH PAYPAL/TYPE: INST XFER ID: PAYPALSI77CO: PAYPAL NAME: STEVEN CHAPLINSKIEntry Class Code: WEB,99.99,,Posted,329.88,2022-11-18,99.99,Withdrawal ACH PAYPAL/TYPE: INST XFER ID: PAYPALSI77CO: PAYPAL NAME: STEVEN CHAPLINSKIEntry Class Code: WEB,99.99
11/17/2022,,Withdrawal ACH PAYPAL/TYPE: INST XFER ID: PAYPALSI77CO: PAYPAL NAME: STEVEN CHAPLINSKIEntry Class Code: WEB,24.95,,Posted,264.87,2022-11-17,24.95,Withdrawal ACH PAYPAL/TYPE: INST XFER ID: PAYPALSI77CO: PAYPAL NAME: STEVEN CHAPLINSKIEntry Class Code: WEB,24.97
11/16/2022,,Withdrawal ACH PAYPAL/TYPE: INST XFER ID: PAYPALSI77CO: PAYPAL NAME: STEVEN CHAPLINSKIEntry Class Code: WEB,8.99,,Posted,289.82,2022-11-16,8.99,Withdrawal ACH PAYPAL/TYPE: INST XFER ID: PAYPALSI77CO: PAYPAL NAME: STEVEN CHAPLINSKIEntry Class Code: WEB,9.015
11/15/2022,,Withdrawal Debit Card MC Debit/PUBLIX #1312 GAINESVILLE FLDate 11/14/22 0 2318057599 1 5411Card 2801,135.45,,Posted,298.81,2022-11-15,135.45,Withdrawal Debit Card MC Debit/PUBLIX #1312 GAINESVILLE FLDate 12/24/21 0 1358678113 1 5411Card 2801,135.45
11/14/2022,,Withdrawal POS #000096292125/FAST TRACK #200 GAINESVILLE FLCard 2801,19.46,,Posted,434.26,2022-11-14,19.46,Withdrawal POS #000096296533/FAST TRACK #200 GAINESVILLE FLCard 2801,19.486666666666665
11/14/2022,,Withdrawal ACH CANVA PTY LIMITE/CO: CANVA PTY LIMITEDTYPE: IAT PAYPAL ID: 770510487CEntry Class Code: IAT,12.99,,Posted,453.72,2022-11-14,12.99,Withdrawal ACH CANVA PTY LIMITE/CO: CANVA PTY LIMITEDTYPE: IAT PAYPAL ID: 770510487CEntry Class Code: IAT,12.99
11/14/2022,,Withdrawal ACH BRAINLY/CO: BRAINLYTYPE: IAT PAYPAL ID: 770510487CEntry Class Code: IAT,10.0,,Posted,466.71,2022-11-14,10.0,Withdrawal ACH BRAINLY/CO: BRAINLYTYPE: IAT PAYPAL ID: 770510487CEntry Class Code: IAT,10.0
11/14/2022,,Withdrawal ACH TARGET CARD SRVC/TYPE: BILL PAY ID: T510215170CO: TARGET CARD SRVCNAME: 7S CH0000000APLINSKI TEntry Class Code: WEB,90.2,,Posted,476.71,2022-11-14,90.2,Withdrawal ACH TARGET CARD SRVC/TYPE: BILL PAY ID: 5411721813CO: TARGET CARD SRVCNAME: S CHAPLINSKI TEntry Class Code: WEB,90.2
11/14/2022,,Withdrawal ACH PAYPAL/TYPE: INST XFER ID: PAYPALSI77CO: PAYPAL NAME: STEVEN CHAPLINSKIEntry Class Code: WEB,9.99,,Posted,566.91,2022-11-14,9.99,Withdrawal ACH PAYPAL/TYPE: INST XFER ID: PAYPALSI77CO: PAYPAL NAME: STEVEN CHAPLINSKIEntry Class Code: WEB,10.093333333333334
11/14/2022,,Withdrawal POS #000000293725/AMAZON.COM*HB3H53TR2 SEATTLE WACard 2801,23.18,,Posted,576.9,2022-11-14,23.18,Withdrawal POS #000000626675/AMAZON.COM*1F8259P12 SEATTLE WACard 2801,23.18
11/13/2022,,Recurring Withdrawal Debit Card Fee/MASTERCARD ISSUER CROSS-BORDER FEEDate 11/11/22 0 2315649444 1 5734Card 2801,0.07,,Posted,600.08,2022-11-13,0.07,Recurring Withdrawal Debit Card Fee/MASTERCARD ISSUER CROSS-BORDER FEEDate 12/11/21 0 1345316936 1 5817Card 2801,0.08666666666666667
11/13/2022,,Recurring Withdrawal Debit Card MC Debit/PAYPAL *LINKTREEPTY 4029357733 AUDate 11/11/22 0 2315649444 1 5734Card 2801,9.0,,Posted,600.15,2022-11-13,9.0,Recurring Withdrawal Debit Card MC Debit/PAYPAL *LINKTREE 4029357733 AUDate 05/12/21 0 1132191600 1 7372Card 2801,9.0
11/11/2022,,Withdrawal POS #000000000586/AMAZON.COM*HB8IG9X21 SEATTLE WACard 2801,20.32,,Posted,609.15,2022-11-11,20.32,Withdrawal POS #000000000873/AMAZON.COM*HI8SN2DS2 SEATTLE WACard 2801,20.2
11/10/2022,,Withdrawal Debit Card MC Debit/PUBLIX #1312 GAINESVILLE FLDate 11/09/22 0 2313064607 1 5411Card 2801,65.66,,Posted,629.47,2022-11-10,65.66,Withdrawal Debit Card MC Debit/PUBLIX #1312 GAINESVILLE FLDate 12/24/21 0 1358678113 1 5411Card 2801,65.66
11/10/2022,,Withdrawal Debit Card MC Debit/WALGREENS #5024 800-289-2273 FLDate 11/09/22 0 2313061342 1 5912Card 2801,60.66,,Posted,695.13,2022-11-10,60.66,Withdrawal Debit Card MC Debit/WALGREENS #5024 800-289-2273 FLDate 12/19/22 0 2353181854 1 5912Card 2801,60.66
11/10/2022,,Withdrawal ACH ENVATO/CO: ENVATOTYPE: IAT PAYPAL ID: 770510487CEntry Class Code: IAT,39.0,,Posted,755.79,2022-11-10,39.0,Withdrawal ACH ENVATO/CO: ENVATOTYPE: IAT PAYPAL ID: 770510487CEntry Class Code: IAT,39.0
11/10/2022,,Withdrawal POS #000000000004/AMAZON.COM*HB21Z6M20 SEATTLE WACard 2801,8.55,,Posted,794.79,2022-11-10,8.55,Withdrawal POS #000000000003/AMAZON.COM*1Z8447YO1 SEATTLE WACard 2801,8.55
11/8/2022,,Withdrawal POS #000000173052/AMAZON.COM*H21U27Y71 SEATTLE WACard 2801,9.51,,Posted,803.34,2022-11-08,9.51,Withdrawal POS #000000990788/AMAZON.COM*215VY1SG1 SEATTLE WACard 2801,9.07
11/8/2022,,Withdrawal POS #000005069927/PAYPAL *VIDIQ 2211 North First StreetJose CACard 2801,10.0,,Posted,812.85,2022-11-08,10.0,Withdrawal POS #000005221556/PAYPAL *VIDIQ 2211 North First StreetJose CACard 2801,10.0
11/7/2022,,Withdrawal ACH ENVATO/CO: ENVATOTYPE: IAT PAYPAL ID: 770510487CEntry Class Code: IAT,23.0,,Posted,822.85,2022-11-07,23.0,Withdrawal ACH ENVATO/CO: ENVATOTYPE: IAT PAYPAL ID: 770510487CEntry Class Code: IAT,23.0
11/7/2022,,Withdrawal ACH PAYPAL/TYPE: INST XFER ID: PAYPALSI77CO: PAYPAL NAME: STEVEN CHAPLINSKIEntry Class Code: WEB,5.66,,Posted,845.85,2022-11-07,5.66,Withdrawal ACH PAYPAL/TYPE: INST XFER ID: PAYPALSI77CO: PAYPAL NAME: STEVEN CHAPLINSKIEntry Class Code: WEB,6.0875
11/7/2022,,Withdrawal ACH PAYPAL/TYPE: INST XFER ID: PAYPALSI77CO: PAYPAL NAME: STEVEN CHAPLINSKIEntry Class Code: WEB,4.99,,Posted,851.51,2022-11-07,4.99,Withdrawal ACH PAYPAL/TYPE: INST XFER ID: PAYPALSI77CO: PAYPAL NAME: STEVEN CHAPLINSKIEntry Class Code: WEB,4.96
11/6/2022,,Withdrawal POS #000000763450/SUNOCO 8002212501 4234 SW 20TH AVEGAINESVILLE FLCard 2801,21.38,,Posted,856.5,2022-11-06,21.38,Withdrawal POS #000000639499/SUNOCO 8002212501 4234 SW 20TH AVEGAINESVILLE FLCard 2801,21.38
11/6/2022,,Withdrawal POS #000000342915/SUNOCO 8002212501 4234 SW 20TH AVEGAINESVILLE FLCard 2801,8.55,,Posted,877.88,2022-11-06,8.55,Withdrawal POS #000000955321/SUNOCO 8002212501 4234 SW 20TH AVEGAINESVILLE FLCard 2801,8.55
11/6/2022,,Withdrawal POS #000000498317/AMAZON.COM*H20LE3DA1 SEATTLE WACard 2801,23.18,,Posted,886.43,2022-11-06,23.18,Withdrawal POS #000000853317/AMAZON.COM*HM8GC4P91 SEATTLE WACard 2801,23.18
11/6/2022,,Recurring Withdrawal Bill Payment - #000000026409/NETFLIX COM LOS GATOS CACard 2801,10.98,,Posted,909.61,2022-11-06,10.98,Recurring Withdrawal Bill Payment - #000006911729/NETFLIX COM LOS GATOS CACard 2801,10.99
11/6/2022,,Withdrawal POS #000000213746/AMAZON.COM*H20Y57OX2 SEATTLE WACard 2801,50.84,,Posted,920.59,2022-11-06,50.84,Withdrawal POS #000000247445/AMAZON.COM*A42ZY7OC3 SEATTLE WACard 2801,50.84
11/4/2022,,Withdrawal POS #000000190083/WAWA 5325 2373 SW ARCHER ROADFLCard 2801,24.55,,Posted,971.43,2022-11-04,24.55,Withdrawal POS #000000553411/WAWA 5325 2373 SW ARCHER ROADFLCard 1247,24.55
11/4/2022,,Withdrawal Debit Card MC Debit/GRU/EZ-PAY WEB PYMT 352-334-3434 FLDate 11/03/22 0 2307358881 0 4900Card 2801,205.33,,Posted,995.98,2022-11-04,205.33,Withdrawal Debit Card MC Debit/GRU/EZ-PAY WEB PYMT 352-334-3434 FLDate 11/01/21 0 1305577800 0 4900Card 2801,205.33
11/4/2022,,Withdrawal Debit Card MC Debit/COX GAINESVILLE COMM 800-234-3993 FLDate 11/03/22 0 2307872387 0 4899Card 2801,117.89,,Posted,1201.31,2022-11-04,117.89,Withdrawal Debit Card MC Debit/COX GAINESVILLE COMM 800-234-3993 FLDate 01/27/22 0 2027240681 1 4899Card 2801,117.89
11/4/2022,,Withdrawal ACH PAYPAL/TYPE: INST XFER ID: PAYPALSI77CO: PAYPAL NAME: STEVEN CHAPLINSKIEntry Class Code: WEB,14.99,,Posted,1319.2,2022-11-04,14.99,Withdrawal ACH PAYPAL/TYPE: INST XFER ID: PAYPALSI77CO: PAYPAL NAME: STEVEN CHAPLINSKIEntry Class Code: WEB,14.948333333333332
11/4/2022,,Withdrawal ACH PAYPAL/TYPE: INST XFER ID: PAYPALSI77CO: PAYPAL NAME: STEVEN CHAPLINSKIEntry Class Code: WEB,2.99,,Posted,1334.19,2022-11-04,2.99,Withdrawal ACH PAYPAL/TYPE: INST XFER ID: PAYPALSI77CO: PAYPAL NAME: STEVEN CHAPLINSKIEntry Class Code: WEB,3.218
11/2/2022,,Withdrawal POS #000000497604/SUNOCO 8002212501 4234 SW 20TH AVEGAINESVILLE FLCard 2801,29.93,,Posted,1337.18,2022-11-02,29.93,Withdrawal POS #000000899960/SUNOCO 8002212501 4234 SW 20TH AVEGAINESVILLE FLCard 2801,30.369999999999997
11/2/2022,,"Withdrawal Debit Card MC Debit/ACI*CREDIT ONE BANK, N 877-825-3242 NVDate 11/01/22 0 2305147365 1 6012Card 2801",180.0,,Posted,1367.11,2022-11-02,180.0,"Withdrawal Debit Card MC Debit/ACI*CREDIT ONE BANK, N 877-825-3242 NVDate 11/01/22 0 2305147365 1 6012Card 2801",180.0
11/2/2022,,Withdrawal ACH Watson Realty Co/TYPE: WEB PMTS ID: 9000321157CO: Watson Realty CoNAME: Steven chaplinskiEntry Class Code: WEB,995.0,,Posted,1547.11,2022-11-02,995.0,Withdrawal ACH Watson Realty Co/TYPE: WEB PMTS ID: 9000321157CO: Watson Realty CoEntry Class Code: WEB,995.0
11/2/2022,,Withdrawal ACH FLUENT-Gainesvil/TYPE: PAYMENT ID: 1371804719CO: FLUENT-GainesvilEntry Class Code: PPD,153.4,,Posted,2542.11,2022-11-02,153.4,Withdrawal ACH FLUENT-Gainesvil/TYPE: PAYMENT ID: 1371804719CO: FLUENT-GainesvilEntry Class Code: PPD,153.4
11/2/2022,,Withdrawal ACH PAYPAL/TYPE: INST XFER ID: PAYPALSI77CO: PAYPAL NAME: STEVEN CHAPLINSKIEntry Class Code: WEB,11.48,,Posted,2695.51,2022-11-02,11.48,Withdrawal ACH PAYPAL/TYPE: INST XFER ID: PAYPALSI77CO: PAYPAL NAME: STEVEN CHAPLINSKIEntry Class Code: WEB,11.7425
11/2/2022,,Withdrawal ACH PAYPAL/TYPE: INST XFER ID: PAYPALSI77CO: PAYPAL NAME: STEVEN CHAPLINSKIEntry Class Code: WEB,3.0,,Posted,2706.99,2022-11-02,3.0,Withdrawal ACH PAYPAL/TYPE: INST XFER ID: PAYPALSI77CO: PAYPAL NAME: STEVEN CHAPLINSKIEntry Class Code: WEB,3.218
11/1/2022,,Recurring Withdrawal Debit Card MC Debit/CHEGG ORDER 8558681054 CADate 10/31/22 0 2304767975 0 5942Card 2801,15.95,,Posted,2709.99,2022-11-01,15.95,Withdrawal Debit Card MC Debit/CHEGG ORDER 8558681054 CADate 09/01/22 0 2244077661 1 5942Card 2801,15.95
11/1/2022,,Withdrawal ACH PADDLE.COM MARKE/CO: PADDLE.COM MARKET LIMITEDTYPE: IAT PAYPAL ID: 770510487CEntry Class Code: IAT,2.99,,Posted,2725.94,2022-11-01,2.99,Withdrawal ACH PADDLE.COM MARKE/CO: PADDLE.COM MARKET LIMITEDTYPE: IAT PAYPAL ID: 770510487CEntry Class Code: IAT,2.99
10/31/2022,,Withdrawal ACH PAYPAL/TYPE: INST XFER ID: PAYPALSI77CO: PAYPAL NAME: STEVEN CHAPLINSKIEntry Class Code: WEB,2.99,,Posted,2678.93,2022-10-31,2.99,Withdrawal ACH PAYPAL/TYPE: INST XFER ID: PAYPALSI77CO: PAYPAL NAME: STEVEN CHAPLINSKIEntry Class Code: WEB,3.218
10/31/2022,,Withdrawal POS #000000000081/AMAZON.COM*H28L57OD0 SEATTLE WACard 2801,23.18,,Posted,2681.92,2022-10-31,23.18,Withdrawal POS #000000000003/AMAZON.COM*1Z8447YO1 SEATTLE WACard 2801,23.18
10/30/2022,,Withdrawal POS #000000915693/SUNOCO 8002212501 4234 SW 20TH AVEGAINESVILLE FLCard 2801,26.73,,Posted,2705.1,2022-10-30,26.73,Withdrawal POS #000000955321/SUNOCO 8002212501 4234 SW 20TH AVEGAINESVILLE FLCard 2801,26.73
10/28/2022,,Withdrawal Debit Card MC Debit/NEW SAMS.COM MEM# 888-746-7726 ARDate 10/26/22 0 2299821095 0 5300Card 2801,25.0,,Posted,231.83,2022-10-28,25.0,Withdrawal Debit Card MC Debit/NEW SAMS.COM MEM# 888-746-7726 ARDate 10/26/22 0 2299821095 0 5300Card 2801,25.0
10/28/2022,,Recurring Withdrawal Debit Card MC Debit/ADOBE *CREATIVE CLOUD 4085366000 CADate 10/27/22 0 2300818282 0 5734Card 2801,19.99,,Posted,256.83,2022-10-28,19.99,Recurring Withdrawal Debit Card MC Debit/ADOBE CREATIVE CLOUD 4085366000 CADate 09/28/22 0 2271807482 0 5734Card 2801,19.99
10/28/2022,,Withdrawal ACH APPLECARD GSBANK/TYPE: PAYMENT ID: 9999999999CO: APPLECARD GSBANKNAME: Steven ChaplinskiEntry Class Code: WEB,42.99,,Posted,276.82,2022-10-28,42.99,Withdrawal ACH APPLECARD GSBANK/TYPE: PAYMENT ID: 9999999999CO: APPLECARD GSBANKNAME: Steven ChaplinskiEntry Class Code: WEB,42.663333333333334
10/28/2022,,Withdrawal ACH PAYPAL/TYPE: INST XFER ID: PAYPALSI77CO: PAYPAL NAME: STEVEN CHAPLINSKIEntry Class Code: WEB,14.99,,Posted,319.81,2022-10-28,14.99,Withdrawal ACH PAYPAL/TYPE: INST XFER ID: PAYPALSI77CO: PAYPAL NAME: STEVEN CHAPLINSKIEntry Class Code: WEB,14.948333333333332
10/28/2022,,Withdrawal ACH PAYPAL/TYPE: INST XFER ID: PAYPALSI77CO: PAYPAL NAME: STEVEN CHAPLINSKIEntry Class Code: WEB,14.62,,Posted,334.8,2022-10-28,14.62,Withdrawal ACH PAYPAL/TYPE: INST XFER ID: PAYPALSI77CO: PAYPAL NAME: STEVEN CHAPLINSKIEntry Class Code: WEB,14.948333333333332
10/27/2022,,Withdrawal Debit Card MC Debit/WALGREENS #5024 800-289-2273 FLDate 10/26/22 0 2299017690 1 5912Card 2801,15.0,,Posted,349.42,2022-10-27,15.0,Withdrawal Debit Card MC Debit/WALGREENS #5024 800-289-2273 FLDate 05/21/22 0 2141999930 0 5912Card 2801,14.64
10/27/2022,,Withdrawal ACH TARGET DEBIT CRD/Location - TARGET -0687Gainesville FL / Terminal ID: 172TYPE: ACH TRAN ID: 1410215170CO: TARGET DEBIT CRDEntry Class C,24.9,,Posted,364.42,2022-10-27,24.9,Withdrawal ACH TARGET DEBIT CRD/Location - TARGET -0687Gainesville FL / Terminal ID: 172TYPE: ACH TRAN ID: 1410215170CO: TARGET DEBIT CRDEntry Class C,24.9
10/27/2022,,Withdrawal ACH PAYPAL/TYPE: INST XFER ID: PAYPALSI77CO: PAYPAL NAME: STEVEN CHAPLINSKIEntry Class Code: WEB,2.99,,Posted,389.32,2022-10-27,2.99,Withdrawal ACH PAYPAL/TYPE: INST XFER ID: PAYPALSI77CO: PAYPAL NAME: STEVEN CHAPLINSKIEntry Class Code: WEB,3.218
10/26/2022,,Withdrawal POS #000000177822/SUNOCO 8002212501 4234 SW 20TH AVEGAINESVILLE FLCard 2801,42.77,,Posted,392.31,2022-10-26,42.77,Withdrawal POS #000000177815/SUNOCO 8002212501 4234 SW 20TH AVEGAINESVILLE FLCard 2801,42.77
10/26/2022,,Withdrawal Debit Card MC Debit/PUBLIX #1376 GAINESVILLE FLDate 10/25/22 0 2298992341 0 5411Card 2801,66.88,,Posted,435.08,2022-10-26,66.88,Withdrawal Debit Card MC Debit/PUBLIX #1376 GAINESVILLE FLDate 10/25/22 0 2298992341 0 5411Card 2801,66.88
10/26/2022,,Withdrawal ACH PAYPAL/TYPE: INST XFER ID: PAYPALSI77CO: PAYPAL NAME: STEVEN CHAPLINSKIEntry Class Code: WEB,4.5,,Posted,501.96,2022-10-26,4.5,Withdrawal ACH PAYPAL/TYPE: INST XFER ID: PAYPALSI77CO: PAYPAL NAME: STEVEN CHAPLINSKIEntry Class Code: WEB,4.96
10/25/2022,,Withdrawal Debit Card MC Debit/PIZZA HUT 27918 3523739402 FLDate 10/23/22 0 2296800127 0 5812Card 2801,36.37,,Posted,506.46,2022-10-25,36.37,Withdrawal Debit Card MC Debit/PIZZA HUT 27918 3523739402 FLDate 12/16/22 0 2350808582 1 5812Card 2801,35.78666666666667
10/25/2022,,Withdrawal POS #000000000016/AMAZON.COM*H87HE1UT1 SEATTLE WACard 2801,8.63,,Posted,542.83,2022-10-25,8.63,Withdrawal POS #000000000023/AMAZON.COM*AU8ER6ZT3 SEATTLE WACard 2801,8.63
10/24/2022,,Withdrawal POS #000013106221/WALGREENS 2415 SW 75TH GAINESVILLE FLCard 2801,23.6,,Posted,551.46,2022-10-24,23.6,Withdrawal POS #000012002801/WALGREENS 3455 SW ARCH GAINESVILLE FLCard 2801,23.6
10/24/2022,,Withdrawal ACH FLUENT-Gainesvil/TYPE: PAYMENT ID: 1371804719CO: FLUENT-GainesvilEntry Class Code: PPD,84.4,,Posted,75.06,2022-10-24,84.4,Withdrawal ACH FLUENT-Gainesvil/TYPE: PAYMENT ID: 1371804719CO: FLUENT-GainesvilEntry Class Code: PPD,84.4
10/23/2022,,Withdrawal Debit Card MC Debit/PIZZA HUT 27918 3523739402 FLDate 10/21/22 0 2294861161 0 5812Card 2801,38.5,,Posted,159.46,2022-10-23,38.5,Withdrawal Debit Card MC Debit/PIZZA HUT 27918 3523739402 FLDate 12/16/22 0 2350808582 1 5812Card 2801,38.876666666666665
10/21/2022,,Withdrawal POS #000000943732/AMAZON.COM*HT1GK8UE2 SEATTLE WACard 2801,10.02,,Posted,197.96,2022-10-21,10.02,Withdrawal POS #000000173052/AMAZON.COM*H21U27Y71 SEATTLE WACard 2801,10.536666666666667
10/21/2022,,Withdrawal Debit Card MC Debit/WALGREENS #5024 GAINESVILLE FLDate 10/20/22 0 2293128318 1 5912Card 2801,20.83,,Posted,207.98,2022-10-21,20.83,Withdrawal Debit Card MC Debit/WALGREENS #5024 GAINESVILLE FLDate 06/23/23 0 3174465834 2 5912Card 2801,20.83
10/21/2022,,Withdrawal ACH PAYPAL/TYPE: INST XFER ID: PAYPALSI77CO: PAYPAL NAME: STEVEN CHAPLINSKIEntry Class Code: WEB,149.99,,Posted,228.81,2022-10-21,149.99,Withdrawal ACH PAYPAL/TYPE: INST XFER ID: PAYPALSI77CO: PAYPAL NAME: STEVEN CHAPLINSKIEntry Class Code: WEB,149.61333333333334
10/21/2022,,Withdrawal POS #000000000006/AMAZON.COM*HT5TG4K52 SEATTLE WACard 2801,62.33,,Posted,378.8,2022-10-21,62.33,Withdrawal POS #000000000001/AMAZON.COM*TK5HF56S1 SEATTLE WACard 2801,62.33
10/20/2022,,Withdrawal POS #000000000411/CIRCLE K # 26146 3525 GAINESVILLE FLCard 2801,19.45,,Posted,441.13,2022-10-20,19.45,Withdrawal POS #000000000558/CIRCLE K # 26146 3525 GAINESVILLE FLCard 2801,19.45
10/20/2022,,Recurring Withdrawal Debit Card Fee/MASTERCARD ISSUER CROSS-BORDER FEEDate 10/19/22 0 2292820530 0 5734Card 2801,0.1,,Posted,460.58,2022-10-20,0.1,Recurring Withdrawal Debit Card Fee/MASTERCARD ISSUER CROSS-BORDER FEEDate 05/12/21 0 1132191600 1 7372Card 2801,0.09500000000000001
10/20/2022,,Recurring Withdrawal Debit Card MC Debit/SWB* TRIAL OVER WELLINGTON NZDate 10/19/22 0 2292820530 0 5734Card 2801,12.0,,Posted,460.68,2022-10-20,12.0,Recurring Withdrawal Debit Card MC Debit/SWB* TRIAL OVER WELLINGTON NZDate 10/19/22 0 2292820530 0 5734Card 2801,12.0
10/20/2022,,Withdrawal ACH PAYPAL/TYPE: INST XFER ID: PAYPALSI77CO: PAYPAL NAME: STEVEN CHAPLINSKIEntry Class Code: WEB,9.18,,Posted,472.68,2022-10-20,9.18,Withdrawal ACH PAYPAL/TYPE: INST XFER ID: PAYPALSI77CO: PAYPAL NAME: STEVEN CHAPLINSKIEntry Class Code: WEB,9.015
10/20/2022,,Withdrawal ACH PAYPAL/TYPE: INST XFER ID: PAYPALSI77CO: PAYPAL NAME: STEVEN CHAPLINSKIEntry Class Code: WEB,6.48,,Posted,481.86,2022-10-20,6.48,Withdrawal ACH PAYPAL/TYPE: INST XFER ID: PAYPALSI77CO: PAYPAL NAME: STEVEN CHAPLINSKIEntry Class Code: WEB,6.0875
10/20/2022,,Withdrawal POS #000003027695/GOOGLE *YouTubePremium 1600 AmphitheatreParkw Mountain View CACard 2801,13.62,,Posted,488.34,2022-10-20,13.62,Withdrawal POS #000003285955/GOOGLE *YouTubePremium 1600 AmphitheatreParkw Mountain View CACard 2801,13.629999999999999
10/18/2022,,Withdrawal ACH CAPITAL ONE/TYPE: MOBILE PMT ID: 9279744380CO: CAPITAL ONE NAME: STEVEN CHAPLINSKIEntry Class Code: WEB,37.0,,Posted,501.96,2022-10-18,37.0,Withdrawal ACH CAPITAL ONE/TYPE: ONLINE PMT ID: 9279744391CO: CAPITAL ONE NAME: STEVEN CHAPLINSKIEntry Class Code: WEB,37.0
10/17/2022,,Withdrawal ACH PADDLE.COM MARKE/CO: PADDLE.COM MARKET LIMITEDTYPE: IAT PAYPAL ID: 770510487CEntry Class Code: IAT,12.49,,Posted,538.96,2022-10-17,12.49,Withdrawal ACH PADDLE.COM MARKE/CO: PADDLE.COM MARKET LIMITEDTYPE: IAT PAYPAL ID: 770510487CEntry Class Code: IAT,12.49
10/17/2022,,Recurring Withdrawal Debit Card MC Debit/JASPER.AI ROLLINGWOOD TXDate 10/16/22 0 2289052781 1 7399Card 2801,59.0,,Posted,551.45,2022-10-17,59.0,Recurring Withdrawal Debit Card MC Debit/JASPER.AI ROLLINGWOOD TXDate 03/30/23 0 3089949341 0 7399Card 2801,59.0
10/17/2022,,Withdrawal POS #000000603486/SUNOCO 8002212501 4234 SW 20TH AVEGAINESVILLE FLCard 2801,29.93,,Posted,610.45,2022-10-17,29.93,Withdrawal POS #000000639499/SUNOCO 8002212501 4234 SW 20TH AVEGAINESVILLE FLCard 2801,30.085
10/17/2022,,Withdrawal ACH TARGET CARD SRVC/TYPE: BILL PAY ID: T510215170CO: TARGET CARD SRVCNAME: 7S CH0000000APLINSKI TEntry Class Code: WEB,250.0,,Posted,640.38,2022-10-17,250.0,Withdrawal ACH TARGET CARD SRVC/TYPE: BILL PAY ID: 5411721813CO: TARGET CARD SRVCNAME: S CHAPLINSKI TEntry Class Code: WEB,250.0
10/17/2022,,Withdrawal ACH PAYPAL/TYPE: INST XFER ID: PAYPALSI77CO: PAYPAL NAME: STEVEN CHAPLINSKIEntry Class Code: WEB,149.35,,Posted,890.38,2022-10-17,149.35,Withdrawal ACH PAYPAL/TYPE: INST XFER ID: PAYPALSI77CO: PAYPAL NAME: STEVEN CHAPLINSKIEntry Class Code: WEB,149.61333333333334
10/17/2022,,Withdrawal ACH PAYPAL/TYPE: INST XFER ID: PAYPALSI77CO: PAYPAL NAME: STEVEN CHAPLINSKIEntry Class Code: WEB,74.87,,Posted,1039.73,2022-10-17,74.87,Withdrawal ACH PAYPAL/TYPE: INST XFER ID: PAYPALSI77CO: PAYPAL NAME: STEVEN CHAPLINSKIEntry Class Code: WEB,74.87
10/17/2022,,Withdrawal ACH PAYPAL/TYPE: INST XFER ID: PAYPALSI77CO: PAYPAL NAME: STEVEN CHAPLINSKIEntry Class Code: WEB,74.67,,Posted,1114.6,2022-10-17,74.67,Withdrawal ACH PAYPAL/TYPE: INST XFER ID: PAYPALSI77CO: PAYPAL NAME: STEVEN CHAPLINSKIEntry Class Code: WEB,74.245
10/17/2022,,Withdrawal ACH PAYPAL/TYPE: INST XFER ID: PAYPALSI77CO: PAYPAL NAME: STEVEN CHAPLINSKIEntry Class Code: WEB,37.44,,Posted,1189.27,2022-10-17,37.44,Withdrawal ACH PAYPAL/TYPE: INST XFER ID: PAYPALSI77CO: PAYPAL NAME: STEVEN CHAPLINSKIEntry Class Code: WEB,36.99666666666666
10/17/2022,,Withdrawal ACH PAYPAL/TYPE: INST XFER ID: PAYPALSI77CO: PAYPAL NAME: STEVEN CHAPLINSKIEntry Class Code: WEB,24.95,,Posted,1226.71,2022-10-17,24.95,Withdrawal ACH PAYPAL/TYPE: INST XFER ID: PAYPALSI77CO: PAYPAL NAME: STEVEN CHAPLINSKIEntry Class Code: WEB,24.97
10/17/2022,,Withdrawal ACH PAYPAL/TYPE: INST XFER ID: PAYPALSI77CO: PAYPAL NAME: STEVEN CHAPLINSKIEntry Class Code: WEB,8.99,,Posted,1251.66,2022-10-17,8.99,Withdrawal ACH PAYPAL/TYPE: INST XFER ID: PAYPALSI77CO: PAYPAL NAME: STEVEN CHAPLINSKIEntry Class Code: WEB,9.015
10/14/2022,,Withdrawal Debit Card Fee/MASTERCARD ISSUER CROSS-BORDER FEEDate 10/13/22 0 2286863628 0 5045Card 2801,0.12,,Posted,1172.23,2022-10-14,0.12,Withdrawal Debit Card Fee/MASTERCARD ISSUER CROSS-BORDER FEEDate 12/25/22 0 2359739765 0 5734Card 2801,0.16428571428571428
10/14/2022,,Withdrawal Debit Card MC Debit/BZFUTURE HONG KONG HKDate 10/13/22 0 2286863628 0 5045Card 2801,15.48,,Posted,1172.35,2022-10-14,15.48,Withdrawal Debit Card MC Debit/BZFUTURE HONG KONG HKDate 10/13/22 0 2286863628 0 5045Card 2801,15.48
10/14/2022,,Withdrawal Debit Card MC Debit/PUBLIX #680 GAINESVILLE FLDate 10/13/22 0 2286695837 0 5411Card 2801,119.02,,Posted,1187.83,2022-10-14,119.02,Withdrawal Debit Card MC Debit/PUBLIX #795 GAINESVILLE FLDate 03/07/22 0 2066965570 0 5411Card 2801,119.02
10/14/2022,,Recurring Withdrawal Debit Card MC Debit/PLAYERAUCTIONS 800-342-0768 DEDate 10/13/22 0 2286345901 0 7993Card 2801,80.42,,Posted,1306.85,2022-10-14,80.42,Recurring Withdrawal Debit Card MC Debit/PLAYERAUCTIONS 800-342-0768 DEDate 09/23/21 0 1266586911 1 7993Card 2801,80.42
10/14/2022,,Withdrawal ACH CANVA PTY LIMITE/CO: CANVA PTY LIMITEDTYPE: IAT PAYPAL ID: 770510487CEntry Class Code: IAT,12.99,,Posted,1387.27,2022-10-14,12.99,Withdrawal ACH CANVA PTY LIMITE/CO: CANVA PTY LIMITEDTYPE: IAT PAYPAL ID: 770510487CEntry Class Code: IAT,12.99
10/14/2022,,Withdrawal ACH AMADORU GALAPPAT/CO: AMADORU GALAPPATHTHIGE RADIKA SAJEETYPE: IAT PAYPAL ID: 770510487CEntry Class Code: IAT,10.0,,Posted,1400.26,2022-10-14,10.0,Withdrawal ACH AMADORU GALAPPAT/CO: AMADORU GALAPPATHTHIGE RADIKA SAJEETYPE: IAT PAYPAL ID: 770510487CEntry Class Code: IAT,10.0
10/13/2022,,Recurring Withdrawal Debit Card MC Debit/PLAYERAUCTIONS 800-342-0768 DEDate 10/12/22 0 2285395918 0 7993Card 2801,61.85,,Posted,610.26,2022-10-13,61.85,Recurring Withdrawal Debit Card MC Debit/PLAYERAUCTIONS 800-342-0768 DEDate 09/23/21 0 1266586911 1 7993Card 2801,61.85
10/13/2022,,Withdrawal POS #000096291737/FAST TRACK #200 GAINESVILLE FLCard 2801,19.46,,Posted,672.11,2022-10-13,19.46,Withdrawal POS #000096296533/FAST TRACK #200 GAINESVILLE FLCard 2801,19.486666666666665
10/12/2022,,Withdrawal POS #000000000006/AMAZON.COM*HT07Z9FA1 SEATTLE WACard 2801,19.06,,Posted,691.57,2022-10-12,19.06,Withdrawal POS #000000000003/AMAZON.COM*1Z8447YO1 SEATTLE WACard 2801,19.06
10/12/2022,,Recurring Withdrawal Debit Card Fee/MASTERCARD ISSUER CROSS-BORDER FEEDate 10/11/22 0 2284797441 0 5734Card 2801,0.05,,Posted,710.63,2022-10-12,0.05,Recurring Withdrawal Debit Card Fee/MASTERCARD ISSUER CROSS-BORDER FEEDate 06/11/22 0 2162900620 0 5734Card 2801,0.07500000000000001
10/12/2022,,Recurring Withdrawal Debit Card MC Debit/PAYPAL *LINKTREEPTY 4029357733 AUDate 10/11/22 0 2284797441 0 5734Card 2801,6.0,,Posted,710.68,2022-10-12,6.0,Recurring Withdrawal Debit Card MC Debit/PAYPAL *LINKTREE 4029357733 AUDate 05/12/21 0 1132191600 1 7372Card 2801,6.0
10/11/2022,,Withdrawal ACH ENVATO/CO: ENVATOTYPE: IAT PAYPAL ID: 770510487CEntry Class Code: IAT,39.0,,Posted,716.68,2022-10-11,39.0,Withdrawal ACH ENVATO/CO: ENVATOTYPE: IAT PAYPAL ID: 770510487CEntry Class Code: IAT,39.0
10/11/2022,,Withdrawal ACH BRAINLY/CO: BRAINLYTYPE: IAT PAYPAL ID: 770510487CEntry Class Code: IAT,10.0,,Posted,755.68,2022-10-11,10.0,Withdrawal ACH BRAINLY/CO: BRAINLYTYPE: IAT PAYPAL ID: 770510487CEntry Class Code: IAT,10.0
10/11/2022,,Withdrawal ACH FLUENT-Gainesvil/TYPE: PAYMENT ID: 1371804719CO: FLUENT-GainesvilEntry Class Code: PPD,198.09,,Posted,765.68,2022-10-11,198.09,Withdrawal ACH FLUENT-Gainesvil/TYPE: PAYMENT ID: 1371804719CO: FLUENT-GainesvilEntry Class Code: PPD,198.09
10/11/2022,,Withdrawal ACH TARGET CARD SRVC/TYPE: BILL PAY ID: T510215170CO: TARGET CARD SRVCNAME: 7S CH0000000APLINSKI TEntry Class Code: WEB,90.2,,Posted,963.77,2022-10-11,90.2,Withdrawal ACH TARGET CARD SRVC/TYPE: BILL PAY ID: 5411721813CO: TARGET CARD SRVCNAME: S CHAPLINSKI TEntry Class Code: WEB,90.2
10/11/2022,,Withdrawal ACH PAYPAL/TYPE: INST XFER ID: PAYPALSI77CO: PAYPAL NAME: STEVEN CHAPLINSKIEntry Class Code: WEB,37.44,,Posted,1053.97,2022-10-11,37.44,Withdrawal ACH PAYPAL/TYPE: INST XFER ID: PAYPALSI77CO: PAYPAL NAME: STEVEN CHAPLINSKIEntry Class Code: WEB,36.99666666666666
10/11/2022,,Withdrawal ACH PAYPAL/TYPE: INST XFER ID: PAYPALSI77CO: PAYPAL NAME: STEVEN CHAPLINSKIEntry Class Code: WEB,9.99,,Posted,1091.41,2022-10-11,9.99,Withdrawal ACH PAYPAL/TYPE: INST XFER ID: PAYPALSI77CO: PAYPAL NAME: STEVEN CHAPLINSKIEntry Class Code: WEB,10.093333333333334
10/11/2022,,Withdrawal ACH PAYPAL/TYPE: INST XFER ID: PAYPALSI77CO: PAYPAL NAME: STEVEN CHAPLINSKIEntry Class Code: WEB,2.0,,Posted,1101.4,2022-10-11,2.0,Withdrawal ACH PAYPAL/TYPE: INST XFER ID: PAYPALSI77CO: PAYPAL NAME: STEVEN CHAPLINSKIEntry Class Code: WEB,2.3299999999999996
10/11/2022,,Withdrawal POS #000000086984/AMAZON.COM*1K9XT1911 SEATTLE WACard 2801,8.63,,Posted,1103.4,2022-10-11,8.63,Withdrawal POS #000000990788/AMAZON.COM*215VY1SG1 SEATTLE WACard 2801,9.07
10/9/2022,,Withdrawal Debit Card MC Debit/PMT*FL LICENSE/TAG/ASM GAINESVILLE FLDate 10/06/22 0 2279613925 1 9399Card 2801,56.75,,Posted,1112.03,2022-10-09,56.75,Withdrawal Debit Card MC Debit/PMT*FL LICENSE/TAG/ASM GAINESVILLE FLDate 10/06/22 0 2279613925 1 9399Card 2801,56.75
10/8/2022,,Withdrawal POS #000006205356/PAYPAL *VIDIQ 2211 North First StreetJose CACard 2801,10.0,,Posted,1168.78,2022-10-08,10.0,Withdrawal POS #000005221556/PAYPAL *VIDIQ 2211 North First StreetJose CACard 2801,10.0
10/8/2022,,Withdrawal POS #000000848934/AMAZON.COM*1K1J94VV0 SEATTLE WACard 2801,10.31,,Posted,1178.78,2022-10-08,10.31,Withdrawal POS #000000922564/AMAZON.COM*VJ71T1BJ3 SEATTLE WACard 2801,10.59
10/8/2022,,Withdrawal POS #000000000054/AMAZON.COM*1K97X11G1 SEATTLE WACard 2801,26.04,,Posted,1189.09,2022-10-08,26.04,Withdrawal POS #000000990788/AMAZON.COM*215VY1SG1 SEATTLE WACard 2801,26.04
10/7/2022,,Withdrawal POS #000000156168/WAWA 5325 2373 SW ARCHER ROADFLCard 2801,34.27,,Posted,1215.13,2022-10-07,34.27,Withdrawal POS #000000553411/WAWA 5325 2373 SW ARCHER ROADFLCard 1247,33.900000000000006
10/7/2022,,Withdrawal Debit Card MC Debit/CANNAMD 855-4209170 FLDate 10/06/22 0 2279964864 0 8011Card 2801,195.0,,Posted,1249.4,2022-10-07,195.0,Withdrawal Debit Card MC Debit/CANNAMD 855-4209170 FLDate 04/07/23 0 3097109858 2 8011Card 2801,195.0
10/7/2022,,Withdrawal Debit Card MC Debit/PUBLIX #680 GAINESVILLE FLDate 10/06/22 0 2279091717 1 5411Card 2801,122.46,,Posted,1444.4,2022-10-07,122.46,Withdrawal Debit Card MC Debit/PUBLIX #795 GAINESVILLE FLDate 03/07/22 0 2066965570 0 5411Card 2801,122.46
10/7/2022,,Recurring Withdrawal Debit Card MC Debit/NETFLIX.COM CADate 10/06/22 0 2279815139 0 4899Card 2801,10.98,,Posted,1566.86,2022-10-07,10.98,Recurring Withdrawal Debit Card MC Debit/NETFLIX.COM CADate 10/06/22 0 2279815139 0 4899Card 2801,10.98
10/7/2022,,Withdrawal ACH PADDLE.COM MARKE/CO: PADDLE.COM MARKET LIMITEDTYPE: IAT PAYPAL ID: 770510487CEntry Class Code: IAT,29.99,,Posted,1577.84,2022-10-07,29.99,Withdrawal ACH PADDLE.COM MARKE/CO: PADDLE.COM MARKET LIMITEDTYPE: IAT PAYPAL ID: 770510487CEntry Class Code: IAT,29.99
10/7/2022,,Withdrawal ACH PAYPAL/TYPE: INST XFER ID: PAYPALSI77CO: PAYPAL NAME: STEVEN CHAPLINSKIEntry Class Code: WEB,74.67,,Posted,1495.83,2022-10-07,74.67,Withdrawal ACH PAYPAL/TYPE: INST XFER ID: PAYPALSI77CO: PAYPAL NAME: STEVEN CHAPLINSKIEntry Class Code: WEB,74.245
10/6/2022,,Withdrawal POS #000000000235/CIRCLE K # 23913 3424 GAINESVILLE FLCard 2801,19.34,,Posted,1570.5,2022-10-06,19.34,Withdrawal POS #000000011248/CIRCLE K # 23913 3424 GAINESVILLE FLCard 2801,19.68
10/6/2022,,Withdrawal ACH PAYPAL/TYPE: INST XFER ID: PAYPALSI77CO: PAYPAL NAME: STEVEN CHAPLINSKIEntry Class Code: WEB,5.66,,Posted,1571.84,2022-10-06,5.66,Withdrawal ACH PAYPAL/TYPE: INST XFER ID: PAYPALSI77CO: PAYPAL NAME: STEVEN CHAPLINSKIEntry Class Code: WEB,6.0875
10/5/2022,,Recurring Withdrawal Debit Card MC Debit/WWW.CLEANDRIVE.APP SEATTLE WADate 10/04/22 0 2277349400 0 5734Card 2801,7.8,,Posted,1577.5,2022-10-05,7.8,Recurring Withdrawal Debit Card MC Debit/WWW.CLEANDRIVE.APP SEATTLE WADate 10/04/22 0 2277349400 0 5734Card 2801,7.895
10/5/2022,,Recurring Withdrawal Debit Card MC Debit/WWW.CLEANDRIVE.APP SEATTLE WADate 10/04/22 0 2277808522 0 5734Card 2801,1.58,,Posted,1585.3,2022-10-05,1.58,Recurring Withdrawal Debit Card MC Debit/WWW.CLEANDRIVE.APP SEATTLE WADate 10/04/22 0 2277349400 0 5734Card 2801,1.58
10/5/2022,,Withdrawal ACH ENVATO/CO: ENVATOTYPE: IAT PAYPAL ID: 770510487CEntry Class Code: IAT,23.0,,Posted,1586.88,2022-10-05,23.0,Withdrawal ACH ENVATO/CO: ENVATOTYPE: IAT PAYPAL ID: 770510487CEntry Class Code: IAT,23.0
10/4/2022,,Withdrawal Debit Card MC Debit/GRU/EZ-PAY WEB PYMT 352-334-3434 FLDate 10/03/22 0 2276349419 0 4900Card 2801,213.12,,Posted,1360.46,2022-10-04,213.12,Withdrawal Debit Card MC Debit/GRU/EZ-PAY WEB PYMT 352-334-3434 FLDate 11/01/21 0 1305577800 0 4900Card 2801,213.12
10/4/2022,,Withdrawal ACH BARCLAYCARD US/TYPE: CREDITCARD ID: 2510407970CO: BARCLAYCARD USNAME: STEVEN CHAPLINSKIEntry Class Code: WEB,249.42,,Posted,1573.58,2022-10-04,249.42,Withdrawal ACH BARCLAYCARD US/TYPE: CREDITCARD ID: 2510407970CO: BARCLAYCARD USNAME: STEVEN CHAPLINSKIEntry Class Code: WEB,249.70999999999998
10/4/2022,,Withdrawal ACH PAYPAL/TYPE: INST XFER ID: PAYPALSI77CO: PAYPAL NAME: STEVEN CHAPLINSKIEntry Class Code: WEB,33.87,,Posted,1823.0,2022-10-04,33.87,Withdrawal ACH PAYPAL/TYPE: INST XFER ID: PAYPALSI77CO: PAYPAL NAME: STEVEN CHAPLINSKIEntry Class Code: WEB,33.519999999999996
10/4/2022,,Withdrawal ACH PAYPAL/TYPE: INST XFER ID: PAYPALSI77CO: PAYPAL NAME: STEVEN CHAPLINSKIEntry Class Code: WEB,14.99,,Posted,1856.87,2022-10-04,14.99,Withdrawal ACH PAYPAL/TYPE: INST XFER ID: PAYPALSI77CO: PAYPAL NAME: STEVEN CHAPLINSKIEntry Class Code: WEB,14.948333333333332
10/4/2022,,Withdrawal ACH PAYPAL/TYPE: INST XFER ID: PAYPALSI77CO: PAYPAL NAME: STEVEN CHAPLINSKIEntry Class Code: WEB,5.35,,Posted,1871.86,2022-10-04,5.35,Withdrawal ACH PAYPAL/TYPE: INST XFER ID: PAYPALSI77CO: PAYPAL NAME: STEVEN CHAPLINSKIEntry Class Code: WEB,4.96
10/4/2022,,Withdrawal ACH PAYPAL/TYPE: INST XFER ID: PAYPALSI77CO: PAYPAL NAME: STEVEN CHAPLINSKIEntry Class Code: WEB,3.06,,Posted,1877.21,2022-10-04,3.06,Withdrawal ACH PAYPAL/TYPE: INST XFER ID: PAYPALSI77CO: PAYPAL NAME: STEVEN CHAPLINSKIEntry Class Code: WEB,3.218
10/4/2022,,Withdrawal ACH PAYPAL/TYPE: INST XFER ID: PAYPALSI77CO: PAYPAL NAME: STEVEN CHAPLINSKIEntry Class Code: WEB,2.99,,Posted,1880.27,2022-10-04,2.99,Withdrawal ACH PAYPAL/TYPE: INST XFER ID: PAYPALSI77CO: PAYPAL NAME: STEVEN CHAPLINSKIEntry Class Code: WEB,3.218
10/3/2022,,Withdrawal POS #000096293292/FAST TRACK #200 GAINESVILLE FLCard 2801,19.46,,Posted,1883.26,2022-10-03,19.46,Withdrawal POS #000096296533/FAST TRACK #200 GAINESVILLE FLCard 2801,19.486666666666665
10/3/2022,,Withdrawal ACH BEST BUY/TYPE: PAYMENT ID: CITIGPUFDRCO: BEST BUYEntry Class Code: PPD,577.0,,Posted,1902.72,2022-10-03,577.0,Withdrawal ACH BEST BUY/TYPE: PAYMENT ID: CITIGPUFDRCO: BEST BUYEntry Class Code: TEL,577.0
10/3/2022,,Withdrawal ACH CAPITAL ONE/TYPE: ONLINE PMT ID: 9279744391CO: CAPITAL ONE NAME: STEVEN CHAPLINSKIEntry Class Code: WEB,37.0,,Posted,2479.72,2022-10-03,37.0,Withdrawal ACH CAPITAL ONE/TYPE: ONLINE PMT ID: 9279744391CO: CAPITAL ONE NAME: STEVEN CHAPLINSKIEntry Class Code: WEB,37.0
10/3/2022,,Withdrawal ACH Watson Realty Co/TYPE: WEB PMTS ID: 9000321157CO: Watson Realty CoNAME: Steven chaplinskiEntry Class Code: WEB,995.0,,Posted,2516.72,2022-10-03,995.0,Withdrawal ACH Watson Realty Co/TYPE: WEB PMTS ID: 9000321157CO: Watson Realty CoEntry Class Code: WEB,995.0
10/3/2022,,Withdrawal ACH BARCLAYCARD US/TYPE: CREDITCARD ID: 2510407970CO: BARCLAYCARD USNAME: STEVEN CHAPLINSKIEntry Class Code: WEB,249.42,,Posted,3511.72,2022-10-03,249.42,Withdrawal ACH BARCLAYCARD US/TYPE: CREDITCARD ID: 2510407970CO: BARCLAYCARD USNAME: STEVEN CHAPLINSKIEntry Class Code: WEB,249.70999999999998
10/3/2022,,Withdrawal ACH BEST BUY/TYPE: PAYMENT ID: CITIGPUFDRCO: BEST BUYEntry Class Code: PPD,58.0,,Posted,3761.14,2022-10-03,58.0,Withdrawal ACH BEST BUY/TYPE: PAYMENT ID: CITIGPUFDRCO: BEST BUYEntry Class Code: TEL,58.0
10/3/2022,,Withdrawal ACH PAYMENT FOR AMZ/TYPE: STORECARD ID: 9069872103CO: PAYMENT FOR AMZNAME: 6045781157416487Entry Class Code: WEB,50.0,,Posted,3819.14,2022-10-03,50.0,Withdrawal ACH PAYMENT FOR AMZ/TYPE: STORECARD ID: 9069872103CO: PAYMENT FOR AMZNAME: 6045781157416487Entry Class Code: WEB,50.0
10/3/2022,,Withdrawal ACH PAYPAL/TYPE: INST XFER ID: PAYPALSI77CO: PAYPAL NAME: STEVEN CHAPLINSKIEntry Class Code: WEB,19.95,,Posted,3869.14,2022-10-03,19.95,Withdrawal ACH PAYPAL/TYPE: INST XFER ID: PAYPALSI77CO: PAYPAL NAME: STEVEN CHAPLINSKIEntry Class Code: WEB,19.98
10/3/2022,,Withdrawal ACH PAYPAL/TYPE: INST XFER ID: PAYPALSI77CO: PAYPAL NAME: STEVEN CHAPLINSKIEntry Class Code: WEB,11.48,,Posted,3889.09,2022-10-03,11.48,Withdrawal ACH PAYPAL/TYPE: INST XFER ID: PAYPALSI77CO: PAYPAL NAME: STEVEN CHAPLINSKIEntry Class Code: WEB,11.7425
10/2/2022,,Withdrawal Debit Card MC Debit/COX GAINESVILLE COMM 800-234-3993 FLDate 10/01/22 0 2274819048 0 4899Card 2801,117.89,,Posted,3900.57,2022-10-02,117.89,Withdrawal Debit Card MC Debit/COX GAINESVILLE COMM 800-234-3993 FLDate 01/27/22 0 2027240681 1 4899Card 2801,117.89
10/2/2022,,Recurring Withdrawal Debit Card MC Debit/CHEGG ORDER 8558681054 CADate 09/30/22 0 2273714063 1 5942Card 2801,15.95,,Posted,4018.46,2022-10-02,15.95,Withdrawal Debit Card MC Debit/CHEGG ORDER 8558681054 CADate 09/01/22 0 2244077661 1 5942Card 2801,15.95
10/1/2022,,Withdrawal POS #000000407993/SUNOCO 8002212501 4234 SW 20TH AVEGAINESVILLE FLCard 2801,13.89,,Posted,4034.41,2022-10-01,13.89,Withdrawal POS #000000639499/SUNOCO 8002212501 4234 SW 20TH AVEGAINESVILLE FLCard 2801,13.89
9/29/2022,,Recurring Withdrawal Debit Card MC Debit/ADOBE CREATIVE CLOUD 4085366000 CADate 09/28/22 0 2271807482 0 5734Card 2801,19.99,,Posted,4048.3,2022-09-29,19.99,Recurring Withdrawal Debit Card MC Debit/ADOBE CREATIVE CLOUD 4085366000 CADate 09/28/22 0 2271807482 0 5734Card 2801,19.99
9/29/2022,,Withdrawal ACH FLUENT-Gainesvil/TYPE: PAYMENT ID: 1371804719CO: FLUENT-GainesvilEntry Class Code: PPD,75.5,,Posted,1568.29,2022-09-29,75.5,Withdrawal ACH FLUENT-Gainesvil/TYPE: PAYMENT ID: 1371804719CO: FLUENT-GainesvilEntry Class Code: PPD,75.5
9/29/2022,,Withdrawal ACH PAYPAL/TYPE: INST XFER ID: PAYPALSI77CO: PAYPAL NAME: STEVEN CHAPLINSKIEntry Class Code: WEB,2.99,,Posted,1643.79,2022-09-29,2.99,Withdrawal ACH PAYPAL/TYPE: INST XFER ID: PAYPALSI77CO: PAYPAL NAME: STEVEN CHAPLINSKIEntry Class Code: WEB,3.218
9/28/2022,,Recurring Withdrawal Debit Card MC Debit/WWW.CLEANDRIVE.APP SEATTLE WADate 09/28/22 0 2271104160 1 5734Card 2801,7.99,,Posted,1646.78,2022-09-28,7.99,Recurring Withdrawal Debit Card MC Debit/WWW.CLEANDRIVE.APP SEATTLE WADate 10/04/22 0 2277349400 0 5734Card 2801,7.895
9/28/2022,,Withdrawal Debit Card MC Debit/PUBLIX #1038 GAINESVILLE FLDate 09/27/22 0 2270102412 1 5411Card 2801,73.35,,Posted,1654.77,2022-09-28,73.35,Withdrawal Debit Card MC Debit/PUBLIX #1560 GAINESVILLE FLDate 09/04/21 0 1247836114 5 5411Card 2801,73.35
9/28/2022,,Withdrawal ACH PAYPAL/TYPE: INST XFER ID: PAYPALSI77CO: PAYPAL NAME: STEVEN CHAPLINSKIEntry Class Code: WEB,14.99,,Posted,1728.12,2022-09-28,14.99,Withdrawal ACH PAYPAL/TYPE: INST XFER ID: PAYPALSI77CO: PAYPAL NAME: STEVEN CHAPLINSKIEntry Class Code: WEB,14.948333333333332
9/28/2022,,Withdrawal POS #000000019465/AMAZON.COM*1U6B04IO0 SEATTLE WACard 2801,66.74,,Posted,1743.11,2022-09-28,66.74,Withdrawal POS #000000019465/AMAZON.COM*1U6B04IO0 SEATTLE WACard 2801,66.74
9/27/2022,,Withdrawal POS #000093423756/BP#8996613SUNRI GAINESVILLE FLCard 2801,23.72,,Posted,1809.85,2022-09-27,23.72,Withdrawal POS #000093424601/BP#8996613SUNRI GAINESVILLE FLCard 2801,23.72
9/27/2022,,Withdrawal POS #000000888946/AMAZON.COM*1U4ZR78L2 SEATTLE WACard 2801,8.63,,Posted,1833.57,2022-09-27,8.63,Withdrawal POS #000000019465/AMAZON.COM*1U6B04IO0 SEATTLE WACard 2801,8.63
9/27/2022,,Withdrawal ACH PAYPAL/TYPE: INST XFER ID: PAYPALSI77CO: PAYPAL NAME: STEVEN CHAPLINSKIEntry Class Code: WEB,2.99,,Posted,1842.2,2022-09-27,2.99,Withdrawal ACH PAYPAL/TYPE: INST XFER ID: PAYPALSI77CO: PAYPAL NAME: STEVEN CHAPLINSKIEntry Class Code: WEB,3.218
9/26/2022,,Recurring Withdrawal Debit Card MC Debit/JASPER.AI AUSTIN TXDate 09/25/22 0 2268000612 1 7399Card 2801,21.16,,Posted,1845.19,2022-09-26,21.16,Recurring Withdrawal Debit Card MC Debit/JASPER.AI AUSTIN TXDate 09/25/22 0 2268000612 1 7399Card 2801,21.39
9/26/2022,,Withdrawal ACH BEST BUY/TYPE: PAYMENT ID: CITIGPUFDRCO: BEST BUYEntry Class Code: PPD,150.0,,Posted,1866.35,2022-09-26,150.0,Withdrawal ACH BEST BUY/TYPE: PAYMENT ID: CITIGPUFDRCO: BEST BUYEntry Class Code: TEL,150.0
9/26/2022,,Withdrawal ACH APPLECARD GSBANK/TYPE: PAYMENT ID: 9999999999CO: APPLECARD GSBANKNAME: Steven ChaplinskiEntry Class Code: WEB,100.0,,Posted,2016.35,2022-09-26,100.0,Withdrawal ACH APPLECARD GSBANK/TYPE: PAYMENT ID: 9999999999CO: APPLECARD GSBANKNAME: Steven ChaplinskiEntry Class Code: WEB,100.0
9/26/2022,,Withdrawal ACH CAPITAL ONE/TYPE: ONLINE PMT ID: 9279744991CO: CAPITAL ONE NAME: STEVEN CHAPLINSKIEntry Class Code: WEB,75.0,,Posted,2116.35,2022-09-26,75.0,Withdrawal ACH CAPITAL ONE/TYPE: ONLINE PMT ID: 9279744391CO: CAPITAL ONE NAME: STEVEN CHAPLINSKIEntry Class Code: WEB,75.0
9/26/2022,,Withdrawal ACH TARGET CARD SRVC/TYPE: BILL PAY ID: 5411721813CO: TARGET CARD SRVCNAME: S CHAPLINSKI TEntry Class Code: WEB,354.0,,Posted,2191.35,2022-09-26,354.0,Withdrawal ACH TARGET CARD SRVC/TYPE: BILL PAY ID: 5411721813CO: TARGET CARD SRVCNAME: S CHAPLINSKI TEntry Class Code: WEB,354.0
9/26/2022,,Withdrawal ACH BEST BUY/TYPE: PAYMENT ID: CITIGPUFDRCO: BEST BUYEntry Class Code: PPD,346.97,,Posted,2545.35,2022-09-26,346.97,Withdrawal ACH BEST BUY/TYPE: PAYMENT ID: CITIGPUFDRCO: BEST BUYEntry Class Code: TEL,346.97
9/26/2022,,Withdrawal ACH DISCOVER/TYPE: E-PAYMENT ID: 2510020270CO: DISCOVER NAME: CHAPLINSKI STEVENEntry Class Code: WEB,191.91,,Posted,2892.32,2022-09-26,191.91,Withdrawal ACH DISCOVER/TYPE: E-PAYMENT ID: 2510020270CO: DISCOVER NAME: CHAPLINSKI STEVENEntry Class Code: WEB,191.91
9/26/2022,,Withdrawal ACH PAYMENT FOR AMZ/TYPE: STORECARD ID: 9069872103CO: PAYMENT FOR AMZNAME: 6045781157416487Entry Class Code: WEB,175.0,,Posted,3084.23,2022-09-26,175.0,Withdrawal ACH PAYMENT FOR AMZ/TYPE: STORECARD ID: 9069872103CO: PAYMENT FOR AMZNAME: 6045781157416487Entry Class Code: WEB,175.0
9/26/2022,,Withdrawal ACH PAYPAL/TYPE: INST XFER ID: PAYPALSI77CO: PAYPAL NAME: STEVEN CHAPLINSKIEntry Class Code: WEB,149.99,,Posted,3259.23,2022-09-26,149.99,Withdrawal ACH PAYPAL/TYPE: INST XFER ID: PAYPALSI77CO: PAYPAL NAME: STEVEN CHAPLINSKIEntry Class Code: WEB,149.61333333333334
9/26/2022,,Withdrawal ACH WAWA CREDIT CARD/TYPE: ONLINE PMT ID: CITICTPCO: WAWA CREDIT CARDNAME: STEVEN CHAPLINSKIEntry Class Code: WEB,143.83,,Posted,3409.22,2022-09-26,143.83,Withdrawal ACH WAWA CREDIT CARD/TYPE: ONLINE PMT ID: CITICTPCO: WAWA CREDIT CARDNAME: STEVEN CHAPLINSKIEntry Class Code: WEB,143.83
9/26/2022,,Withdrawal ACH BARCLAYCARD US/TYPE: CREDITCARD ID: 2510407970CO: BARCLAYCARD USNAME: STEVEN CHAPLINSKIEntry Class Code: WEB,128.36,,Posted,3553.05,2022-09-26,128.36,Withdrawal ACH BARCLAYCARD US/TYPE: CREDITCARD ID: 2510407970CO: BARCLAYCARD USNAME: STEVEN CHAPLINSKIEntry Class Code: WEB,128.36
9/26/2022,,Withdrawal ACH PAYPAL/TYPE: INST XFER ID: PAYPALSI77CO: PAYPAL NAME: STEVEN CHAPLINSKIEntry Class Code: WEB,99.99,,Posted,3681.41,2022-09-26,99.99,Withdrawal ACH PAYPAL/TYPE: INST XFER ID: PAYPALSI77CO: PAYPAL NAME: STEVEN CHAPLINSKIEntry Class Code: WEB,99.99
9/26/2022,,Withdrawal ACH AMZ_STORECRD_PMT/TYPE: PAYMENT ID: 9069872000CO: AMZ_STORECRD_PMTNAME: 6045781157416487Entry Class Code: WEB,32.0,,Posted,3781.4,2022-09-26,32.0,Withdrawal ACH AMZ_STORECRD_PMT/TYPE: PAYMENT ID: 9069872000CO: AMZ_STORECRD_PMTNAME: 6045781157416487Entry Class Code: WEB,32.0
9/26/2022,,Withdrawal ACH PAYPAL/TYPE: INST XFER ID: PAYPALSI77CO: PAYPAL NAME: STEVEN CHAPLINSKIEntry Class Code: WEB,4.5,,Posted,3813.4,2022-09-26,4.5,Withdrawal ACH PAYPAL/TYPE: INST XFER ID: PAYPALSI77CO: PAYPAL NAME: STEVEN CHAPLINSKIEntry Class Code: WEB,4.96
9/25/2022,,Withdrawal Debit Card MC Debit/WALGREENS #5024 800-289-2273 FLDate 09/23/22 0 2266343180 2 5912Card 2801,83.07,,Posted,3817.9,2022-09-25,83.07,Withdrawal Debit Card MC Debit/WALGREENS #5024 800-289-2273 FLDate 05/21/22 0 2141999930 0 5912Card 2801,83.07
9/25/2022,,Withdrawal POS #000000041929/SUNOCO 8002212501 4234 SW 20TH AVEGAINESVILLE FLCard 2801,30.24,,Posted,3900.97,2022-09-25,30.24,Withdrawal POS #000000639499/SUNOCO 8002212501 4234 SW 20TH AVEGAINESVILLE FLCard 2801,30.085
9/23/2022,,Withdrawal Debit Card MC Debit/PUBLIX #680 GAINESVILLE FLDate 09/22/22 0 2265055591 1 5411Card 2801,43.48,,Posted,1831.21,2022-09-23,43.48,Withdrawal Debit Card MC Debit/PUBLIX #795 GAINESVILLE FLDate 03/07/22 0 2066965570 0 5411Card 2801,43.48
9/22/2022,,Withdrawal POS #000000352639/SUNOCO 8002212501 4234 SW 20TH AVEGAINESVILLE FLCard 2801,24.89,,Posted,1874.69,2022-09-22,24.89,Withdrawal POS #000000639499/SUNOCO 8002212501 4234 SW 20TH AVEGAINESVILLE FLCard 2801,24.89
9/20/2022,,Withdrawal ACH PAYPAL/TYPE: INST XFER ID: PAYPALSI77CO: PAYPAL NAME: STEVEN CHAPLINSKIEntry Class Code: WEB,2.29,,Posted,1899.58,2022-09-20,2.29,Withdrawal ACH PAYPAL/TYPE: INST XFER ID: PAYPALSI77CO: PAYPAL NAME: STEVEN CHAPLINSKIEntry Class Code: WEB,2.3299999999999996
9/20/2022,,Withdrawal POS #000003041632/GOOGLE *YouTubePremium 1600 AmphitheatreParkw Mountain View CACard 2801,13.62,,Posted,1901.87,2022-09-20,13.62,Withdrawal POS #000003285955/GOOGLE *YouTubePremium 1600 AmphitheatreParkw Mountain View CACard 2801,13.629999999999999
9/19/2022,,Withdrawal ACH DISCOVER/TYPE: E-PAYMENT ID: 2510020270CO: DISCOVER NAME: CHAPLINSKI STEVENEntry Class Code: WEB,250.0,,Posted,1915.49,2022-09-19,250.0,Withdrawal ACH DISCOVER/TYPE: E-PAYMENT ID: 2510020270CO: DISCOVER NAME: CHAPLINSKI STEVENEntry Class Code: WEB,250.0
9/19/2022,,Withdrawal ACH PAYPAL/TYPE: INST XFER ID: PAYPALSI77CO: PAYPAL NAME: STEVEN CHAPLINSKIEntry Class Code: WEB,24.95,,Posted,2165.49,2022-09-19,24.95,Withdrawal ACH PAYPAL/TYPE: INST XFER ID: PAYPALSI77CO: PAYPAL NAME: STEVEN CHAPLINSKIEntry Class Code: WEB,24.97
9/18/2022,,Withdrawal Debit Card MC Debit/WELLSAID LABS SEATTLE WADate 09/16/22 0 2259782243 1 5734Card 2801,49.0,,Posted,2190.44,2022-09-18,49.0,Withdrawal Debit Card MC Debit/WELLSAID LABS SEATTLE WADate 09/16/22 0 2259782243 1 5734Card 2801,49.0
9/18/2022,,Recurring Withdrawal Debit Card MC Debit/JASPER.AI AUSTIN TXDate 09/16/22 0 2259933032 1 7399Card 2801,29.0,,Posted,2239.44,2022-09-18,29.0,Recurring Withdrawal Debit Card MC Debit/JASPER.AI AUSTIN TXDate 09/25/22 0 2268000612 1 7399Card 2801,29.0
9/18/2022,,Recurring Withdrawal Debit Card MC Debit/PLAYERAUCTIONS 800-342-0768 DEDate 09/17/22 0 2260857045 0 7993Card 2801,66.25,,Posted,2268.44,2022-09-18,66.25,Recurring Withdrawal Debit Card MC Debit/PLAYERAUCTIONS 800-342-0768 DEDate 09/23/21 0 1266586911 1 7993Card 2801,66.25
9/18/2022,,Withdrawal Debit Card MC Debit/WALGREENS #5024 800-289-2273 FLDate 09/17/22 0 2260124597 1 5912Card 2801,7.49,,Posted,2334.69,2022-09-18,7.49,Withdrawal Debit Card MC Debit/WALGREENS #5024 800-289-2273 FLDate 09/08/21 0 1251607416 1 5912Card 2801,7.025
9/17/2022,,Withdrawal POS #000000000323/CIRCLE K # 26146 3525 GAINESVILLE FLCard 2801,29.05,,Posted,2342.18,2022-09-17,29.05,Withdrawal POS #000000000558/CIRCLE K # 26146 3525 GAINESVILLE FLCard 2801,29.05
9/17/2022,,Withdrawal ATM Fee/EFT 6419 W Newberry Rd Gainesville FLCard 2801,2.0,,Posted,2371.23,2022-09-17,2.0,"Withdrawal ATM Fee/EFT 6419 W Newberry Rd Gainesville FL

Card 1247",2.0
9/17/2022,,Withdrawal at ATM #000000000077/EFT 6419 W Newberry Rd Gainesville FLCard 2801,73.0,,Posted,2373.23,2022-09-17,73.0,"Withdrawal at ATM #000000785755/EFT 6419 W Newberry Rd Gainesville FL

Card 1247",73.0
9/16/2022,,Withdrawal POS #000000550998/SUNOCO 8002212501 4234 SW 20TH AVEGAINESVILLE FLCard 2801,30.24,,Posted,2446.23,2022-09-16,30.24,Withdrawal POS #000000550998/SUNOCO 8002212501 4234 SW 20TH AVEGAINESVILLE FLCard 2801,30.24
9/14/2022,,Recurring Withdrawal Debit Card MC Debit/EIG*BLUEHOST.COM 888-4014678 UTDate 09/13/22 0 2256946058 0 5968Card 2801,19.99,,Posted,2476.47,2022-09-14,19.99,Recurring Withdrawal Debit Card MC Debit/EIG*BLUEHOST.COM 888-4014678 UTDate 09/13/22 0 2256946058 0 5968Card 2801,19.99
9/14/2022,,Withdrawal ACH APPLECARD GSBANK/TYPE: PAYMENT ID: 9999999999CO: APPLECARD GSBANKNAME: Steven ChaplinskiEntry Class Code: WEB,174.0,,Posted,2496.46,2022-09-14,174.0,Withdrawal ACH APPLECARD GSBANK/TYPE: PAYMENT ID: 9999999999CO: APPLECARD GSBANKNAME: Steven ChaplinskiEntry Class Code: WEB,174.0
9/14/2022,,Withdrawal ACH CANVA PTY LIMITE/CO: CANVA PTY LIMITEDTYPE: IAT PAYPAL ID: 770510487CEntry Class Code: IAT,12.99,,Posted,2670.46,2022-09-14,12.99,Withdrawal ACH CANVA PTY LIMITE/CO: CANVA PTY LIMITEDTYPE: IAT PAYPAL ID: 770510487CEntry Class Code: IAT,12.99
9/14/2022,,Withdrawal ACH BARCLAYCARD US/TYPE: CREDITCARD ID: 2510407970CO: BARCLAYCARD USNAME: STEVEN CHAPLINSKIEntry Class Code: WEB,250.0,,Posted,2683.45,2022-09-14,250.0,Withdrawal ACH BARCLAYCARD US/TYPE: CREDITCARD ID: 2510407970CO: BARCLAYCARD USNAME: STEVEN CHAPLINSKIEntry Class Code: WEB,249.70999999999998
9/13/2022,,Recurring Withdrawal Debit Card MC Debit/EIG*BLUEHOST.COM 888-4014678 UTDate 09/12/22 0 2255927552 0 5968Card 2801,119.88,,Posted,433.45,2022-09-13,119.88,Recurring Withdrawal Debit Card MC Debit/EIG*BLUEHOST.COM 888-4014678 UTDate 09/13/22 0 2256946058 0 5968Card 2801,119.88
9/13/2022,,Withdrawal ACH PAYPAL/TYPE: INST XFER ID: PAYPALSI77CO: PAYPAL NAME: STEVEN CHAPLINSKIEntry Class Code: WEB,73.82,,Posted,553.33,2022-09-13,73.82,Withdrawal ACH PAYPAL/TYPE: INST XFER ID: PAYPALSI77CO: PAYPAL NAME: STEVEN CHAPLINSKIEntry Class Code: WEB,74.245
9/13/2022,,Withdrawal ACH PAYPAL/TYPE: INST XFER ID: PAYPALSI77CO: PAYPAL NAME: STEVEN CHAPLINSKIEntry Class Code: WEB,43.83,,Posted,627.15,2022-09-13,43.83,Withdrawal ACH PAYPAL/TYPE: INST XFER ID: PAYPALSI77CO: PAYPAL NAME: STEVEN CHAPLINSKIEntry Class Code: WEB,44.12
9/13/2022,,Withdrawal ACH PAYMENT FOR AMZ/TYPE: STORECARD ID: 9069872103CO: PAYMENT FOR AMZNAME: 6045781157416487Entry Class Code: WEB,5.0,,Posted,670.98,2022-09-13,5.0,Withdrawal ACH PAYMENT FOR AMZ/TYPE: STORECARD ID: 9069872103CO: PAYMENT FOR AMZNAME: 6045781157416487Entry Class Code: WEB,5.0
9/12/2022,,Withdrawal POS #000000626675/AMAZON.COM*1F8259P12 SEATTLE WACard 2801,8.63,,Posted,75.98,2022-09-12,8.63,Withdrawal POS #000000626675/AMAZON.COM*1F8259P12 SEATTLE WACard 2801,8.63
9/12/2022,,Withdrawal POS #000000000008/AMAZON.COM*1F9PJ82A0 SEATTLE WACard 2801,29.26,,Posted,84.61,2022-09-12,29.26,Withdrawal POS #000000000003/AMAZON.COM*1Z8447YO1 SEATTLE WACard 2801,29.26
9/12/2022,,Withdrawal Transfer fee,8.0,,Posted,113.87,2022-09-12,8.0,Withdrawal Transfer fee,8.0
9/12/2022,,Withdrawal POS #000000346729/SUNOCO 8002212501 4234 SW 20TH AVEGAINESVILLE FLCard 2801,28.09,,Posted,21.87,2022-09-12,28.09,Withdrawal POS #000000639499/SUNOCO 8002212501 4234 SW 20TH AVEGAINESVILLE FLCard 2801,28.32
9/12/2022,,Recurring Withdrawal Debit Card Fee/MASTERCARD ISSUER CROSS-BORDER FEEDate 09/11/22 0 2254978797 0 5734Card 2801,0.05,,Posted,49.96,2022-09-12,0.05,Recurring Withdrawal Debit Card Fee/MASTERCARD ISSUER CROSS-BORDER FEEDate 06/11/22 0 2162900620 0 5734Card 2801,0.07500000000000001
9/12/2022,,Recurring Withdrawal Debit Card MC Debit/PAYPAL *LINKTREEPTY 4029357733 AUDate 09/11/22 0 2254978797 0 5734Card 2801,6.0,,Posted,50.01,2022-09-12,6.0,Recurring Withdrawal Debit Card MC Debit/PAYPAL *LINKTREEPTY 4029357733 AUDate 01/11/23 0 3011789326 0 5734Card 2801,6.0
9/12/2022,,Withdrawal ACH ENVATO/CO: ENVATOTYPE: IAT PAYPAL ID: 770510487CEntry Class Code: IAT,39.0,,Posted,56.01,2022-09-12,39.0,Withdrawal ACH ENVATO/CO: ENVATOTYPE: IAT PAYPAL ID: 770510487CEntry Class Code: IAT,39.0
9/12/2022,,Withdrawal ACH PAYPAL/TYPE: INST XFER ID: PAYPALSI77CO: PAYPAL NAME: STEVEN CHAPLINSKIEntry Class Code: WEB,39.99,,Posted,95.01,2022-09-12,39.99,Withdrawal ACH PAYPAL/TYPE: INST XFER ID: PAYPALSI77CO: PAYPAL NAME: STEVEN CHAPLINSKIEntry Class Code: WEB,39.985
9/12/2022,,Withdrawal ACH PAYPAL/TYPE: INST XFER ID: PAYPALSI77CO: PAYPAL NAME: STEVEN CHAPLINSKIEntry Class Code: WEB,9.99,,Posted,135.0,2022-09-12,9.99,Withdrawal ACH PAYPAL/TYPE: INST XFER ID: PAYPALSI77CO: PAYPAL NAME: STEVEN CHAPLINSKIEntry Class Code: WEB,10.093333333333334
9/11/2022,,Withdrawal Debit Card MC Debit/PUBLIX #680 GAINESVILLE FLDate 09/10/22 0 2253492453 1 5411Card 2801,47.34,,Posted,144.99,2022-09-11,47.34,Withdrawal Debit Card MC Debit/PUBLIX #1560 GAINESVILLE FLDate 09/04/21 0 1247836114 5 5411Card 2801,47.715
9/11/2022,,Recurring Withdrawal Debit Card MC Debit/PLAYERAUCTIONS 800-342-0768 DEDate 09/10/22 0 2253689154 2 7993Card 2801,45.93,,Posted,192.33,2022-09-11,45.93,Recurring Withdrawal Debit Card MC Debit/PLAYERAUCTIONS 800-342-0768 DEDate 09/23/21 0 1266586911 1 7993Card 2801,45.72
9/10/2022,,Withdrawal ATM Fee/EFT 3401 W University Ave Gainesville FLCard 2801,2.0,,Posted,238.26,2022-09-10,2.0,"Withdrawal ATM Fee/EFT 3401 W University Ave Gainesville FL

Card 1247",2.0
9/10/2022,,Withdrawal at ATM #000000000054/EFT 3401 W University Ave Gainesville FLCard 2801,78.0,,Posted,240.26,2022-09-10,78.0,"Withdrawal at ATM #000000776623/EFT 3401 W University Ave Gainesville FL

Card 1247",78.0
9/10/2022,,Withdrawal POS #000096292296/FAST TRACK #200 GAINESVILLE FLCard 2801,22.66,,Posted,318.26,2022-09-10,22.66,Withdrawal POS #000096296533/FAST TRACK #200 GAINESVILLE FLCard 2801,22.586666666666662
9/8/2022,,Withdrawal ACH PAYPAL/TYPE: INST XFER ID: PAYPALSI77CO: PAYPAL NAME: STEVEN CHAPLINSKIEntry Class Code: WEB,39.99,,Posted,340.92,2022-09-08,39.99,Withdrawal ACH PAYPAL/TYPE: INST XFER ID: PAYPALSI77CO: PAYPAL NAME: STEVEN CHAPLINSKIEntry Class Code: WEB,39.985
9/8/2022,,Withdrawal ACH PAYPAL/TYPE: INST XFER ID: PAYPALSI77CO: PAYPAL NAME: STEVEN CHAPLINSKIEntry Class Code: WEB,39.99,,Posted,380.91,2022-09-08,39.99,Withdrawal ACH PAYPAL/TYPE: INST XFER ID: PAYPALSI77CO: PAYPAL NAME: STEVEN CHAPLINSKIEntry Class Code: WEB,39.985
9/8/2022,,Withdrawal POS #000006032550/PAYPAL *VIDIQ 2211 North First StreetJose CACard 2801,10.0,,Posted,420.9,2022-09-08,10.0,Withdrawal POS #000005221556/PAYPAL *VIDIQ 2211 North First StreetJose CACard 2801,10.0
9/7/2022,,Withdrawal POS #000000966379/WAWA 5325 2373 SW ARCHER ROADFLCard 2801,37.37,,Posted,430.9,2022-09-07,37.37,Withdrawal POS #000000553411/WAWA 5325 2373 SW ARCHER ROADFLCard 1247,37.37
9/6/2022,,Withdrawal POS #000000464658/SUNOCO 8002212501 4234 SW 20TH AVEGAINESVILLE FLCard 2801,28.09,,Posted,468.27,2022-09-06,28.09,Withdrawal POS #000000046634/SUNOCO 8002212501 4234 SW 20TH AVEGAINESVILLE FLCard 2801,28.09
9/6/2022,,Withdrawal Debit Card MC Debit/PARCHMENT-UNIV DOCS 480-719-1646 AZDate 09/05/22 0 2248770013 0 7372Card 2801,9.0,,Posted,351.36,2022-09-06,9.0,Withdrawal Debit Card MC Debit/PARCHMENT-UNIV DOCS 480-719-1646 AZDate 09/05/22 0 2248770013 0 7372Card 2801,9.0
9/6/2022,,Withdrawal Debit Card MC Debit/GRU/EZ-PAY WEB PYMT 352-334-3434 FLDate 09/05/22 0 2248310426 0 4900Card 2801,242.33,,Posted,360.36,2022-09-06,242.33,Withdrawal Debit Card MC Debit/GRU/EZ-PAY WEB PYMT 352-334-3434 FLDate 11/01/21 0 1305577800 0 4900Card 2801,242.33
9/6/2022,,Recurring Withdrawal Bill Payment - #000000223090/NETFLIX COM LOS GATOS CACard 2801,10.98,,Posted,602.69,2022-09-06,10.98,Recurring Withdrawal Bill Payment - #000006911729/NETFLIX COM LOS GATOS CACard 2801,10.99
9/6/2022,,Withdrawal ACH DISCOVER/TYPE: E-PAYMENT ID: 2510020270CO: DISCOVER NAME: CHAPLINSKI STEVENEntry Class Code: WEB,55.0,,Posted,613.67,2022-09-06,55.0,Withdrawal ACH DISCOVER/TYPE: E-PAYMENT ID: 2510020270CO: DISCOVER NAME: CHAPLINSKI STEVENEntry Class Code: WEB,55.0
9/6/2022,,Withdrawal ACH PAYPAL/TYPE: INST XFER ID: PAYPALSI77CO: PAYPAL NAME: STEVEN CHAPLINSKIEntry Class Code: WEB,39.99,,Posted,668.67,2022-09-06,39.99,Withdrawal ACH PAYPAL/TYPE: INST XFER ID: PAYPALSI77CO: PAYPAL NAME: STEVEN CHAPLINSKIEntry Class Code: WEB,39.985
9/6/2022,,Withdrawal ACH PAYPAL/TYPE: INST XFER ID: PAYPALSI77CO: PAYPAL NAME: STEVEN CHAPLINSKIEntry Class Code: WEB,19.95,,Posted,708.66,2022-09-06,19.95,Withdrawal ACH PAYPAL/TYPE: INST XFER ID: PAYPALSI77CO: PAYPAL NAME: STEVEN CHAPLINSKIEntry Class Code: WEB,19.98
9/6/2022,,Withdrawal ACH PAYPAL/TYPE: INST XFER ID: PAYPALSI77CO: PAYPAL NAME: STEVEN CHAPLINSKIEntry Class Code: WEB,14.99,,Posted,728.61,2022-09-06,14.99,Withdrawal ACH PAYPAL/TYPE: INST XFER ID: PAYPALSI77CO: PAYPAL NAME: STEVEN CHAPLINSKIEntry Class Code: WEB,14.948333333333332
9/6/2022,,Withdrawal ACH PAYPAL/TYPE: INST XFER ID: PAYPALSI77CO: PAYPAL NAME: STEVEN CHAPLINSKIEntry Class Code: WEB,5.66,,Posted,743.6,2022-09-06,5.66,Withdrawal ACH PAYPAL/TYPE: INST XFER ID: PAYPALSI77CO: PAYPAL NAME: STEVEN CHAPLINSKIEntry Class Code: WEB,6.0875
9/6/2022,,Withdrawal ACH PAYPAL/TYPE: INST XFER ID: PAYPALSI77CO: PAYPAL NAME: STEVEN CHAPLINSKIEntry Class Code: WEB,2.99,,Posted,749.26,2022-09-06,2.99,Withdrawal ACH PAYPAL/TYPE: INST XFER ID: PAYPALSI77CO: PAYPAL NAME: STEVEN CHAPLINSKIEntry Class Code: WEB,3.218
9/5/2022,,Withdrawal Debit Card MC Debit/PUBLIX #680 GAINESVILLE FLDate 09/04/22 0 2247925737 0 5411Card 2801,39.14,,Posted,752.25,2022-09-05,39.14,Withdrawal Debit Card MC Debit/PUBLIX #1560 GAINESVILLE FLDate 09/04/21 0 1247836114 5 5411Card 2801,39.14
9/4/2022,,Withdrawal ATM Fee/EFT 3401 W University Ave Gainesville FLCard 2801,2.0,,Posted,791.39,2022-09-04,2.0,"Withdrawal ATM Fee/EFT 3401 W University Ave Gainesville FL

Card 1247",2.0
9/4/2022,,Withdrawal at ATM #000000000111/EFT 3401 W University Ave Gainesville FLCard 2801,83.0,,Posted,793.39,2022-09-04,83.0,"Withdrawal at ATM #000000776623/EFT 3401 W University Ave Gainesville FL

Card 1247",83.0
9/4/2022,,Recurring Withdrawal Debit Card MC Debit/PLAYERAUCTIONS 800-342-0768 DEDate 09/03/22 0 2246441191 0 7993Card 2801,45.51,,Posted,876.39,2022-09-04,45.51,Recurring Withdrawal Debit Card MC Debit/PLAYERAUCTIONS 800-342-0768 DEDate 09/23/21 0 1266586911 1 7993Card 2801,45.72
9/4/2022,,Withdrawal Debit Card MC Debit/COX GAINESVILLE COMM 800-234-3993 FLDate 09/03/22 0 2246615886 0 4899Card 2801,117.89,,Posted,921.9,2022-09-04,117.89,Withdrawal Debit Card MC Debit/COX GAINESVILLE COMM 800-234-3993 FLDate 01/27/22 0 2027240681 1 4899Card 2801,117.89
9/3/2022,,Withdrawal POS #000000292954/SUNOCO 8002212501 4234 SW 20TH AVEGAINESVILLE FLCard 2801,30.24,,Posted,1039.79,2022-09-03,30.24,Withdrawal POS #000000219124/SUNOCO 8002212501 4234 SW 20TH AVEGAINESVILLE FLCard 2801,30.24
9/2/2022,,Withdrawal ACH Watson Realty Co/TYPE: WEB PMTS ID: 9000321157CO: Watson Realty CoNAME: Steven chaplinskiEntry Class Code: WEB,995.0,,Posted,1070.03,2022-09-02,995.0,Withdrawal ACH Watson Realty Co/TYPE: WEB PMTS ID: 9000321157CO: Watson Realty CoEntry Class Code: WEB,995.0
9/2/2022,,Withdrawal ACH PAYPAL/TYPE: INST XFER ID: PAYPALSI77CO: PAYPAL NAME: STEVEN CHAPLINSKIEntry Class Code: WEB,39.99,,Posted,2065.03,2022-09-02,39.99,Withdrawal ACH PAYPAL/TYPE: INST XFER ID: PAYPALSI77CO: PAYPAL NAME: STEVEN CHAPLINSKIEntry Class Code: WEB,39.985
9/2/2022,,Withdrawal ACH PAYPAL/TYPE: INST XFER ID: PAYPALSI77CO: PAYPAL NAME: STEVEN CHAPLINSKIEntry Class Code: WEB,11.48,,Posted,2105.02,2022-09-02,11.48,Withdrawal ACH PAYPAL/TYPE: INST XFER ID: PAYPALSI77CO: PAYPAL NAME: STEVEN CHAPLINSKIEntry Class Code: WEB,11.7425
9/2/2022,,Withdrawal POS #000000027265/AMAZON.COM*1V1FM9EV0 SEATTLE WACard 2801,32.07,,Posted,2116.5,2022-09-02,32.07,Withdrawal POS #000000990788/AMAZON.COM*215VY1SG1 SEATTLE WACard 2801,32.07
9/1/2022,,Withdrawal Debit Card MC Debit/PUBLIX #435 GAINESVILLE FLDate 08/31/22 0 2243083753 1 5411Card 2801,19.27,,Posted,2148.57,2022-09-01,19.27,Withdrawal Debit Card MC Debit/PUBLIX #435 GAINESVILLE FLDate 08/31/22 0 2243083753 1 5411Card 2801,19.27
9/1/2022,,Withdrawal Debit Card MC Debit/CHEGG ORDER 8558681054 CADate 09/01/22 0 2244077661 1 5942Card 2801,15.95,,Posted,2167.84,2022-09-01,15.95,Withdrawal Debit Card MC Debit/CHEGG ORDER 8558681054 CADate 09/01/22 0 2244077661 1 5942Card 2801,15.95
9/1/2022,,Withdrawal ACH PAYPAL/TYPE: INST XFER ID: PAYPALSI77CO: PAYPAL NAME: STEVEN CHAPLINSKIEntry Class Code: WEB,39.99,,Posted,2183.79,2022-09-01,39.99,Withdrawal ACH PAYPAL/TYPE: INST XFER ID: PAYPALSI77CO: PAYPAL NAME: STEVEN CHAPLINSKIEntry Class Code: WEB,39.985
8/31/2022,,Withdrawal POS #000000000388/CIRCLE K # 26146 3525 GAINESVILLE FLCard 2801,19.45,,Posted,223.78,2022-08-31,19.45,Withdrawal POS #000000000558/CIRCLE K # 26146 3525 GAINESVILLE FLCard 2801,19.45
8/31/2022,,Withdrawal ATM Fee/EFT 3401 W University Ave Gainesville FLCard 2801,2.0,,Posted,243.23,2022-08-31,2.0,"Withdrawal ATM Fee/EFT 3401 W University Ave Gainesville FL

Card 1247",2.0
8/31/2022,,Withdrawal at ATM #000000000065/EFT 3401 W University Ave Gainesville FLCard 2801,33.0,,Posted,245.23,2022-08-31,33.0,"Withdrawal at ATM #000000776623/EFT 3401 W University Ave Gainesville FL

Card 1247",33.0
8/31/2022,,Withdrawal/Cash Disbursed 35.00,35.0,,Posted,278.23,2022-08-31,35.0,Withdrawal/Cash Disbursed 35.00,35.0
8/31/2022,,Withdrawal ACH DISCOVER/TYPE: E-PAYMENT ID: 2510020270CO: DISCOVER NAME: CHAPLINSKI STEVENEntry Class Code: WEB,33.0,,Posted,313.23,2022-08-31,33.0,Withdrawal ACH DISCOVER/TYPE: E-PAYMENT ID: 2510020270CO: DISCOVER NAME: CHAPLINSKI STEVENEntry Class Code: WEB,33.5
8/31/2022,,Withdrawal POS #000000960895/AMAZON.COM*NZ8UC5PW3 SEATTLE WACard 2801,16.68,,Posted,346.23,2022-08-31,16.68,Withdrawal POS #000000630901/AMAZON.COM*ZA2053S23 SEATTLE WACard 2801,16.835
8/30/2022,,Withdrawal ACH PAYPAL/TYPE: INST XFER ID: PAYPALSI77CO: PAYPAL NAME: STEVEN CHAPLINSKIEntry Class Code: WEB,39.99,,Posted,362.91,2022-08-30,39.99,Withdrawal ACH PAYPAL/TYPE: INST XFER ID: PAYPALSI77CO: PAYPAL NAME: STEVEN CHAPLINSKIEntry Class Code: WEB,39.985
8/30/2022,,Withdrawal POS #000000630901/AMAZON.COM*ZA2053S23 SEATTLE WACard 2801,10.15,,Posted,402.9,2022-08-30,10.15,Withdrawal POS #000000990788/AMAZON.COM*215VY1SG1 SEATTLE WACard 2801,10.15
8/30/2022,,Withdrawal POS #000000000021/CIRCLE K # 26146 3525 GAINESVILLE FLCard 2801,25.85,,Posted,413.05,2022-08-30,25.85,Withdrawal POS #000000000558/CIRCLE K # 26146 3525 GAINESVILLE FLCard 2801,25.85
8/30/2022,,Withdrawal ATM Fee/EFT 3401 W University Ave Gainesville FLCard 2801,2.0,,Posted,438.9,2022-08-30,2.0,"Withdrawal ATM Fee/EFT 3401 W University Ave Gainesville FL

Card 1247",2.0
8/30/2022,,Withdrawal at ATM #000000000050/EFT 3401 W University Ave Gainesville FLCard 2801,63.0,,Posted,440.9,2022-08-30,63.0,"Withdrawal at ATM #000000776623/EFT 3401 W University Ave Gainesville FL

Card 1247",63.0
8/29/2022,,Recurring Withdrawal Debit Card MC Debit/ADOBE CREATIVE CLOUD 4085366000 CADate 08/28/22 0 2240015432 1 5734Card 2801,19.99,,Posted,3.9,2022-08-29,19.99,Recurring Withdrawal Debit Card MC Debit/ADOBE CREATIVE CLOUD 4085366000 CADate 09/28/22 0 2271807482 0 5734Card 2801,19.99
8/29/2022,,Withdrawal ACH PAYPAL/TYPE: INST XFER ID: PAYPALSI77CO: PAYPAL NAME: STEVEN CHAPLINSKIEntry Class Code: WEB,14.99,,Posted,23.89,2022-08-29,14.99,Withdrawal ACH PAYPAL/TYPE: INST XFER ID: PAYPALSI77CO: PAYPAL NAME: STEVEN CHAPLINSKIEntry Class Code: WEB,14.948333333333332
8/29/2022,,Withdrawal ACH PAYPAL/TYPE: INST XFER ID: PAYPALSI77CO: PAYPAL NAME: STEVEN CHAPLINSKIEntry Class Code: WEB,2.99,,Posted,38.88,2022-08-29,2.99,Withdrawal ACH PAYPAL/TYPE: INST XFER ID: PAYPALSI77CO: PAYPAL NAME: STEVEN CHAPLINSKIEntry Class Code: WEB,3.218
8/29/2022,,Withdrawal ACH PAYPAL/TYPE: INST XFER ID: PAYPALSI77CO: PAYPAL NAME: STEVEN CHAPLINSKIEntry Class Code: WEB,2.99,,Posted,41.87,2022-08-29,2.99,Withdrawal ACH PAYPAL/TYPE: INST XFER ID: PAYPALSI77CO: PAYPAL NAME: STEVEN CHAPLINSKIEntry Class Code: WEB,3.218
8/29/2022,,Withdrawal POS #000088529500/FAST TRACK #200 3960 SW ARCHER RDGAINESVILLE FLCard 2801,9.88,,Posted,44.86,2022-08-29,9.88,Withdrawal POS #000088529500/FAST TRACK #200 3960 SW ARCHER RDGAINESVILLE FLCard 2801,10.280000000000001
8/28/2022,,Withdrawal Debit Card MC Debit/WALGREENS #5024 800-289-2273 FLDate 08/26/22 0 2238277635 2 5912Card 2801,15.0,,Posted,54.74,2022-08-28,15.0,Withdrawal Debit Card MC Debit/WALGREENS #5024 800-289-2273 FLDate 08/26/22 0 2238277635 2 5912Card 2801,15.0
8/26/2022,,Withdrawal POS #000000789325/SUNOCO 8002212501 4234 SW 20TH AVEGAINESVILLE FLCard 2801,22.74,,Posted,69.74,2022-08-26,22.74,Withdrawal POS #000000955321/SUNOCO 8002212501 4234 SW 20TH AVEGAINESVILLE FLCard 2801,22.569999999999997
8/26/2022,,Withdrawal ACH PAYPAL/TYPE: INST XFER ID: PAYPALSI77CO: PAYPAL NAME: STEVEN CHAPLINSKIEntry Class Code: WEB,4.5,,Posted,92.48,2022-08-26,4.5,Withdrawal ACH PAYPAL/TYPE: INST XFER ID: PAYPALSI77CO: PAYPAL NAME: STEVEN CHAPLINSKIEntry Class Code: WEB,4.96
8/25/2022,,Withdrawal Debit Card MC Debit/PUBLIX #680 GAINESVILLE FLDate 08/24/22 0 2236025671 1 5411Card 2801,40.29,,Posted,96.98,2022-08-25,40.29,Withdrawal Debit Card MC Debit/PUBLIX #1560 GAINESVILLE FLDate 09/04/21 0 1247836114 5 5411Card 2801,40.72
8/25/2022,,Withdrawal Debit Card MC Debit/DOCTORS RADIOLOGY GROU 352-3319729 FLDate 08/24/22 0 2236023780 1 8011Card 2801,184.7,,Posted,137.27,2022-08-25,184.7,Withdrawal Debit Card MC Debit/DOCTORS RADIOLOGY GROU 352-3319729 FLDate 08/24/22 0 2236023780 1 8011Card 2801,184.7
8/25/2022,,Withdrawal Debit Card MC Debit/BESTBUYCOM806672104504 888BESTBUY MNDate 08/24/22 0 2236332547 0 5732Card 2801,26.73,,Posted,321.97,2022-08-25,26.73,Withdrawal Debit Card MC Debit/BESTBUYCOM806672104504 888BESTBUY MNDate 08/24/22 0 2236332547 0 5732Card 2801,26.73
8/25/2022,,Withdrawal ACH SABRINA AZAMBUJA/CO: SABRINA AZAMBUJATYPE: IAT PAYPAL ID: 770510487CEntry Class Code: IAT,22.0,,Posted,348.7,2022-08-25,22.0,Withdrawal ACH SABRINA AZAMBUJA/CO: SABRINA AZAMBUJATYPE: IAT PAYPAL ID: 770510487CEntry Class Code: IAT,22.0
8/24/2022,,Withdrawal ATM Fee/EFT 6419 W Newberry Rd Gainesville FLCard 2801,2.0,,Posted,370.7,2022-08-24,2.0,"Withdrawal ATM Fee/EFT 6419 W Newberry Rd Gainesville FL

Card 1247",2.0
8/24/2022,,Withdrawal at ATM #000000000781/EFT 6419 W Newberry Rd Gainesville FLCard 2801,83.0,,Posted,372.7,2022-08-24,83.0,"Withdrawal at ATM #000000785755/EFT 6419 W Newberry Rd Gainesville FL

Card 1247",83.0
8/24/2022,,Withdrawal ACH DISCOVER/TYPE: E-PAYMENT ID: 2510020270CO: DISCOVER NAME: CHAPLINSKI STEVENEntry Class Code: WEB,15.0,,Posted,55.7,2022-08-24,15.0,Withdrawal ACH DISCOVER/TYPE: E-PAYMENT ID: 2510020270CO: DISCOVER NAME: CHAPLINSKI STEVENEntry Class Code: WEB,15.0
8/24/2022,,Withdrawal POS #000096291462/FAST TRACK #200 GAINESVILLE FLCard 2801,27.48,,Posted,70.7,2022-08-24,27.48,Withdrawal POS #000096296533/FAST TRACK #200 GAINESVILLE FLCard 2801,27.52
8/23/2022,,Withdrawal POS #000000642926/SUNOCO 8002212501 4234 SW 20TH AVEGAINESVILLE FLCard 2801,18.32,,Posted,98.18,2022-08-23,18.32,Withdrawal POS #000000639499/SUNOCO 8002212501 4234 SW 20TH AVEGAINESVILLE FLCard 2801,18.32
8/23/2022,,Withdrawal Debit Card MC Debit/DOCTORS RADIOLOGY GROU 352-3319729 FLDate 08/22/22 0 2234957871 0 8011Card 2801,30.0,,Posted,116.5,2022-08-23,30.0,Withdrawal Debit Card MC Debit/DOCTORS RADIOLOGY GROU 352-3319729 FLDate 08/24/22 0 2236023780 1 8011Card 2801,30.0
8/20/2022,,Withdrawal POS #000003108754/GOOGLE *YouTubePremium 1600 AmphitheatreParkw Mountain View CACard 2801,13.62,,Posted,146.5,2022-08-20,13.62,Withdrawal POS #000003285955/GOOGLE *YouTubePremium 1600 AmphitheatreParkw Mountain View CACard 2801,13.629999999999999
8/20/2022,,Withdrawal POS #000000032357/SUNOCO 8002212501 4234 SW 20TH AVEGAINESVILLE FLCard 2801,18.32,,Posted,160.12,2022-08-20,18.32,Withdrawal POS #000000673237/SUNOCO 8002212501 4234 SW 20TH AVEGAINESVILLE FLCard 2801,18.32
8/18/2022,,Withdrawal Debit Card MC Debit/WALGREENS #5024 800-289-2273 FLDate 08/17/22 0 2229033652 1 5912Card 2801,7.49,,Posted,178.44,2022-08-18,7.49,Withdrawal Debit Card MC Debit/WALGREENS #5024 800-289-2273 FLDate 08/26/22 0 2238277635 2 5912Card 2801,7.49
8/17/2022,,Recurring Withdrawal Debit Card MC Debit/PLAYERAUCTIONS 800-342-0768 DEDate 08/16/22 0 2228778394 0 7993Card 2801,21.84,,Posted,185.93,2022-08-17,21.84,Recurring Withdrawal Debit Card MC Debit/PLAYERAUCTIONS 800-342-0768 DEDate 11/17/22 0 2321371857 0 7993Card 2801,21.84
8/16/2022,,Withdrawal POS #000000001638/CIRCLE K # 06527 9404 GAINESVILLE FLCard 2801,19.6,,Posted,207.77,2022-08-16,19.6,Withdrawal POS #000000001638/CIRCLE K # 06527 9404 GAINESVILLE FLCard 2801,19.855
8/15/2022,,Withdrawal POS #000000765169/SUNOCO 8002212501 4234 SW 20TH AVEGAINESVILLE FLCard 2801,30.24,,Posted,227.37,2022-08-15,30.24,Withdrawal POS #000000437179/SUNOCO 8002212501 4234 SW 20TH AVEGAINESVILLE FLCard 2801,30.24
8/15/2022,,Withdrawal ACH CANVA PTY LIMITE/CO: CANVA PTY LIMITEDTYPE: IAT PAYPAL ID: 770510487CEntry Class Code: IAT,12.99,,Posted,257.61,2022-08-15,12.99,Withdrawal ACH CANVA PTY LIMITE/CO: CANVA PTY LIMITEDTYPE: IAT PAYPAL ID: 770510487CEntry Class Code: IAT,12.99
8/15/2022,,Withdrawal ACH PAYMENT FOR AMZ/TYPE: STORECARD ID: 9069872103CO: PAYMENT FOR AMZNAME: 6045781157416487Entry Class Code: WEB,5.0,,Posted,270.6,2022-08-15,5.0,Withdrawal ACH PAYMENT FOR AMZ/TYPE: STORECARD ID: 9069872103CO: PAYMENT FOR AMZNAME: 6045781157416487Entry Class Code: WEB,5.0
8/14/2022,,Withdrawal Debit Card MC Debit/ODH-BIRTH CERTIF 614-466-2531 OHDate 08/13/22 0 2225808784 0 9399Card 2801,21.5,,Posted,275.6,2022-08-14,21.5,Withdrawal Debit Card MC Debit/ODH-BIRTH CERTIF 614-466-2531 OHDate 08/13/22 0 2225808784 0 9399Card 2801,21.5
8/12/2022,,Recurring Withdrawal Debit Card Fee/MASTERCARD ISSUER CROSS-BORDER FEEDate 08/11/22 0 2223767056 0 5734Card 2801,0.05,,Posted,297.1,2022-08-12,0.05,Recurring Withdrawal Debit Card Fee/MASTERCARD ISSUER CROSS-BORDER FEEDate 06/11/22 0 2162900620 0 5734Card 2801,0.07500000000000001
8/12/2022,,Recurring Withdrawal Debit Card MC Debit/PAYPAL *LINKTREEPTY 4029357733 AUDate 08/11/22 0 2223767056 0 5734Card 2801,6.0,,Posted,297.15,2022-08-12,6.0,Recurring Withdrawal Debit Card MC Debit/PAYPAL *LINKTREE 4029357733 AUDate 05/12/21 0 1132191600 1 7372Card 2801,6.0
8/11/2022,,Withdrawal Debit Card MC Debit/PUBLIX #1312 GAINESVILLE FLDate 08/10/22 0 2222058464 1 5411Card 2801,86.85,,Posted,303.15,2022-08-11,86.85,Withdrawal Debit Card MC Debit/PUBLIX #1312 GAINESVILLE FLDate 03/11/21 0 1070536058 1 5411Card 2801,86.85
8/11/2022,,Withdrawal ACH PAYPAL/TYPE: INST XFER ID: PAYPALSI77CO: PAYPAL NAME: STEVEN CHAPLINSKIEntry Class Code: WEB,9.99,,Posted,390.0,2022-08-11,9.99,Withdrawal ACH PAYPAL/TYPE: INST XFER ID: PAYPALSI77CO: PAYPAL NAME: STEVEN CHAPLINSKIEntry Class Code: WEB,10.093333333333334
8/11/2022,,Withdrawal POS #000000736780/AMAZON.COM*U78AZ3Q63 SEATTLE WACard 2801,10.15,,Posted,399.99,2022-08-11,10.15,Withdrawal POS #000000991850/AMAZON.COM*7Q29B9KF3 SEATTLE WACard 2801,10.51
8/10/2022,,Withdrawal ATM Fee/EFT 6419 W Newberry Rd Gainesville FLCard 2801,2.0,,Posted,325.14,2022-08-10,2.0,"Withdrawal ATM Fee/EFT 6419 W Newberry Rd Gainesville FL

Card 1247",2.0
8/10/2022,,Withdrawal at ATM #000000000571/EFT 6419 W Newberry Rd Gainesville FLCard 2801,63.0,,Posted,327.14,2022-08-10,63.0,"Withdrawal at ATM #000000785755/EFT 6419 W Newberry Rd Gainesville FL

Card 1247",63.0
8/10/2022,,Withdrawal POS #000055843900/WAWA 5325 2373 SW ARCHER ROADFLCard 2801,2.64,,Posted,390.14,2022-08-10,2.64,Withdrawal POS #000000553411/WAWA 5325 2373 SW ARCHER ROADFLCard 1247,2.64
8/10/2022,,Withdrawal Debit Card MC Debit/DOCTORS RADIOLOGY GROU 352-3319729 FLDate 08/09/22 0 2221023616 1 8011Card 2801,55.0,,Posted,392.78,2022-08-10,55.0,Withdrawal Debit Card MC Debit/DOCTORS RADIOLOGY GROU 352-3319729 FLDate 08/24/22 0 2236023780 1 8011Card 2801,55.0
8/10/2022,,Withdrawal ACH ENVATO/CO: ENVATOTYPE: IAT PAYPAL ID: 770510487CEntry Class Code: IAT,39.0,,Posted,447.78,2022-08-10,39.0,Withdrawal ACH ENVATO/CO: ENVATOTYPE: IAT PAYPAL ID: 770510487CEntry Class Code: IAT,39.0
8/8/2022,,Withdrawal POS #000000734498/SUNOCO 8002212501 4234 SW 20TH AVEGAINESVILLE FLCard 2801,20.47,,Posted,486.78,2022-08-08,20.47,Withdrawal POS #000000238444/SUNOCO 8002212501 4234 SW 20TH AVEGAINESVILLE FLCard 2801,20.47
8/8/2022,,Withdrawal ACH SABRINA AZAMBUJA/CO: SABRINA AZAMBUJATYPE: IAT PAYPAL ID: 770510487CEntry Class Code: IAT,42.0,,Posted,507.25,2022-08-08,42.0,Withdrawal ACH SABRINA AZAMBUJA/CO: SABRINA AZAMBUJATYPE: IAT PAYPAL ID: 770510487CEntry Class Code: IAT,42.0
8/8/2022,,Withdrawal ACH PAYPAL/TYPE: INST XFER ID: PAYPALSI77CO: PAYPAL NAME: STEVEN CHAPLINSKIEntry Class Code: WEB,14.99,,Posted,549.25,2022-08-08,14.99,Withdrawal ACH PAYPAL/TYPE: INST XFER ID: PAYPALSI77CO: PAYPAL NAME: STEVEN CHAPLINSKIEntry Class Code: WEB,14.948333333333332
8/8/2022,,Withdrawal POS #000007022835/PAYPAL *VIDIQ 2211 North First StreetJose CACard 2801,10.0,,Posted,564.24,2022-08-08,10.0,Withdrawal POS #000005221556/PAYPAL *VIDIQ 2211 North First StreetJose CACard 2801,10.0
8/6/2022,,Recurring Withdrawal Bill Payment - #000000400342/NETFLIX COM LOS GATOS CACard 2801,10.98,,Posted,574.24,2022-08-06,10.98,Recurring Withdrawal Bill Payment - #000006911729/NETFLIX COM LOS GATOS CACard 2801,10.99
8/5/2022,,Withdrawal ACH DISCOVER/TYPE: E-PAYMENT ID: 2510020270CO: DISCOVER NAME: CHAPLINSKI STEVENEntry Class Code: WEB,10.0,,Posted,585.22,2022-08-05,10.0,Withdrawal ACH DISCOVER/TYPE: E-PAYMENT ID: 2510020270CO: DISCOVER NAME: CHAPLINSKI STEVENEntry Class Code: WEB,10.0
8/4/2022,,Withdrawal ACH BEST BUY/TYPE: PAYMENT ID: CITIGPUFDRCO: BEST BUYEntry Class Code: PPD,15.0,,Posted,595.22,2022-08-04,15.0,Withdrawal ACH BEST BUY/TYPE: PAYMENT ID: CITIGPUFDRCO: BEST BUYEntry Class Code: TEL,15.0
8/4/2022,,Withdrawal ACH BEST BUY/TYPE: PAYMENT ID: CITIGPUFDRCO: BEST BUYEntry Class Code: PPD,25.0,,Posted,610.22,2022-08-04,25.0,Withdrawal ACH BEST BUY/TYPE: PAYMENT ID: CITIGPUFDRCO: BEST BUYEntry Class Code: TEL,25.0
8/4/2022,,Withdrawal ACH PAYPAL/TYPE: INST XFER ID: PAYPALSI77CO: PAYPAL NAME: STEVEN CHAPLINSKIEntry Class Code: WEB,2.99,,Posted,635.22,2022-08-04,2.99,Withdrawal ACH PAYPAL/TYPE: INST XFER ID: PAYPALSI77CO: PAYPAL NAME: STEVEN CHAPLINSKIEntry Class Code: WEB,3.218
8/3/2022,,Withdrawal POS #000000054086/SUNOCO 8002212501 4234 SW 20TH AVEGAINESVILLE FLCard 2801,28.09,,Posted,638.21,2022-08-03,28.09,Withdrawal POS #000000550998/SUNOCO 8002212501 4234 SW 20TH AVEGAINESVILLE FLCard 2801,28.09
8/3/2022,,Withdrawal ACH PAYPAL/TYPE: INST XFER ID: PAYPALSI77CO: PAYPAL NAME: STEVEN CHAPLINSKIEntry Class Code: WEB,14.99,,Posted,666.3,2022-08-03,14.99,Withdrawal ACH PAYPAL/TYPE: INST XFER ID: PAYPALSI77CO: PAYPAL NAME: STEVEN CHAPLINSKIEntry Class Code: WEB,14.948333333333332
8/3/2022,,Withdrawal ACH PAYPAL/TYPE: INST XFER ID: PAYPALSI77CO: PAYPAL NAME: STEVEN CHAPLINSKIEntry Class Code: WEB,1.99,,Posted,681.29,2022-08-03,1.99,Withdrawal ACH PAYPAL/TYPE: INST XFER ID: PAYPALSI77CO: PAYPAL NAME: STEVEN CHAPLINSKIEntry Class Code: WEB,2.3299999999999996
8/2/2022,,Withdrawal ACH PAYPAL/TYPE: INST XFER ID: PAYPALSI77CO: PAYPAL NAME: STEVEN CHAPLINSKIEntry Class Code: WEB,11.48,,Posted,683.28,2022-08-02,11.48,Withdrawal ACH PAYPAL/TYPE: INST XFER ID: PAYPALSI77CO: PAYPAL NAME: STEVEN CHAPLINSKIEntry Class Code: WEB,11.7425
8/2/2022,,Withdrawal POS #000000337080/AMAZON.COM*3S5OR1RN3 SEATTLE WACard 2801,10.15,,Posted,694.76,2022-08-02,10.15,Withdrawal POS #000000736780/AMAZON.COM*U78AZ3Q63 SEATTLE WACard 2801,10.51
8/1/2022,,Withdrawal ACH Watson Realty Co/TYPE: WEB PMTS ID: 9000321157CO: Watson Realty CoNAME: Steven chaplinskiEntry Class Code: WEB,995.0,,Posted,704.91,2022-08-01,995.0,Withdrawal ACH Watson Realty Co/TYPE: WEB PMTS ID: 9000321157CO: Watson Realty CoEntry Class Code: WEB,995.0
8/1/2022,,Withdrawal ACH GRU/EZ-PAY PHONE/TYPE: UTILITIES ID: 0000007041CO: GRU/EZ-PAY PHONEEntry Class Code: TEL,225.35,,Posted,1699.91,2022-08-01,225.35,Withdrawal ACH GRU/EZ-PAY PHONE/TYPE: UTILITIES ID: 0000007041CO: GRU/EZ-PAY PHONEEntry Class Code: TEL,225.35
8/1/2022,,Withdrawal ACH PAYPAL/TYPE: INST XFER ID: PAYPALSI77CO: PAYPAL NAME: STEVEN CHAPLINSKIEntry Class Code: WEB,3.99,,Posted,1925.26,2022-08-01,3.99,Withdrawal ACH PAYPAL/TYPE: INST XFER ID: PAYPALSI77CO: PAYPAL NAME: STEVEN CHAPLINSKIEntry Class Code: WEB,3.218
8/1/2022,,Withdrawal ACH PAYPAL/TYPE: INST XFER ID: PAYPALSI77CO: PAYPAL NAME: STEVEN CHAPLINSKIEntry Class Code: WEB,3.99,,Posted,1929.25,2022-08-01,3.99,Withdrawal ACH PAYPAL/TYPE: INST XFER ID: PAYPALSI77CO: PAYPAL NAME: STEVEN CHAPLINSKIEntry Class Code: WEB,3.218
8/1/2022,,Withdrawal POS #000000255319/SUNOCO 8002212501 4234 SW 20TH AVEGAINESVILLE FLCard 2801,22.74,,Posted,1933.24,2022-08-01,22.74,Withdrawal POS #000000955321/SUNOCO 8002212501 4234 SW 20TH AVEGAINESVILLE FLCard 2801,22.569999999999997
7/31/2022,,Withdrawal Debit Card MC Debit/PUBLIX #1038 GAINESVILLE FLDate 07/29/22 0 2210149844 2 5411Card 2801,125.79,,Posted,1955.98,2022-07-31,125.79,Withdrawal Debit Card MC Debit/PUBLIX #1376 GAINESVILLE FLDate 10/25/22 0 2298992341 0 5411Card 2801,125.79
7/31/2022,,Recurring Withdrawal Debit Card MC Debit/PLAYERAUCTIONS 800-342-0768 DEDate 07/30/22 0 2211746194 0 7993Card 2801,37.55,,Posted,2081.77,2022-07-31,37.55,Recurring Withdrawal Debit Card MC Debit/PLAYERAUCTIONS 800-342-0768 DEDate 09/23/21 0 1266586911 1 7993Card 2801,37.55
7/31/2022,,Withdrawal Debit Card MC Debit/COX GAINESVILLE COMM 800-234-3993 FLDate 07/29/22 0 2210539477 1 4899Card 2801,117.89,,Posted,2119.32,2022-07-31,117.89,Withdrawal Debit Card MC Debit/COX GAINESVILLE COMM 800-234-3993 FLDate 01/27/22 0 2027240681 1 4899Card 2801,117.89
7/29/2022,,Withdrawal ATM Fee/EFT 3401 W University Ave Gainesville FLCard 2801,2.0,,Posted,2237.21,2022-07-29,2.0,"Withdrawal ATM Fee/EFT 3401 W University Ave Gainesville FL

Card 1247",2.0
7/29/2022,,Withdrawal at ATM #000000000102/EFT 3401 W University Ave Gainesville FLCard 2801,163.0,,Posted,2239.21,2022-07-29,163.0,"Withdrawal at ATM #000000776623/EFT 3401 W University Ave Gainesville FL

Card 1247",163.0
7/29/2022,,Recurring Withdrawal Debit Card MC Debit/ADOBE CREATIVE CLOUD 4085366000 CADate 07/28/22 0 2209831549 0 5734Card 2801,19.99,,Posted,2402.21,2022-07-29,19.99,Recurring Withdrawal Debit Card MC Debit/ADOBE CREATIVE CLOUD 4085366000 CADate 09/28/22 0 2271807482 0 5734Card 2801,19.99
7/29/2022,,Withdrawal Debit Card MC Debit/WALGREENS #5024 800-289-2273 FLDate 07/28/22 0 2209059762 1 5912Card 2801,67.54,,Posted,2422.2,2022-07-29,67.54,Withdrawal Debit Card MC Debit/WALGREENS #5024 800-289-2273 FLDate 09/08/21 0 1251607416 1 5912Card 2801,67.54
7/29/2022,,Withdrawal Debit Card MC Debit/AMAZON PRIME*AH5FK9BT3 AMZN.COM/BIL WADate 07/29/22 0 2210009971 1 5968Card 2801,15.13,,Posted,2489.74,2022-07-29,15.13,Withdrawal Debit Card MC Debit/AMAZON PRIME*AH5FK9BT3 AMZN.COM/BIL WADate 07/29/22 0 2210009971 1 5968Card 2801,15.13
7/29/2022,,Withdrawal ACH PAYPAL/TYPE: INST XFER ID: PAYPALSI77CO: PAYPAL NAME: STEVEN CHAPLINSKIEntry Class Code: WEB,2.99,,Posted,2504.87,2022-07-29,2.99,Withdrawal ACH PAYPAL/TYPE: INST XFER ID: PAYPALSI77CO: PAYPAL NAME: STEVEN CHAPLINSKIEntry Class Code: WEB,3.218
7/28/2022,,Withdrawal Debit Card MC Debit/PIZZA HUT 27918 3523739402 FLDate 07/26/22 0 2207797243 0 5812Card 2801,36.52,,Posted,2007.86,2022-07-28,36.52,Withdrawal Debit Card MC Debit/PIZZA HUT 27918 3523739402 FLDate 12/16/22 0 2350808582 1 5812Card 2801,36.52
7/28/2022,,Withdrawal POS #000000980939/SUNOCO 8002212501 4234 SW 20TH AVEGAINESVILLE FLCard 2801,28.09,,Posted,2044.38,2022-07-28,28.09,Withdrawal POS #000000899960/SUNOCO 8002212501 4234 SW 20TH AVEGAINESVILLE FLCard 2801,28.09
7/28/2022,,Withdrawal ACH PAYPAL/TYPE: INST XFER ID: PAYPALSI77CO: PAYPAL NAME: STEVEN CHAPLINSKIEntry Class Code: WEB,24.99,,Posted,2072.47,2022-07-28,24.99,Withdrawal ACH PAYPAL/TYPE: INST XFER ID: PAYPALSI77CO: PAYPAL NAME: STEVEN CHAPLINSKIEntry Class Code: WEB,24.97
7/28/2022,,Withdrawal ACH PAYPAL/TYPE: INST XFER ID: PAYPALSI77CO: PAYPAL NAME: STEVEN CHAPLINSKIEntry Class Code: WEB,14.99,,Posted,2097.46,2022-07-28,14.99,Withdrawal ACH PAYPAL/TYPE: INST XFER ID: PAYPALSI77CO: PAYPAL NAME: STEVEN CHAPLINSKIEntry Class Code: WEB,14.948333333333332
7/27/2022,,Withdrawal ACH PAYPAL/TYPE: INST XFER ID: PAYPALSI77CO: PAYPAL NAME: STEVEN CHAPLINSKIEntry Class Code: WEB,2.99,,Posted,112.45,2022-07-27,2.99,Withdrawal ACH PAYPAL/TYPE: INST XFER ID: PAYPALSI77CO: PAYPAL NAME: STEVEN CHAPLINSKIEntry Class Code: WEB,3.218
7/26/2022,,Withdrawal Debit Card MC Debit/PIZZA HUT 27918 3523739402 FLDate 07/25/22 0 2206773805 0 5812Card 2801,36.52,,Posted,115.44,2022-07-26,36.52,Withdrawal Debit Card MC Debit/PIZZA HUT 27918 3523739402 FLDate 12/16/22 0 2350808582 1 5812Card 2801,36.52
7/26/2022,,Withdrawal ACH PAYPAL/TYPE: INST XFER ID: PAYPALSI77CO: PAYPAL NAME: STEVEN CHAPLINSKIEntry Class Code: WEB,4.5,,Posted,151.96,2022-07-26,4.5,Withdrawal ACH PAYPAL/TYPE: INST XFER ID: PAYPALSI77CO: PAYPAL NAME: STEVEN CHAPLINSKIEntry Class Code: WEB,4.96
7/25/2022,,Withdrawal ACH PAYPAL/TYPE: INST XFER ID: PAYPALSI77CO: PAYPAL NAME: STEVEN CHAPLINSKIEntry Class Code: WEB,44.41,,Posted,156.46,2022-07-25,44.41,Withdrawal ACH PAYPAL/TYPE: INST XFER ID: PAYPALSI77CO: PAYPAL NAME: STEVEN CHAPLINSKIEntry Class Code: WEB,44.12
7/25/2022,,Withdrawal POS #000000271313/AMAZON.COM*BA54M5XZ3 SEATTLE WACard 2801,35.76,,Posted,200.87,2022-07-25,35.76,Withdrawal POS #000000247445/AMAZON.COM*A42ZY7OC3 SEATTLE WACard 2801,35.76
7/23/2022,,Withdrawal POS #000000683464/SUNOCO 8002212501 4234 SW 20TH AVEGAINESVILLE FLCard 2801,30.24,,Posted,236.63,2022-07-23,30.24,Withdrawal POS #000000689838/SUNOCO 8002212501 4234 SW 20TH AVEGAINESVILLE FLCard 2801,30.24
7/23/2022,,Withdrawal POS #000000600037/SUNOCO 8002212501 4234 SW 20TH AVEGAINESVILLE FLCard 2801,18.32,,Posted,66.87,2022-07-23,18.32,Withdrawal POS #000000260400/SUNOCO 8002212501 4234 SW 20TH AVEGAINESVILLE FLCard 2801,18.32
7/21/2022,,Recurring Withdrawal Debit Card MC Debit/ZIP.CO* BEST BUY NEW YORK NYDate 07/20/22 0 2201728200 0 5399Card 2801,36.92,,Posted,85.19,2022-07-21,36.92,Recurring Withdrawal Debit Card MC Debit/ZIP.CO* BEST BUY NEW YORK NYDate 07/20/22 0 2201728200 0 5399Card 2801,36.92
7/20/2022,,Withdrawal POS #000003052032/GOOGLE *YouTubePremium 1600 AmphitheatreParkw Mountain View CACard 2801,11.99,,Posted,122.11,2022-07-20,11.99,Withdrawal POS #000003285955/GOOGLE *YouTubePremium 1600 AmphitheatreParkw Mountain View CACard 2801,11.99
7/18/2022,,Withdrawal POS #000000411427/SUNOCO 8002212501 4234 SW 20TH AVEGAINESVILLE FLCard 2801,20.0,,Posted,134.1,2022-07-18,20.0,Withdrawal POS #000000142991/SUNOCO 8002212501 4234 SW 20TH AVEGAINESVILLE FLCard 2801,20.0
7/18/2022,,Withdrawal POS #000000403720/SUNOCO 8002212501 4234 SW 20TH AVEGAINESVILLE FLCard 2801,28.09,,Posted,154.1,2022-07-18,28.09,Withdrawal POS #000000403720/SUNOCO 8002212501 4234 SW 20TH AVEGAINESVILLE FLCard 2801,28.32
7/18/2022,,Withdrawal ACH PAYPAL/TYPE: INST XFER ID: PAYPALSI77CO: PAYPAL NAME: STEVEN CHAPLINSKIEntry Class Code: WEB,8.89,,Posted,182.19,2022-07-18,8.89,Withdrawal ACH PAYPAL/TYPE: INST XFER ID: PAYPALSI77CO: PAYPAL NAME: STEVEN CHAPLINSKIEntry Class Code: WEB,9.015
7/15/2022,,Withdrawal ACH PAYPAL/TYPE: INST XFER ID: PAYPALSI77CO: PAYPAL NAME: STEVEN CHAPLINSKIEntry Class Code: WEB,14.99,,Posted,191.08,2022-07-15,14.99,Withdrawal ACH PAYPAL/TYPE: INST XFER ID: PAYPALSI77CO: PAYPAL NAME: STEVEN CHAPLINSKIEntry Class Code: WEB,14.948333333333332
7/14/2022,,Withdrawal POS #000000062086/PUBLIX 3100 SW 35TH BLVD GAINESVILLE FLCard 2801,17.58,,Posted,206.07,2022-07-14,17.58,Withdrawal POS #000000036956/PUBLIX 5801 SW 75TH ST GAINESVILLE FLCard 2801,17.58
7/14/2022,,Withdrawal POS #000000000558/CIRCLE K # 26146 3525 GAINESVILLE FLCard 2801,33.37,,Posted,223.65,2022-07-14,33.37,Withdrawal POS #000000000558/CIRCLE K # 26146 3525 GAINESVILLE FLCard 2801,33.37
7/14/2022,,Withdrawal ATM Fee/EFT 3401 W University Ave Gainesville FLCard 2801,2.0,,Posted,257.02,2022-07-14,2.0,"Withdrawal ATM Fee/EFT 3401 W University Ave Gainesville FL

Card 1247",2.0
7/14/2022,,Withdrawal at ATM #000000000098/EFT 3401 W University Ave Gainesville FLCard 2801,58.0,,Posted,259.02,2022-07-14,58.0,"Withdrawal at ATM #000000776623/EFT 3401 W University Ave Gainesville FL

Card 1247",58.0
7/14/2022,,Withdrawal ACH CANVA PTY LIMITE/CO: CANVA PTY LIMITEDTYPE: IAT PAYPAL ID: 770510487CEntry Class Code: IAT,12.99,,Posted,317.02,2022-07-14,12.99,Withdrawal ACH CANVA PTY LIMITE/CO: CANVA PTY LIMITEDTYPE: IAT PAYPAL ID: 770510487CEntry Class Code: IAT,12.99
7/14/2022,,Withdrawal POS #000000991850/AMAZON.COM*7Q29B9KF3 SEATTLE WACard 2801,10.15,,Posted,330.01,2022-07-14,10.15,Withdrawal POS #000000259511/AMAZON.COM*2776K9KH0 SEATTLE WACard 2801,10.026666666666667
7/13/2022,,Withdrawal Debit Card MC Debit/PUBLIX #527 GAINESVILLE FLDate 07/12/22 0 2193036098 1 5411Card 2801,84.05,,Posted,340.16,2022-07-13,84.05,Withdrawal Debit Card MC Debit/PUBLIX #1312 GAINESVILLE FLDate 03/11/21 0 1070536058 1 5411Card 2801,84.05
7/13/2022,,Withdrawal Debit Card MC Debit/WALGREENS #5024 800-289-2273 FLDate 07/12/22 0 2193032769 1 5912Card 2801,15.48,,Posted,424.21,2022-07-13,15.48,Withdrawal Debit Card MC Debit/WALGREENS #5024 800-289-2273 FLDate 09/08/21 0 1251607416 1 5912Card 2801,15.24
7/13/2022,,Withdrawal Debit Card MC Debit/AMAZON PRIME*MG74E16U3 AMZN.COM/BIL WADate 07/13/22 0 2194975902 0 5968Card 2801,2.01,,Posted,439.69,2022-07-13,2.01,Withdrawal Debit Card MC Debit/AMAZON PRIME*MG74E16U3 AMZN.COM/BIL WADate 07/13/22 0 2194975902 0 5968Card 2801,2.01
7/13/2022,,Withdrawal ACH SABRINA AZAMBUJA/CO: SABRINA AZAMBUJATYPE: IAT PAYPAL ID: 770510487CEntry Class Code: IAT,37.0,,Posted,441.7,2022-07-13,37.0,Withdrawal ACH SABRINA AZAMBUJA/CO: SABRINA AZAMBUJATYPE: IAT PAYPAL ID: 770510487CEntry Class Code: IAT,37.0
7/13/2022,,Withdrawal ACH PAYMENT FOR AMZ/TYPE: STORECARD ID: 9069872103CO: PAYMENT FOR AMZNAME: 6045781157416487Entry Class Code: WEB,5.0,,Posted,478.7,2022-07-13,5.0,Withdrawal ACH PAYMENT FOR AMZ/TYPE: STORECARD ID: 9069872103CO: PAYMENT FOR AMZNAME: 6045781157416487Entry Class Code: WEB,5.0
7/13/2022,,Withdrawal POS #000000000008/AMAZON.COM*AH6A64SD3 SEATTLE WACard 2801,21.39,,Posted,483.7,2022-07-13,21.39,Withdrawal POS #000000000023/AMAZON.COM*AU8ER6ZT3 SEATTLE WACard 2801,21.39
7/12/2022,,Withdrawal POS #000000183316/GATE 1445 506 NW 13TH GAINESVILLE FLCard 2801,21.1,,Posted,505.09,2022-07-12,21.1,Withdrawal POS #000000183316/GATE 1445 506 NW 13TH GAINESVILLE FLCard 2801,21.335
7/12/2022,,Recurring Withdrawal Debit Card Fee/MASTERCARD ISSUER CROSS-BORDER FEEDate 07/11/22 0 2192747961 0 5734Card 2801,0.05,,Posted,526.19,2022-07-12,0.05,Recurring Withdrawal Debit Card Fee/MASTERCARD ISSUER CROSS-BORDER FEEDate 05/12/21 0 1132191600 1 7372Card 2801,0.09500000000000001
7/12/2022,,Recurring Withdrawal Debit Card MC Debit/PAYPAL *LINKTREEPTY 4029357733 AUDate 07/11/22 0 2192747961 0 5734Card 2801,6.0,,Posted,526.24,2022-07-12,6.0,Recurring Withdrawal Debit Card MC Debit/PAYPAL *LINKTREE 4029357733 AUDate 05/12/21 0 1132191600 1 7372Card 2801,6.0
7/11/2022,,Withdrawal ACH TARGET CARD SRVC/TYPE: BILL PAY ID: 5411721813CO: TARGET CARD SRVCNAME: S CHAPLINSKI TEntry Class Code: WEB,20.0,,Posted,532.24,2022-07-11,20.0,Withdrawal ACH TARGET CARD SRVC/TYPE: BILL PAY ID: 5411721813CO: TARGET CARD SRVCNAME: S CHAPLINSKI TEntry Class Code: WEB,20.0
7/11/2022,,Withdrawal ACH PAYPAL/TYPE: INST XFER ID: PAYPALSI77CO: PAYPAL NAME: STEVEN CHAPLINSKIEntry Class Code: WEB,14.99,,Posted,552.24,2022-07-11,14.99,Withdrawal ACH PAYPAL/TYPE: INST XFER ID: PAYPALSI77CO: PAYPAL NAME: STEVEN CHAPLINSKIEntry Class Code: WEB,14.948333333333332
7/8/2022,,Withdrawal POS #000096291670/FAST TRACK #200 GAINESVILLE FLCard 2801,19.46,,Posted,567.23,2022-07-08,19.46,Withdrawal POS #000096296533/FAST TRACK #200 GAINESVILLE FLCard 2801,19.486666666666665
7/8/2022,,Withdrawal POS #000000384676/SUNOCO 8002212501 4234 SW 20TH AVEGAINESVILLE FLCard 2801,10.7,,Posted,586.69,2022-07-08,10.7,Withdrawal POS #000000866633/SUNOCO 8002212501 4234 SW 20TH AVEGAINESVILLE FLCard 2801,10.7
7/8/2022,,Withdrawal POS #000006266765/PAYPAL *VIDIQ 2211 North First StreetJose CACard 2801,10.0,,Posted,597.39,2022-07-08,10.0,Withdrawal POS #000005221556/PAYPAL *VIDIQ 2211 North First StreetJose CACard 2801,10.0
7/6/2022,,Withdrawal POS #000000192090/SUNOCO 8002212501 4234 SW 20TH AVEGAINESVILLE FLCard 2801,28.09,,Posted,577.99,2022-07-06,28.09,Withdrawal POS #000000899960/SUNOCO 8002212501 4234 SW 20TH AVEGAINESVILLE FLCard 2801,28.09
7/6/2022,,Recurring Withdrawal Bill Payment - #000000253554/NETFLIX COM LOS GATOS CACard 2801,10.98,,Posted,606.08,2022-07-06,10.98,Recurring Withdrawal Bill Payment - #000006911729/NETFLIX COM LOS GATOS CACard 2801,10.99
7/5/2022,,Withdrawal Debit Card MC Debit/DOCTORS RADIOLOGY GROU 352-3319729 FLDate 07/04/22 0 2185730588 0 8011Card 2801,55.0,,Posted,617.06,2022-07-05,55.0,Withdrawal Debit Card MC Debit/DOCTORS RADIOLOGY GROU 352-3319729 FLDate 08/24/22 0 2236023780 1 8011Card 2801,55.0
7/5/2022,,Recurring Withdrawal Debit Card MC Debit/PLAYERAUCTIONS 800-342-0768 DEDate 07/04/22 0 2185265396 0 7993Card 2801,49.08,,Posted,672.06,2022-07-05,49.08,Recurring Withdrawal Debit Card MC Debit/PLAYERAUCTIONS 800-342-0768 DEDate 09/23/21 0 1266586911 1 7993Card 2801,49.08
7/5/2022,,Withdrawal POS #000000074662/AMAZON.COM*DH4RM6253 SEATTLE WACard 2801,10.15,,Posted,721.14,2022-07-05,10.15,Withdrawal POS #000000247445/AMAZON.COM*A42ZY7OC3 SEATTLE WACard 2801,10.475
7/5/2022,,Withdrawal ACH PAYPAL/TYPE: INST XFER ID: PAYPALSI77CO: PAYPAL NAME: STEVEN CHAPLINSKIEntry Class Code: WEB,14.98,,Posted,731.29,2022-07-05,14.98,Withdrawal ACH PAYPAL/TYPE: INST XFER ID: PAYPALSI77CO: PAYPAL NAME: STEVEN CHAPLINSKIEntry Class Code: WEB,14.948333333333332
7/5/2022,,Withdrawal ACH PAYPAL/TYPE: INST XFER ID: PAYPALSI77CO: PAYPAL NAME: STEVEN CHAPLINSKIEntry Class Code: WEB,11.48,,Posted,746.27,2022-07-05,11.48,Withdrawal ACH PAYPAL/TYPE: INST XFER ID: PAYPALSI77CO: PAYPAL NAME: STEVEN CHAPLINSKIEntry Class Code: WEB,11.7425
7/5/2022,,Withdrawal ACH PAYPAL/TYPE: INST XFER ID: PAYPALSI77CO: PAYPAL NAME: STEVEN CHAPLINSKIEntry Class Code: WEB,2.99,,Posted,757.75,2022-07-05,2.99,Withdrawal ACH PAYPAL/TYPE: INST XFER ID: PAYPALSI77CO: PAYPAL NAME: STEVEN CHAPLINSKIEntry Class Code: WEB,3.218
7/4/2022,,Recurring Withdrawal Debit Card MC Debit/ZIP.CO* BEST BUY NEW YORK NYDate 07/03/22 0 2184993464 0 5399Card 2801,42.05,,Posted,760.74,2022-07-04,42.05,Recurring Withdrawal Debit Card MC Debit/ZIP.CO* BEST BUY NEW YORK NYDate 07/20/22 0 2201728200 0 5399Card 2801,42.045
7/3/2022,,Withdrawal POS #000000610804/SUNOCO 8002212501 4234 SW 20TH AVEGAINESVILLE FLCard 2801,24.89,,Posted,802.79,2022-07-03,24.89,Withdrawal POS #000000068021/SUNOCO 8002212501 4234 SW 20TH AVEGAINESVILLE FLCard 2801,24.89
7/3/2022,,Withdrawal Debit Card MC Debit/PIZZA HUT 27918 3523739402 FLDate 07/02/22 0 2183861104 0 5812Card 2801,28.43,,Posted,827.68,2022-07-03,28.43,Withdrawal Debit Card MC Debit/PIZZA HUT 27918 3523739402 FLDate 12/16/22 0 2350808582 1 5812Card 2801,28.43
7/1/2022,,Recurring Withdrawal Debit Card MC Debit/PLAYERAUCTIONS 800-342-0768 DEDate 06/30/22 0 2181794560 0 7993Card 2801,42.79,,Posted,856.11,2022-07-01,42.79,Recurring Withdrawal Debit Card MC Debit/PLAYERAUCTIONS 800-342-0768 DEDate 09/23/21 0 1266586911 1 7993Card 2801,42.445
7/1/2022,,Withdrawal Debit Card MC Debit/GRU/EZ-PAY WEB PYMT 352-334-3434 FLDate 06/30/22 0 2181194793 0 4900Card 2801,254.1,,Posted,898.9,2022-07-01,254.1,Withdrawal Debit Card MC Debit/GRU/EZ-PAY WEB PYMT 352-334-3434 FLDate 11/01/21 0 1305577800 0 4900Card 2801,254.1
7/1/2022,,Withdrawal Debit Card MC Debit/COX GAINESVILLE COMM 800-234-3993 FLDate 06/30/22 0 2181792489 0 4899Card 2801,117.89,,Posted,1153.0,2022-07-01,117.89,Withdrawal Debit Card MC Debit/COX GAINESVILLE COMM 800-234-3993 FLDate 01/27/22 0 2027240681 1 4899Card 2801,117.89
6/30/2022,,Withdrawal ATM Fee/EFT 6419 W Newberry Rd Gainesville FLCard 2801,2.0,,Posted,1270.89,2022-06-30,2.0,"Withdrawal ATM Fee/EFT 6419 W Newberry Rd Gainesville FL

Card 1247",2.0
6/30/2022,,Withdrawal at ATM #000000000114/EFT 6419 W Newberry Rd Gainesville FLCard 2801,113.0,,Posted,1272.89,2022-06-30,113.0,"Withdrawal at ATM #000000785755/EFT 6419 W Newberry Rd Gainesville FL

Card 1247",113.0
6/30/2022,,Recurring Withdrawal Debit Card MC Debit/PLAYERAUCTIONS 800-342-0768 DEDate 06/29/22 0 2180001243 1 7993Card 2801,42.79,,Posted,885.89,2022-06-30,42.79,Recurring Withdrawal Debit Card MC Debit/PLAYERAUCTIONS 800-342-0768 DEDate 09/23/21 0 1266586911 1 7993Card 2801,42.445
6/30/2022,,Recurring Withdrawal Debit Card MC Debit/PLAYERAUCTIONS 800-342-0768 DEDate 06/29/22 0 2180293381 0 7993Card 2801,42.1,,Posted,928.68,2022-06-30,42.1,Recurring Withdrawal Debit Card MC Debit/PLAYERAUCTIONS 800-342-0768 DEDate 09/23/21 0 1266586911 1 7993Card 2801,42.445
6/30/2022,,Withdrawal ACH CAPITAL ONE/TYPE: ONLINE PMT ID: 9279744991CO: CAPITAL ONE NAME: STEVEN CHAPLINSKIEntry Class Code: WEB,55.0,,Posted,970.78,2022-06-30,55.0,Withdrawal ACH CAPITAL ONE/TYPE: ONLINE PMT ID: 9279744391CO: CAPITAL ONE NAME: STEVEN CHAPLINSKIEntry Class Code: WEB,55.0
6/30/2022,,Withdrawal ACH APPLECARD GSBANK/TYPE: PAYMENT ID: 9999999999CO: APPLECARD GSBANKNAME: Steven ChaplinskiEntry Class Code: WEB,3.38,,Posted,1025.78,2022-06-30,3.38,Withdrawal ACH APPLECARD GSBANK/TYPE: PAYMENT ID: 9999999999CO: APPLECARD GSBANKNAME: Steven ChaplinskiEntry Class Code: WEB,3.38
6/30/2022,,Withdrawal ACH Watson Realty Co/TYPE: WEB PMTS ID: 9000321157CO: Watson Realty CoNAME: Steven chaplinskiEntry Class Code: WEB,935.0,,Posted,1029.16,2022-06-30,935.0,Withdrawal ACH Watson Realty Co/TYPE: WEB PMTS ID: 9000321157CO: Watson Realty CoEntry Class Code: WEB,935.0
6/30/2022,,Withdrawal ACH WAWA CREDIT CARD/TYPE: PAYMENT ID: CITIGPUFDRCO: WAWA CREDIT CARDEntry Class Code: PPD,81.0,,Posted,1964.16,2022-06-30,81.0,Withdrawal ACH WAWA CREDIT CARD/TYPE: PAYMENT ID: CITIGPUFDRCO: WAWA CREDIT CARDEntry Class Code: PPD,81.0
6/30/2022,,Withdrawal ACH DISCOVER/TYPE: E-PAYMENT ID: 2510020270CO: DISCOVER NAME: CHAPLINSKI STEVENEntry Class Code: WEB,34.6,,Posted,2045.16,2022-06-30,34.6,Withdrawal ACH DISCOVER/TYPE: E-PAYMENT ID: 2510020270CO: DISCOVER NAME: CHAPLINSKI STEVENEntry Class Code: WEB,34.8
6/29/2022,,Withdrawal POS #000000000246/CIRCLE K # 06782 5237 GAINESVILLE FLCard 2801,21.79,,Posted,2060.11,2022-06-29,21.79,Withdrawal POS #000000000343/CIRCLE K # 06782 5237 GAINESVILLE FLCard 1247,21.79
6/29/2022,,Withdrawal POS #000012043432/WALGREENS 2415 SW 75TH GAINESVILLE FLCard 2801,4.28,,Posted,2081.9,2022-06-29,4.28,Withdrawal POS #000012002801/WALGREENS 3455 SW ARCH GAINESVILLE FLCard 2801,4.28
6/29/2022,,Withdrawal POS #000012033280/WALGREENS 2415 SW 75TH GAINESVILLE FLCard 2801,36.92,,Posted,2086.18,2022-06-29,36.92,Withdrawal POS #000012002801/WALGREENS 3455 SW ARCH GAINESVILLE FLCard 2801,36.92
6/29/2022,,Recurring Withdrawal Debit Card MC Debit/ADOBE CREATIVE CLOUD 4085366000 CADate 06/28/22 0 2179824627 0 5734Card 2801,19.99,,Posted,2123.1,2022-06-29,19.99,Recurring Withdrawal Debit Card MC Debit/ADOBE CREATIVE CLOUD 4085366000 CADate 09/28/22 0 2271807482 0 5734Card 2801,19.99
6/29/2022,,Withdrawal ACH PAYPAL/TYPE: INST XFER ID: PAYPALSI77CO: PAYPAL NAME: STEVEN CHAPLINSKIEntry Class Code: WEB,2.99,,Posted,43.09,2022-06-29,2.99,Withdrawal ACH PAYPAL/TYPE: INST XFER ID: PAYPALSI77CO: PAYPAL NAME: STEVEN CHAPLINSKIEntry Class Code: WEB,3.218
6/28/2022,,Withdrawal ACH PAYPAL/TYPE: INST XFER ID: PAYPALSI77CO: PAYPAL NAME: STEVEN CHAPLINSKIEntry Class Code: WEB,14.99,,Posted,46.08,2022-06-28,14.99,Withdrawal ACH PAYPAL/TYPE: INST XFER ID: PAYPALSI77CO: PAYPAL NAME: STEVEN CHAPLINSKIEntry Class Code: WEB,14.948333333333332
6/27/2022,,Withdrawal ACH PAYPAL/TYPE: INST XFER ID: PAYPALSI77CO: PAYPAL NAME: STEVEN CHAPLINSKIEntry Class Code: WEB,4.5,,Posted,61.07,2022-06-27,4.5,Withdrawal ACH PAYPAL/TYPE: INST XFER ID: PAYPALSI77CO: PAYPAL NAME: STEVEN CHAPLINSKIEntry Class Code: WEB,4.96
6/27/2022,,Withdrawal ACH PAYPAL/TYPE: INST XFER ID: PAYPALSI77CO: PAYPAL NAME: STEVEN CHAPLINSKIEntry Class Code: WEB,2.99,,Posted,65.57,2022-06-27,2.99,Withdrawal ACH PAYPAL/TYPE: INST XFER ID: PAYPALSI77CO: PAYPAL NAME: STEVEN CHAPLINSKIEntry Class Code: WEB,3.218
6/26/2022,,Withdrawal POS #000096297648/FAST TRACK #200 GAINESVILLE FLCard 2801,22.33,,Posted,68.56,2022-06-26,22.33,Withdrawal POS #000096296533/FAST TRACK #200 GAINESVILLE FLCard 2801,22.586666666666662
6/26/2022,,Withdrawal POS #000000021747/PUBLIX 3930 SW ARCHER ROA GAINESVILLE FLCard 2801,39.7,,Posted,90.89,2022-06-26,39.7,Withdrawal POS #000000029500/PUBLIX 3930 SW ARCHER ROA GAINESVILLE FLCard 2801,39.589999999999996
6/24/2022,,Withdrawal Debit Card MC Debit/B2P* FL OMMU MJ MED CA 877-767-6148 FLDate 06/23/22 0 2174976284 0 4900Card 2801,77.75,,Posted,130.59,2022-06-24,77.75,Withdrawal Debit Card MC Debit/B2P* FL OMMU MJ MED CA 877-767-6148 FLDate 06/23/22 0 2174976284 0 4900Card 2801,77.75
6/23/2022,,Recurring Withdrawal Debit Card MC Debit/ZIP.CO* BEST BUY NEW YORK NYDate 06/22/22 0 2173764872 0 5399Card 2801,42.05,,Posted,208.34,2022-06-23,42.05,Recurring Withdrawal Debit Card MC Debit/ZIP.CO* BEST BUY NEW YORK NYDate 07/20/22 0 2201728200 0 5399Card 2801,42.045
6/23/2022,,Withdrawal Debit Card MC Debit/WALGREENS #5024 800-289-2273 FLDate 06/22/22 0 2173993795 0 5912Card 2801,3.71,,Posted,250.39,2022-06-23,3.71,Withdrawal Debit Card MC Debit/WALGREENS #5024 800-289-2273 FLDate 05/21/22 0 2141999930 0 5912Card 2801,3.81
6/22/2022,,Withdrawal POS #000000439148/SUNOCO 8002212501 4234 SW 20TH AVEGAINESVILLE FLCard 2801,28.09,,Posted,254.1,2022-06-22,28.09,Withdrawal POS #000000966158/SUNOCO 8002212501 4234 SW 20TH AVEGAINESVILLE FLCard 2801,28.09
6/20/2022,,Withdrawal Debit Card MC Debit/WALGREENS #5024 800-289-2273 FLDate 06/19/22 0 2170973553 0 5912Card 2801,16.55,,Posted,48.19,2022-06-20,16.55,Withdrawal Debit Card MC Debit/WALGREENS #5024 800-289-2273 FLDate 05/21/22 0 2141999930 0 5912Card 2801,16.55
6/20/2022,,Withdrawal POS #000003265400/GOOGLE *YouTubePremium 1600 AmphitheatreParkw Mountain View CACard 2801,11.99,,Posted,64.74,2022-06-20,11.99,Withdrawal POS #000003285955/GOOGLE *YouTubePremium 1600 AmphitheatreParkw Mountain View CACard 2801,11.99
6/19/2022,,Withdrawal ATM Fee/FLUENT DISPE-375207 3400 SW 34TH STREEGAINESVILLE FLCard 2801,2.0,,Posted,58.73,2022-06-19,2.0,Withdrawal ATM Fee/FLUENT DISPE-375207 3400 SW 34TH STREETGAINESVILLE FLCard 1231,1.5
6/19/2022,,Withdrawal at ATM #000000007588/FLUENT DISPE-375207 3400 SW 34TH STREEGAINESVILLE FLCard 2801,43.0,,Posted,60.73,2022-06-19,43.0,Withdrawal at ATM #000000001720/FLUENT DISPE-375207 3400 SW 34TH STREETGAINESVILLE FLCard 1231,43.0
6/19/2022,,Withdrawal POS #000016464450/WALGREENS 2415 SW 75TH GAINESVILLE FLCard 2801,5.35,,Posted,103.73,2022-06-19,5.35,Withdrawal POS #000014264526/WALGREENS 2415 SW GAINESVILLE FLCard 2801,5.705
6/19/2022,,Recurring Withdrawal Debit Card MC Debit/PLAYERAUCTIONS 800-342-0768 DEDate 06/19/22 0 2170016985 1 7993Card 2801,40.28,,Posted,109.08,2022-06-19,40.28,Recurring Withdrawal Debit Card MC Debit/PLAYERAUCTIONS 800-342-0768 DEDate 09/23/21 0 1266586911 1 7993Card 2801,40.53666666666667
6/18/2022,,Withdrawal POS #000000246955/SUNOCO 8002212501 4234 SW 20TH AVEGAINESVILLE FLCard 2801,24.89,,Posted,149.36,2022-06-18,24.89,Withdrawal POS #000000955321/SUNOCO 8002212501 4234 SW 20TH AVEGAINESVILLE FLCard 2801,24.89
6/17/2022,,Withdrawal POS #000000032587/PUBLIX 3100 SW 35TH BLVD GAINESVILLE FLCard 2801,8.94,,Posted,174.25,2022-06-17,8.94,Withdrawal POS #000000036956/PUBLIX 5801 SW 75TH ST GAINESVILLE FLCard 2801,8.94
6/17/2022,,Withdrawal POS #000000741852/PUBLIX 3930 SW ARCHER ROA GAINESVILLE FLCard 2801,5.99,,Posted,183.19,2022-06-17,5.99,Withdrawal POS #000000737891/PUBLIX 3930 SW ARCHER ROA GAINESVILLE FLCard 2801,5.99
6/16/2022,,Withdrawal ACH PAYPAL/TYPE: INST XFER ID: PAYPALSI77CO: PAYPAL NAME: STEVEN CHAPLINSKIEntry Class Code: WEB,8.89,,Posted,149.74,2022-06-16,8.89,Withdrawal ACH PAYPAL/TYPE: INST XFER ID: PAYPALSI77CO: PAYPAL NAME: STEVEN CHAPLINSKIEntry Class Code: WEB,9.015
6/16/2022,,Withdrawal POS #000000296803/AMAZON.COM*W79KJ68A3 SEATTLE WACard 2801,9.73,,Posted,158.63,2022-06-16,9.73,Withdrawal POS #000000259511/AMAZON.COM*2776K9KH0 SEATTLE WACard 2801,10.026666666666667
6/15/2022,,"Withdrawal Home Banking Transfer/To CHAPLINSKI,LEONA 3496297 Share 0090Funds Transfer via Online",550.0,,Posted,168.36,2022-06-15,550.0,"Withdrawal Home Banking Transfer/To CHAPLINSKI,LEONA 3496297 Share 0090Funds Transfer via Online",550.0
6/15/2022,,Recurring Withdrawal Debit Card MC Debit/PLAYERAUCTIONS 800-342-0768 DEDate 06/15/22 0 2166056029 1 7993Card 2801,40.7,,Posted,718.36,2022-06-15,40.7,Recurring Withdrawal Debit Card MC Debit/PLAYERAUCTIONS 800-342-0768 DEDate 09/23/21 0 1266586911 1 7993Card 2801,40.53666666666667
6/15/2022,,Recurring Withdrawal Debit Card MC Debit/PLAYERAUCTIONS 800-342-0768 DEDate 06/14/22 0 2165922687 0 7993Card 2801,39.44,,Posted,759.06,2022-06-15,39.44,Recurring Withdrawal Debit Card MC Debit/PLAYERAUCTIONS 800-342-0768 DEDate 09/23/21 0 1266586911 1 7993Card 2801,39.019999999999996
6/15/2022,,Withdrawal ACH PAYMENT FOR AMZ/TYPE: STORECARD ID: 9069872103CO: PAYMENT FOR AMZNAME: 6045781157416487Entry Class Code: WEB,45.0,,Posted,798.5,2022-06-15,45.0,Withdrawal ACH PAYMENT FOR AMZ/TYPE: STORECARD ID: 9069872103CO: PAYMENT FOR AMZNAME: 6045781157416487Entry Class Code: WEB,45.0
6/14/2022,,Withdrawal ACH CAPITAL ONE/TYPE: ONLINE PMT ID: 9279744991CO: CAPITAL ONE NAME: STEVEN CHAPLINSKIEntry Class Code: WEB,50.0,,Posted,843.5,2022-06-14,50.0,Withdrawal ACH CAPITAL ONE/TYPE: ONLINE PMT ID: 9279744391CO: CAPITAL ONE NAME: STEVEN CHAPLINSKIEntry Class Code: WEB,50.0
6/14/2022,,Withdrawal ACH BEST BUY/TYPE: PAYMENT ID: CITICTP CO: BEST BUYNAME: STEVEN J CHAPLINSKIEntry Class Code: WEB,74.0,,Posted,893.5,2022-06-14,74.0,Withdrawal ACH BEST BUY/TYPE: PAYMENT ID: CITICTP CO: BEST BUYNAME: STEVEN J CHAPLINSKIEntry Class Code: WEB,74.0
6/14/2022,,Withdrawal ACH TARGET CARD SRVC/TYPE: BILL PAY ID: 5411721813CO: TARGET CARD SRVCNAME: S CHAPLINSKI TEntry Class Code: WEB,55.0,,Posted,967.5,2022-06-14,55.0,Withdrawal ACH TARGET CARD SRVC/TYPE: BILL PAY ID: 5411721813CO: TARGET CARD SRVCNAME: S CHAPLINSKI TEntry Class Code: WEB,55.0
6/13/2022,,Recurring Withdrawal Debit Card Fee/MASTERCARD ISSUER CROSS-BORDER FEEDate 06/11/22 0 2162900620 0 5734Card 2801,0.05,,Posted,1022.5,2022-06-13,0.05,Recurring Withdrawal Debit Card Fee/MASTERCARD ISSUER CROSS-BORDER FEEDate 05/12/21 0 1132191600 1 7372Card 2801,0.09500000000000001
6/13/2022,,Recurring Withdrawal Debit Card MC Debit/PAYPAL *LINKTREEPTY 4029357733 AUDate 06/11/22 0 2162900620 0 5734Card 2801,6.0,,Posted,1022.55,2022-06-13,6.0,Recurring Withdrawal Debit Card MC Debit/PAYPAL *LINKTREE 4029357733 AUDate 05/12/21 0 1132191600 1 7372Card 2801,6.0
6/13/2022,,Withdrawal ACH PAYMENT FOR AMZ/TYPE: STORECARD ID: 9069872103CO: PAYMENT FOR AMZNAME: 6045781157416487Entry Class Code: WEB,5.0,,Posted,1028.55,2022-06-13,5.0,Withdrawal ACH PAYMENT FOR AMZ/TYPE: STORECARD ID: 9069872103CO: PAYMENT FOR AMZNAME: 6045781157416487Entry Class Code: WEB,5.0
6/13/2022,,Withdrawal POS #000000906869/SUNOCO 8002212501 4234 SW 20TH AVEGAINESVILLE FLCard 2801,24.89,,Posted,1033.55,2022-06-13,24.89,Withdrawal POS #000000689838/SUNOCO 8002212501 4234 SW 20TH AVEGAINESVILLE FLCard 2801,24.89
6/9/2022,,Withdrawal Debit Card MC Debit/PUBLIX #527 GAINESVILLE FLDate 06/08/22 0 2159954918 0 5411Card 2801,78.53,,Posted,1058.44,2022-06-09,78.53,Withdrawal Debit Card MC Debit/PUBLIX #795 GAINESVILLE FLDate 03/07/22 0 2066965570 0 5411Card 2801,78.53
6/9/2022,,Recurring Withdrawal Debit Card MC Debit/ZIP.CO* BEST BUY NEW YORK NYDate 06/08/22 0 2159765976 0 5399Card 2801,42.04,,Posted,1136.97,2022-06-09,42.04,Recurring Withdrawal Debit Card MC Debit/ZIP.CO* BEST BUY NEW YORK NYDate 07/20/22 0 2201728200 0 5399Card 2801,42.045
6/9/2022,,Withdrawal Debit Card MC Debit/WALGREENS #5024 800-289-2273 FLDate 06/08/22 0 2159030924 1 5912Card 2801,6.56,,Posted,1179.01,2022-06-09,6.56,Withdrawal Debit Card MC Debit/WALGREENS #5024 800-289-2273 FLDate 09/08/21 0 1251607416 1 5912Card 2801,7.025
6/9/2022,,Withdrawal Debit Card MC Debit/WALGREENS #5024 800-289-2273 FLDate 06/08/22 0 2159030923 1 5912Card 2801,3.71,,Posted,1185.57,2022-06-09,3.71,Withdrawal Debit Card MC Debit/WALGREENS #5024 800-289-2273 FLDate 09/08/21 0 1251607416 1 5912Card 2801,4.09
6/9/2022,,Withdrawal ACH WAWA CREDIT CARD/TYPE: PAYMENT ID: CITIGPUFDRCO: WAWA CREDIT CARDEntry Class Code: PPD,30.0,,Posted,1189.28,2022-06-09,30.0,Withdrawal ACH WAWA CREDIT CARD/TYPE: PAYMENT ID: CITIGPUFDRCO: WAWA CREDIT CARDEntry Class Code: PPD,30.0
6/9/2022,,Withdrawal ACH PAYPAL/TYPE: INST XFER ID: PAYPALSI77CO: PAYPAL NAME: STEVEN CHAPLINSKIEntry Class Code: WEB,14.99,,Posted,1219.28,2022-06-09,14.99,Withdrawal ACH PAYPAL/TYPE: INST XFER ID: PAYPALSI77CO: PAYPAL NAME: STEVEN CHAPLINSKIEntry Class Code: WEB,14.948333333333332
6/8/2022,,Withdrawal Debit Card MC Debit/PUBLIX #1312 GAINESVILLE FLDate 06/07/22 0 2158976004 0 5411Card 2801,101.42,,Posted,1234.27,2022-06-08,101.42,Withdrawal Debit Card MC Debit/PUBLIX #795 GAINESVILLE FLDate 03/07/22 0 2066965570 0 5411Card 2801,101.42
6/8/2022,,Withdrawal POS #000010405957/WALGREENS 2415 SW 75TH GAINESVILLE FLCard 2801,10.9,,Posted,1335.69,2022-06-08,10.9,Withdrawal POS #000015057686/WALGREENS 2415 SW 75TH GAINESVILLE FLCard 1231,11.355
6/8/2022,,Withdrawal POS #000007063712/PAYPAL *VIDIQ 2211 North First StreetJose CACard 2801,10.0,,Posted,384.59,2022-06-08,10.0,Withdrawal POS #000005221556/PAYPAL *VIDIQ 2211 North First StreetJose CACard 2801,10.0
6/7/2022,,Recurring Withdrawal Debit Card MC Debit/NETFLIX.COM 866-5797172 CADate 06/06/22 0 2157765586 0 4899Card 2801,10.98,,Posted,355.99,2022-06-07,10.98,Recurring Withdrawal Debit Card MC Debit/NETFLIX.COM 866-5797172 CADate 11/13/21 0 1317106681 1 4899Card 2801,10.98
6/7/2022,,Withdrawal ACH DISCOVER/TYPE: E-PAYMENT ID: 2510020270CO: DISCOVER NAME: CHAPLINSKI STEVENEntry Class Code: WEB,65.0,,Posted,366.97,2022-06-07,65.0,Withdrawal ACH DISCOVER/TYPE: E-PAYMENT ID: 2510020270CO: DISCOVER NAME: CHAPLINSKI STEVENEntry Class Code: WEB,65.0
6/6/2022,,Withdrawal ACH ACANVASARTT/CO: ACANVASARTTTYPE: IAT PAYPAL ID: 770510487CEntry Class Code: IAT,75.95,,Posted,350.92,2022-06-06,75.95,Withdrawal ACH ACANVASARTT/CO: ACANVASARTTTYPE: IAT PAYPAL ID: 770510487CEntry Class Code: IAT,75.95
6/6/2022,,Recurring Withdrawal Debit Card MC Debit/PLAYERAUCTIONS 800-342-0768 DEDate 06/05/22 0 2156255006 0 7993Card 2801,40.63,,Posted,426.87,2022-06-06,40.63,Recurring Withdrawal Debit Card MC Debit/PLAYERAUCTIONS 800-342-0768 DEDate 09/23/21 0 1266586911 1 7993Card 2801,40.53666666666667
6/6/2022,,Withdrawal Debit Card MC Debit/WALGREENS #5024 800-289-2273 FLDate 06/05/22 0 2156870796 0 5912Card 2801,3.91,,Posted,467.5,2022-06-06,3.91,Withdrawal Debit Card MC Debit/WALGREENS #5024 800-289-2273 FLDate 09/08/21 0 1251607416 1 5912Card 2801,4.09
6/6/2022,,Withdrawal ACH PAYPAL/TYPE: INST XFER ID: PAYPALSI77CO: PAYPAL NAME: STEVEN CHAPLINSKIEntry Class Code: WEB,81.05,,Posted,471.41,2022-06-06,81.05,Withdrawal ACH PAYPAL/TYPE: INST XFER ID: PAYPALSI77CO: PAYPAL NAME: STEVEN CHAPLINSKIEntry Class Code: WEB,81.05
6/6/2022,,Withdrawal ACH PAYPAL/TYPE: INST XFER ID: PAYPALSI77CO: PAYPAL NAME: STEVEN CHAPLINSKIEntry Class Code: WEB,2.99,,Posted,552.46,2022-06-06,2.99,Withdrawal ACH PAYPAL/TYPE: INST XFER ID: PAYPALSI77CO: PAYPAL NAME: STEVEN CHAPLINSKIEntry Class Code: WEB,3.218
6/5/2022,,Withdrawal ATM Fee/ASAI 3400 B SW 34th St. Gainesville FLCard 2801,2.0,,Posted,426.45,2022-06-05,2.0,Withdrawal ATM Fee/ASAI 3400 B SW 34th St. Gainesville FLCard 2801,2.0
6/5/2022,,Withdrawal at ATM #000000000323/ASAI 3400 B SW 34th St. Gainesville FLCard 2801,128.0,,Posted,428.45,2022-06-05,128.0,Withdrawal at ATM #000000000323/ASAI 3400 B SW 34th St. Gainesville FLCard 2801,127.875
6/5/2022,,Withdrawal Debit Card MC Debit/EVERLYWELL DIAGNOSTICS DALLAS TXDate 06/05/22 0 2156212746 1 8071Card 2801,49.0,,Posted,556.45,2022-06-05,49.0,Withdrawal Debit Card MC Debit/EVERLYWELL DIAGNOSTICS DALLAS TXDate 06/05/22 0 2156212746 1 8071Card 2801,49.0
6/5/2022,,Recurring Withdrawal Debit Card MC Debit/PLAYERAUCTIONS 800-342-0768 DEDate 06/05/22 0 2156207038 1 7993Card 2801,38.6,,Posted,605.45,2022-06-05,38.6,Recurring Withdrawal Debit Card MC Debit/PLAYERAUCTIONS 800-342-0768 DEDate 09/23/21 0 1266586911 1 7993Card 2801,39.019999999999996
6/4/2022,,Withdrawal POS #000000392594/SUNOCO 8002212501 4234 SW 20TH AVEGAINESVILLE FLCard 2801,24.89,,Posted,644.05,2022-06-04,24.89,Withdrawal POS #000000392594/SUNOCO 8002212501 4234 SW 20TH AVEGAINESVILLE FLCard 2801,24.89
6/2/2022,,Withdrawal Debit Card MC Debit/PUBLIX #1312 GAINESVILLE FLDate 06/01/22 0 2152104117 1 5411Card 2801,123.21,,Posted,583.94,2022-06-02,123.21,Withdrawal Debit Card MC Debit/PUBLIX #1312 GAINESVILLE FLDate 06/18/21 0 1169764423 1 5411Card 2801,123.21
6/2/2022,,Withdrawal POS #000000000052/AMAZON.COM*N77HP2U23 SEATTLE WACard 2801,6.74,,Posted,707.15,2022-06-02,6.74,Withdrawal POS #000000000023/AMAZON.COM*AU8ER6ZT3 SEATTLE WACard 2801,6.74
6/1/2022,,Withdrawal ATM Transaction,80.0,,Posted,533.89,2022-06-01,80.0,Withdrawal ATM Transaction,80.0
6/1/2022,,Withdrawal Debit Card MC Debit/WALGREENS #5024 800-289-2273 FLDate 05/31/22 0 2151982468 0 5912Card 2801,15.0,,Posted,598.76,2022-06-01,15.0,Withdrawal Debit Card MC Debit/WALGREENS #5024 800-289-2273 FLDate 05/21/22 0 2141999930 0 5912Card 2801,14.64
6/1/2022,,Withdrawal ACH Watson Realty Co/TYPE: WEB PMTS ID: 9000321157CO: Watson Realty CoNAME: Steven chaplinskiEntry Class Code: WEB,885.0,,Posted,613.76,2022-06-01,885.0,Withdrawal ACH Watson Realty Co/TYPE: WEB PMTS ID: 9000321157CO: Watson Realty CoEntry Class Code: WEB,885.0
6/1/2022,,Withdrawal ACH DISCOVER/TYPE: E-PAYMENT ID: 2510020270CO: DISCOVER NAME: CHAPLINSKI STEVENEntry Class Code: WEB,15.0,,Posted,1498.76,2022-06-01,15.0,Withdrawal ACH DISCOVER/TYPE: E-PAYMENT ID: 2510020270CO: DISCOVER NAME: CHAPLINSKI STEVENEntry Class Code: WEB,15.0
6/1/2022,,Withdrawal ACH PAYPAL/TYPE: INST XFER ID: PAYPALSI77CO: PAYPAL NAME: STEVEN CHAPLINSKIEntry Class Code: WEB,14.99,,Posted,1513.76,2022-06-01,14.99,Withdrawal ACH PAYPAL/TYPE: INST XFER ID: PAYPALSI77CO: PAYPAL NAME: STEVEN CHAPLINSKIEntry Class Code: WEB,14.948333333333332
5/31/2022,,Withdrawal POS #000000219124/SUNOCO 8002212501 4234 SW 20TH AVEGAINESVILLE FLCard 2801,22.74,,Posted,1499.2,2022-05-31,22.74,Withdrawal POS #000000219124/SUNOCO 8002212501 4234 SW 20TH AVEGAINESVILLE FLCard 2801,23.02
5/31/2022,,Withdrawal ACH APPLECARD GSBANK/TYPE: PAYMENT ID: 9999999999CO: APPLECARD GSBANKNAME: Steven ChaplinskiEntry Class Code: WEB,43.0,,Posted,1521.94,2022-05-31,43.0,Withdrawal ACH APPLECARD GSBANK/TYPE: PAYMENT ID: 9999999999CO: APPLECARD GSBANKNAME: Steven ChaplinskiEntry Class Code: WEB,42.663333333333334
5/31/2022,,Withdrawal ACH PAYMENT FOR AMZ/TYPE: STORECARD ID: 9069872103CO: PAYMENT FOR AMZNAME: 6045781157416487Entry Class Code: WEB,25.0,,Posted,1564.94,2022-05-31,25.0,Withdrawal ACH PAYMENT FOR AMZ/TYPE: STORECARD ID: 9069872103CO: PAYMENT FOR AMZNAME: 6045781157416487Entry Class Code: WEB,25.0
5/31/2022,,Withdrawal ACH PAYPAL/TYPE: INST XFER ID: PAYPALSI77CO: PAYPAL NAME: STEVEN CHAPLINSKIEntry Class Code: WEB,14.99,,Posted,1589.94,2022-05-31,14.99,Withdrawal ACH PAYPAL/TYPE: INST XFER ID: PAYPALSI77CO: PAYPAL NAME: STEVEN CHAPLINSKIEntry Class Code: WEB,14.948333333333332
5/31/2022,,Withdrawal ACH PAYPAL/TYPE: INST XFER ID: PAYPALSI77CO: PAYPAL NAME: STEVEN CHAPLINSKIEntry Class Code: WEB,2.99,,Posted,1604.93,2022-05-31,2.99,Withdrawal ACH PAYPAL/TYPE: INST XFER ID: PAYPALSI77CO: PAYPAL NAME: STEVEN CHAPLINSKIEntry Class Code: WEB,3.218
5/30/2022,,Withdrawal Debit Card MC Debit/PUBLIX #1312 GAINESVILLE FLDate 05/29/22 0 2149812561 0 5411Card 2801,79.11,,Posted,1607.92,2022-05-30,79.11,Withdrawal Debit Card MC Debit/PUBLIX #1312 GAINESVILLE FLDate 05/28/21 0 1148028662 2 5411Card 2801,79.11
5/29/2022,,Recurring Withdrawal Debit Card MC Debit/ADOBE CREATIVE CLOUD 4085366000 CADate 05/28/22 0 2148889909 0 5734Card 2801,19.99,,Posted,1687.03,2022-05-29,19.99,Recurring Withdrawal Debit Card MC Debit/ADOBE CREATIVE CLOUD 4085366000 CADate 09/28/22 0 2271807482 0 5734Card 2801,19.99
5/27/2022,,Withdrawal ACH CANVA PTY LIMITE/CO: CANVA PTY LIMITEDTYPE: IAT PAYPAL ID: 770510487CEntry Class Code: IAT,12.99,,Posted,1707.02,2022-05-27,12.99,Withdrawal ACH CANVA PTY LIMITE/CO: CANVA PTY LIMITEDTYPE: IAT PAYPAL ID: 770510487CEntry Class Code: IAT,12.99
5/27/2022,,Withdrawal Debit Card MC Debit/AMAZON PRIME*1R55T47L2 AMZN.COM/BIL WADate 05/27/22 0 2147054474 1 5968Card 2801,15.13,,Posted,1720.01,2022-05-27,15.13,Withdrawal Debit Card MC Debit/AMAZON PRIME*AH5FK9BT3 AMZN.COM/BIL WADate 07/29/22 0 2210009971 1 5968Card 2801,15.13
5/27/2022,,Withdrawal Debit Card MC Debit/GRU/EZ-PAY WEB PYMT 352-334-3434 FLDate 05/26/22 0 2146308771 0 4900Card 2801,169.7,,Posted,1735.14,2022-05-27,169.7,Withdrawal Debit Card MC Debit/GRU/EZ-PAY WEB PYMT 352-334-3434 FLDate 11/01/21 0 1305577800 0 4900Card 2801,169.7
5/27/2022,,Withdrawal Debit Card MC Debit/COX GAINESVILLE COMM 800-234-3993 FLDate 05/26/22 0 2146802258 0 4899Card 2801,117.89,,Posted,1904.84,2022-05-27,117.89,Withdrawal Debit Card MC Debit/COX GAINESVILLE COMM 800-234-3993 FLDate 01/27/22 0 2027240681 1 4899Card 2801,117.89
5/27/2022,,Withdrawal ACH PAYPAL/TYPE: INST XFER ID: PAYPALSI77CO: PAYPAL NAME: STEVEN CHAPLINSKIEntry Class Code: WEB,2.99,,Posted,2022.73,2022-05-27,2.99,Withdrawal ACH PAYPAL/TYPE: INST XFER ID: PAYPALSI77CO: PAYPAL NAME: STEVEN CHAPLINSKIEntry Class Code: WEB,3.218
5/27/2022,,Withdrawal POS #000000041009/PUBLIX 3930 SW ARCHER ROA GAINESVILLE FLCard 2801,43.8,,Posted,2025.72,2022-05-27,43.8,Withdrawal POS #000000029500/PUBLIX 3930 SW ARCHER ROA GAINESVILLE FLCard 2801,44.129999999999995
5/26/2022,,Withdrawal ACH PAYPAL/TYPE: INST XFER ID: PAYPALSI77CO: PAYPAL NAME: STEVEN CHAPLINSKIEntry Class Code: WEB,4.5,,Posted,59.53,2022-05-26,4.5,Withdrawal ACH PAYPAL/TYPE: INST XFER ID: PAYPALSI77CO: PAYPAL NAME: STEVEN CHAPLINSKIEntry Class Code: WEB,4.96
5/25/2022,,Withdrawal Debit Card MC Debit/KINDLE UNLTD*WC29623B3 866-321-8851 WADate 05/24/22 0 2144970619 0 5818Card 2801,9.99,,Posted,64.03,2022-05-25,9.99,Withdrawal Debit Card MC Debit/KINDLE UNLTD*WC29623B3 866-321-8851 WADate 05/24/22 0 2144970619 0 5818Card 2801,9.99
5/25/2022,,Withdrawal POS #000096297551/FAST TRACK #200 GAINESVILLE FLCard 2801,19.45,,Posted,74.02,2022-05-25,19.45,Withdrawal POS #000096296533/FAST TRACK #200 GAINESVILLE FLCard 2801,19.486666666666665
5/25/2022,,Withdrawal POS #000000073251/PUBLIX 3930 SW ARCHER ROA GAINESVILLE FLCard 2801,57.01,,Posted,93.47,2022-05-25,57.01,Withdrawal POS #000000029500/PUBLIX 3930 SW ARCHER ROA GAINESVILLE FLCard 2801,57.239999999999995
5/24/2022,,Withdrawal POS #000000000001/AMAZON.COM*Z37JL9KM3 SEATTLE WACard 2801,7.21,,Posted,150.48,2022-05-24,7.21,Withdrawal POS #000000991850/AMAZON.COM*7Q29B9KF3 SEATTLE WACard 2801,7.21
5/23/2022,,Withdrawal ACH PAYPAL/TYPE: INST XFER ID: PAYPALSI77CO: PAYPAL NAME: STEVEN CHAPLINSKIEntry Class Code: WEB,11.99,,Posted,157.69,2022-05-23,11.99,Withdrawal ACH PAYPAL/TYPE: INST XFER ID: PAYPALSI77CO: PAYPAL NAME: STEVEN CHAPLINSKIEntry Class Code: WEB,11.7425
5/23/2022,,Withdrawal ACH DISCOVER/TYPE: E-PAYMENT ID: 2510020270CO: DISCOVER NAME: CHAPLINSKI STEVENEntry Class Code: WEB,4.18,,Posted,169.68,2022-05-23,4.18,Withdrawal ACH DISCOVER/TYPE: E-PAYMENT ID: 2510020270CO: DISCOVER NAME: CHAPLINSKI STEVENEntry Class Code: WEB,4.59
5/22/2022,,Withdrawal Debit Card MC Debit/WALGREENS #5024 800-289-2273 FLDate 05/21/22 0 2141999930 0 5912Card 2801,14.28,,Posted,173.86,2022-05-22,14.28,Withdrawal Debit Card MC Debit/WALGREENS #5024 800-289-2273 FLDate 05/21/22 0 2141999930 0 5912Card 2801,14.64
5/21/2022,,Withdrawal POS #000000639499/SUNOCO 8002212501 4234 SW 20TH AVEGAINESVILLE FLCard 2801,22.74,,Posted,188.14,2022-05-21,22.74,Withdrawal POS #000000899960/SUNOCO 8002212501 4234 SW 20TH AVEGAINESVILLE FLCard 2801,22.74
5/17/2022,,Withdrawal Debit Card MC Debit/PUBLIX #1312 GAINESVILLE FLDate 05/16/22 0 2136986442 0 5411Card 2801,103.95,,Posted,210.88,2022-05-17,103.95,Withdrawal Debit Card MC Debit/PUBLIX #1312 GAINESVILLE FLDate 06/18/21 0 1169764423 1 5411Card 2801,103.95
5/16/2022,,Withdrawal POS #000000399046/SUNOCO 8002212501 4234 SW 20TH AVEGAINESVILLE FLCard 2801,22.74,,Posted,314.83,2022-05-16,22.74,Withdrawal POS #000000899960/SUNOCO 8002212501 4234 SW 20TH AVEGAINESVILLE FLCard 2801,22.74
5/16/2022,,Recurring Withdrawal Debit Card MC Debit/ZIP.CO* NEWEGG NEW YORK NYDate 05/16/22 0 2136907205 0 5399Card 2801,42.77,,Posted,337.57,2022-05-16,42.77,Withdrawal Debit Card MC Debit/ZIP.CO* NEWEGG NEW YORK NYDate 04/03/22 0 2093025644 1 5399Card 2801,42.765
5/16/2022,,Withdrawal ACH PAYMENT FOR AMZ/TYPE: STORECARD ID: 9069872103CO: PAYMENT FOR AMZNAME: 6045781157416487Entry Class Code: WEB,5.0,,Posted,380.34,2022-05-16,5.0,Withdrawal ACH PAYMENT FOR AMZ/TYPE: STORECARD ID: 9069872103CO: PAYMENT FOR AMZNAME: 6045781157416487Entry Class Code: WEB,5.0
5/16/2022,,Withdrawal ACH PAYPAL/TYPE: INST XFER ID: PAYPALSI77CO: PAYPAL NAME: STEVEN CHAPLINSKIEntry Class Code: WEB,1.43,,Posted,385.34,2022-05-16,1.43,Withdrawal ACH PAYPAL/TYPE: INST XFER ID: PAYPALSI77CO: PAYPAL NAME: STEVEN CHAPLINSKIEntry Class Code: WEB,1.11
5/14/2022,,Withdrawal ATM Transaction,45.0,,Posted,186.77,2022-05-14,45.0,Withdrawal ATM Transaction,45.0
5/13/2022,,Withdrawal Debit Card MC Debit/DOCTORS RADIOLOGY GROU 352-3319729 FLDate 05/12/22 0 2132061814 1 8011Card 2801,5.0,,Posted,231.77,2022-05-13,5.0,Withdrawal Debit Card MC Debit/DOCTORS RADIOLOGY GROU 352-3319729 FLDate 08/24/22 0 2236023780 1 8011Card 2801,5.0
5/13/2022,,Withdrawal ACH CAPITAL ONE/TYPE: ONLINE PMT ID: 9279744991CO: CAPITAL ONE NAME: STEVEN CHAPLINSKIEntry Class Code: WEB,5.0,,Posted,236.77,2022-05-13,5.0,Withdrawal ACH CAPITAL ONE/TYPE: ONLINE PMT ID: 9279744391CO: CAPITAL ONE NAME: STEVEN CHAPLINSKIEntry Class Code: WEB,5.0
5/13/2022,,Withdrawal ACH DISCOVER/TYPE: E-PAYMENT ID: 2510020270CO: DISCOVER NAME: CHAPLINSKI STEVENEntry Class Code: WEB,5.0,,Posted,241.77,2022-05-13,5.0,Withdrawal ACH DISCOVER/TYPE: E-PAYMENT ID: 2510020270CO: DISCOVER NAME: CHAPLINSKI STEVENEntry Class Code: WEB,4.59
5/13/2022,,Withdrawal ACH TARGET CARD SRVC/TYPE: BILL PAY ID: T510215170CO: TARGET CARD SRVCNAME: 7S CH0000000APLINSKI TEntry Class Code: WEB,5.0,,Posted,246.77,2022-05-13,5.0,Withdrawal ACH TARGET CARD SRVC/TYPE: BILL PAY ID: 5411721813CO: TARGET CARD SRVCNAME: S CHAPLINSKI TEntry Class Code: WEB,5.0
5/13/2022,,Withdrawal ACH PAYPAL/TYPE: INST XFER ID: PAYPALSI77CO: PAYPAL NAME: STEVEN CHAPLINSKIEntry Class Code: WEB,2.86,,Posted,251.77,2022-05-13,2.86,Withdrawal ACH PAYPAL/TYPE: INST XFER ID: PAYPALSI77CO: PAYPAL NAME: STEVEN CHAPLINSKIEntry Class Code: WEB,2.3299999999999996
5/12/2022,,Recurring Withdrawal Debit Card MC Debit/PAYPAL *LINKTREEPTY 4029357733 CADate 05/11/22 0 2131030580 1 5734Card 2801,6.0,,Posted,254.63,2022-05-12,6.0,Recurring Withdrawal Debit Card MC Debit/PAYPAL *LINKTREE 4029357733 AUDate 05/12/21 0 1132191600 1 7372Card 2801,6.0
5/10/2022,,Recurring Withdrawal Debit Card MC Debit/PLAYERAUCTIONS 800-342-0768 DEDate 05/09/22 0 2129742511 0 7993Card 2801,40.7,,Posted,260.63,2022-05-10,40.7,Recurring Withdrawal Debit Card MC Debit/PLAYERAUCTIONS 800-342-0768 DEDate 09/23/21 0 1266586911 1 7993Card 2801,40.53666666666667
5/10/2022,,Withdrawal POS #000000900705/AMAZON.COM*134LE0B92 SEATTLE WACard 2801,7.21,,Posted,301.33,2022-05-10,7.21,Withdrawal POS #000000626675/AMAZON.COM*1F8259P12 SEATTLE WACard 2801,7.21
5/9/2022,,Recurring Withdrawal Debit Card MC Debit/ADOBE CREATIVE CLOUD 4085366000 CADate 05/08/22 0 2128950507 0 5734Card 2801,19.99,,Posted,308.54,2022-05-09,19.99,Recurring Withdrawal Debit Card MC Debit/ADOBE CREATIVE CLOUD 4085366000 CADate 09/28/22 0 2271807482 0 5734Card 2801,19.99
5/9/2022,,Withdrawal Debit Card MC Debit/WALGREENS #5024 800-289-2273 FLDate 05/08/22 0 2128974293 0 5912Card 2801,12.97,,Posted,328.53,2022-05-09,12.97,Withdrawal Debit Card MC Debit/WALGREENS #5024 800-289-2273 FLDate 05/21/22 0 2141999930 0 5912Card 2801,12.97
5/9/2022,,Withdrawal ACH DISCOVER/TYPE: E-PAYMENT ID: 2510020270CO: DISCOVER NAME: CHAPLINSKI STEVENEntry Class Code: WEB,10.0,,Posted,341.5,2022-05-09,10.0,Withdrawal ACH DISCOVER/TYPE: E-PAYMENT ID: 2510020270CO: DISCOVER NAME: CHAPLINSKI STEVENEntry Class Code: WEB,10.0
5/8/2022,,Withdrawal POS #000016124369/WALGREENS 2415 SW 75TH GAINESVILLE FLCard 2801,5.35,,Posted,351.5,2022-05-08,5.35,Withdrawal POS #000015057686/WALGREENS 2415 SW 75TH GAINESVILLE FLCard 1231,5.35
5/8/2022,,Withdrawal POS #000007247911/PAYPAL *VIDIQ San Jose CACard 2801,10.0,,Posted,356.85,2022-05-08,10.0,Withdrawal POS #000007247911/PAYPAL *VIDIQ San Jose CACard 2801,10.0
5/8/2022,,Withdrawal Debit Card MC Debit/PUBLIX #527 GAINESVILLE FLDate 05/06/22 0 2126310396 2 5411Card 2801,37.07,,Posted,208.44,2022-05-08,37.07,Withdrawal Debit Card MC Debit/PUBLIX #795 GAINESVILLE FLDate 03/07/22 0 2066965570 0 5411Card 2801,37.07
5/6/2022,,Withdrawal POS #000000000275/CIRCLE K # 26146 3525 GAINESVILLE FLCard 2801,25.08,,Posted,245.51,2022-05-06,25.08,Withdrawal POS #000000000558/CIRCLE K # 26146 3525 GAINESVILLE FLCard 2801,24.92
5/6/2022,,Withdrawal ATM Fee/ASAI 3400 B SW 34th St. Gainesville FLCard 2801,2.0,,Posted,270.59,2022-05-06,2.0,Withdrawal ATM Fee/ASAI 3400 B SW 34th St. Gainesville FLCard 2801,2.0
5/6/2022,,Withdrawal at ATM #000000000051/ASAI 3400 B SW 34th St. Gainesville FLCard 2801,78.0,,Posted,272.59,2022-05-06,78.0,Withdrawal at ATM #000000000323/ASAI 3400 B SW 34th St. Gainesville FLCard 2801,78.0
5/6/2022,,Withdrawal Debit Card MC Debit/PUBLIX #1312 GAINESVILLE FLDate 05/05/22 0 2125034182 1 5411Card 2801,28.52,,Posted,350.59,2022-05-06,28.52,Withdrawal Debit Card MC Debit/PUBLIX #1312 GAINESVILLE FLDate 05/28/21 0 1148028662 2 5411Card 2801,28.52
5/6/2022,,Recurring Withdrawal Bill Payment - #000008065471/NETFLIX COM LOS GATOS CACard 2801,10.98,,Posted,98.35,2022-05-06,10.98,Recurring Withdrawal Bill Payment - #000006911729/NETFLIX COM LOS GATOS CACard 2801,10.99
5/5/2022,,Withdrawal Debit Card MC Debit/SANTAFECCOLBKSTOR #341 352-395-5240 FLDate 05/04/22 0 2124074809 1 5942Card 2801,174.25,,Posted,109.33,2022-05-05,174.25,Withdrawal Debit Card MC Debit/SANTAFECCOLBKSTOR #341 352-395-5240 FLDate 05/04/22 0 2124074809 1 5942Card 2801,174.25
5/5/2022,,Withdrawal Debit Card MC Debit/WALGREENS #5024 800-289-2273 FLDate 05/04/22 0 2124070501 1 5912Card 2801,23.16,,Posted,283.58,2022-05-05,23.16,Withdrawal Debit Card MC Debit/WALGREENS #5024 800-289-2273 FLDate 09/08/21 0 1251607416 1 5912Card 2801,23.16
5/5/2022,,Withdrawal ACH PAYMENT FOR AMZ/TYPE: STORECARD ID: 9069872103CO: PAYMENT FOR AMZNAME: 6045781157416487Entry Class Code: WEB,25.0,,Posted,306.74,2022-05-05,25.0,Withdrawal ACH PAYMENT FOR AMZ/TYPE: STORECARD ID: 9069872103CO: PAYMENT FOR AMZNAME: 6045781157416487Entry Class Code: WEB,25.0
5/4/2022,,Withdrawal POS #000000000140/CIRCLE K # 06782 5237 GAINESVILLE FLCard 2801,18.59,,Posted,331.74,2022-05-04,18.59,Withdrawal POS #000000000343/CIRCLE K # 06782 5237 GAINESVILLE FLCard 1247,18.59
5/4/2022,,Withdrawal ACH PAYPAL/TYPE: INST XFER ID: PAYPALSI77CO: PAYPAL NAME: STEVEN CHAPLINSKIEntry Class Code: WEB,2.99,,Posted,350.33,2022-05-04,2.99,Withdrawal ACH PAYPAL/TYPE: INST XFER ID: PAYPALSI77CO: PAYPAL NAME: STEVEN CHAPLINSKIEntry Class Code: WEB,3.218
5/3/2022,,Recurring Withdrawal Debit Card MC Debit/ZIP.CO* NEWEGG NEW YORK NYDate 05/02/22 0 2122798522 0 5399Card 2801,42.77,,Posted,353.32,2022-05-03,42.77,Withdrawal Debit Card MC Debit/ZIP.CO* NEWEGG NEW YORK NYDate 04/03/22 0 2093025644 1 5399Card 2801,42.765
5/3/2022,,Withdrawal ACH TARGET CARD SRVC/TYPE: BILL PAY ID: 5411721813CO: TARGET CARD SRVCNAME: S CHAPLINSKI TEntry Class Code: WEB,40.0,,Posted,396.09,2022-05-03,40.0,Withdrawal ACH TARGET CARD SRVC/TYPE: BILL PAY ID: 5411721813CO: TARGET CARD SRVCNAME: S CHAPLINSKI TEntry Class Code: WEB,40.0
5/3/2022,,Withdrawal ACH PAYPAL/TYPE: INST XFER ID: PAYPALSI77CO: PAYPAL NAME: STEVEN CHAPLINSKIEntry Class Code: WEB,14.99,,Posted,436.09,2022-05-03,14.99,Withdrawal ACH PAYPAL/TYPE: INST XFER ID: PAYPALSI77CO: PAYPAL NAME: STEVEN CHAPLINSKIEntry Class Code: WEB,14.948333333333332
5/2/2022,,Withdrawal POS #000000675678/SUNOCO 8002212501 4234 SW 20TH AVEGAINESVILLE FLCard 2801,24.89,,Posted,451.08,2022-05-02,24.89,Withdrawal POS #000000177815/SUNOCO 8002212501 4234 SW 20TH AVEGAINESVILLE FLCard 2801,25.115000000000002
5/2/2022,,Withdrawal Home Banking Transfer - To Share 0000/Funds Transfer via Mobile,5.0,,Posted,475.97,2022-05-02,5.0,Withdrawal Home Banking Transfer - To Share 0000/Funds Transfer via Online,5.0
5/2/2022,,Withdrawal ACH APPLECARD GSBANK/TYPE: PAYMENT ID: 9999999999CO: APPLECARD GSBANKNAME: Steven ChaplinskiEntry Class Code: WEB,17.0,,Posted,480.97,2022-05-02,17.0,Withdrawal ACH APPLECARD GSBANK/TYPE: PAYMENT ID: 9999999999CO: APPLECARD GSBANKNAME: Steven ChaplinskiEntry Class Code: WEB,17.0
5/2/2022,,Withdrawal Debit Card MC Debit/WALGREENS #5024 800-289-2273 FLDate 05/01/22 0 2121942003 0 5912Card 2801,39.6,,Posted,497.97,2022-05-02,39.6,Withdrawal Debit Card MC Debit/WALGREENS #5024 800-289-2273 FLDate 05/21/22 0 2141999930 0 5912Card 2801,39.6
5/2/2022,,Withdrawal ACH Watson Realty Co/TYPE: WEB PMTS ID: 9000321157CO: Watson Realty CoNAME: Steven chaplinskiEntry Class Code: WEB,885.0,,Posted,537.57,2022-05-02,885.0,Withdrawal ACH Watson Realty Co/TYPE: WEB PMTS ID: 9000321157CO: Watson Realty CoEntry Class Code: WEB,885.0
5/1/2022,,Recurring Withdrawal Bill Payment - #000019084874/AFFIRM PAY CHYKSKQD SAN FRANCISCO CACard 2801,26.92,,Posted,1422.57,2022-05-01,26.92,Recurring Withdrawal Bill Payment - #000000233587/AFFIRM PAY YSM SAN FRANCISCO CACard 2801,26.92
5/1/2022,,Withdrawal POS #000000738174/PUBLIX 3930 SW ARCHER ROA GAINESVILLE FLCard 2801,23.78,,Posted,1449.49,2022-05-01,23.78,Withdrawal POS #000000086361/PUBLIX 3930 SW ARCHER ROA GAINESVILLE FLCard 2801,23.78
4/30/2022,,Withdrawal Debit Card MC Debit/GRU/EZ-PAY WEB PYMT 352-334-3434 FLDate 04/29/22 0 2119231842 0 4900Card 2801,218.91,,Posted,1473.27,2022-04-30,218.91,Withdrawal Debit Card MC Debit/GRU/EZ-PAY WEB PYMT 352-334-3434 FLDate 11/01/21 0 1305577800 0 4900Card 2801,219.075
4/30/2022,,Withdrawal Debit Card MC Debit/COX GAINESVILLE COMM 800-234-3993 FLDate 04/29/22 0 2119829506 0 4899Card 2801,115.39,,Posted,1692.18,2022-04-30,115.39,Withdrawal Debit Card MC Debit/COX GAINESVILLE COMM 800-234-3993 FLDate 01/27/22 0 2027240681 1 4899Card 2801,115.39
4/30/2022,,Withdrawal ATM Fee/ASAI 3400 B SW 34th St. Gainesville FLCard 2801,2.0,,Posted,1807.57,2022-04-30,2.0,Withdrawal ATM Fee/ASAI 3400 B SW 34th St. Gainesville FLCard 2801,2.0
4/30/2022,,Withdrawal at ATM #000000001804/ASAI 3400 B SW 34th St. Gainesville FLCard 2801,127.75,,Posted,1809.57,2022-04-30,127.75,Withdrawal at ATM #000000000323/ASAI 3400 B SW 34th St. Gainesville FLCard 2801,127.875
4/30/2022,,Withdrawal POS #000000585470/FAST TRACK #200 3960 SW ARCHER RDGAINESVILLE FLCard 2801,19.45,,Posted,1937.32,2022-04-30,19.45,Withdrawal POS #000000166784/FAST TRACK #200 3960 SW ARCHER RDGAINESVILLE FLCard 2801,19.865000000000002
4/30/2022,,Withdrawal POS #000000737718/PUBLIX 3930 SW ARCHER ROA GAINESVILLE FLCard 2801,46.19,,Posted,1956.77,2022-04-30,46.19,Withdrawal POS #000000086361/PUBLIX 3930 SW ARCHER ROA GAINESVILLE FLCard 2801,46.19
4/29/2022,,Withdrawal ACH PAYPAL/TYPE: INST XFER ID: PAYPALSI77CO: PAYPAL NAME: STEVEN CHAPLINSKIEntry Class Code: WEB,2.99,,Posted,2.96,2022-04-29,2.99,Withdrawal ACH PAYPAL/TYPE: INST XFER ID: PAYPALSI77CO: PAYPAL NAME: STEVEN CHAPLINSKIEntry Class Code: WEB,3.218
4/28/2022,,Withdrawal Debit Card MC Debit/COLLEGE TRANSCRIPT 847-716-3000 ILDate 04/27/22 0 2117043656 1 7375Card 2801,3.0,,Posted,5.95,2022-04-28,3.0,Withdrawal Debit Card MC Debit/COLLEGE TRANSCRIPT 847-716-3000 ILDate 04/27/22 0 2117043656 1 7375Card 2801,3.0
4/27/2022,,Recurring Withdrawal Debit Card MC Debit/HELP.HBOMAX.COM NEW YORK NYDate 04/27/22 0 2117023223 1 5815Card 2801,17.23,,Posted,-3.05,2022-04-27,17.23,Recurring Withdrawal Debit Card MC Debit/HELP.HBOMAX.COM NEW YORK NYDate 04/27/22 0 2117023223 1 5815Card 2801,17.23
4/27/2022,,Withdrawal ACH CANVA PTY LIMITE/CO: CANVA PTY LIMITEDTYPE: IAT PAYPAL ID: 770510487CEntry Class Code: IAT,12.99,,Posted,14.0,2022-04-27,12.99,Withdrawal ACH CANVA PTY LIMITE/CO: CANVA PTY LIMITEDTYPE: IAT PAYPAL ID: 770510487CEntry Class Code: IAT,12.99
4/27/2022,,Withdrawal ACH PAYPAL/TYPE: INST XFER ID: PAYPALSI77CO: PAYPAL NAME: STEVEN CHAPLINSKIEntry Class Code: WEB,2.99,,Posted,26.99,2022-04-27,2.99,Withdrawal ACH PAYPAL/TYPE: INST XFER ID: PAYPALSI77CO: PAYPAL NAME: STEVEN CHAPLINSKIEntry Class Code: WEB,3.218
4/27/2022,,Recurring Withdrawal Bill Payment - #000021122613/AFFIRM PAY 2KXLN0HP SAN FRANCISCO CACard 2801,26.92,,Posted,25.98,2022-04-27,26.92,Recurring Withdrawal Bill Payment - #000000233587/AFFIRM PAY YSM SAN FRANCISCO CACard 2801,26.92
4/26/2022,,Withdrawal Debit Card MC Debit/PUBLIX #680 GAINESVILLE FLDate 04/25/22 0 2115965172 0 5411Card 2801,33.33,,Posted,22.9,2022-04-26,33.33,Withdrawal Debit Card MC Debit/PUBLIX #795 GAINESVILLE FLDate 03/07/22 0 2066965570 0 5411Card 2801,33.33
4/26/2022,,Withdrawal Debit Card MC Debit/AMAZON.COM*1Q8DL7DY1 AMZN.COM/BIL WADate 04/26/22 0 2116907583 0 5942Card 2801,35.76,,Posted,56.23,2022-04-26,35.76,Withdrawal Debit Card MC Debit/AMAZON.COM*1Q8DL7DY1 AMZN.COM/BIL WADate 04/26/22 0 2116907583 0 5942Card 2801,35.76
4/26/2022,,Withdrawal ACH PAYPAL/TYPE: INST XFER ID: PAYPALSI77CO: PAYPAL NAME: STEVEN CHAPLINSKIEntry Class Code: WEB,8.89,,Posted,91.99,2022-04-26,8.89,Withdrawal ACH PAYPAL/TYPE: INST XFER ID: PAYPALSI77CO: PAYPAL NAME: STEVEN CHAPLINSKIEntry Class Code: WEB,9.015
4/26/2022,,Withdrawal ACH PAYPAL/TYPE: INST XFER ID: PAYPALSI77CO: PAYPAL NAME: STEVEN CHAPLINSKIEntry Class Code: WEB,4.5,,Posted,100.88,2022-04-26,4.5,Withdrawal ACH PAYPAL/TYPE: INST XFER ID: PAYPALSI77CO: PAYPAL NAME: STEVEN CHAPLINSKIEntry Class Code: WEB,4.96
4/26/2022,,Withdrawal POS #000000407601/SUNOCO 8002212501 4234 SW 20TH AVEGAINESVILLE FLCard 2801,12.97,,Posted,105.38,2022-04-26,12.97,Withdrawal POS #000000403720/SUNOCO 8002212501 4234 SW 20TH AVEGAINESVILLE FLCard 2801,12.97
4/25/2022,,"Withdrawal Debit Card MC Debit/COLLEGENET *FLORIDA, 8772143932 FLDate 04/24/22 0 2114014607 1 8220Card 2801",30.0,,Posted,118.35,2022-04-25,30.0,"Withdrawal Debit Card MC Debit/COLLEGENET *FLORIDA, 8772143932 FLDate 04/24/22 0 2114014607 1 8220Card 2801",30.0
4/25/2022,,Withdrawal Debit Card MC Debit/KINDLE UNLTD*1Q3V82MS1 866-321-8851 WADate 04/24/22 0 2114009003 1 5818Card 2801,9.99,,Posted,148.35,2022-04-25,9.99,Withdrawal Debit Card MC Debit/KINDLE UNLTD*1N4IN7U80 866-321-8851 WADate 03/24/22 0 2083036398 1 5818Card 2801,9.99
4/23/2022,,Withdrawal POS #000000338186/FAST TRACK #200 3960 SW ARCHER RDGAINESVILLE FLCard 2801,25.21,,Posted,158.34,2022-04-23,25.21,Withdrawal POS #000000194488/FAST TRACK #200 3960 SW ARCHER RDGAINESVILLE FLCard 1140,25.21
4/23/2022,,Withdrawal POS #000000736088/PUBLIX 3930 SW ARCHER ROA GAINESVILLE FLCard 2801,41.8,,Posted,183.55,2022-04-23,41.8,Withdrawal POS #000000086361/PUBLIX 3930 SW ARCHER ROA GAINESVILLE FLCard 2801,41.8
4/22/2022,,Withdrawal ACH WAWA CREDIT CARD/TYPE: ONLINE PMT ID: CITICTPCO: WAWA CREDIT CARDNAME: STEVEN CHAPLINSKIEntry Class Code: WEB,29.0,,Posted,225.35,2022-04-22,29.0,Withdrawal ACH WAWA CREDIT CARD/TYPE: ONLINE PMT ID: CITICTPCO: WAWA CREDIT CARDNAME: STEVEN CHAPLINSKIEntry Class Code: WEB,29.0
4/21/2022,,Recurring Withdrawal Debit Card MC Debit/JASPER.AI AUSTIN TXDate 04/20/22 0 2110444189 0 7399Card 2801,21.62,,Posted,254.35,2022-04-21,21.62,Recurring Withdrawal Debit Card MC Debit/JASPER.AI AUSTIN TXDate 09/25/22 0 2268000612 1 7399Card 2801,21.39
4/21/2022,,Withdrawal ACH PAYPAL/TYPE: INST XFER ID: PAYPALSI77CO: PAYPAL NAME: STEVEN CHAPLINSKIEntry Class Code: WEB,15.99,,Posted,275.97,2022-04-21,15.99,Withdrawal ACH PAYPAL/TYPE: INST XFER ID: PAYPALSI77CO: PAYPAL NAME: STEVEN CHAPLINSKIEntry Class Code: WEB,15.99
4/21/2022,,Withdrawal ACH PAYPAL/TYPE: INST XFER ID: PAYPALSI77CO: PAYPAL NAME: STEVEN CHAPLINSKIEntry Class Code: WEB,11.99,,Posted,291.96,2022-04-21,11.99,Withdrawal ACH PAYPAL/TYPE: INST XFER ID: PAYPALSI77CO: PAYPAL NAME: STEVEN CHAPLINSKIEntry Class Code: WEB,11.7425
4/21/2022,,Withdrawal POS #000000000011/AMAZON.COM*1O6A36FN2 SEATTLE WACard 2801,7.71,,Posted,303.95,2022-04-21,7.71,Withdrawal POS #000000630901/AMAZON.COM*ZA2053S23 SEATTLE WACard 2801,7.71
4/20/2022,,Withdrawal POS #000000830952/AMAZON.COM*1A8JG3W82 SEATTLE WACard 2801,19.2,,Posted,311.66,2022-04-20,19.2,Withdrawal POS #000000630901/AMAZON.COM*ZA2053S23 SEATTLE WACard 2801,19.2
4/19/2022,,Withdrawal at ATM #000000001389/PAI ISO 318 NW 13TH ST GAINESVILLE FLCard 2801,53.5,,Posted,330.86,2022-04-19,53.5,Withdrawal at ATM #000000001389/PAI ISO 318 NW 13TH ST GAINESVILLE FLCard 2801,53.5
4/19/2022,,Recurring Withdrawal Debit Card MC Debit/ZIP.CO* NEWEGG NEW YORK NYDate 04/18/22 0 2108628572 0 5399Card 2801,42.77,,Posted,384.36,2022-04-19,42.77,Withdrawal Debit Card MC Debit/ZIP.CO* NEWEGG NEW YORK NYDate 04/03/22 0 2093025644 1 5399Card 2801,42.765
4/18/2022,,Withdrawal ACH PAYPAL/TYPE: INST XFER ID: PAYPALSI77CO: PAYPAL NAME: STEVEN CHAPLINSKIEntry Class Code: WEB,64.99,,Posted,427.13,2022-04-18,64.99,Withdrawal ACH PAYPAL/TYPE: INST XFER ID: PAYPALSI77CO: PAYPAL NAME: STEVEN CHAPLINSKIEntry Class Code: WEB,64.99
4/18/2022,,Withdrawal ACH PAYPAL/TYPE: INST XFER ID: PAYPALSI77CO: PAYPAL NAME: STEVEN CHAPLINSKIEntry Class Code: WEB,18.25,,Posted,492.12,2022-04-18,18.25,Withdrawal ACH PAYPAL/TYPE: INST XFER ID: PAYPALSI77CO: PAYPAL NAME: STEVEN CHAPLINSKIEntry Class Code: WEB,18.244999999999997
4/17/2022,,Withdrawal Debit Card MC Debit/PUBLIX #1312 GAINESVILLE FLDate 04/16/22 0 2106080947 1 5411Card 2801,49.92,,Posted,490.37,2022-04-17,49.92,Withdrawal Debit Card MC Debit/PUBLIX #1312 GAINESVILLE FLDate 03/11/21 0 1070536058 1 5411Card 2801,49.92
4/16/2022,,Withdrawal POS #000019892829/SHELL SERVICE S GAINESVILLE FLCard 2801,35.51,,Posted,244.79,2022-04-16,35.51,Withdrawal POS #000019892829/SHELL SERVICE S GAINESVILLE FLCard 2801,35.51
4/16/2022,,Withdrawal ATM Fee/ASAI 3400 B SW 34th St. Gainesville FLCard 2801,2.0,,Posted,280.3,2022-04-16,2.0,Withdrawal ATM Fee/ASAI 3400 B SW 34th St. Gainesville FLCard 2801,2.0
4/16/2022,,Withdrawal at ATM #000000001554/ASAI 3400 B SW 34th St. Gainesville FLCard 2801,92.75,,Posted,282.3,2022-04-16,92.75,Withdrawal at ATM #000000000323/ASAI 3400 B SW 34th St. Gainesville FLCard 2801,92.75
4/15/2022,,Withdrawal ACH PAYPAL/TYPE: INST XFER ID: PAYPALSI77CO: PAYPAL NAME: STEVEN CHAPLINSKIEntry Class Code: WEB,18.24,,Posted,300.05,2022-04-15,18.24,Withdrawal ACH PAYPAL/TYPE: INST XFER ID: PAYPALSI77CO: PAYPAL NAME: STEVEN CHAPLINSKIEntry Class Code: WEB,18.244999999999997
4/15/2022,,Withdrawal POS #000000930774/FAST TRACK #200 3960 SW ARCHER RDGAINESVILLE FLCard 2801,30.97,,Posted,318.29,2022-04-15,30.97,Withdrawal POS #000000194488/FAST TRACK #200 3960 SW ARCHER RDGAINESVILLE FLCard 1140,30.97
4/15/2022,,Recurring Withdrawal Bill Payment - #000000254133/AFFIRM PAY O725AJ97 SAN FRANCISCO CACard 2801,26.92,,Posted,349.26,2022-04-15,26.92,Recurring Withdrawal Bill Payment - #000000233587/AFFIRM PAY YSM SAN FRANCISCO CACard 2801,26.92
4/12/2022,,Withdrawal Debit Card MC Debit/YVETTE GODET DMD GAINESVILLE FLDate 04/11/22 0 2101019240 1 8021Card 2801,35.8,,Posted,376.18,2022-04-12,35.8,Withdrawal Debit Card MC Debit/YVETTE GODET DMD GAINESVILLE FLDate 04/11/22 0 2101019240 1 8021Card 2801,35.8
4/12/2022,,Withdrawal Debit Card MC Debit/WALGREENS #5024 800-289-2273 FLDate 04/11/22 0 2101016047 1 5912Card 2801,20.92,,Posted,411.98,2022-04-12,20.92,Withdrawal Debit Card MC Debit/WALGREENS #5024 800-289-2273 FLDate 09/08/21 0 1251607416 1 5912Card 2801,20.92
4/12/2022,,Recurring Withdrawal Debit Card MC Debit/PAYPAL *LINKTREEPTY 4029357733 CADate 04/11/22 0 2101984105 0 5734Card 2801,6.0,,Posted,432.9,2022-04-12,6.0,Recurring Withdrawal Debit Card MC Debit/PAYPAL *LINKTREE 4029357733 AUDate 05/12/21 0 1132191600 1 7372Card 2801,6.0
4/12/2022,,Withdrawal ACH PAYPAL/TYPE: INST XFER ID: PAYPALSI77CO: PAYPAL NAME: STEVEN CHAPLINSKIEntry Class Code: WEB,9.99,,Posted,438.9,2022-04-12,9.99,Withdrawal ACH PAYPAL/TYPE: INST XFER ID: PAYPALSI77CO: PAYPAL NAME: STEVEN CHAPLINSKIEntry Class Code: WEB,10.093333333333334
4/11/2022,,Withdrawal POS #000000000072/CIRCLE K # 06782 5237 GAINESVILLE FLCard 2801,24.65,,Posted,448.89,2022-04-11,24.65,Withdrawal POS #000000000343/CIRCLE K # 06782 5237 GAINESVILLE FLCard 1247,24.65
4/11/2022,,Withdrawal POS #000014436615/WALGREENS 2415 SW 75TH GAINESVILLE FLCard 2801,8.56,,Posted,473.54,2022-04-11,8.56,Withdrawal POS #000015057686/WALGREENS 2415 SW 75TH GAINESVILLE FLCard 1231,8.56
4/11/2022,,Withdrawal ACH PAYPAL INC./CO: PAYPAL INC.TYPE: IAT PAYPAL ID: 770510487CEntry Class Code: IAT,20.0,,Posted,282.1,2022-04-11,20.0,Withdrawal ACH PAYPAL INC./CO: PAYPAL INC.TYPE: IAT PAYPAL ID: 770510487CEntry Class Code: IAT,20.5
4/11/2022,,Withdrawal ACH PAYPAL/TYPE: INST XFER ID: PAYPALSI77CO: PAYPAL NAME: STEVEN CHAPLINSKIEntry Class Code: WEB,6.75,,Posted,302.1,2022-04-11,6.75,Withdrawal ACH PAYPAL/TYPE: INST XFER ID: PAYPALSI77CO: PAYPAL NAME: STEVEN CHAPLINSKIEntry Class Code: WEB,6.87
4/8/2022,,Withdrawal POS #000007043708/PAYPAL *VIDIQ San Jose CACard 2801,10.0,,Posted,249.75,2022-04-08,10.0,Withdrawal POS #000007247911/PAYPAL *VIDIQ San Jose CACard 2801,10.0
4/7/2022,,Withdrawal POS #000000922694/AMAZON.COM*1H1WA7880 SEATTLE WACard 2801,10.87,,Posted,259.75,2022-04-07,10.87,Withdrawal POS #000000922564/AMAZON.COM*VJ71T1BJ3 SEATTLE WACard 2801,10.59
4/6/2022,,Withdrawal POS #000000000067/CIRCLE K # 26146 3525 GAINESVILLE FLCard 2801,24.76,,Posted,270.62,2022-04-06,24.76,Withdrawal POS #000000000558/CIRCLE K # 26146 3525 GAINESVILLE FLCard 2801,24.92
4/6/2022,,Withdrawal ATM Fee/ASAI 3400 B SW 34th St. Gainesville FLCard 2801,2.0,,Posted,295.38,2022-04-06,2.0,Withdrawal ATM Fee/ASAI 3400 B SW 34th St. Gainesville FLCard 2801,2.0
4/6/2022,,Withdrawal at ATM #000000000388/ASAI 3400 B SW 34th St. Gainesville FLCard 2801,137.75,,Posted,297.38,2022-04-06,137.75,Withdrawal at ATM #000000000323/ASAI 3400 B SW 34th St. Gainesville FLCard 2801,137.75
4/6/2022,,Withdrawal Debit Card MC Debit/WALGREENS #5024 800-289-2273 FLDate 04/05/22 0 2095019278 1 5912Card 2801,29.15,,Posted,435.13,2022-04-06,29.15,Withdrawal Debit Card MC Debit/WALGREENS #5024 800-289-2273 FLDate 09/08/21 0 1251607416 1 5912Card 2801,29.15
4/6/2022,,Recurring Withdrawal Bill Payment - #000008370732/NETFLIX COM LOS GATOS CACard 2801,10.98,,Posted,464.28,2022-04-06,10.98,Recurring Withdrawal Bill Payment - #000006911729/NETFLIX COM LOS GATOS CACard 2801,10.99
4/5/2022,,Withdrawal POS #000000517521/SUNOCO 8002212501 4234 SW 20TH AVEGAINESVILLE FLCard 2801,23.82,,Posted,475.26,2022-04-05,23.82,Withdrawal POS #000000955321/SUNOCO 8002212501 4234 SW 20TH AVEGAINESVILLE FLCard 2801,23.975
4/5/2022,,Withdrawal Debit Card MC Debit/GRU/EZ-PAY WEB PYMT 352-334-3434 FLDate 04/04/22 0 2094304849 0 4900Card 2801,181.6,,Posted,499.08,2022-04-05,181.6,Withdrawal Debit Card MC Debit/GRU/EZ-PAY WEB PYMT 352-334-3434 FLDate 11/01/21 0 1305577800 0 4900Card 2801,181.6
4/5/2022,,Withdrawal Debit Card MC Debit/COX GAINESVILLE COMM 800-234-3993 FLDate 04/04/22 0 2094304808 0 4899Card 2801,115.39,,Posted,680.68,2022-04-05,115.39,Withdrawal Debit Card MC Debit/COX GAINESVILLE COMM 800-234-3993 FLDate 01/27/22 0 2027240681 1 4899Card 2801,115.39
4/5/2022,,Withdrawal ACH PAYPAL/TYPE: INST XFER ID: PAYPALSI77CO: PAYPAL NAME: STEVEN CHAPLINSKIEntry Class Code: WEB,37.04,,Posted,796.07,2022-04-05,37.04,Withdrawal ACH PAYPAL/TYPE: INST XFER ID: PAYPALSI77CO: PAYPAL NAME: STEVEN CHAPLINSKIEntry Class Code: WEB,36.99666666666666
4/5/2022,,Withdrawal ACH PAYPAL/TYPE: INST XFER ID: PAYPALSI77CO: PAYPAL NAME: STEVEN CHAPLINSKIEntry Class Code: WEB,36.51,,Posted,833.11,2022-04-05,36.51,Withdrawal ACH PAYPAL/TYPE: INST XFER ID: PAYPALSI77CO: PAYPAL NAME: STEVEN CHAPLINSKIEntry Class Code: WEB,36.99666666666666
4/5/2022,,Withdrawal ACH PAYPAL/TYPE: INST XFER ID: PAYPALSI77CO: PAYPAL NAME: STEVEN CHAPLINSKIEntry Class Code: WEB,14.95,,Posted,869.62,2022-04-05,14.95,Withdrawal ACH PAYPAL/TYPE: INST XFER ID: PAYPALSI77CO: PAYPAL NAME: STEVEN CHAPLINSKIEntry Class Code: WEB,14.948333333333332
4/4/2022,,Withdrawal ACH BARCLAYCARD US/TYPE: CREDITCARD ID: 2510407970CO: BARCLAYCARD USNAME: STEVEN CHAPLINSKIEntry Class Code: WEB,68.77,,Posted,884.57,2022-04-04,68.77,Withdrawal ACH BARCLAYCARD US/TYPE: CREDITCARD ID: 2510407970CO: BARCLAYCARD USNAME: STEVEN CHAPLINSKIEntry Class Code: WEB,68.77
4/4/2022,,Withdrawal ACH CAPITAL ONE/TYPE: MOBILE PMT ID: 9279744980CO: CAPITAL ONE NAME: STEVEN CHAPLINSKIEntry Class Code: WEB,55.0,,Posted,953.34,2022-04-04,55.0,Withdrawal ACH CAPITAL ONE/TYPE: ONLINE PMT ID: 9279744391CO: CAPITAL ONE NAME: STEVEN CHAPLINSKIEntry Class Code: WEB,55.0
4/4/2022,,Withdrawal ACH APPLECARD GSBANK/TYPE: PAYMENT ID: 9999999999CO: APPLECARD GSBANKNAME: Steven ChaplinskiEntry Class Code: WEB,25.0,,Posted,1008.34,2022-04-04,25.0,Withdrawal ACH APPLECARD GSBANK/TYPE: PAYMENT ID: 9999999999CO: APPLECARD GSBANKNAME: Steven ChaplinskiEntry Class Code: WEB,25.0
4/4/2022,,Withdrawal Debit Card MC Debit/ZIP.CO* NEWEGG NEW YORK NYDate 04/03/22 0 2093025644 1 5399Card 2801,42.76,,Posted,1033.34,2022-04-04,42.76,Withdrawal Debit Card MC Debit/ZIP.CO* NEWEGG NEW YORK NYDate 04/03/22 0 2093025644 1 5399Card 2801,42.765
4/4/2022,,Withdrawal ACH Watson Realty Co/TYPE: WEB PMTS ID: 9000321157CO: Watson Realty CoNAME: Steven chaplinskiEntry Class Code: WEB,885.0,,Posted,1076.1,2022-04-04,885.0,Withdrawal ACH Watson Realty Co/TYPE: WEB PMTS ID: 9000321157CO: Watson Realty CoEntry Class Code: WEB,885.0
4/4/2022,,Withdrawal ACH DISCOVER/TYPE: E-PAYMENT ID: 2510020270CO: DISCOVER NAME: CHAPLINSKI STEVENEntry Class Code: WEB,33.0,,Posted,1961.1,2022-04-04,33.0,Withdrawal ACH DISCOVER/TYPE: E-PAYMENT ID: 2510020270CO: DISCOVER NAME: CHAPLINSKI STEVENEntry Class Code: WEB,33.5
4/4/2022,,Withdrawal ACH PAYPAL/TYPE: INST XFER ID: PAYPALSI77CO: PAYPAL NAME: STEVEN CHAPLINSKIEntry Class Code: WEB,24.97,,Posted,1994.1,2022-04-04,24.97,Withdrawal ACH PAYPAL/TYPE: INST XFER ID: PAYPALSI77CO: PAYPAL NAME: STEVEN CHAPLINSKIEntry Class Code: WEB,24.97
4/4/2022,,Withdrawal ACH PAYPAL/TYPE: INST XFER ID: PAYPALSI77CO: PAYPAL NAME: STEVEN CHAPLINSKIEntry Class Code: WEB,14.99,,Posted,2019.07,2022-04-04,14.99,Withdrawal ACH PAYPAL/TYPE: INST XFER ID: PAYPALSI77CO: PAYPAL NAME: STEVEN CHAPLINSKIEntry Class Code: WEB,14.948333333333332
4/4/2022,,Withdrawal ACH PAYPAL/TYPE: INST XFER ID: PAYPALSI77CO: PAYPAL NAME: STEVEN CHAPLINSKIEntry Class Code: WEB,2.99,,Posted,2034.06,2022-04-04,2.99,Withdrawal ACH PAYPAL/TYPE: INST XFER ID: PAYPALSI77CO: PAYPAL NAME: STEVEN CHAPLINSKIEntry Class Code: WEB,3.218
4/3/2022,,Withdrawal Debit Card MC Debit/WALGREENS #5024 800-289-2273 FLDate 04/01/22 0 2091305278 2 5912Card 2801,23.56,,Posted,2037.05,2022-04-03,23.56,Withdrawal Debit Card MC Debit/WALGREENS #5024 800-289-2273 FLDate 05/21/22 0 2141999930 0 5912Card 2801,23.56
4/1/2022,,Withdrawal POS #000000389731/FAST TRACK #200 3960 SW ARCHER RDGAINESVILLE FLCard 2801,18.79,,Posted,2060.61,2022-04-01,18.79,Withdrawal POS #000000418393/FAST TRACK #200 3960 SW ARCHER RDGAINESVILLE FLCard 2801,18.61
4/1/2022,,Withdrawal POS #000000745669/PUBLIX 3930 SW ARCHER ROA GAINESVILLE FLCard 2801,51.65,,Posted,2079.4,2022-04-01,51.65,Withdrawal POS #000000086361/PUBLIX 3930 SW ARCHER ROA GAINESVILLE FLCard 2801,51.65
4/1/2022,,Withdrawal ACH PAYPAL/TYPE: INST XFER ID: PAYPALSI77CO: PAYPAL NAME: STEVEN CHAPLINSKIEntry Class Code: WEB,18.24,,Posted,2131.05,2022-04-01,18.24,Withdrawal ACH PAYPAL/TYPE: INST XFER ID: PAYPALSI77CO: PAYPAL NAME: STEVEN CHAPLINSKIEntry Class Code: WEB,18.244999999999997
3/31/2022,,Withdrawal ACH PAYPAL/TYPE: INST XFER ID: PAYPALSI77CO: PAYPAL NAME: STEVEN CHAPLINSKIEntry Class Code: WEB,49.0,,Posted,149.29,2022-03-31,49.0,Withdrawal ACH PAYPAL/TYPE: INST XFER ID: PAYPALSI77CO: PAYPAL NAME: STEVEN CHAPLINSKIEntry Class Code: WEB,49.663333333333334
3/30/2022,,Withdrawal POS #000000247486/SUNOCO 8002212501 4234 SW 20TH AVEGAINESVILLE FLCard 2801,23.82,,Posted,198.29,2022-03-30,23.82,Withdrawal POS #000000238444/SUNOCO 8002212501 4234 SW 20TH AVEGAINESVILLE FLCard 2801,23.82
3/29/2022,,Withdrawal ACH PAYPAL/TYPE: INST XFER ID: PAYPALSI77CO: PAYPAL NAME: STEVEN CHAPLINSKIEntry Class Code: WEB,11.48,,Posted,222.11,2022-03-29,11.48,Withdrawal ACH PAYPAL/TYPE: INST XFER ID: PAYPALSI77CO: PAYPAL NAME: STEVEN CHAPLINSKIEntry Class Code: WEB,11.7425
3/29/2022,,Withdrawal ACH PAYPAL/TYPE: INST XFER ID: PAYPALSI77CO: PAYPAL NAME: STEVEN CHAPLINSKIEntry Class Code: WEB,2.99,,Posted,233.59,2022-03-29,2.99,Withdrawal ACH PAYPAL/TYPE: INST XFER ID: PAYPALSI77CO: PAYPAL NAME: STEVEN CHAPLINSKIEntry Class Code: WEB,3.218
3/28/2022,,Withdrawal ACH CANVA PTY LIMITE/CO: CANVA PTY LIMITEDTYPE: IAT PAYPAL ID: 770510487CEntry Class Code: IAT,12.99,,Posted,236.58,2022-03-28,12.99,Withdrawal ACH CANVA PTY LIMITE/CO: CANVA PTY LIMITEDTYPE: IAT PAYPAL ID: 770510487CEntry Class Code: IAT,12.99
3/28/2022,,Withdrawal ACH PAYPAL/TYPE: INST XFER ID: PAYPALSI77CO: PAYPAL NAME: STEVEN CHAPLINSKIEntry Class Code: WEB,19.99,,Posted,249.57,2022-03-28,19.99,Withdrawal ACH PAYPAL/TYPE: INST XFER ID: PAYPALSI77CO: PAYPAL NAME: STEVEN CHAPLINSKIEntry Class Code: WEB,19.98
3/28/2022,,Withdrawal ACH PAYPAL/TYPE: INST XFER ID: PAYPALSI77CO: PAYPAL NAME: STEVEN CHAPLINSKIEntry Class Code: WEB,15.15,,Posted,269.56,2022-03-28,15.15,Withdrawal ACH PAYPAL/TYPE: INST XFER ID: PAYPALSI77CO: PAYPAL NAME: STEVEN CHAPLINSKIEntry Class Code: WEB,14.948333333333332
3/28/2022,,Withdrawal ACH PAYPAL/TYPE: INST XFER ID: PAYPALSI77CO: PAYPAL NAME: STEVEN CHAPLINSKIEntry Class Code: WEB,8.89,,Posted,284.71,2022-03-28,8.89,Withdrawal ACH PAYPAL/TYPE: INST XFER ID: PAYPALSI77CO: PAYPAL NAME: STEVEN CHAPLINSKIEntry Class Code: WEB,9.015
3/28/2022,,Withdrawal ACH PAYPAL/TYPE: INST XFER ID: PAYPALSI77CO: PAYPAL NAME: STEVEN CHAPLINSKIEntry Class Code: WEB,4.5,,Posted,293.6,2022-03-28,4.5,Withdrawal ACH PAYPAL/TYPE: INST XFER ID: PAYPALSI77CO: PAYPAL NAME: STEVEN CHAPLINSKIEntry Class Code: WEB,4.96
3/28/2022,,Withdrawal ACH PAYPAL/TYPE: INST XFER ID: PAYPALSI77CO: PAYPAL NAME: STEVEN CHAPLINSKIEntry Class Code: WEB,2.99,,Posted,298.1,2022-03-28,2.99,Withdrawal ACH PAYPAL/TYPE: INST XFER ID: PAYPALSI77CO: PAYPAL NAME: STEVEN CHAPLINSKIEntry Class Code: WEB,3.218
3/27/2022,,Recurring Withdrawal Debit Card MC Debit/HELP.HBOMAX.COM NEW YORK NYDate 03/27/22 0 2086013781 1 5815Card 2801,17.23,,Posted,281.1,2022-03-27,17.23,Recurring Withdrawal Debit Card MC Debit/HELP.HBOMAX.COM NEW YORK NYDate 04/27/22 0 2117023223 1 5815Card 2801,17.23
3/25/2022,,Withdrawal at ATM #000000000601/Gainesville Inn 1250 W UniversityGainesville FLCard 2801,108.5,,Posted,298.33,2022-03-25,108.5,Withdrawal at ATM #000000000601/Gainesville Inn 1250 W UniversityGainesville FLCard 2801,108.5
3/25/2022,,Withdrawal POS #000000143143/GATE 1445 506 NW 13TH GAINESVILLE FLCard 2801,15.22,,Posted,406.83,2022-03-25,15.22,Withdrawal POS #000000183316/GATE 1445 506 NW 13TH GAINESVILLE FLCard 2801,15.22
3/25/2022,,Withdrawal Debit Card MC Debit/KINDLE UNLTD*1N4IN7U80 866-321-8851 WADate 03/24/22 0 2083036398 1 5818Card 2801,9.99,,Posted,222.05,2022-03-25,9.99,Withdrawal Debit Card MC Debit/KINDLE UNLTD*1N4IN7U80 866-321-8851 WADate 03/24/22 0 2083036398 1 5818Card 2801,9.99
3/25/2022,,Withdrawal ACH PAYPAL INC./CO: PAYPAL INC.TYPE: IAT PAYPAL ID: 770510487CEntry Class Code: IAT,5.0,,Posted,232.04,2022-03-25,5.0,Withdrawal ACH PAYPAL INC./CO: PAYPAL INC.TYPE: IAT PAYPAL ID: 770510487CEntry Class Code: IAT,5.0
3/25/2022,,Withdrawal ACH PAYPAL/TYPE: INST XFER ID: PAYPALSI77CO: PAYPAL NAME: STEVEN CHAPLINSKIEntry Class Code: WEB,49.0,,Posted,237.04,2022-03-25,49.0,Withdrawal ACH PAYPAL/TYPE: INST XFER ID: PAYPALSI77CO: PAYPAL NAME: STEVEN CHAPLINSKIEntry Class Code: WEB,49.663333333333334
3/24/2022,,Withdrawal POS #000000193528/AMAZON.COM*169EL7T31 SEATTLE WACard 2801,10.87,,Posted,286.04,2022-03-24,10.87,Withdrawal POS #000000173052/AMAZON.COM*H21U27Y71 SEATTLE WACard 2801,10.536666666666667
3/22/2022,,Withdrawal Debit Card MC Debit/PUBLIX #1376 GAINESVILLE FLDate 03/21/22 0 2080977324 0 5411Card 2801,18.17,,Posted,296.91,2022-03-22,18.17,Withdrawal Debit Card MC Debit/PUBLIX #795 GAINESVILLE FLDate 03/07/22 0 2066965570 0 5411Card 2801,18.17
3/22/2022,,Withdrawal ACH PAYPAL/TYPE: INST XFER ID: PAYPALSI77CO: PAYPAL NAME: STEVEN CHAPLINSKIEntry Class Code: WEB,19.99,,Posted,315.08,2022-03-22,19.99,Withdrawal ACH PAYPAL/TYPE: INST XFER ID: PAYPALSI77CO: PAYPAL NAME: STEVEN CHAPLINSKIEntry Class Code: WEB,19.98
3/21/2022,,Withdrawal POS #000000000107/CIRCLE K # 01313 4221 GAINESVILLE FLCard 2801,37.27,,Posted,335.07,2022-03-21,37.27,Withdrawal POS #000000011248/CIRCLE K # 23913 3424 GAINESVILLE FLCard 2801,37.27
3/21/2022,,Withdrawal ACH PAYPAL/TYPE: INST XFER ID: PAYPALSI77CO: PAYPAL NAME: STEVEN CHAPLINSKIEntry Class Code: WEB,70.03,,Posted,372.34,2022-03-21,70.03,Withdrawal ACH PAYPAL/TYPE: INST XFER ID: PAYPALSI77CO: PAYPAL NAME: STEVEN CHAPLINSKIEntry Class Code: WEB,70.03
3/21/2022,,Withdrawal ACH PAYPAL/TYPE: INST XFER ID: PAYPALSI77CO: PAYPAL NAME: STEVEN CHAPLINSKIEntry Class Code: WEB,11.99,,Posted,442.37,2022-03-21,11.99,Withdrawal ACH PAYPAL/TYPE: INST XFER ID: PAYPALSI77CO: PAYPAL NAME: STEVEN CHAPLINSKIEntry Class Code: WEB,11.7425
3/20/2022,,Withdrawal Debit Card MC Debit/PUBLIX #1312 GAINESVILLE FLDate 03/19/22 0 2078423092 1 5411Card 2801,91.88,,Posted,454.36,2022-03-20,91.88,Withdrawal Debit Card MC Debit/PUBLIX #1312 GAINESVILLE FLDate 03/11/21 0 1070536058 1 5411Card 2801,91.88
3/19/2022,,Withdrawal POS #000000773167/SUNOCO 8002212501 4234 SW 20TH AVEGAINESVILLE FLCard 2801,19.54,,Posted,546.24,2022-03-19,19.54,Withdrawal POS #000000177815/SUNOCO 8002212501 4234 SW 20TH AVEGAINESVILLE FLCard 2801,19.54
3/18/2022,,Withdrawal ACH PAYPAL/TYPE: INST XFER ID: PAYPALSI77CO: PAYPAL NAME: STEVEN CHAPLINSKIEntry Class Code: WEB,18.24,,Posted,565.78,2022-03-18,18.24,Withdrawal ACH PAYPAL/TYPE: INST XFER ID: PAYPALSI77CO: PAYPAL NAME: STEVEN CHAPLINSKIEntry Class Code: WEB,18.244999999999997
3/17/2022,,Withdrawal ACH PAYPAL/TYPE: INST XFER ID: PAYPALSI77CO: PAYPAL NAME: STEVEN CHAPLINSKIEntry Class Code: WEB,19.99,,Posted,584.02,2022-03-17,19.99,Withdrawal ACH PAYPAL/TYPE: INST XFER ID: PAYPALSI77CO: PAYPAL NAME: STEVEN CHAPLINSKIEntry Class Code: WEB,19.98
3/16/2022,,Withdrawal Debit Card MC Debit/PUBLIX #435 GAINESVILLE FLDate 03/15/22 0 2074063906 1 5411Card 2801,58.14,,Posted,604.01,2022-03-16,58.14,Withdrawal Debit Card MC Debit/PUBLIX #1312 GAINESVILLE FLDate 03/11/21 0 1070536058 1 5411Card 2801,58.14
3/15/2022,,Withdrawal POS #000000576488/SUNOCO 8002212501 4234 SW 20TH AVEGAINESVILLE FLCard 2801,19.54,,Posted,662.15,2022-03-15,19.54,Withdrawal POS #000000689838/SUNOCO 8002212501 4234 SW 20TH AVEGAINESVILLE FLCard 2801,19.54
3/15/2022,,Withdrawal ACH PAYPAL INC./CO: PAYPAL INC.TYPE: IAT PAYPAL ID: 770510487CEntry Class Code: IAT,8.9,,Posted,681.69,2022-03-15,8.9,Withdrawal ACH PAYPAL INC./CO: PAYPAL INC.TYPE: IAT PAYPAL ID: 770510487CEntry Class Code: IAT,8.9
3/15/2022,,Withdrawal POS #000000186025/AMAZON.COM*1N8QH9FJ1 SEATTLE WACard 2801,10.87,,Posted,690.59,2022-03-15,10.87,Withdrawal POS #000000991850/AMAZON.COM*7Q29B9KF3 SEATTLE WACard 2801,10.51
3/14/2022,,Withdrawal POS #000000000003/AMAZON.COM*1Z8447YO1 SEATTLE WACard 2801,22.88,,Posted,701.46,2022-03-14,22.88,Withdrawal POS #000000000007/AMAZON.COM*2864R4HI1 SEATTLE WACard 1140,22.88
3/14/2022,,Withdrawal Debit Card MC Debit/PUBLIX #1312 GAINESVILLE FLDate 03/13/22 0 2072901006 0 5411Card 2801,64.48,,Posted,724.34,2022-03-14,64.48,Withdrawal Debit Card MC Debit/PUBLIX #795 GAINESVILLE FLDate 03/07/22 0 2066965570 0 5411Card 2801,64.48
3/14/2022,,Withdrawal ACH PAYPAL/TYPE: INST XFER ID: PAYPALSI77CO: PAYPAL NAME: STEVEN CHAPLINSKIEntry Class Code: WEB,9.99,,Posted,788.82,2022-03-14,9.99,Withdrawal ACH PAYPAL/TYPE: INST XFER ID: PAYPALSI77CO: PAYPAL NAME: STEVEN CHAPLINSKIEntry Class Code: WEB,10.093333333333334
3/13/2022,,Withdrawal ATM Fee/ASAI 3400 B SW 34th St. Gainesville FLCard 2801,2.0,,Posted,798.81,2022-03-13,2.0,Withdrawal ATM Fee/ASAI 3400 B SW 34th St. Gainesville FLCard 2801,2.0
3/13/2022,,Withdrawal at ATM #000000000151/ASAI 3400 B SW 34th St. Gainesville FLCard 2801,97.75,,Posted,800.81,2022-03-13,97.75,Withdrawal at ATM #000000000323/ASAI 3400 B SW 34th St. Gainesville FLCard 2801,97.75
3/13/2022,,Withdrawal POS #000000519839/FAST TRACK #200 3960 SW ARCHER RDGAINESVILLE FLCard 2801,21.67,,Posted,398.56,2022-03-13,21.67,Withdrawal POS #000000194488/FAST TRACK #200 3960 SW ARCHER RDGAINESVILLE FLCard 1140,22.2575
3/13/2022,,Recurring Withdrawal Debit Card MC Debit/PAYPAL *LINKTREEPTY 4029357733 CADate 03/11/22 0 2070556529 1 5734Card 2801,6.0,,Posted,420.23,2022-03-13,6.0,Recurring Withdrawal Debit Card MC Debit/PAYPAL *LINKTREE 4029357733 AUDate 05/12/21 0 1132191600 1 7372Card 2801,6.0
3/10/2022,,Withdrawal Debit Card MC Debit/PRIME VIDEO*1Z06F6ZI0 888-802-3080 WADate 03/10/22 0 2069976770 0 5818Card 2801,4.53,,Posted,426.23,2022-03-10,4.53,Withdrawal Debit Card MC Debit/PRIME VIDEO*1Z06F6ZI0 888-802-3080 WADate 03/10/22 0 2069976770 0 5818Card 2801,4.53
3/10/2022,,Withdrawal ACH PAYPAL INC./CO: PAYPAL INC.TYPE: IAT PAYPAL ID: 770510487CEntry Class Code: IAT,20.0,,Posted,430.76,2022-03-10,20.0,Withdrawal ACH PAYPAL INC./CO: PAYPAL INC.TYPE: IAT PAYPAL ID: 770510487CEntry Class Code: IAT,20.5
3/10/2022,,Withdrawal ACH PAYPAL/TYPE: INST XFER ID: PAYPALSI77CO: PAYPAL NAME: STEVEN CHAPLINSKIEntry Class Code: WEB,15.0,,Posted,450.76,2022-03-10,15.0,Withdrawal ACH PAYPAL/TYPE: INST XFER ID: PAYPALSI77CO: PAYPAL NAME: STEVEN CHAPLINSKIEntry Class Code: WEB,14.948333333333332
3/10/2022,,Withdrawal ACH PAYPAL/TYPE: INST XFER ID: PAYPALSI77CO: PAYPAL NAME: STEVEN CHAPLINSKIEntry Class Code: WEB,10.0,,Posted,465.76,2022-03-10,10.0,Withdrawal ACH PAYPAL/TYPE: INST XFER ID: PAYPALSI77CO: PAYPAL NAME: STEVEN CHAPLINSKIEntry Class Code: WEB,10.093333333333334
3/9/2022,,Withdrawal Debit Card MC Debit/SUNOCO 8002212501 QPS GAINESVILLE FLDate 03/08/22 0 2067990525 0 5541Card 2801,23.82,,Posted,475.76,2022-03-09,23.82,Withdrawal Debit Card MC Debit/SUNOCO 8002212501 QPS GAINESVILLE FLDate 03/08/22 0 2067990525 0 5541Card 2801,23.82
3/8/2022,,Withdrawal POS #000006282715/PAYPAL *VIDIQ San Jose CACard 2801,10.0,,Posted,499.58,2022-03-08,10.0,Withdrawal POS #000007247911/PAYPAL *VIDIQ San Jose CACard 2801,10.0
3/8/2022,,Withdrawal Debit Card MC Debit/CANNAMD 855-4209170 FLDate 03/07/22 0 2066971853 0 8011Card 2801,195.0,,Posted,509.58,2022-03-08,195.0,Withdrawal Debit Card MC Debit/CANNAMD 855-4209170 FLDate 04/07/23 0 3097109858 2 8011Card 2801,195.0
3/8/2022,,Withdrawal Debit Card MC Debit/PUBLIX #795 GAINESVILLE FLDate 03/07/22 0 2066965570 0 5411Card 2801,49.26,,Posted,704.58,2022-03-08,49.26,Withdrawal Debit Card MC Debit/PUBLIX #795 GAINESVILLE FLDate 03/07/22 0 2066965570 0 5411Card 2801,49.26
3/8/2022,,Withdrawal Debit Card MC Debit/WALGREENS #5024 800-289-2273 FLDate 03/07/22 0 2066962196 0 5912Card 2801,19.83,,Posted,753.84,2022-03-08,19.83,Withdrawal Debit Card MC Debit/WALGREENS #5024 800-289-2273 FLDate 05/21/22 0 2141999930 0 5912Card 2801,19.83
3/8/2022,,Withdrawal POS #000045519887/NNT URGENTVET - GAI002555 2680 CLARKBUTLER GAINESVILLE FLCard 2801,560.61,,Posted,773.67,2022-03-08,560.61,Withdrawal POS #000045519887/NNT URGENTVET - GAI002555 2680 CLARKBUTLER GAINESVILLE FLCard 2801,560.61
3/7/2022,,Withdrawal Debit Card MC Debit/OCALA SNACK VENDING GAINESVILLE FLDate 03/06/22 0 2065060173 1 5814Card 2801,2.1,,Posted,1058.49,2022-03-07,2.1,Withdrawal Debit Card MC Debit/OCALA SNACK VENDING GAINESVILLE FLDate 03/06/22 0 2065060173 1 5814Card 2801,2.1
3/7/2022,,Withdrawal ACH PAYPAL/TYPE: INST XFER ID: PAYPALSI77CO: PAYPAL NAME: STEVEN CHAPLINSKIEntry Class Code: WEB,59.99,,Posted,1060.59,2022-03-07,59.99,Withdrawal ACH PAYPAL/TYPE: INST XFER ID: PAYPALSI77CO: PAYPAL NAME: STEVEN CHAPLINSKIEntry Class Code: WEB,59.495000000000005
3/7/2022,,Withdrawal ACH PAYPAL/TYPE: INST XFER ID: PAYPALSI77CO: PAYPAL NAME: STEVEN CHAPLINSKIEntry Class Code: WEB,14.95,,Posted,1120.58,2022-03-07,14.95,Withdrawal ACH PAYPAL/TYPE: INST XFER ID: PAYPALSI77CO: PAYPAL NAME: STEVEN CHAPLINSKIEntry Class Code: WEB,14.948333333333332
3/7/2022,,Withdrawal ACH PAYPAL/TYPE: INST XFER ID: PAYPALSI77CO: PAYPAL NAME: STEVEN CHAPLINSKIEntry Class Code: WEB,12.0,,Posted,1135.53,2022-03-07,12.0,Withdrawal ACH PAYPAL/TYPE: INST XFER ID: PAYPALSI77CO: PAYPAL NAME: STEVEN CHAPLINSKIEntry Class Code: WEB,11.7425
3/7/2022,,Withdrawal ACH PAYPAL/TYPE: INST XFER ID: PAYPALSI77CO: PAYPAL NAME: STEVEN CHAPLINSKIEntry Class Code: WEB,1.99,,Posted,1147.53,2022-03-07,1.99,Withdrawal ACH PAYPAL/TYPE: INST XFER ID: PAYPALSI77CO: PAYPAL NAME: STEVEN CHAPLINSKIEntry Class Code: WEB,2.3299999999999996
3/7/2022,,Withdrawal ACH PAYPAL/TYPE: INST XFER ID: PAYPALSI77CO: PAYPAL NAME: STEVEN CHAPLINSKIEntry Class Code: WEB,1.99,,Posted,1149.52,2022-03-07,1.99,Withdrawal ACH PAYPAL/TYPE: INST XFER ID: PAYPALSI77CO: PAYPAL NAME: STEVEN CHAPLINSKIEntry Class Code: WEB,2.3299999999999996
3/6/2022,,Recurring Withdrawal Bill Payment - #000006911729/NETFLIX COM LOS GATOS CACard 2801,10.98,,Posted,201.51,2022-03-06,10.98,Recurring Withdrawal Bill Payment - #000006911729/NETFLIX COM LOS GATOS CACard 2801,10.99
3/4/2022,,Withdrawal Debit Card MC Debit/COX GAINESVILLE COMM 800-234-3993 FLDate 03/03/22 0 2062854829 0 4899Card 2801,95.39,,Posted,212.49,2022-03-04,95.39,Withdrawal Debit Card MC Debit/COX GAINESVILLE COMM 800-234-3993 FLDate 01/27/22 0 2027240681 1 4899Card 2801,95.39
3/4/2022,,Withdrawal ACH CAPITAL ONE/TYPE: MOBILE PMT ID: 9279744980CO: CAPITAL ONE NAME: STEVEN CHAPLINSKIEntry Class Code: WEB,55.0,,Posted,307.88,2022-03-04,55.0,Withdrawal ACH CAPITAL ONE/TYPE: ONLINE PMT ID: 9279744391CO: CAPITAL ONE NAME: STEVEN CHAPLINSKIEntry Class Code: WEB,55.0
3/4/2022,,Withdrawal ACH BARCLAYCARD US/TYPE: CREDITCARD ID: 2510407970CO: BARCLAYCARD USNAME: STEVEN CHAPLINSKIEntry Class Code: WEB,50.0,,Posted,362.88,2022-03-04,50.0,Withdrawal ACH BARCLAYCARD US/TYPE: CREDITCARD ID: 2510407970CO: BARCLAYCARD USNAME: STEVEN CHAPLINSKIEntry Class Code: WEB,50.0
3/4/2022,,Withdrawal POS #000000000216/CIRCLE K # 26146 3525 GAINESVILLE FLCard 2801,17.27,,Posted,412.88,2022-03-04,17.27,Withdrawal POS #000000000558/CIRCLE K # 26146 3525 GAINESVILLE FLCard 2801,17.02
3/4/2022,,Withdrawal ATM Transaction,125.0,,Posted,430.15,2022-03-04,125.0,Withdrawal ATM Transaction,125.0
3/4/2022,,Withdrawal ACH PAYPAL/TYPE: INST XFER ID: PAYPALSI77CO: PAYPAL NAME: STEVEN CHAPLINSKIEntry Class Code: WEB,79.0,,Posted,555.15,2022-03-04,79.0,Withdrawal ACH PAYPAL/TYPE: INST XFER ID: PAYPALSI77CO: PAYPAL NAME: STEVEN CHAPLINSKIEntry Class Code: WEB,79.495
3/4/2022,,Withdrawal ACH TARGET CARD SRVC/TYPE: BILL PAY ID: T510215170CO: TARGET CARD SRVCNAME: 7S CH0000000APLINSKI TEntry Class Code: WEB,75.0,,Posted,634.15,2022-03-04,75.0,Withdrawal ACH TARGET CARD SRVC/TYPE: BILL PAY ID: 5411721813CO: TARGET CARD SRVCNAME: S CHAPLINSKI TEntry Class Code: WEB,75.0
3/4/2022,,Withdrawal ACH WAWA CREDIT CARD/TYPE: PAYMENT ID: CITIGPUFDRCO: WAWA CREDIT CARDEntry Class Code: PPD,63.0,,Posted,709.15,2022-03-04,63.0,Withdrawal ACH WAWA CREDIT CARD/TYPE: PAYMENT ID: CITIGPUFDRCO: WAWA CREDIT CARDEntry Class Code: PPD,63.0
3/4/2022,,Withdrawal ACH DISCOVER/TYPE: E-PAYMENT ID: 2510020270CO: DISCOVER NAME: CHAPLINSKI STEVENEntry Class Code: WEB,60.0,,Posted,772.15,2022-03-04,60.0,Withdrawal ACH DISCOVER/TYPE: E-PAYMENT ID: 2510020270CO: DISCOVER NAME: CHAPLINSKI STEVENEntry Class Code: WEB,60.0
3/4/2022,,Withdrawal ACH PAYPAL/TYPE: INST XFER ID: PAYPALSI77CO: PAYPAL NAME: STEVEN CHAPLINSKIEntry Class Code: WEB,14.99,,Posted,832.15,2022-03-04,14.99,Withdrawal ACH PAYPAL/TYPE: INST XFER ID: PAYPALSI77CO: PAYPAL NAME: STEVEN CHAPLINSKIEntry Class Code: WEB,14.948333333333332
3/4/2022,,Withdrawal ACH PAYPAL/TYPE: INST XFER ID: PAYPALSI77CO: PAYPAL NAME: STEVEN CHAPLINSKIEntry Class Code: WEB,14.95,,Posted,847.14,2022-03-04,14.95,Withdrawal ACH PAYPAL/TYPE: INST XFER ID: PAYPALSI77CO: PAYPAL NAME: STEVEN CHAPLINSKIEntry Class Code: WEB,14.948333333333332
3/4/2022,,Withdrawal ACH PAYPAL/TYPE: INST XFER ID: PAYPALSI77CO: PAYPAL NAME: STEVEN CHAPLINSKIEntry Class Code: WEB,2.99,,Posted,862.09,2022-03-04,2.99,Withdrawal ACH PAYPAL/TYPE: INST XFER ID: PAYPALSI77CO: PAYPAL NAME: STEVEN CHAPLINSKIEntry Class Code: WEB,3.218
3/3/2022,,Withdrawal Debit Card MC Debit/WALGREENS #5024 800-289-2273 FLDate 03/02/22 0 2061067429 1 5912Card 2801,15.0,,Posted,865.08,2022-03-03,15.0,Withdrawal Debit Card MC Debit/WALGREENS #5024 800-289-2273 FLDate 09/08/21 0 1251607416 1 5912Card 2801,15.24
3/3/2022,,Withdrawal ACH PAYMENT FOR AMZ/TYPE: STORECARD ID: 9069872103CO: PAYMENT FOR AMZNAME: 6045781157416487Entry Class Code: WEB,197.0,,Posted,880.08,2022-03-03,197.0,Withdrawal ACH PAYMENT FOR AMZ/TYPE: STORECARD ID: 9069872103CO: PAYMENT FOR AMZNAME: 6045781157416487Entry Class Code: WEB,197.0
3/2/2022,,Withdrawal POS #000018259061/WALGREENS 2415 SW 75TH GAINESVILLE FLCard 2801,12.29,,Posted,1077.08,2022-03-02,12.29,Withdrawal POS #000012002801/WALGREENS 3455 SW ARCH GAINESVILLE FLCard 2801,12.29
3/2/2022,,Withdrawal ACH BEST BUY/TYPE: PAYMENT ID: CITIGPUFDRCO: BEST BUYEntry Class Code: PPD,200.0,,Posted,1089.37,2022-03-02,200.0,Withdrawal ACH BEST BUY/TYPE: PAYMENT ID: CITIGPUFDRCO: BEST BUYEntry Class Code: TEL,200.0
3/2/2022,,Withdrawal ACH APPLECARD GSBANK/TYPE: PAYMENT ID: 9999999999CO: APPLECARD GSBANKNAME: Steven ChaplinskiEntry Class Code: WEB,150.0,,Posted,1289.37,2022-03-02,150.0,Withdrawal ACH APPLECARD GSBANK/TYPE: PAYMENT ID: 9999999999CO: APPLECARD GSBANKNAME: Steven ChaplinskiEntry Class Code: WEB,150.0
3/2/2022,,Withdrawal ACH BARCLAYCARD US/TYPE: CREDITCARD ID: 2510407970CO: BARCLAYCARD USNAME: STEVEN CHAPLINSKIEntry Class Code: WEB,77.79,,Posted,1439.37,2022-03-02,77.79,Withdrawal ACH BARCLAYCARD US/TYPE: CREDITCARD ID: 2510407970CO: BARCLAYCARD USNAME: STEVEN CHAPLINSKIEntry Class Code: WEB,77.79
3/2/2022,,Withdrawal ACH CAPITAL ONE/TYPE: MOBILE PMT ID: 9279744980CO: CAPITAL ONE NAME: STEVEN CHAPLINSKIEntry Class Code: WEB,25.0,,Posted,1517.16,2022-03-02,25.0,Withdrawal ACH CAPITAL ONE/TYPE: ONLINE PMT ID: 9279744391CO: CAPITAL ONE NAME: STEVEN CHAPLINSKIEntry Class Code: WEB,25.5
3/2/2022,,Withdrawal ACH Watson Realty Co/TYPE: WEB PMTS ID: 9000321157CO: Watson Realty CoNAME: Steven chaplinskiEntry Class Code: WEB,885.0,,Posted,1542.16,2022-03-02,885.0,Withdrawal ACH Watson Realty Co/TYPE: WEB PMTS ID: 9000321157CO: Watson Realty CoEntry Class Code: WEB,885.0
3/2/2022,,Withdrawal ACH BEST BUY/TYPE: PAYMENT ID: CITIGPUFDRCO: BEST BUYEntry Class Code: PPD,132.3,,Posted,2427.16,2022-03-02,132.3,Withdrawal ACH BEST BUY/TYPE: PAYMENT ID: CITIGPUFDRCO: BEST BUYEntry Class Code: TEL,132.3
3/2/2022,,Withdrawal ACH PAYPAL/TYPE: INST XFER ID: PAYPALSI77CO: PAYPAL NAME: STEVEN CHAPLINSKIEntry Class Code: WEB,59.0,,Posted,2559.46,2022-03-02,59.0,Withdrawal ACH PAYPAL/TYPE: INST XFER ID: PAYPALSI77CO: PAYPAL NAME: STEVEN CHAPLINSKIEntry Class Code: WEB,59.495000000000005
3/2/2022,,Withdrawal ACH DISCOVER/TYPE: E-PAYMENT ID: 2510020270CO: DISCOVER NAME: CHAPLINSKI STEVENEntry Class Code: WEB,35.0,,Posted,2618.46,2022-03-02,35.0,Withdrawal ACH DISCOVER/TYPE: E-PAYMENT ID: 2510020270CO: DISCOVER NAME: CHAPLINSKI STEVENEntry Class Code: WEB,34.8
3/1/2022,,Withdrawal POS #000000000550/CIRCLE K # 06782 5237 GAINESVILLE FLCard 2801,20.0,,Posted,2653.46,2022-03-01,20.0,Withdrawal POS #000000000343/CIRCLE K # 06782 5237 GAINESVILLE FLCard 1247,20.2
3/1/2022,,Withdrawal POS #000013115732/WALGREENS 2415 SW 75TH GAINESVILLE FLCard 2801,40.63,,Posted,2673.46,2022-03-01,40.63,Withdrawal POS #000015057686/WALGREENS 2415 SW 75TH GAINESVILLE FLCard 1231,40.63
3/1/2022,,Withdrawal ACH PAYPAL/TYPE: INST XFER ID: PAYPALSI77CO: PAYPAL NAME: STEVEN CHAPLINSKIEntry Class Code: WEB,49.0,,Posted,2714.09,2022-03-01,49.0,Withdrawal ACH PAYPAL/TYPE: INST XFER ID: PAYPALSI77CO: PAYPAL NAME: STEVEN CHAPLINSKIEntry Class Code: WEB,49.663333333333334
3/1/2022,,Withdrawal ACH PAYPAL/TYPE: INST XFER ID: PAYPALSI77CO: PAYPAL NAME: STEVEN CHAPLINSKIEntry Class Code: WEB,11.48,,Posted,2763.09,2022-03-01,11.48,Withdrawal ACH PAYPAL/TYPE: INST XFER ID: PAYPALSI77CO: PAYPAL NAME: STEVEN CHAPLINSKIEntry Class Code: WEB,11.7425
3/1/2022,,Withdrawal ACH PAYPAL/TYPE: INST XFER ID: PAYPALSI77CO: PAYPAL NAME: STEVEN CHAPLINSKIEntry Class Code: WEB,2.99,,Posted,2774.57,2022-03-01,2.99,Withdrawal ACH PAYPAL/TYPE: INST XFER ID: PAYPALSI77CO: PAYPAL NAME: STEVEN CHAPLINSKIEntry Class Code: WEB,3.218
2/28/2022,,Withdrawal Debit Card MC Debit/WALGREENS #5024 800-289-2273 FLDate 02/27/22 0 2058964465 0 5912Card 2801,18.32,,Posted,2777.56,2022-02-28,18.32,Withdrawal Debit Card MC Debit/WALGREENS #5024 800-289-2273 FLDate 12/19/22 0 2353181854 1 5912Card 2801,18.32
2/28/2022,,Withdrawal ACH CANVA PTY LIMITE/CO: CANVA PTY LIMITEDTYPE: IAT PAYPAL ID: 770510487CEntry Class Code: IAT,12.99,,Posted,2795.88,2022-02-28,12.99,Withdrawal ACH CANVA PTY LIMITE/CO: CANVA PTY LIMITEDTYPE: IAT PAYPAL ID: 770510487CEntry Class Code: IAT,12.99
2/28/2022,,Withdrawal ACH PAYPAL/TYPE: INST XFER ID: PAYPALSI77CO: PAYPAL NAME: STEVEN CHAPLINSKIEntry Class Code: WEB,13.13,,Posted,2808.87,2022-02-28,13.13,Withdrawal ACH PAYPAL/TYPE: INST XFER ID: PAYPALSI77CO: PAYPAL NAME: STEVEN CHAPLINSKIEntry Class Code: WEB,12.88
2/28/2022,,Withdrawal ACH PAYPAL/TYPE: INST XFER ID: PAYPALSI77CO: PAYPAL NAME: STEVEN CHAPLINSKIEntry Class Code: WEB,8.89,,Posted,2822.0,2022-02-28,8.89,Withdrawal ACH PAYPAL/TYPE: INST XFER ID: PAYPALSI77CO: PAYPAL NAME: STEVEN CHAPLINSKIEntry Class Code: WEB,9.015
2/28/2022,,Withdrawal ACH PAYPAL/TYPE: INST XFER ID: PAYPALSI77CO: PAYPAL NAME: STEVEN CHAPLINSKIEntry Class Code: WEB,4.5,,Posted,2830.89,2022-02-28,4.5,Withdrawal ACH PAYPAL/TYPE: INST XFER ID: PAYPALSI77CO: PAYPAL NAME: STEVEN CHAPLINSKIEntry Class Code: WEB,4.96
2/28/2022,,Withdrawal ACH PAYPAL/TYPE: INST XFER ID: PAYPALSI77CO: PAYPAL NAME: STEVEN CHAPLINSKIEntry Class Code: WEB,2.99,,Posted,2835.39,2022-02-28,2.99,Withdrawal ACH PAYPAL/TYPE: INST XFER ID: PAYPALSI77CO: PAYPAL NAME: STEVEN CHAPLINSKIEntry Class Code: WEB,3.218
2/27/2022,,Withdrawal POS #000000238565/SUNOCO 8002212501 4234 SW 20TH AVEGAINESVILLE FLCard 2801,23.82,,Posted,2838.38,2022-02-27,23.82,Withdrawal POS #000000265255/SUNOCO 8002212501 4234 SW 20TH AVEGAINESVILLE FLCard 2801,23.82
2/27/2022,,Recurring Withdrawal Debit Card MC Debit/HELP.HBOMAX.COM NEW YORK NYDate 02/27/22 0 2058092418 1 5815Card 2801,17.23,,Posted,2862.2,2022-02-27,17.23,Recurring Withdrawal Debit Card MC Debit/HELP.HBOMAX.COM NEW YORK NYDate 04/27/22 0 2117023223 1 5815Card 2801,17.23
2/27/2022,,Withdrawal Debit Card MC Debit/GRU/EZ-PAY WEB PYMT 352-334-3434 FLDate 02/25/22 0 2056621461 0 4900Card 2801,220.97,,Posted,2879.43,2022-02-27,220.97,Withdrawal Debit Card MC Debit/GRU/EZ-PAY WEB PYMT 352-334-3434 FLDate 11/01/21 0 1305577800 0 4900Card 2801,220.97
2/25/2022,,Withdrawal Debit Card MC Debit/KINDLE UNLTD*1B3UF0UI2 866-321-8851 WADate 02/24/22 0 2055055205 1 5818Card 2801,9.99,,Posted,3100.4,2022-02-25,9.99,Withdrawal Debit Card MC Debit/KINDLE UNLTD*1N4IN7U80 866-321-8851 WADate 03/24/22 0 2083036398 1 5818Card 2801,9.99
2/24/2022,,Withdrawal POS #000000000004/AMAZON.COM*1I2DX3EV0 SEATTLE WACard 2801,10.87,,Posted,3110.39,2022-02-24,10.87,Withdrawal POS #000000000873/AMAZON.COM*HI8SN2DS2 SEATTLE WACard 2801,10.406666666666666
2/23/2022,,Withdrawal POS #000000732083/PUBLIX 3930 SW ARCHER ROA GAINESVILLE FLCard 2801,35.49,,Posted,1121.26,2022-02-23,35.49,Withdrawal POS #000000029500/PUBLIX 3930 SW ARCHER ROA GAINESVILLE FLCard 2801,35.49
2/23/2022,,Withdrawal Debit Card MC Debit/PRIME VIDEO*QI3ZR57V3 888-802-3080 WADate 02/22/22 0 2053875656 0 5818Card 2801,9.99,,Posted,1156.75,2022-02-23,9.99,Withdrawal Debit Card MC Debit/PRIME VIDEO*QI3ZR57V3 888-802-3080 WADate 02/22/22 0 2053875656 0 5818Card 2801,9.99
2/23/2022,,Withdrawal Debit Card MC Debit/PRIME VIDEO*DF3LU6DP3 888-802-3080 WADate 02/22/22 0 2053875651 0 5818Card 2801,9.99,,Posted,1166.74,2022-02-23,9.99,Withdrawal Debit Card MC Debit/PRIME VIDEO*QI3ZR57V3 888-802-3080 WADate 02/22/22 0 2053875656 0 5818Card 2801,9.99
2/22/2022,,Withdrawal ACH PAYPAL/TYPE: INST XFER ID: PAYPALSI77CO: PAYPAL NAME: STEVEN CHAPLINSKIEntry Class Code: WEB,39.98,,Posted,1176.73,2022-02-22,39.98,Withdrawal ACH PAYPAL/TYPE: INST XFER ID: PAYPALSI77CO: PAYPAL NAME: STEVEN CHAPLINSKIEntry Class Code: WEB,39.985
2/22/2022,,Withdrawal ACH PAYPAL/TYPE: INST XFER ID: PAYPALSI77CO: PAYPAL NAME: STEVEN CHAPLINSKIEntry Class Code: WEB,11.99,,Posted,1216.71,2022-02-22,11.99,Withdrawal ACH PAYPAL/TYPE: INST XFER ID: PAYPALSI77CO: PAYPAL NAME: STEVEN CHAPLINSKIEntry Class Code: WEB,11.7425
2/21/2022,,Withdrawal POS #000000129608/FAST TRACK #200 3960 SW ARCHER RDGAINESVILLE FLCard 2801,21.67,,Posted,1228.7,2022-02-21,21.67,Withdrawal POS #000000194488/FAST TRACK #200 3960 SW ARCHER RDGAINESVILLE FLCard 1140,22.2575
2/21/2022,,Withdrawal POS #000000089340/PUBLIX 3930 SW ARCHER ROA GAINESVILLE FLCard 2801,54.95,,Posted,1250.37,2022-02-21,54.95,Withdrawal POS #000000029500/PUBLIX 3930 SW ARCHER ROA GAINESVILLE FLCard 2801,54.95
2/20/2022,,Withdrawal Debit Card MC Debit/PRIME VIDEO*1I03U0LH1 888-802-3080 WADate 02/19/22 0 2050297887 0 5818Card 2801,9.99,,Posted,1305.32,2022-02-20,9.99,Withdrawal Debit Card MC Debit/PRIME VIDEO*QI3ZR57V3 888-802-3080 WADate 02/22/22 0 2053875656 0 5818Card 2801,9.99
2/20/2022,,Withdrawal Debit Card MC Debit/PRIME VIDEO*4V7RJ4QL3 888-802-3080 WADate 02/18/22 0 2049172668 2 5818Card 2801,7.99,,Posted,1315.31,2022-02-20,7.99,Withdrawal Debit Card MC Debit/PRIME VIDEO*QI3ZR57V3 888-802-3080 WADate 02/22/22 0 2053875656 0 5818Card 2801,7.99
2/17/2022,,Withdrawal POS #000000000029/CIRCLE K # 26146 3525 GAINESVILLE FLCard 2801,30.07,,Posted,1323.3,2022-02-17,30.07,Withdrawal POS #000000003339/CIRCLE K # 26146 3525 GAINESVILLE FLCard 2801,30.35
2/17/2022,,Withdrawal ATM Fee/ASAI 3400 B SW 34th St. Gainesville FLCard 2801,2.0,,Posted,1353.37,2022-02-17,2.0,Withdrawal ATM Fee/ASAI 3400 B SW 34th St. Gainesville FLCard 2801,2.0
2/17/2022,,Withdrawal at ATM #000000000624/ASAI 3400 B SW 34th St. Gainesville FLCard 2801,72.75,,Posted,1355.37,2022-02-17,72.75,Withdrawal at ATM #000000000323/ASAI 3400 B SW 34th St. Gainesville FLCard 2801,72.75
2/17/2022,,Withdrawal ACH TARGET CARD SRVC/TYPE: BILL PAY ID: T510215170CO: TARGET CARD SRVCNAME: 7S CH0000000APLINSKI TEntry Class Code: WEB,100.0,,Posted,1428.12,2022-02-17,100.0,Withdrawal ACH TARGET CARD SRVC/TYPE: BILL PAY ID: 5411721813CO: TARGET CARD SRVCNAME: S CHAPLINSKI TEntry Class Code: WEB,100.0
2/16/2022,,Withdrawal POS #000000730199/PUBLIX 3930 SW ARCHER ROA GAINESVILLE FLCard 2801,32.28,,Posted,1528.12,2022-02-16,32.28,Withdrawal POS #000000029500/PUBLIX 3930 SW ARCHER ROA GAINESVILLE FLCard 2801,32.18
2/14/2022,,Withdrawal ACH PAYPAL/TYPE: INST XFER ID: PAYPALSI77CO: PAYPAL NAME: STEVEN CHAPLINSKIEntry Class Code: WEB,9.99,,Posted,1560.4,2022-02-14,9.99,Withdrawal ACH PAYPAL/TYPE: INST XFER ID: PAYPALSI77CO: PAYPAL NAME: STEVEN CHAPLINSKIEntry Class Code: WEB,10.093333333333334
2/13/2022,,Recurring Withdrawal Debit Card MC Debit/PAYPAL *LINKTREEPTY 4029357733 CADate 02/11/22 0 2042196699 1 5734Card 2801,6.0,,Posted,1570.39,2022-02-13,6.0,Recurring Withdrawal Debit Card MC Debit/PAYPAL *LINKTREE 4029357733 AUDate 05/12/21 0 1132191600 1 7372Card 2801,6.0
2/11/2022,,Withdrawal Debit Card MC Debit/YVETTE GODET DMD GAINESVILLE FLDate 02/09/22 0 2040046562 1 8021Card 2801,309.8,,Posted,1576.39,2022-02-11,309.8,Withdrawal Debit Card MC Debit/YVETTE GODET DMD GAINESVILLE FLDate 04/11/22 0 2101019240 1 8021Card 2801,309.8
2/10/2022,,Withdrawal POS #000000000000/AMAZON.COM*OY9RM3IQ3 SEATTLE WACard 2801,10.69,,Posted,1886.19,2022-02-10,10.69,Withdrawal POS #000000000000/AMAZON.COM*V40RU1143 SEATTLE WACard 2801,10.44
2/10/2022,,Withdrawal POS #000000000015/AMAZON.COM*QT8AR01Y3 SEATTLE WACard 2801,10.87,,Posted,1896.88,2022-02-10,10.87,Withdrawal POS #000000000023/AMAZON.COM*AU8ER6ZT3 SEATTLE WACard 2801,10.4725
2/10/2022,,Withdrawal POS #000000338900/AMAZON.COM*AD9WT2H83 SEATTLE WACard 2801,42.9,,Posted,1907.75,2022-02-10,42.9,Withdrawal POS #000000630901/AMAZON.COM*ZA2053S23 SEATTLE WACard 2801,42.9
2/10/2022,,Withdrawal POS #000000342204/AMAZON.COM*PJ37R3343 SEATTLE WACard 2801,6.41,,Posted,1950.65,2022-02-10,6.41,Withdrawal POS #000000922564/AMAZON.COM*VJ71T1BJ3 SEATTLE WACard 2801,6.41
2/10/2022,,Withdrawal POS #000000319757/AMAZON.COM*7M3MV8SV3 SEATTLE WACard 2801,42.9,,Posted,1914.16,2022-02-10,42.9,Withdrawal POS #000000853317/AMAZON.COM*HM8GC4P91 SEATTLE WACard 2801,42.9
2/9/2022,,Withdrawal POS #000000543099/SUNOCO 8002212501 4234 SW 20TH AVEGAINESVILLE FLCard 2801,23.82,,Posted,1597.06,2022-02-09,23.82,Withdrawal POS #000000550998/SUNOCO 8002212501 4234 SW 20TH AVEGAINESVILLE FLCard 2801,23.82
2/8/2022,,Withdrawal POS #000000021622/PUBLIX 3100 SW 35TH BLVD GAINESVILLE FLCard 2801,3.44,,Posted,557.21,2022-02-08,3.44,Withdrawal POS #000000058955/PUBLIX 3100 SW 35TH BLVD GAINESVILLE FLCard 2801,3.44
2/8/2022,,Withdrawal POS #000000024721/PUBLIX 3930 SW ARCHER ROA GAINESVILLE FLCard 2801,39.62,,Posted,560.65,2022-02-08,39.62,Withdrawal POS #000000029500/PUBLIX 3930 SW ARCHER ROA GAINESVILLE FLCard 2801,39.589999999999996
2/8/2022,,Withdrawal POS #000000000122/CIRCLE K # 26146 3525 GAINESVILLE FLCard 2801,22.43,,Posted,600.27,2022-02-08,22.43,Withdrawal POS #000000011248/CIRCLE K # 23913 3424 GAINESVILLE FLCard 2801,22.43
2/8/2022,,Withdrawal ACH PAYPAL/TYPE: INST XFER ID: PAYPALSI77CO: PAYPAL NAME: STEVEN CHAPLINSKIEntry Class Code: WEB,162.93,,Posted,622.7,2022-02-08,162.93,Withdrawal ACH PAYPAL/TYPE: INST XFER ID: PAYPALSI77CO: PAYPAL NAME: STEVEN CHAPLINSKIEntry Class Code: WEB,162.93
2/8/2022,,Withdrawal ACH PAYPAL/TYPE: INST XFER ID: PAYPALSI77CO: PAYPAL NAME: STEVEN CHAPLINSKIEntry Class Code: WEB,3.05,,Posted,785.63,2022-02-08,3.05,Withdrawal ACH PAYPAL/TYPE: INST XFER ID: PAYPALSI77CO: PAYPAL NAME: STEVEN CHAPLINSKIEntry Class Code: WEB,3.218
2/8/2022,,Withdrawal Bill Payment #000005023648/PAYPAL *VIDIQ San Jose CACard 2801,10.0,,Posted,788.68,2022-02-08,10.0,Withdrawal Bill Payment #000005023648/PAYPAL *VIDIQ San Jose CACard 2801,10.0
2/7/2022,,Withdrawal Debit Card MC Debit/WALGREENS #5024 800-289-2273 FLDate 02/06/22 0 2037175384 1 5912Card 2801,12.59,,Posted,788.39,2022-02-07,12.59,Withdrawal Debit Card MC Debit/WALGREENS #5024 800-289-2273 FLDate 08/26/22 0 2238277635 2 5912Card 2801,12.780000000000001
2/7/2022,,Recurring Withdrawal Debit Card MC Debit/NETFLIX.COM CADate 02/07/22 0 2038364942 1 4899Card 2801,10.98,,Posted,800.98,2022-02-07,10.98,Recurring Withdrawal Debit Card MC Debit/NETFLIX.COM CADate 10/06/22 0 2279815139 0 4899Card 2801,10.98
2/7/2022,,Withdrawal ACH PAYPAL/TYPE: INST XFER ID: PAYPALSI77CO: PAYPAL NAME: STEVEN CHAPLINSKIEntry Class Code: WEB,67.8,,Posted,811.96,2022-02-07,67.8,Withdrawal ACH PAYPAL/TYPE: INST XFER ID: PAYPALSI77CO: PAYPAL NAME: STEVEN CHAPLINSKIEntry Class Code: WEB,67.8
2/7/2022,,Withdrawal ACH PAYPAL/TYPE: INST XFER ID: PAYPALSI77CO: PAYPAL NAME: STEVEN CHAPLINSKIEntry Class Code: WEB,49.99,,Posted,879.76,2022-02-07,49.99,Withdrawal ACH PAYPAL/TYPE: INST XFER ID: PAYPALSI77CO: PAYPAL NAME: STEVEN CHAPLINSKIEntry Class Code: WEB,49.663333333333334
2/7/2022,,Withdrawal ACH PAYPAL/TYPE: INST XFER ID: PAYPALSI77CO: PAYPAL NAME: STEVEN CHAPLINSKIEntry Class Code: WEB,46.0,,Posted,929.75,2022-02-07,46.0,Withdrawal ACH PAYPAL/TYPE: INST XFER ID: PAYPALSI77CO: PAYPAL NAME: STEVEN CHAPLINSKIEntry Class Code: WEB,46.0
2/7/2022,,Withdrawal ACH PAYPAL/TYPE: INST XFER ID: PAYPALSI77CO: PAYPAL NAME: STEVEN CHAPLINSKIEntry Class Code: WEB,14.95,,Posted,975.75,2022-02-07,14.95,Withdrawal ACH PAYPAL/TYPE: INST XFER ID: PAYPALSI77CO: PAYPAL NAME: STEVEN CHAPLINSKIEntry Class Code: WEB,14.948333333333332
2/7/2022,,Withdrawal ACH PAYPAL/TYPE: INST XFER ID: PAYPALSI77CO: PAYPAL NAME: STEVEN CHAPLINSKIEntry Class Code: WEB,14.95,,Posted,990.7,2022-02-07,14.95,Withdrawal ACH PAYPAL/TYPE: INST XFER ID: PAYPALSI77CO: PAYPAL NAME: STEVEN CHAPLINSKIEntry Class Code: WEB,14.948333333333332
2/7/2022,,Withdrawal ACH PAYPAL/TYPE: INST XFER ID: PAYPALSI77CO: PAYPAL NAME: STEVEN CHAPLINSKIEntry Class Code: WEB,9.0,,Posted,1005.65,2022-02-07,9.0,Withdrawal ACH PAYPAL/TYPE: INST XFER ID: PAYPALSI77CO: PAYPAL NAME: STEVEN CHAPLINSKIEntry Class Code: WEB,9.015
2/6/2022,,Withdrawal POS #000011504557/WALGREENS 2415 SW 75TH GAINESVILLE FLCard 2801,26.8,,Posted,1014.65,2022-02-06,26.8,Withdrawal POS #000015057686/WALGREENS 2415 SW 75TH GAINESVILLE FLCard 1231,26.8
2/4/2022,,Withdrawal Debit Card MC Debit/PUBLIX #1312 GAINESVILLE FLDate 02/03/22 0 2034252762 1 5411Card 2801,88.58,,Posted,876.96,2022-02-04,88.58,Withdrawal Debit Card MC Debit/PUBLIX #435 GAINESVILLE FLDate 08/31/22 0 2243083753 1 5411Card 2801,88.58
2/4/2022,,Withdrawal ACH BARCLAYCARD US/TYPE: CREDITCARD ID: 2510407970CO: BARCLAYCARD USNAME: STEVEN CHAPLINSKIEntry Class Code: WEB,287.06,,Posted,965.54,2022-02-04,287.06,Withdrawal ACH BARCLAYCARD US/TYPE: CREDITCARD ID: 2510407970CO: BARCLAYCARD USNAME: STEVEN CHAPLINSKIEntry Class Code: WEB,287.06
2/4/2022,,Withdrawal ACH TARGET CARD SRVC/TYPE: BILL PAY ID: T510215170CO: TARGET CARD SRVCNAME: 7S CH0000000APLINSKI TEntry Class Code: WEB,75.0,,Posted,1252.6,2022-02-04,75.0,Withdrawal ACH TARGET CARD SRVC/TYPE: BILL PAY ID: 5411721813CO: TARGET CARD SRVCNAME: S CHAPLINSKI TEntry Class Code: WEB,75.0
2/4/2022,,Withdrawal ACH PAYPAL/TYPE: INST XFER ID: PAYPALSI77CO: PAYPAL NAME: STEVEN CHAPLINSKIEntry Class Code: WEB,2.99,,Posted,1327.6,2022-02-04,2.99,Withdrawal ACH PAYPAL/TYPE: INST XFER ID: PAYPALSI77CO: PAYPAL NAME: STEVEN CHAPLINSKIEntry Class Code: WEB,3.218
2/3/2022,,Withdrawal POS #000000274617/FAST TRACK #200 3960 SW ARCHER RDGAINESVILLE FLCard 2801,21.67,,Posted,1330.59,2022-02-03,21.67,Withdrawal POS #000000418393/FAST TRACK #200 3960 SW ARCHER RDGAINESVILLE FLCard 2801,21.67
2/2/2022,,Withdrawal Debit Card MC Debit/WALGREENS #5024 800-289-2273 FLDate 02/01/22 0 2032451065 1 5912Card 2801,19.28,,Posted,1276.26,2022-02-02,19.28,Withdrawal Debit Card MC Debit/WALGREENS #5024 800-289-2273 FLDate 09/08/21 0 1251607416 1 5912Card 2801,19.28
2/2/2022,,Withdrawal ACH PAYPAL/TYPE: INST XFER ID: PAYPALSI77CO: PAYPAL NAME: STEVEN CHAPLINSKIEntry Class Code: WEB,10.29,,Posted,1295.54,2022-02-02,10.29,Withdrawal ACH PAYPAL/TYPE: INST XFER ID: PAYPALSI77CO: PAYPAL NAME: STEVEN CHAPLINSKIEntry Class Code: WEB,10.093333333333334
2/2/2022,,Withdrawal POS #000000281965/SUNOCO 8002212501 4234 SW 20TH AVEGAINESVILLE FLCard 2801,23.82,,Posted,1210.66,2022-02-02,23.82,Withdrawal POS #000000899960/SUNOCO 8002212501 4234 SW 20TH AVEGAINESVILLE FLCard 2801,23.82
2/1/2022,,Withdrawal ACH APPLECARD GSBANK/TYPE: PAYMENT ID: 9999999999CO: APPLECARD GSBANKNAME: Steven ChaplinskiEntry Class Code: WEB,150.0,,Posted,1234.48,2022-02-01,150.0,Withdrawal ACH APPLECARD GSBANK/TYPE: PAYMENT ID: 9999999999CO: APPLECARD GSBANKNAME: Steven ChaplinskiEntry Class Code: WEB,150.0
2/1/2022,,Withdrawal ACH CAPITAL ONE/TYPE: MOBILE PMT ID: 9279744980CO: CAPITAL ONE NAME: STEVEN CHAPLINSKIEntry Class Code: WEB,100.0,,Posted,1384.48,2022-02-01,100.0,Withdrawal ACH CAPITAL ONE/TYPE: ONLINE PMT ID: 9279744391CO: CAPITAL ONE NAME: STEVEN CHAPLINSKIEntry Class Code: WEB,100.0
2/1/2022,,Withdrawal ACH Watson Realty Co/TYPE: WEB PMTS ID: 9000321157CO: Watson Realty CoNAME: Steven chaplinskiEntry Class Code: WEB,885.0,,Posted,1484.48,2022-02-01,885.0,Withdrawal ACH Watson Realty Co/TYPE: WEB PMTS ID: 9000321157CO: Watson Realty CoEntry Class Code: WEB,885.0
2/1/2022,,Withdrawal ACH PAYPAL/TYPE: INST XFER ID: PAYPALSI77CO: PAYPAL NAME: STEVEN CHAPLINSKIEntry Class Code: WEB,126.59,,Posted,2369.48,2022-02-01,126.59,Withdrawal ACH PAYPAL/TYPE: INST XFER ID: PAYPALSI77CO: PAYPAL NAME: STEVEN CHAPLINSKIEntry Class Code: WEB,126.59
2/1/2022,,Withdrawal ACH DISCOVER/TYPE: E-PAYMENT ID: 2510020270CO: DISCOVER NAME: CHAPLINSKI STEVENEntry Class Code: WEB,100.0,,Posted,2496.07,2022-02-01,100.0,Withdrawal ACH DISCOVER/TYPE: E-PAYMENT ID: 2510020270CO: DISCOVER NAME: CHAPLINSKI STEVENEntry Class Code: WEB,100.5
2/1/2022,,Withdrawal ACH PAYPAL/TYPE: INST XFER ID: PAYPALSI77CO: PAYPAL NAME: STEVEN CHAPLINSKIEntry Class Code: WEB,95.17,,Posted,2596.07,2022-02-01,95.17,Withdrawal ACH PAYPAL/TYPE: INST XFER ID: PAYPALSI77CO: PAYPAL NAME: STEVEN CHAPLINSKIEntry Class Code: WEB,95.17
2/1/2022,,Withdrawal ACH PAYPAL/TYPE: INST XFER ID: PAYPALSI77CO: PAYPAL NAME: STEVEN CHAPLINSKIEntry Class Code: WEB,60.97,,Posted,2691.24,2022-02-01,60.97,Withdrawal ACH PAYPAL/TYPE: INST XFER ID: PAYPALSI77CO: PAYPAL NAME: STEVEN CHAPLINSKIEntry Class Code: WEB,60.97
2/1/2022,,Withdrawal ACH PAYPAL/TYPE: INST XFER ID: PAYPALSI77CO: PAYPAL NAME: STEVEN CHAPLINSKIEntry Class Code: WEB,24.99,,Posted,2752.21,2022-02-01,24.99,Withdrawal ACH PAYPAL/TYPE: INST XFER ID: PAYPALSI77CO: PAYPAL NAME: STEVEN CHAPLINSKIEntry Class Code: WEB,24.97
2/1/2022,,Withdrawal ACH PAYPAL/TYPE: INST XFER ID: PAYPALSI77CO: PAYPAL NAME: STEVEN CHAPLINSKIEntry Class Code: WEB,9.99,,Posted,2777.2,2022-02-01,9.99,Withdrawal ACH PAYPAL/TYPE: INST XFER ID: PAYPALSI77CO: PAYPAL NAME: STEVEN CHAPLINSKIEntry Class Code: WEB,10.093333333333334
2/1/2022,,Withdrawal ACH PAYPAL/TYPE: INST XFER ID: PAYPALSI77CO: PAYPAL NAME: STEVEN CHAPLINSKIEntry Class Code: WEB,3.99,,Posted,2787.19,2022-02-01,3.99,Withdrawal ACH PAYPAL/TYPE: INST XFER ID: PAYPALSI77CO: PAYPAL NAME: STEVEN CHAPLINSKIEntry Class Code: WEB,3.218
1/31/2022,,Withdrawal ACH TARGET CARD SRVC/TYPE: BILL PAY ID: 5411721813CO: TARGET CARD SRVCNAME: S CHAPLINSKI TEntry Class Code: WEB,200.0,,Posted,2791.18,2022-01-31,200.0,Withdrawal ACH TARGET CARD SRVC/TYPE: BILL PAY ID: 5411721813CO: TARGET CARD SRVCNAME: S CHAPLINSKI TEntry Class Code: WEB,200.0
1/31/2022,,Withdrawal ACH PAYPAL/TYPE: INST XFER ID: PAYPALSI77CO: PAYPAL NAME: STEVEN CHAPLINSKIEntry Class Code: WEB,129.67,,Posted,2991.18,2022-01-31,129.67,Withdrawal ACH PAYPAL/TYPE: INST XFER ID: PAYPALSI77CO: PAYPAL NAME: STEVEN CHAPLINSKIEntry Class Code: WEB,129.67
1/31/2022,,Withdrawal ACH PAYPAL/TYPE: INST XFER ID: PAYPALSI77CO: PAYPAL NAME: STEVEN CHAPLINSKIEntry Class Code: WEB,59.0,,Posted,3120.85,2022-01-31,59.0,Withdrawal ACH PAYPAL/TYPE: INST XFER ID: PAYPALSI77CO: PAYPAL NAME: STEVEN CHAPLINSKIEntry Class Code: WEB,59.495000000000005
1/31/2022,,Withdrawal ACH PAYPAL/TYPE: INST XFER ID: PAYPALSI77CO: PAYPAL NAME: STEVEN CHAPLINSKIEntry Class Code: WEB,49.0,,Posted,3179.85,2022-01-31,49.0,Withdrawal ACH PAYPAL/TYPE: INST XFER ID: PAYPALSI77CO: PAYPAL NAME: STEVEN CHAPLINSKIEntry Class Code: WEB,49.663333333333334
1/31/2022,,Withdrawal ACH PAYPAL/TYPE: INST XFER ID: PAYPALSI77CO: PAYPAL NAME: STEVEN CHAPLINSKIEntry Class Code: WEB,20.0,,Posted,3228.85,2022-01-31,20.0,Withdrawal ACH PAYPAL/TYPE: INST XFER ID: PAYPALSI77CO: PAYPAL NAME: STEVEN CHAPLINSKIEntry Class Code: WEB,19.98
1/31/2022,,Withdrawal ACH PAYPAL/TYPE: INST XFER ID: PAYPALSI77CO: PAYPAL NAME: STEVEN CHAPLINSKIEntry Class Code: WEB,11.48,,Posted,3248.85,2022-01-31,11.48,Withdrawal ACH PAYPAL/TYPE: INST XFER ID: PAYPALSI77CO: PAYPAL NAME: STEVEN CHAPLINSKIEntry Class Code: WEB,11.7425
1/31/2022,,Withdrawal ACH PAYPAL/TYPE: INST XFER ID: PAYPALSI77CO: PAYPAL NAME: STEVEN CHAPLINSKIEntry Class Code: WEB,2.99,,Posted,3260.33,2022-01-31,2.99,Withdrawal ACH PAYPAL/TYPE: INST XFER ID: PAYPALSI77CO: PAYPAL NAME: STEVEN CHAPLINSKIEntry Class Code: WEB,3.218
1/30/2022,,Withdrawal POS #000000171647/FAST TRACK #200 3960 SW ARCHER RDGAINESVILLE FLCard 2801,23.69,,Posted,3263.32,2022-01-30,23.69,Withdrawal POS #000000194488/FAST TRACK #200 3960 SW ARCHER RDGAINESVILLE FLCard 1140,23.51
1/30/2022,,Withdrawal POS #000000044398/PUBLIX 3930 SW ARCHER ROA GAINESVILLE FLCard 2801,57.47,,Posted,3287.01,2022-01-30,57.47,Withdrawal POS #000000029500/PUBLIX 3930 SW ARCHER ROA GAINESVILLE FLCard 2801,57.239999999999995
1/30/2022,,Withdrawal ATM Fee/ASAI 3400 B SW 34th St. Gainesville FLCard 2801,2.0,,Posted,3344.48,2022-01-30,2.0,Withdrawal ATM Fee/ASAI 3400 B SW 34th St. Gainesville FLCard 2801,2.0
1/30/2022,,Withdrawal at ATM #000000001785/ASAI 3400 B SW 34th St. Gainesville FLCard 2801,92.75,,Posted,3346.48,2022-01-30,92.75,Withdrawal at ATM #000000000323/ASAI 3400 B SW 34th St. Gainesville FLCard 2801,92.75
1/28/2022,,Withdrawal Debit Card MC Debit/WALGREENS #5024 800-289-2273 FLDate 01/27/22 0 2027311351 1 5912Card 2801,12.97,,Posted,3439.23,2022-01-28,12.97,Withdrawal Debit Card MC Debit/WALGREENS #5024 800-289-2273 FLDate 08/26/22 0 2238277635 2 5912Card 2801,12.780000000000001
1/28/2022,,Withdrawal Debit Card MC Debit/GRU/EZ-PAY WEB PYMT 352-334-3434 FLDate 01/27/22 0 2027417961 0 4900Card 2801,219.24,,Posted,3452.2,2022-01-28,219.24,Withdrawal Debit Card MC Debit/GRU/EZ-PAY WEB PYMT 352-334-3434 FLDate 11/01/21 0 1305577800 0 4900Card 2801,219.075
1/28/2022,,Withdrawal ACH CJS SALES   SERV/CO: CJS SALES SERVICES LIMITEDTYPE: IAT PAYPAL ID: 770510487CEntry Class Code: IAT,14.07,,Posted,1671.44,2022-01-28,14.07,Withdrawal ACH CJS SALES   SERV/CO: CJS SALES SERVICES LIMITEDTYPE: IAT PAYPAL ID: 770510487CEntry Class Code: IAT,14.07
1/28/2022,,Withdrawal ACH PAYMENT FOR AMZ/TYPE: STORECARD ID: 9069872103CO: PAYMENT FOR AMZNAME: 6045781157416487Entry Class Code: WEB,199.0,,Posted,1685.51,2022-01-28,199.0,Withdrawal ACH PAYMENT FOR AMZ/TYPE: STORECARD ID: 9069872103CO: PAYMENT FOR AMZNAME: 6045781157416487Entry Class Code: WEB,199.0
1/28/2022,,Withdrawal ACH PAYPAL/TYPE: INST XFER ID: PAYPALSI77CO: PAYPAL NAME: STEVEN CHAPLINSKIEntry Class Code: WEB,37.86,,Posted,1884.51,2022-01-28,37.86,Withdrawal ACH PAYPAL/TYPE: INST XFER ID: PAYPALSI77CO: PAYPAL NAME: STEVEN CHAPLINSKIEntry Class Code: WEB,37.86
1/28/2022,,Withdrawal ACH PAYPAL/TYPE: INST XFER ID: PAYPALSI77CO: PAYPAL NAME: STEVEN CHAPLINSKIEntry Class Code: WEB,0.9,,Posted,1922.37,2022-01-28,0.9,Withdrawal ACH PAYPAL/TYPE: INST XFER ID: PAYPALSI77CO: PAYPAL NAME: STEVEN CHAPLINSKIEntry Class Code: WEB,1.11
1/27/2022,,Withdrawal POS #000000127575/GATE 1445 506 NW 13TH GAINESVILLE FLCard 2801,23.3,,Posted,1923.27,2022-01-27,23.3,Withdrawal POS #000000183316/GATE 1445 506 NW 13TH GAINESVILLE FLCard 2801,22.908
1/27/2022,,Withdrawal ATM Transaction,300.0,,Posted,1946.57,2022-01-27,300.0,Withdrawal ATM Transaction,300.0
1/27/2022,,Withdrawal Debit Card MC Debit/PUBLIX #1312 GAINESVILLE FLDate 01/26/22 0 2026245945 1 5411Card 2801,46.48,,Posted,2246.57,2022-01-27,46.48,Withdrawal Debit Card MC Debit/PUBLIX #1312 GAINESVILLE FLDate 05/28/21 0 1148028662 2 5411Card 2801,46.48
1/27/2022,,Recurring Withdrawal Debit Card MC Debit/HELP.HBOMAX.COM NEW YORK NYDate 01/27/22 0 2027245862 1 5815Card 2801,17.23,,Posted,2293.05,2022-01-27,17.23,Recurring Withdrawal Debit Card MC Debit/HELP.HBOMAX.COM NEW YORK NYDate 04/27/22 0 2117023223 1 5815Card 2801,17.23
1/27/2022,,Withdrawal Debit Card MC Debit/COX GAINESVILLE COMM 800-234-3993 FLDate 01/27/22 0 2027240681 1 4899Card 2801,95.39,,Posted,2310.28,2022-01-27,95.39,Withdrawal Debit Card MC Debit/COX GAINESVILLE COMM 800-234-3993 FLDate 01/27/22 0 2027240681 1 4899Card 2801,95.39
1/26/2022,,Withdrawal POS #000000969614/FAST TRACK #200 3960 SW ARCHER RDGAINESVILLE FLCard 2801,21.67,,Posted,905.67,2022-01-26,21.67,Withdrawal POS #000000194488/FAST TRACK #200 3960 SW ARCHER RDGAINESVILLE FLCard 1140,22.2575
1/26/2022,,Withdrawal POS #000000034916/PUBLIX 3100 SW 35TH BLVD GAINESVILLE FLCard 2801,31.84,,Posted,927.34,2022-01-26,31.84,Withdrawal POS #000000036956/PUBLIX 5801 SW 75TH ST GAINESVILLE FLCard 2801,31.744999999999997
1/26/2022,,Withdrawal POS #000000734001/AMAZON.COM*GY8WZ4UH3 SEATTLE WACard 2801,10.87,,Posted,959.18,2022-01-26,10.87,Withdrawal POS #000000736780/AMAZON.COM*U78AZ3Q63 SEATTLE WACard 2801,10.51
1/26/2022,,Withdrawal ACH PAYMENT FOR AMZ/TYPE: STORECARD ID: 9069872103CO: PAYMENT FOR AMZNAME: 6045781157416487Entry Class Code: WEB,55.0,,Posted,970.05,2022-01-26,55.0,Withdrawal ACH PAYMENT FOR AMZ/TYPE: STORECARD ID: 9069872103CO: PAYMENT FOR AMZNAME: 6045781157416487Entry Class Code: WEB,55.0
1/25/2022,,Withdrawal Debit Card MC Debit/KINDLE UNLTD*RI6NG8OB3 866-321-8851 WADate 01/24/22 0 2024161795 1 5818Card 2801,9.99,,Posted,175.05,2022-01-25,9.99,Withdrawal Debit Card MC Debit/KINDLE UNLTD*1N4IN7U80 866-321-8851 WADate 03/24/22 0 2083036398 1 5818Card 2801,9.99
1/25/2022,,Withdrawal ACH BEST BUY/TYPE: PAYMENT ID: CITIGPUFDRCO: BEST BUYEntry Class Code: PPD,65.0,,Posted,185.04,2022-01-25,65.0,Withdrawal ACH BEST BUY/TYPE: PAYMENT ID: CITIGPUFDRCO: BEST BUYEntry Class Code: TEL,65.0
1/25/2022,,Withdrawal ACH BARCLAYCARD US/TYPE: CREDITCARD ID: 2510407970CO: BARCLAYCARD USNAME: STEVEN CHAPLINSKIEntry Class Code: WEB,55.0,,Posted,250.04,2022-01-25,55.0,Withdrawal ACH BARCLAYCARD US/TYPE: CREDITCARD ID: 2510407970CO: BARCLAYCARD USNAME: STEVEN CHAPLINSKIEntry Class Code: WEB,55.0
1/25/2022,,Withdrawal ACH CAPITAL ONE/TYPE: MOBILE PMT ID: 9279744980CO: CAPITAL ONE NAME: STEVEN CHAPLINSKIEntry Class Code: WEB,50.0,,Posted,305.04,2022-01-25,50.0,Withdrawal ACH CAPITAL ONE/TYPE: ONLINE PMT ID: 9279744391CO: CAPITAL ONE NAME: STEVEN CHAPLINSKIEntry Class Code: WEB,50.0
1/25/2022,,Withdrawal ACH DISCOVER/TYPE: E-PAYMENT ID: 2510020270CO: DISCOVER NAME: CHAPLINSKI STEVENEntry Class Code: WEB,85.0,,Posted,355.04,2022-01-25,85.0,Withdrawal ACH DISCOVER/TYPE: E-PAYMENT ID: 2510020270CO: DISCOVER NAME: CHAPLINSKI STEVENEntry Class Code: WEB,85.0
1/25/2022,,Withdrawal ACH BEST BUY/TYPE: PAYMENT ID: CITIGPUFDRCO: BEST BUYEntry Class Code: PPD,55.0,,Posted,440.04,2022-01-25,55.0,Withdrawal ACH BEST BUY/TYPE: PAYMENT ID: CITIGPUFDRCO: BEST BUYEntry Class Code: TEL,54.5
1/25/2022,,Withdrawal ACH WAWA CREDIT CARD/TYPE: ONLINE PMT ID: CITICTPCO: WAWA CREDIT CARDNAME: STEVEN CHAPLINSKIEntry Class Code: WEB,29.0,,Posted,495.04,2022-01-25,29.0,Withdrawal ACH WAWA CREDIT CARD/TYPE: ONLINE PMT ID: CITICTPCO: WAWA CREDIT CARDNAME: STEVEN CHAPLINSKIEntry Class Code: WEB,29.0
1/24/2022,,Withdrawal POS #000000916698/FAST TRACK #200 3960 SW ARCHER RDGAINESVILLE FLCard 2801,21.67,,Posted,524.04,2022-01-24,21.67,Withdrawal POS #000000194488/FAST TRACK #200 3960 SW ARCHER RDGAINESVILLE FLCard 1140,22.2575
1/24/2022,,Withdrawal POS #000000024099/PUBLIX 3930 SW ARCHER ROA GAINESVILLE FLCard 2801,47.43,,Posted,545.71,2022-01-24,47.43,Withdrawal POS #000000029500/PUBLIX 3930 SW ARCHER ROA GAINESVILLE FLCard 2801,47.43
1/24/2022,,Withdrawal ATM Transaction,100.0,,Posted,593.14,2022-01-24,100.0,Withdrawal ATM Transaction,100.0
1/23/2022,,Withdrawal POS #000000899960/SUNOCO 8002212501 4234 SW 20TH AVEGAINESVILLE FLCard 2801,19.54,,Posted,28.14,2022-01-23,19.54,Withdrawal POS #000000899960/SUNOCO 8002212501 4234 SW 20TH AVEGAINESVILLE FLCard 2801,19.54
1/23/2022,,Withdrawal POS #000000734069/PUBLIX 3930 SW ARCHER ROA GAINESVILLE FLCard 2801,39.45,,Posted,47.68,2022-01-23,39.45,Withdrawal POS #000000029500/PUBLIX 3930 SW ARCHER ROA GAINESVILLE FLCard 2801,39.589999999999996
1/21/2022,,Withdrawal ACH PAYPAL/TYPE: INST XFER ID: PAYPALSI77CO: PAYPAL NAME: STEVEN CHAPLINSKIEntry Class Code: WEB,6.99,,Posted,87.13,2022-01-21,6.99,Withdrawal ACH PAYPAL/TYPE: INST XFER ID: PAYPALSI77CO: PAYPAL NAME: STEVEN CHAPLINSKIEntry Class Code: WEB,6.87
1/18/2022,,Withdrawal ACH PAYPAL/TYPE: INST XFER ID: PAYPALSI77CO: PAYPAL NAME: STEVEN CHAPLINSKIEntry Class Code: WEB,22.88,,Posted,94.12,2022-01-18,22.88,Withdrawal ACH PAYPAL/TYPE: INST XFER ID: PAYPALSI77CO: PAYPAL NAME: STEVEN CHAPLINSKIEntry Class Code: WEB,22.88
1/18/2022,,Withdrawal ACH PAYPAL/TYPE: INST XFER ID: PAYPALSI77CO: PAYPAL NAME: STEVEN CHAPLINSKIEntry Class Code: WEB,17.11,,Posted,117.0,2022-01-18,17.11,Withdrawal ACH PAYPAL/TYPE: INST XFER ID: PAYPALSI77CO: PAYPAL NAME: STEVEN CHAPLINSKIEntry Class Code: WEB,17.3975
1/17/2022,,Withdrawal POS #000000049615/PUBLIX 3100 SW 35TH BLVD GAINESVILLE FLCard 2801,26.73,,Posted,134.11,2022-01-17,26.73,Withdrawal POS #000000036956/PUBLIX 5801 SW 75TH ST GAINESVILLE FLCard 2801,26.73
1/14/2022,,Withdrawal ACH PAYPAL/TYPE: INST XFER ID: PAYPALSI77CO: PAYPAL NAME: STEVEN CHAPLINSKIEntry Class Code: WEB,2.01,,Posted,160.84,2022-01-14,2.01,Withdrawal ACH PAYPAL/TYPE: INST XFER ID: PAYPALSI77CO: PAYPAL NAME: STEVEN CHAPLINSKIEntry Class Code: WEB,2.3299999999999996
1/13/2022,,Withdrawal POS #000000123825/GATE 1445 506 NW 1 GAINESVILLE FLCard 2801,9.24,,Posted,162.85,2022-01-13,9.24,Withdrawal POS #000000183316/GATE 1445 506 NW 13TH GAINESVILLE FLCard 2801,9.0
1/13/2022,,Withdrawal ATM Transaction,80.0,,Posted,172.09,2022-01-13,80.0,Withdrawal ATM Transaction,80.0
1/12/2022,,Withdrawal POS #000000050790/PUBLIX 3930 SW ARCHER ROA GAINESVILLE FLCard 2801,29.01,,Posted,252.09,2022-01-12,29.01,Withdrawal POS #000000029500/PUBLIX 3930 SW ARCHER ROA GAINESVILLE FLCard 2801,29.01
1/12/2022,,Recurring Withdrawal Debit Card Fee/MASTERCARD ISSUER CROSS-BORDER FEEDate 01/11/22 0 2011933313 0 5817Card 2801,0.05,,Posted,81.1,2022-01-12,0.05,Recurring Withdrawal Debit Card Fee/MASTERCARD ISSUER CROSS-BORDER FEEDate 12/11/21 0 1345316936 1 5817Card 2801,0.08666666666666667
1/12/2022,,Recurring Withdrawal Debit Card MC Debit/PAYPAL *LINKTREE 4029357733 AUDate 01/11/22 0 2011933313 0 5817Card 2801,6.0,,Posted,81.15,2022-01-12,6.0,Recurring Withdrawal Debit Card MC Debit/PAYPAL *LINKTREE 4029357733 AUDate 05/12/21 0 1132191600 1 7372Card 2801,6.0
1/12/2022,,Withdrawal ACH GAMIVO.COM LIMIT/CO: GAMIVO.COM LIMITEDTYPE: IAT PAYPAL ID: 770510487CEntry Class Code: IAT,10.89,,Posted,87.15,2022-01-12,10.89,Withdrawal ACH GAMIVO.COM LIMIT/CO: GAMIVO.COM LIMITEDTYPE: IAT PAYPAL ID: 770510487CEntry Class Code: IAT,10.89
1/12/2022,,Withdrawal ACH PAYPAL/TYPE: INST XFER ID: PAYPALSI77CO: PAYPAL NAME: STEVEN CHAPLINSKIEntry Class Code: WEB,9.99,,Posted,98.04,2022-01-12,9.99,Withdrawal ACH PAYPAL/TYPE: INST XFER ID: PAYPALSI77CO: PAYPAL NAME: STEVEN CHAPLINSKIEntry Class Code: WEB,10.093333333333334
1/12/2022,,Withdrawal POS #000000737145/AMAZON.COM*UD0KC6Q23 SEATTLE WACard 2801,10.15,,Posted,108.03,2022-01-12,10.15,Withdrawal POS #000000247445/AMAZON.COM*A42ZY7OC3 SEATTLE WACard 2801,10.475
1/11/2022,,Withdrawal Debit Card MC Debit/GRU/EZ-PAY WEB PYMT 352-334-3434 FLDate 01/10/22 0 2010416794 0 4900Card 2801,187.36,,Posted,118.18,2022-01-11,187.36,Withdrawal Debit Card MC Debit/GRU/EZ-PAY WEB PYMT 352-334-3434 FLDate 11/01/21 0 1305577800 0 4900Card 2801,187.36
1/8/2022,,Withdrawal POS #000000188596/WAWA 5325 2373 SW ARCHER ROA GAINESVILLEFLCard 2801,18.34,,Posted,294.54,2022-01-08,18.34,Withdrawal POS #000000188596/WAWA 5325 2373 SW ARCHER ROA GAINESVILLEFLCard 2801,18.32
1/8/2022,,Withdrawal ATM Fee/ASAI 3400 B SW 34th St. Gainesville FLCard 2801,2.0,,Posted,312.88,2022-01-08,2.0,Withdrawal ATM Fee/ASAI 3400 B SW 34th St. Gainesville FLCard 2801,2.0
1/8/2022,,Withdrawal at ATM #000000000088/ASAI 3400 B SW 34th St. Gainesville FLCard 2801,37.75,,Posted,314.88,2022-01-08,37.75,Withdrawal at ATM #000000000323/ASAI 3400 B SW 34th St. Gainesville FLCard 2801,37.75
1/8/2022,,Withdrawal ATM Fee/ASAI 3400 B SW 34th St. Gainesville FLCard 2801,2.0,,Posted,352.63,2022-01-08,2.0,Withdrawal ATM Fee/ASAI 3400 B SW 34th St. Gainesville FLCard 2801,2.0
1/8/2022,,Withdrawal at ATM #000000000087/ASAI 3400 B SW 34th St. Gainesville FLCard 2801,87.75,,Posted,354.63,2022-01-08,87.75,Withdrawal at ATM #000000000323/ASAI 3400 B SW 34th St. Gainesville FLCard 2801,87.75
1/8/2022,,Withdrawal ATM Transaction,80.0,,Posted,277.38,2022-01-08,80.0,Withdrawal ATM Transaction,80.0
1/8/2022,,Recurring Withdrawal Bill Payment - #000045891971/PAYPAL *VIDIQ 2211 North First S SanCACard 2801,10.0,,Posted,357.38,2022-01-08,10.0,Recurring Withdrawal Bill Payment - #000045891971/PAYPAL *VIDIQ 2211 North First S SanCACard 2801,10.25
1/7/2022,,Withdrawal ACH Watson Realty Co/TYPE: WEB PMTS ID: 9000321157CO: Watson Realty CoNAME: Steven chaplinskiEntry Class Code: WEB,885.0,,Posted,344.73,2022-01-07,885.0,Withdrawal ACH Watson Realty Co/TYPE: WEB PMTS ID: 9000321157CO: Watson Realty CoEntry Class Code: WEB,885.0
1/7/2022,,Withdrawal ACH DISCOVER/TYPE: E-PAYMENT ID: 2510020270CO: DISCOVER NAME: CHAPLINSKI STEVENEntry Class Code: WEB,13.0,,Posted,1229.73,2022-01-07,13.0,Withdrawal ACH DISCOVER/TYPE: E-PAYMENT ID: 2510020270CO: DISCOVER NAME: CHAPLINSKI STEVENEntry Class Code: WEB,13.0
1/6/2022,,Withdrawal Debit Card MC Debit/PUBLIX #1312 GAINESVILLE FLDate 01/05/22 0 2005258752 1 5411Card 2801,108.9,,Posted,1242.73,2022-01-06,108.9,Withdrawal Debit Card MC Debit/PUBLIX #1312 GAINESVILLE FLDate 03/11/21 0 1070536058 1 5411Card 2801,108.9
1/6/2022,,Withdrawal Debit Card MC Debit/YVETTE GODET DMD GAINESVILLE FLDate 01/05/22 0 2005258437 1 8021Card 2801,138.0,,Posted,1351.63,2022-01-06,138.0,Withdrawal Debit Card MC Debit/YVETTE GODET DMD GAINESVILLE FLDate 04/11/22 0 2101019240 1 8021Card 2801,138.0
1/6/2022,,Withdrawal Debit Card MC Debit/WALGREENS #5024 800-289-2273 FLDate 01/05/22 0 2005255724 1 5912Card 2801,21.67,,Posted,1489.63,2022-01-06,21.67,Withdrawal Debit Card MC Debit/WALGREENS #5024 800-289-2273 FLDate 09/17/22 0 2260124597 1 5912Card 2801,21.67
1/6/2022,,Withdrawal POS #000000387313/WAWA 5325 2373 SW ARCHER ROA GAINESVILLEFLCard 2801,18.34,,Posted,1400.3,2022-01-06,18.34,Withdrawal POS #000000188596/WAWA 5325 2373 SW ARCHER ROA GAINESVILLEFLCard 2801,18.32
1/5/2022,,Withdrawal Debit Card MC Debit/PIZZA HUT 27918 3523739402 FLDate 01/04/22 0 2004889023 0 5812Card 2801,32.86,,Posted,1418.64,2022-01-05,32.86,Withdrawal Debit Card MC Debit/PIZZA HUT 27918 3523739402 FLDate 12/16/22 0 2350808582 1 5812Card 2801,32.614999999999995
1/5/2022,,Withdrawal ACH APPLECARD GSBANK/TYPE: PAYMENT ID: 9999999999CO: APPLECARD GSBANKNAME: Steven ChaplinskiEntry Class Code: WEB,42.0,,Posted,1313.5,2022-01-05,42.0,Withdrawal ACH APPLECARD GSBANK/TYPE: PAYMENT ID: 9999999999CO: APPLECARD GSBANKNAME: Steven ChaplinskiEntry Class Code: WEB,42.663333333333334
1/5/2022,,Withdrawal ACH BARCLAYCARD US/TYPE: CREDITCARD ID: 2510407970CO: BARCLAYCARD USNAME: STEVEN CHAPLINSKIEntry Class Code: WEB,25.0,,Posted,1355.5,2022-01-05,25.0,Withdrawal ACH BARCLAYCARD US/TYPE: CREDITCARD ID: 2510407970CO: BARCLAYCARD USNAME: STEVEN CHAPLINSKIEntry Class Code: WEB,25.0
1/5/2022,,Withdrawal ACH PAYPAL/TYPE: INST XFER ID: PAYPALSI77CO: PAYPAL NAME: STEVEN CHAPLINSKIEntry Class Code: WEB,9.0,,Posted,1380.5,2022-01-05,9.0,Withdrawal ACH PAYPAL/TYPE: INST XFER ID: PAYPALSI77CO: PAYPAL NAME: STEVEN CHAPLINSKIEntry Class Code: WEB,9.015
1/4/2022,,Withdrawal Debit Card MC Debit/WALGREENS #5024 800-289-2273 FLDate 01/03/22 0 2003268853 1 5912Card 2801,19.28,,Posted,1389.5,2022-01-04,19.28,Withdrawal Debit Card MC Debit/WALGREENS #5024 800-289-2273 FLDate 08/26/22 0 2238277635 2 5912Card 2801,19.28
1/4/2022,,Withdrawal ACH BEST BUY/TYPE: PAYMENT ID: CITIGPUFDRCO: BEST BUYEntry Class Code: PPD,70.0,,Posted,1408.78,2022-01-04,70.0,Withdrawal ACH BEST BUY/TYPE: PAYMENT ID: CITIGPUFDRCO: BEST BUYEntry Class Code: TEL,70.0
1/4/2022,,Withdrawal ACH PAYPAL/TYPE: INST XFER ID: PAYPALSI77CO: PAYPAL NAME: STEVEN CHAPLINSKIEntry Class Code: WEB,14.95,,Posted,1478.78,2022-01-04,14.95,Withdrawal ACH PAYPAL/TYPE: INST XFER ID: PAYPALSI77CO: PAYPAL NAME: STEVEN CHAPLINSKIEntry Class Code: WEB,14.948333333333332
1/4/2022,,Withdrawal ACH PAYPAL/TYPE: INST XFER ID: PAYPALSI77CO: PAYPAL NAME: STEVEN CHAPLINSKIEntry Class Code: WEB,2.99,,Posted,1493.73,2022-01-04,2.99,Withdrawal ACH PAYPAL/TYPE: INST XFER ID: PAYPALSI77CO: PAYPAL NAME: STEVEN CHAPLINSKIEntry Class Code: WEB,3.218
1/3/2022,,Withdrawal POS #000000219170/AMAZON.COM*CQ14M5TP3 SEATTLE WACard 2801,10.15,,Posted,1496.72,2022-01-03,10.15,Withdrawal POS #000000991850/AMAZON.COM*7Q29B9KF3 SEATTLE WACard 2801,10.51
1/3/2022,,Withdrawal POS #000012562406/WALGREENS 2415 SW GAINESVILLE FLCard 2801,43.37,,Posted,1506.87,2022-01-03,43.37,Withdrawal POS #000014264526/WALGREENS 2415 SW GAINESVILLE FLCard 2801,43.37
1/3/2022,,Withdrawal ACH PAYPAL/TYPE: INST XFER ID: PAYPALSI77CO: PAYPAL NAME: STEVEN CHAPLINSKIEntry Class Code: WEB,24.99,,Posted,1550.24,2022-01-03,24.99,Withdrawal ACH PAYPAL/TYPE: INST XFER ID: PAYPALSI77CO: PAYPAL NAME: STEVEN CHAPLINSKIEntry Class Code: WEB,24.97
12/31/2021,,Withdrawal ACH PAYPAL/TYPE: INST XFER ID: PAYPALSI77CO: PAYPAL NAME: STEVEN CHAPLINSKIEntry Class Code: WEB,49.0,,Posted,575.23,2021-12-31,49.0,Withdrawal ACH PAYPAL/TYPE: INST XFER ID: PAYPALSI77CO: PAYPAL NAME: STEVEN CHAPLINSKIEntry Class Code: WEB,49.663333333333334
12/31/2021,,Withdrawal ACH PAYPAL/TYPE: INST XFER ID: PAYPALSI77CO: PAYPAL NAME: STEVEN CHAPLINSKIEntry Class Code: WEB,6.52,,Posted,624.23,2021-12-31,6.52,Withdrawal ACH PAYPAL/TYPE: INST XFER ID: PAYPALSI77CO: PAYPAL NAME: STEVEN CHAPLINSKIEntry Class Code: WEB,6.0875
12/30/2021,,Withdrawal POS #000000037252/PUBLIX 3930 SW ARCHER ROA GAINESVILLE FLCard 2801,11.34,,Posted,630.75,2021-12-30,11.34,Withdrawal POS #000000029500/PUBLIX 3930 SW ARCHER ROA GAINESVILLE FLCard 2801,11.77
12/30/2021,,Withdrawal POS #000000875122/FAST TRACK #200 3960 SW ARCHER RDGAINESVILLE FLCard 2801,18.79,,Posted,642.09,2021-12-30,18.79,Withdrawal POS #000000779962/FAST TRACK #200 3960 SW ARCHER RDGAINESVILLE FLCard 2801,18.79
12/30/2021,,Withdrawal ATM Transaction,100.0,,Posted,660.88,2021-12-30,100.0,Withdrawal ATM Transaction,100.0
12/29/2021,,Withdrawal POS #000000779962/FAST TRACK #200 3960 SW ARCHER RDGAINESVILLE FLCard 2801,21.56,,Posted,760.88,2021-12-29,21.56,Withdrawal POS #000000779962/FAST TRACK #200 3960 SW ARCHER RDGAINESVILLE FLCard 2801,21.77
12/29/2021,,Withdrawal POS #000000737891/PUBLIX 3930 SW ARCHER ROA GAINESVILLE FLCard 2801,31.95,,Posted,782.44,2021-12-29,31.95,Withdrawal POS #000000086361/PUBLIX 3930 SW ARCHER ROA GAINESVILLE FLCard 2801,31.95
12/29/2021,,Withdrawal ACH PAYPAL/TYPE: INST XFER ID: PAYPALSI77CO: PAYPAL NAME: STEVEN CHAPLINSKIEntry Class Code: WEB,11.48,,Posted,814.39,2021-12-29,11.48,Withdrawal ACH PAYPAL/TYPE: INST XFER ID: PAYPALSI77CO: PAYPAL NAME: STEVEN CHAPLINSKIEntry Class Code: WEB,11.7425
12/29/2021,,Withdrawal ACH PAYPAL/TYPE: INST XFER ID: PAYPALSI77CO: PAYPAL NAME: STEVEN CHAPLINSKIEntry Class Code: WEB,2.99,,Posted,825.87,2021-12-29,2.99,Withdrawal ACH PAYPAL/TYPE: INST XFER ID: PAYPALSI77CO: PAYPAL NAME: STEVEN CHAPLINSKIEntry Class Code: WEB,3.218
12/28/2021,,Withdrawal ACH PAYPAL/TYPE: INST XFER ID: PAYPALSI77CO: PAYPAL NAME: STEVEN CHAPLINSKIEntry Class Code: WEB,21.38,,Posted,828.86,2021-12-28,21.38,Withdrawal ACH PAYPAL/TYPE: INST XFER ID: PAYPALSI77CO: PAYPAL NAME: STEVEN CHAPLINSKIEntry Class Code: WEB,21.38
12/27/2021,,Recurring Withdrawal Debit Card MC Debit/HELP.HBOMAX.COM NEW YORK NYDate 12/27/21 0 1361077074 1 5815Card 2801,17.23,,Posted,850.24,2021-12-27,17.23,Recurring Withdrawal Debit Card MC Debit/HELP.HBOMAX.COM NEW YORK NYDate 04/27/22 0 2117023223 1 5815Card 2801,17.23
12/27/2021,,Withdrawal Debit Card MC Debit/COX GAINESVILLE COMM 800-234-3993 FLDate 12/27/21 0 1361072441 1 4899Card 2801,95.39,,Posted,867.47,2021-12-27,95.39,Withdrawal Debit Card MC Debit/COX GAINESVILLE COMM 800-234-3993 FLDate 01/27/22 0 2027240681 1 4899Card 2801,95.39
12/27/2021,,Withdrawal ACH CANVA PTY LIMITE/CO: CANVA PTY LIMITEDTYPE: IAT PAYPAL ID: 770510487CEntry Class Code: IAT,12.99,,Posted,962.86,2021-12-27,12.99,Withdrawal ACH CANVA PTY LIMITE/CO: CANVA PTY LIMITEDTYPE: IAT PAYPAL ID: 770510487CEntry Class Code: IAT,12.99
12/27/2021,,Withdrawal ACH PAYPAL/TYPE: INST XFER ID: PAYPALSI77CO: PAYPAL NAME: STEVEN CHAPLINSKIEntry Class Code: WEB,4.5,,Posted,975.85,2021-12-27,4.5,Withdrawal ACH PAYPAL/TYPE: INST XFER ID: PAYPALSI77CO: PAYPAL NAME: STEVEN CHAPLINSKIEntry Class Code: WEB,4.96
12/27/2021,,Withdrawal ACH PAYPAL/TYPE: INST XFER ID: PAYPALSI77CO: PAYPAL NAME: STEVEN CHAPLINSKIEntry Class Code: WEB,2.99,,Posted,980.35,2021-12-27,2.99,Withdrawal ACH PAYPAL/TYPE: INST XFER ID: PAYPALSI77CO: PAYPAL NAME: STEVEN CHAPLINSKIEntry Class Code: WEB,3.218
12/26/2021,,Withdrawal ATM Transaction,80.0,,Posted,983.34,2021-12-26,80.0,Withdrawal ATM Transaction,80.0
12/26/2021,,Withdrawal Debit Card MC Debit/PUBLIX #1312 GAINESVILLE FLDate 12/24/21 0 1358678113 1 5411Card 2801,37.6,,Posted,1063.34,2021-12-26,37.6,Withdrawal Debit Card MC Debit/PUBLIX #1312 GAINESVILLE FLDate 12/24/21 0 1358678113 1 5411Card 2801,37.6
12/26/2021,,Withdrawal Debit Card MC Debit/KINDLE UNLTD*YG62Q6YB3 866-321-8851 WADate 12/24/21 0 1358747903 1 5818Card 2801,9.99,,Posted,1100.94,2021-12-26,9.99,Withdrawal Debit Card MC Debit/KINDLE UNLTD*439YD1353 866-321-8851 WADate 11/24/21 0 1328430085 1 5818Card 2801,9.99
12/24/2021,,Withdrawal POS #000000547940/FAST TRACK #200 3960 SW ARCHER RDGAINESVILLE FLCard 2801,9.39,,Posted,1110.93,2021-12-24,9.39,Withdrawal POS #000000194488/FAST TRACK #200 3960 SW ARCHER RDGAINESVILLE FLCard 1140,9.39
12/22/2021,,Withdrawal ATM Transaction,60.0,,Posted,120.32,2021-12-22,60.0,Withdrawal ATM Transaction,60.0
12/22/2021,,Withdrawal Debit Card MC Debit/PUBLIX #1312 GAINESVILLE FLDate 12/21/21 0 1355585485 1 5411Card 2801,46.84,,Posted,180.32,2021-12-22,46.84,Withdrawal Debit Card MC Debit/PUBLIX #1312 GAINESVILLE FLDate 12/24/21 0 1358678113 1 5411Card 2801,46.84
12/21/2021,,Withdrawal ACH PAYPAL/TYPE: INST XFER ID: PAYPALSI77CO: PAYPAL NAME: STEVEN CHAPLINSKIEntry Class Code: WEB,6.99,,Posted,146.39,2021-12-21,6.99,Withdrawal ACH PAYPAL/TYPE: INST XFER ID: PAYPALSI77CO: PAYPAL NAME: STEVEN CHAPLINSKIEntry Class Code: WEB,6.87
12/18/2021,,Withdrawal ATM Fee/ASAI 3400 B SW 34th St. Gainesville FLCard 2801,2.0,,Posted,124.38,2021-12-18,2.0,Withdrawal ATM Fee/ASAI 3400 B SW 34th St. Gainesville FLCard 2801,2.0
12/18/2021,,Withdrawal at ATM #000000001835/ASAI 3400 B SW 34th St. Gainesville FLCard 2801,12.75,,Posted,126.38,2021-12-18,12.75,Withdrawal at ATM #000000000323/ASAI 3400 B SW 34th St. Gainesville FLCard 2801,12.75
12/17/2021,,Recurring Withdrawal Debit Card MC Debit/JARVIS - CONVERSION.AI AUSTIN TXDate 12/16/21 0 1350165435 1 7399Card 2801,29.0,,Posted,139.13,2021-12-17,29.0,Recurring Withdrawal Debit Card MC Debit/JARVIS - CONVERSION.AI AUSTIN TXDate 12/16/21 0 1350165435 1 7399Card 2801,29.0
12/16/2021,,Withdrawal ACH Coinbase.com/TYPE: TKSAMGXM ID: 1455293997CO: Coinbase.comEntry Class Code: WEB,10.0,,Posted,163.95,2021-12-16,10.0,Withdrawal ACH Coinbase.com/TYPE: TKSAMGXM ID: 1455293997CO: Coinbase.comEntry Class Code: WEB,10.0
12/16/2021,,Withdrawal ACH Coinbase.com/TYPE: 4N9CGTSG ID: 1455293997CO: Coinbase.comEntry Class Code: WEB,6.0,,Posted,173.95,2021-12-16,6.0,Withdrawal ACH Coinbase.com/TYPE: TKSAMGXM ID: 1455293997CO: Coinbase.comEntry Class Code: WEB,6.0
12/16/2021,,Withdrawal ACH AVANGATE B.V./CO: AVANGATE B.V.TYPE: IAT PAYPAL ID: 770510487CEntry Class Code: IAT,29.58,,Posted,166.12,2021-12-16,29.58,Withdrawal ACH AVANGATE B.V./CO: AVANGATE B.V.TYPE: IAT PAYPAL ID: 770510487CEntry Class Code: IAT,29.58
12/16/2021,,Withdrawal ACH PAYPAL/TYPE: INST XFER ID: PAYPALSI77CO: PAYPALEntry Class Code: WEB,32.05,,Posted,195.7,2021-12-16,32.05,Withdrawal ACH PAYPAL/TYPE: INST XFER ID: PAYPALSI77CO: PAYPALEntry Class Code: WEB,32.05
12/16/2021,,Withdrawal ACH E*TRADE/TYPE: ACH TRNSFR ID: 1391321258CO: E*TRADEEntry Class Code: PPD,20.0,,Posted,227.75,2021-12-16,20.0,Withdrawal ACH E*TRADE/TYPE: ACH TRNSFR ID: 1391321258CO: E*TRADEEntry Class Code: PPD,20.0
12/16/2021,,Withdrawal POS #000000247445/AMAZON.COM*A42ZY7OC3 SEATTLE WACard 2801,10.87,,Posted,242.75,2021-12-16,10.87,Withdrawal POS #000000247445/AMAZON.COM*A42ZY7OC3 SEATTLE WACard 2801,10.475
12/15/2021,,Withdrawal POS #000000033409/PUBLIX 3100 SW 35TH BLVD GAINESVILLE FLCard 2801,32.82,,Posted,253.62,2021-12-15,32.82,Withdrawal POS #000000036956/PUBLIX 5801 SW 75TH ST GAINESVILLE FLCard 2801,32.82
12/15/2021,,Withdrawal ATM Fee/ASAI 3400 B SW 34th St. Gainesville FLCard 2801,2.0,,Posted,286.44,2021-12-15,2.0,Withdrawal ATM Fee/ASAI 3400 B SW 34th St. Gainesville FLCard 2801,2.0
12/15/2021,,Withdrawal at ATM #000000001792/ASAI 3400 B SW 34th St. Gainesville FLCard 2801,52.75,,Posted,288.44,2021-12-15,52.75,Withdrawal at ATM #000000000323/ASAI 3400 B SW 34th St. Gainesville FLCard 2801,52.75
12/14/2021,,Withdrawal ACH ROBINHOOD/TYPE: DEBITS ID: 5326394001CO: ROBINHOODEntry Class Code: WEB,20.0,,Posted,341.19,2021-12-14,20.0,Withdrawal ACH ROBINHOOD/TYPE: DEBITS ID: 5326394001CO: ROBINHOODEntry Class Code: WEB,20.0
12/13/2021,,Recurring Withdrawal Debit Card Fee/MASTERCARD ISSUER CROSS-BORDER FEEDate 12/11/21 0 1345316936 1 5817Card 2801,0.05,,Posted,134.57,2021-12-13,0.05,Recurring Withdrawal Debit Card Fee/MASTERCARD ISSUER CROSS-BORDER FEEDate 05/12/21 0 1132191600 1 7372Card 2801,0.09500000000000001
12/13/2021,,Recurring Withdrawal Debit Card MC Debit/PAYPAL *LINKTREE 4029357733 AUDate 12/11/21 0 1345316936 1 5817Card 2801,6.0,,Posted,134.62,2021-12-13,6.0,Recurring Withdrawal Debit Card MC Debit/PAYPAL *LINKTREE 4029357733 AUDate 05/12/21 0 1132191600 1 7372Card 2801,6.0
12/13/2021,,Withdrawal ACH PAYPAL INC./CO: PAYPAL INC.TYPE: IAT PAYPAL ID: 770510487CEntry Class Code: IAT,10.13,,Posted,140.62,2021-12-13,10.13,Withdrawal ACH PAYPAL INC./CO: PAYPAL INC.TYPE: IAT PAYPAL ID: 770510487CEntry Class Code: IAT,10.13
12/13/2021,,Withdrawal ACH CDKEYS/CO: CDKEYSTYPE: IAT PAYPAL ID: 770510487CEntry Class Code: IAT,7.49,,Posted,150.75,2021-12-13,7.49,Withdrawal ACH BRAINLY/CO: BRAINLYTYPE: IAT PAYPAL ID: 770510487CEntry Class Code: IAT,7.49
12/13/2021,,Recurring Withdrawal Bill Payment - #000009064015/NETFLIX COM LOS GATOS CACard 2801,9.88,,Posted,158.24,2021-12-13,9.88,Recurring Withdrawal Bill Payment - #000006911729/NETFLIX COM LOS GATOS CACard 2801,9.88
12/13/2021,,Withdrawal ACH PAYPAL/TYPE: INST XFER ID: PAYPALSI77CO: PAYPALEntry Class Code: WEB,11.99,,Posted,168.12,2021-12-13,11.99,Withdrawal ACH PAYPAL/TYPE: INST XFER ID: PAYPALSI77CO: PAYPALEntry Class Code: WEB,11.876666666666667
12/13/2021,,Withdrawal ACH PAYPAL/TYPE: INST XFER ID: PAYPALSI77CO: PAYPALEntry Class Code: WEB,9.99,,Posted,180.11,2021-12-13,9.99,Withdrawal ACH PAYPAL/TYPE: INST XFER ID: PAYPALSI77CO: PAYPALEntry Class Code: WEB,9.723333333333334
12/13/2021,,Withdrawal ACH PAYPAL/TYPE: INST XFER ID: PAYPALSI77CO: PAYPALEntry Class Code: WEB,9.18,,Posted,190.1,2021-12-13,9.18,Withdrawal ACH PAYPAL/TYPE: INST XFER ID: PAYPALSI77CO: PAYPALEntry Class Code: WEB,9.723333333333334
12/13/2021,,Withdrawal ACH PAYPAL/TYPE: INST XFER ID: PAYPALSI77CO: PAYPALEntry Class Code: WEB,4.99,,Posted,199.28,2021-12-13,4.99,Withdrawal ACH PAYPAL/TYPE: INST XFER ID: PAYPALSI77CO: PAYPALEntry Class Code: WEB,5.032
12/13/2021,,Withdrawal ACH PAYPAL/TYPE: INST XFER ID: PAYPALSI77CO: PAYPALEntry Class Code: WEB,2.99,,Posted,204.27,2021-12-13,2.99,Withdrawal ACH PAYPAL/TYPE: INST XFER ID: PAYPALSI77CO: PAYPALEntry Class Code: WEB,3.2266666666666666
12/12/2021,,Withdrawal Debit Card MC Debit/PIZZA HUT 27918 3523739402 FLDate 12/11/21 0 1345093373 1 5812Card 2801,38.73,,Posted,206.96,2021-12-12,38.73,Withdrawal Debit Card MC Debit/PIZZA HUT 27918 3523739402 FLDate 12/16/22 0 2350808582 1 5812Card 2801,38.876666666666665
12/12/2021,,Withdrawal Debit Card MC Debit/PUBLIX #1312 GAINESVILLE FLDate 12/11/21 0 1345536904 1 5411Card 2801,41.68,,Posted,245.69,2021-12-12,41.68,Withdrawal Debit Card MC Debit/PUBLIX #1312 GAINESVILLE FLDate 03/11/21 0 1070536058 1 5411Card 2801,41.795
12/11/2021,,Withdrawal ATM Fee/ASAI 3400 B SW 34th St. Gainesville FLCard 2801,2.0,,Posted,287.37,2021-12-11,2.0,Withdrawal ATM Fee/ASAI 3400 B SW 34th St. Gainesville FLCard 2801,2.0
12/11/2021,,Withdrawal at ATM #000000001742/ASAI 3400 B SW 34th St. Gainesville FLCard 2801,62.75,,Posted,289.37,2021-12-11,62.75,Withdrawal at ATM #000000000323/ASAI 3400 B SW 34th St. Gainesville FLCard 2801,62.75
12/10/2021,,Withdrawal POS #000000866633/SUNOCO 8002212501 4234 SW 20TH AVEGAINESVILLE FLCard 2801,23.52,,Posted,341.25,2021-12-10,23.52,Withdrawal POS #000000866633/SUNOCO 8002212501 4234 SW 20TH AVEGAINESVILLE FLCard 2801,23.52
12/9/2021,,Withdrawal Debit Card MC Debit/PUBLIX #680 GAINESVILLE FLDate 12/08/21 0 1342465886 1 5411Card 2801,9.39,,Posted,364.77,2021-12-09,9.39,Withdrawal Debit Card MC Debit/PUBLIX #1560 GAINESVILLE FLDate 09/04/21 0 1247836114 5 5411Card 2801,9.39
12/9/2021,,Withdrawal Debit Card MC Debit/AMZN DIGITAL*1Q88M4VC3 888-802-3080 WADate 12/08/21 0 1342087624 1 5818Card 2801,60.0,,Posted,374.16,2021-12-09,60.0,Withdrawal Debit Card MC Debit/AMZN DIGITAL*1Q88M4VC3 888-802-3080 WADate 12/08/21 0 1342087624 1 5818Card 2801,60.0
12/9/2021,,Withdrawal ACH BEST BUY/TYPE: PAYMENT ID: CITIGPUFDRCO: BEST BUYEntry Class Code: PPD,1072.0,,Posted,434.16,2021-12-09,1072.0,Withdrawal ACH BEST BUY/TYPE: PAYMENT ID: CITIGPUFDRCO: BEST BUYEntry Class Code: TEL,1072.0
12/8/2021,,Withdrawal ATM Fee/ASAI 3400 B SW 34th St. Gainesville FLCard 2801,2.0,,Posted,230.16,2021-12-08,2.0,Withdrawal ATM Fee/ASAI 3400 B SW 34th St. Gainesville FLCard 2801,2.0
12/8/2021,,Withdrawal at ATM #000000001701/ASAI 3400 B SW 34th St. Gainesville FLCard 2801,52.75,,Posted,232.16,2021-12-08,52.75,Withdrawal at ATM #000000000323/ASAI 3400 B SW 34th St. Gainesville FLCard 2801,52.75
12/8/2021,,Withdrawal Bill Payment #000005244166/PAYPAL *VIDIQ San Jose CACard 2801,10.0,,Posted,284.91,2021-12-08,10.0,Withdrawal Bill Payment #000005023648/PAYPAL *VIDIQ San Jose CACard 2801,10.0
12/7/2021,,Withdrawal Debit Card MC Debit/BURGER KING #2314 Q07 GAINESVILLE FLDate 12/06/21 0 1340414040 1 5814Card 2801,14.64,,Posted,294.91,2021-12-07,14.64,Withdrawal Debit Card MC Debit/BURGER KING #2314 Q07 GAINESVILLE FLDate 12/06/21 0 1340414040 1 5814Card 2801,14.64
12/7/2021,,Withdrawal Debit Card MC Debit/WALGREENS #5024 800-289-2273 FLDate 12/06/21 0 1340411522 1 5912Card 2801,4.5,,Posted,309.55,2021-12-07,4.5,Withdrawal Debit Card MC Debit/WALGREENS #5024 800-289-2273 FLDate 12/19/22 0 2353181854 1 5912Card 2801,4.5
12/7/2021,,Withdrawal ACH PAYPAL/TYPE: INST XFER ID: PAYPALSI77CO: PAYPALEntry Class Code: WEB,19.99,,Posted,314.05,2021-12-07,19.99,Withdrawal ACH PAYPAL/TYPE: INST XFER ID: PAYPALSI77CO: PAYPALEntry Class Code: WEB,19.99
12/7/2021,,Withdrawal POS #000000000001/AMAZON.COM*1H2FW4UE3 SEATTLE WACard 2801,10.87,,Posted,334.04,2021-12-07,10.87,Withdrawal POS #000000000023/AMAZON.COM*AU8ER6ZT3 SEATTLE WACard 2801,10.4725
12/6/2021,,Withdrawal ACH BEST BUY/TYPE: PAYMENT ID: CITIGPUFDRCO: BEST BUYEntry Class Code: PPD,62.0,,Posted,294.91,2021-12-06,62.0,Withdrawal ACH BEST BUY/TYPE: PAYMENT ID: CITIGPUFDRCO: BEST BUYEntry Class Code: TEL,62.0
12/6/2021,,Withdrawal Debit Card MC Debit/PUBLIX #1312 GAINESVILLE FLDate 12/05/21 0 1339321130 1 5411Card 2801,28.24,,Posted,356.91,2021-12-06,28.24,Withdrawal Debit Card MC Debit/PUBLIX #1312 GAINESVILLE FLDate 12/24/21 0 1358678113 1 5411Card 2801,28.24
12/6/2021,,Withdrawal Debit Card MC Debit/PUBLIX #1312 GAINESVILLE FLDate 12/05/21 0 1339321129 1 5411Card 2801,39.16,,Posted,385.15,2021-12-06,39.16,Withdrawal Debit Card MC Debit/PUBLIX #1312 GAINESVILLE FLDate 12/24/21 0 1358678113 1 5411Card 2801,39.16
12/6/2021,,Withdrawal Debit Card MC Debit/WALGREENS #5024 800-289-2273 FLDate 12/05/21 0 1339318061 1 5912Card 2801,30.96,,Posted,424.31,2021-12-06,30.96,Withdrawal Debit Card MC Debit/WALGREENS #5024 800-289-2273 FLDate 12/19/22 0 2353181854 1 5912Card 2801,30.96
12/6/2021,,Recurring Withdrawal Debit Card MC Debit/AMAZON PRIME*B135K3GA3 AMZN.COM/BIL WADate 12/05/21 0 1339329704 1 5968Card 2801,13.1,,Posted,455.27,2021-12-06,13.1,Recurring Withdrawal Debit Card MC Debit/AMAZON PRIME*B135K3GA3 AMZN.COM/BIL WADate 12/05/21 0 1339329704 1 5968Card 2801,13.1
12/6/2021,,Withdrawal ACH TARGET CARD SRVC/TYPE: BILL PAY ID: 5411721813CO: TARGET CARD SRVCEntry Class Code: WEB,98.0,,Posted,468.37,2021-12-06,98.0,Withdrawal ACH TARGET CARD SRVC/TYPE: BILL PAY ID: T510215170CO: TARGET CARD SRVCEntry Class Code: WEB,98.0
12/6/2021,,Withdrawal ACH PAYPAL/TYPE: INST XFER ID: PAYPALSI77CO: PAYPALEntry Class Code: WEB,35.99,,Posted,566.37,2021-12-06,35.99,Withdrawal ACH PAYPAL/TYPE: INST XFER ID: PAYPALSI77CO: PAYPALEntry Class Code: WEB,35.995000000000005
12/6/2021,,Withdrawal ACH PAYPAL/TYPE: INST XFER ID: PAYPALSI77CO: PAYPALEntry Class Code: WEB,14.95,,Posted,602.36,2021-12-06,14.95,Withdrawal ACH PAYPAL/TYPE: INST XFER ID: PAYPALSI77CO: PAYPALEntry Class Code: WEB,14.646666666666667
12/6/2021,,Withdrawal ACH PAYPAL/TYPE: INST XFER ID: PAYPALSI77CO: PAYPALEntry Class Code: WEB,2.99,,Posted,617.31,2021-12-06,2.99,Withdrawal ACH PAYPAL/TYPE: INST XFER ID: PAYPALSI77CO: PAYPALEntry Class Code: WEB,3.2266666666666666
12/5/2021,,Withdrawal POS #000000691470/FAST TRACK #200 3960 SW ARCHER RDGAINESVILLE FLCard 2801,12.17,,Posted,544.46,2021-12-05,12.17,Withdrawal POS #000000194488/FAST TRACK #200 3960 SW ARCHER RDGAINESVILLE FLCard 1140,12.175
12/5/2021,,Withdrawal ATM Fee/ASAI 3400 B SW 34th St. Gainesville FLCard 2801,2.0,,Posted,556.63,2021-12-05,2.0,Withdrawal ATM Fee/ASAI 3400 B SW 34th St. Gainesville FLCard 2801,2.0
12/5/2021,,Withdrawal at ATM #000000001471/ASAI 3400 B SW 34th St. Gainesville FLCard 2801,37.75,,Posted,558.63,2021-12-05,37.75,Withdrawal at ATM #000000000323/ASAI 3400 B SW 34th St. Gainesville FLCard 2801,37.75
12/5/2021,,Withdrawal POS #000014264526/WALGREENS 2415 SW GAINESVILLE FLCard 2801,19.33,,Posted,596.38,2021-12-05,19.33,Withdrawal POS #000014264526/WALGREENS 2415 SW GAINESVILLE FLCard 2801,19.52
12/4/2021,,Withdrawal POS #000000000496/AMAZON.COM*PX74B4CW3 SEATTLE WACard 2801,10.87,,Posted,604.84,2021-12-04,10.87,Withdrawal POS #000000353089/AMAZON.COM*D84KU4CA3 SEATTLE WACard 2801,10.87
12/3/2021,,Withdrawal POS #000000053288/PUBLIX 3930 SW ARCHER ROA GAINESVILLE FLCard 2801,52.25,,Posted,615.71,2021-12-03,52.25,Withdrawal POS #000000029500/PUBLIX 3930 SW ARCHER ROA GAINESVILLE FLCard 2801,52.25
12/3/2021,,Withdrawal POS #000000045074/CIRCLE K # 26146 3 GAINESVILLE FLCard 2801,30.83,,Posted,667.96,2021-12-03,30.83,Withdrawal POS #000000011248/CIRCLE K # 23913 3424 GAINESVILLE FLCard 2801,30.83
12/3/2021,,Withdrawal ATM Transaction,100.0,,Posted,698.79,2021-12-03,100.0,Withdrawal ATM Transaction,100.0
12/3/2021,,Withdrawal ACH PAYPAL/TYPE: INST XFER ID: PAYPALSI77CO: PAYPALEntry Class Code: WEB,0.61,,Posted,798.79,2021-12-03,0.61,Withdrawal ACH PAYPAL/TYPE: INST XFER ID: PAYPALSI77CO: PAYPALEntry Class Code: WEB,0.835
12/2/2021,,Withdrawal Debit Card MC Debit/GRU/EZ-PAY WEB PYMT 352-334-3434 FLDate 12/01/21 0 1335452228 0 4900Card 2801,150.26,,Posted,799.4,2021-12-02,150.26,Withdrawal Debit Card MC Debit/GRU/EZ-PAY WEB PYMT 352-334-3434 FLDate 11/01/21 0 1305577800 0 4900Card 2801,150.26
12/2/2021,,Withdrawal Debit Card MC Debit/COX GAINESVILLE COMM 800-234-3993 FLDate 12/01/21 0 1335305470 1 4899Card 2801,94.32,,Posted,949.66,2021-12-02,94.32,Withdrawal Debit Card MC Debit/COX GAINESVILLE COMM 800-234-3993 FLDate 01/27/22 0 2027240681 1 4899Card 2801,94.32
12/2/2021,,Withdrawal ACH Watson Realty Co/TYPE: WEB PMTS ID: 9000321157CO: Watson Realty CoEntry Class Code: WEB,885.0,,Posted,1043.98,2021-12-02,885.0,Withdrawal ACH Watson Realty Co/TYPE: WEB PMTS ID: 9000321157CO: Watson Realty CoEntry Class Code: WEB,885.0
12/2/2021,,Withdrawal ACH PAYPAL/TYPE: INST XFER ID: PAYPALSI77CO: PAYPALEntry Class Code: WEB,24.99,,Posted,1928.98,2021-12-02,24.99,Withdrawal ACH PAYPAL/TYPE: INST XFER ID: PAYPALSI77CO: PAYPALEntry Class Code: WEB,24.653333333333332
12/1/2021,,Withdrawal ACH APPLECARD GSBANK/TYPE: PAYMENT ID: 9999999999CO: APPLECARD GSBANKEntry Class Code: WEB,48.49,,Posted,1953.97,2021-12-01,48.49,Withdrawal ACH APPLECARD GSBANK/TYPE: PAYMENT ID: 9999999999 CO: APPLECARD GSBANK Entry Class Code: WEB,48.77
12/1/2021,,Withdrawal ACH CAPITAL ONE/TYPE: MOBILE PMT ID: 9279744980CO: CAPITAL ONEEntry Class Code: WEB,25.0,,Posted,2002.46,2021-12-01,25.0,Withdrawal ACH CAPITAL ONE/TYPE: MOBILE PMT ID: 9279744980CO: CAPITAL ONEEntry Class Code: WEB,25.0
12/1/2021,,Withdrawal ACH DISCOVER/TYPE: E-PAYMENT ID: 2510020270CO: DISCOVEREntry Class Code: WEB,57.0,,Posted,2027.46,2021-12-01,57.0,Withdrawal ACH DISCOVER/TYPE: E-PAYMENT ID: 2510020270CO: DISCOVEREntry Class Code: WEB,57.5
12/1/2021,,Withdrawal ACH PAYPAL/TYPE: INST XFER ID: PAYPALSI77CO: PAYPALEntry Class Code: WEB,49.0,,Posted,2084.46,2021-12-01,49.0,Withdrawal ACH PAYPAL/TYPE: INST XFER ID: PAYPALSI77CO: PAYPALEntry Class Code: WEB,49.66
11/30/2021,,Withdrawal ACH PAYPAL/TYPE: INST XFER ID: PAYPALSI77CO: PAYPALEntry Class Code: WEB,77.99,,Posted,133.46,2021-11-30,77.99,Withdrawal ACH PAYPAL/TYPE: INST XFER ID: PAYPALSI77CO: PAYPALEntry Class Code: WEB,78.1
11/29/2021,,Withdrawal ACH CANVA PTY LIMITE/CO: CANVA PTY LIMITEDTYPE: IAT PAYPAL ID: 770510487CEntry Class Code: IAT,12.99,,Posted,211.45,2021-11-29,12.99,Withdrawal ACH CANVA PTY LIMITE/CO: CANVA PTY LIMITEDTYPE: IAT PAYPAL ID: 770510487CEntry Class Code: IAT,12.99
11/29/2021,,Withdrawal ACH PAYPAL/TYPE: INST XFER ID: PAYPALSI77CO: PAYPALEntry Class Code: WEB,11.48,,Posted,224.44,2021-11-29,11.48,Withdrawal ACH PAYPAL/TYPE: INST XFER ID: PAYPALSI77CO: PAYPALEntry Class Code: WEB,10.88
11/29/2021,,Withdrawal ACH PAYPAL/TYPE: INST XFER ID: PAYPALSI77CO: PAYPALEntry Class Code: WEB,2.99,,Posted,235.92,2021-11-29,2.99,Withdrawal ACH PAYPAL/TYPE: INST XFER ID: PAYPALSI77CO: PAYPALEntry Class Code: WEB,3.2266666666666666
11/29/2021,,Withdrawal ACH PAYPAL/TYPE: INST XFER ID: PAYPALSI77CO: PAYPALEntry Class Code: WEB,2.99,,Posted,238.91,2021-11-29,2.99,Withdrawal ACH PAYPAL/TYPE: INST XFER ID: PAYPALSI77CO: PAYPALEntry Class Code: WEB,3.2266666666666666
11/28/2021,,Withdrawal POS #000000374038/FAST TRACK #200 3960 SW ARCHER RDGAINESVILLE FLCard 2801,18.79,,Posted,43.9,2021-11-28,18.79,Withdrawal POS #000000194488/FAST TRACK #200 3960 SW ARCHER RDGAINESVILLE FLCard 1140,18.79
11/28/2021,,Withdrawal POS #000000744128/PUBLIX 3930 SW ARCHER ROA GAINESVILLE FLCard 2801,49.89,,Posted,62.69,2021-11-28,49.89,Withdrawal POS #000000737891/PUBLIX 3930 SW ARCHER ROA GAINESVILLE FLCard 2801,49.89
11/28/2021,,Recurring Withdrawal Debit Card MC Debit/HELP.HBOMAX.COM NEW YORK NYDate 11/27/21 0 1331892549 2 5815Card 2801,17.23,,Posted,72.58,2021-11-28,17.23,Recurring Withdrawal Debit Card MC Debit/HELP.HBOMAX.COM NEW YORK NYDate 04/27/22 0 2117023223 1 5815Card 2801,17.23
11/26/2021,,Withdrawal POS #000000041075/PUBLIX 3930 SW ARCHER ROA GAINESVILLE FLCard 2801,12.2,,Posted,89.81,2021-11-26,12.2,Withdrawal POS #000000029500/PUBLIX 3930 SW ARCHER ROA GAINESVILLE FLCard 2801,11.77
11/26/2021,,Withdrawal ACH PAYPAL/TYPE: INST XFER ID: PAYPALSI77CO: PAYPALEntry Class Code: WEB,14.0,,Posted,102.01,2021-11-26,14.0,Withdrawal ACH PAYPAL/TYPE: INST XFER ID: PAYPALSI77CO: PAYPALEntry Class Code: WEB,14.646666666666667
11/26/2021,,Withdrawal ACH PAYPAL/TYPE: INST XFER ID: PAYPALSI77CO: PAYPALEntry Class Code: WEB,4.5,,Posted,116.01,2021-11-26,4.5,Withdrawal ACH PAYPAL/TYPE: INST XFER ID: PAYPALSI77CO: PAYPALEntry Class Code: WEB,5.032
11/25/2021,,Recurring Withdrawal Debit Card MC Debit/WELLSAID LABS SEATTLE WADate 11/24/21 0 1328159011 1 5734Card 2801,49.0,,Posted,32.11,2021-11-25,49.0,Recurring Withdrawal Debit Card MC Debit/WELLSAID LABS SEATTLE WADate 11/24/21 0 1328159011 1 5734Card 2801,49.0
11/25/2021,,Withdrawal Debit Card MC Debit/KINDLE UNLTD*439YD1353 866-321-8851 WADate 11/24/21 0 1328430085 1 5818Card 2801,9.99,,Posted,81.11,2021-11-25,9.99,Withdrawal Debit Card MC Debit/KINDLE UNLTD*439YD1353 866-321-8851 WADate 11/24/21 0 1328430085 1 5818Card 2801,9.99
11/25/2021,,Withdrawal POS #000000436948/SUNOCO 8002212501 4234 SW 20TH AVEGAINESVILLE FLCard 2801,22.44,,Posted,91.1,2021-11-25,22.44,Withdrawal POS #000000689838/SUNOCO 8002212501 4234 SW 20TH AVEGAINESVILLE FLCard 2801,22.44
11/25/2021,,Withdrawal Transfer fee,8.0,,Posted,113.54,2021-11-25,8.0,Withdrawal Transfer fee,8.0
11/24/2021,,Withdrawal ACH PAYPAL/TYPE: INST XFER ID: PAYPALSI77CO: PAYPALEntry Class Code: WEB,99.0,,Posted,21.54,2021-11-24,99.0,Withdrawal ACH PAYPAL/TYPE: INST XFER ID: PAYPALSI77CO: PAYPALEntry Class Code: WEB,99.66333333333334
11/23/2021,,Withdrawal ACH WAWA CREDIT CARD/TYPE: ONLINE PMT ID: CITICTPCO: WAWA CREDIT CARDEntry Class Code: WEB,10.39,,Posted,120.54,2021-11-23,10.39,Withdrawal ACH WAWA CREDIT CARD/TYPE: PAYMENT ID: CITIGPUFDRCO: WAWA CREDIT CARDEntry Class Code: PPD,10.39
11/22/2021,,Withdrawal POS #000000000009/AMAZON.COM*J21CC2E03 SEATTLE WACard 2801,10.15,,Posted,130.93,2021-11-22,10.15,Withdrawal POS #000000000005/AMAZON.COM*HY2208FJ0 SEATTLE WACard 2801,10.15
11/22/2021,,Withdrawal Debit Card MC Debit/PUBLIX #1312 GAINESVILLE FLDate 11/21/21 0 1325259660 1 5411Card 2801,52.16,,Posted,141.08,2021-11-22,52.16,Withdrawal Debit Card MC Debit/PUBLIX #1312 GAINESVILLE FLDate 12/24/21 0 1358678113 1 5411Card 2801,52.16
11/22/2021,,Withdrawal ACH CAPITAL ONE/TYPE: MOBILE PMT ID: 9279744980CO: CAPITAL ONEEntry Class Code: WEB,25.0,,Posted,193.24,2021-11-22,25.0,Withdrawal ACH CAPITAL ONE/TYPE: MOBILE PMT ID: 9279744980CO: CAPITAL ONEEntry Class Code: WEB,25.0
11/22/2021,,Withdrawal ACH MYNOISE BV/CO: MYNOISE BVTYPE: IAT PAYPAL ID: 770510487CEntry Class Code: IAT,10.0,,Posted,218.24,2021-11-22,10.0,Withdrawal ACH MYNOISE BV/CO: MYNOISE BVTYPE: IAT PAYPAL ID: 770510487CEntry Class Code: IAT,10.0
11/22/2021,,Withdrawal ACH PAYPAL/TYPE: INST XFER ID: PAYPALSI77CO: PAYPALEntry Class Code: WEB,39.99,,Posted,228.24,2021-11-22,39.99,Withdrawal ACH PAYPAL/TYPE: INST XFER ID: PAYPALSI77CO: PAYPALEntry Class Code: WEB,39.656666666666666
11/22/2021,,Withdrawal ACH PAYPAL/TYPE: INST XFER ID: PAYPALSI77CO: PAYPALEntry Class Code: WEB,6.99,,Posted,268.23,2021-11-22,6.99,Withdrawal ACH PAYPAL/TYPE: INST XFER ID: PAYPALSI77CO: PAYPALEntry Class Code: WEB,6.995
11/21/2021,,Withdrawal POS #000000955321/SUNOCO 8002212501 4234 SW 20TH AVEGAINESVILLE FLCard 2801,19.24,,Posted,275.22,2021-11-21,19.24,Withdrawal POS #000000955321/SUNOCO 8002212501 4234 SW 20TH AVEGAINESVILLE FLCard 2801,19.24
11/19/2021,,Withdrawal ACH CAPITAL ONE/TYPE: MOBILE PMT ID: 9279744980CO: CAPITAL ONEEntry Class Code: WEB,25.0,,Posted,294.46,2021-11-19,25.0,Withdrawal ACH CAPITAL ONE/TYPE: MOBILE PMT ID: 9279744980CO: CAPITAL ONEEntry Class Code: WEB,25.0
11/18/2021,,Withdrawal POS #000000110304/GATE 1445 506 NW 1 GAINESVILLE FLCard 2801,22.98,,Posted,260.36,2021-11-18,22.98,Withdrawal POS #000000183316/GATE 1445 506 NW 13TH GAINESVILLE FLCard 2801,22.908
11/18/2021,,Withdrawal ACH PAYPAL/TYPE: INST XFER ID: PAYPALSI77CO: PAYPALEntry Class Code: WEB,29.0,,Posted,283.34,2021-11-18,29.0,Withdrawal ACH PAYPAL/TYPE: INST XFER ID: PAYPALSI77CO: PAYPALEntry Class Code: WEB,29.0
11/17/2021,,Withdrawal ACH PAYPAL INC./CO: PAYPAL INC.TYPE: IAT PAYPAL ID: 770510487CEntry Class Code: IAT,1.0,,Posted,240.87,2021-11-17,1.0,Withdrawal ACH PAYPAL INC./CO: PAYPAL INC.TYPE: IAT PAYPAL ID: 770510487CEntry Class Code: IAT,1.0
11/17/2021,,Withdrawal ACH PAYPAL/TYPE: INST XFER ID: PAYPALSI77CO: PAYPALEntry Class Code: WEB,100.47,,Posted,241.87,2021-11-17,100.47,Withdrawal ACH PAYPAL/TYPE: INST XFER ID: PAYPALSI77CO: PAYPALEntry Class Code: WEB,100.47
11/17/2021,,Withdrawal ACH DISCOVER/TYPE: E-PAYMENT ID: 2510020270CO: DISCOVEREntry Class Code: WEB,35.0,,Posted,342.34,2021-11-17,35.0,Withdrawal ACH DISCOVER/TYPE: E-PAYMENT ID: 2510020270CO: DISCOVEREntry Class Code: WEB,35.0
11/16/2021,,Withdrawal ATM Transaction,100.0,,Posted,314.34,2021-11-16,100.0,Withdrawal ATM Transaction,100.0
11/16/2021,,Withdrawal Debit Card MC Debit/PUBLIX #1312 GAINESVILLE FLDate 11/15/21 0 1319336042 1 5411Card 2801,55.11,,Posted,325.69,2021-11-16,55.11,Withdrawal Debit Card MC Debit/PUBLIX #1312 GAINESVILLE FLDate 06/18/21 0 1169764423 1 5411Card 2801,55.11
11/16/2021,,Withdrawal POS #000000750286/FAST TRACK #200 3960 SW ARCHER RDGAINESVILLE FLCard 2801,31.56,,Posted,198.58,2021-11-16,31.56,Withdrawal POS #000000166784/FAST TRACK #200 3960 SW ARCHER RDGAINESVILLE FLCard 2801,31.56
11/15/2021,,Withdrawal ACH BARCLAYCARD US/TYPE: CREDITCARD ID: 2510407970CO: BARCLAYCARD USEntry Class Code: WEB,80.0,,Posted,105.14,2021-11-15,80.0,Withdrawal ACH BARCLAYCARD US/TYPE: CREDITCARD ID: 2510407970 CO: BARCLAYCARD US Entry Class Code: WEB,80.0
11/14/2021,,Recurring Withdrawal Debit Card MC Debit/NETFLIX.COM 866-5797172 CADate 11/13/21 0 1317106681 1 4899Card 2801,9.88,,Posted,185.14,2021-11-14,9.88,Recurring Withdrawal Debit Card MC Debit/NETFLIX.COM 866-5797172 CADate 11/13/21 0 1317106681 1 4899Card 2801,9.88
11/12/2021,,Withdrawal Debit Card MC Debit/PUBLIX #1312 GAINESVILLE FLDate 11/11/21 0 1315441966 1 5411Card 2801,92.11,,Posted,195.02,2021-11-12,92.11,Withdrawal Debit Card MC Debit/PUBLIX #1312 GAINESVILLE FLDate 12/24/21 0 1358678113 1 5411Card 2801,92.11
11/12/2021,,Recurring Withdrawal Debit Card Fee/MASTERCARD ISSUER CROSS-BORDER FEEDate 11/11/21 0 1315054260 1 5817Card 2801,0.05,,Posted,287.13,2021-11-12,0.05,Recurring Withdrawal Debit Card Fee/MASTERCARD ISSUER CROSS-BORDER FEEDate 05/12/21 0 1132191600 1 7372Card 2801,0.09500000000000001
11/12/2021,,Recurring Withdrawal Debit Card MC Debit/PAYPAL *LINKTREE 4029357733 AUDate 11/11/21 0 1315054260 1 5817Card 2801,6.0,,Posted,287.18,2021-11-12,6.0,Recurring Withdrawal Debit Card MC Debit/PAYPAL *LINKTREE 4029357733 AUDate 05/12/21 0 1132191600 1 7372Card 2801,6.0
11/12/2021,,Withdrawal ACH PHOTOPEA/CO: PHOTOPEATYPE: IAT PAYPAL ID: 770510487CEntry Class Code: IAT,9.0,,Posted,293.18,2021-11-12,9.0,Withdrawal ACH PHOTOPEA/CO: PHOTOPEATYPE: IAT PAYPAL ID: 770510487CEntry Class Code: IAT,9.5
11/12/2021,,Withdrawal ACH PAYPAL/TYPE: INST XFER ID: PAYPALSI77CO: PAYPALEntry Class Code: WEB,9.99,,Posted,302.18,2021-11-12,9.99,Withdrawal ACH PAYPAL/TYPE: INST XFER ID: PAYPALSI77CO: PAYPALEntry Class Code: WEB,9.723333333333334
11/12/2021,,Withdrawal ACH PAYPAL/TYPE: INST XFER ID: PAYPALSI77CO: PAYPALEntry Class Code: WEB,9.18,,Posted,312.17,2021-11-12,9.18,Withdrawal ACH PAYPAL/TYPE: INST XFER ID: PAYPALSI77CO: PAYPALEntry Class Code: WEB,9.723333333333334
11/11/2021,,Withdrawal POS #000000547105/FAST TRACK #200 3960 SW ARCHER RDGAINESVILLE FLCard 2801,18.79,,Posted,321.35,2021-11-11,18.79,Withdrawal POS #000000418393/FAST TRACK #200 3960 SW ARCHER RDGAINESVILLE FLCard 2801,18.61
11/11/2021,,Withdrawal POS #000000790681/AMAZON.COM*1I32Z59U3 SEATTLE WACard 2801,10.15,,Posted,340.14,2021-11-11,10.15,Withdrawal POS #000000990788/AMAZON.COM*215VY1SG1 SEATTLE WACard 2801,10.15
11/10/2021,,Withdrawal POS #000000436271/SUNOCO 8002212501 4234 SW 20TH AVEGAINESVILLE FLCard 2801,22.44,,Posted,350.29,2021-11-10,22.44,Withdrawal POS #000000955321/SUNOCO 8002212501 4234 SW 20TH AVEGAINESVILLE FLCard 2801,22.569999999999997
11/10/2021,,Withdrawal POS #000000000000/AMAZON.COM*F02M82ZR3 SEATTLE WACard 2801,10.14,,Posted,372.73,2021-11-10,10.14,Withdrawal POS #000000000007/AMAZON.COM*2864R4HI1 SEATTLE WACard 1140,10.17
11/9/2021,,Withdrawal Debit Card MC Debit/ELDERSCROLLSONLINE. 855-296-3170 MDDate 11/09/21 0 1313300656 1 5816Card 2801,14.99,,Posted,382.87,2021-11-09,14.99,Withdrawal Debit Card MC Debit/ELDERSCROLLSONLINE. 855-296-3170 MDDate 11/09/21 0 1313300656 1 5816Card 2801,14.99
11/9/2021,,Withdrawal POS #000000000000/AMAZON.COM*7A1DQ5XY3 SEATTLE WACard 2801,22.98,,Posted,397.86,2021-11-09,22.98,Withdrawal POS #000000000000/AMAZON.COM*V40RU1143 SEATTLE WACard 2801,22.98
11/9/2021,,Withdrawal ACH PAYPAL/TYPE: INST XFER ID: PAYPALSI77CO: PAYPALEntry Class Code: WEB,2.99,,Posted,420.84,2021-11-09,2.99,Withdrawal ACH PAYPAL/TYPE: INST XFER ID: PAYPALSI77CO: PAYPALEntry Class Code: WEB,3.2266666666666666
11/9/2021,,Withdrawal POS #000000000006/AMAZON.COM*TS5A16DQ3 SEATTLE WACard 2801,20.07,,Posted,423.83,2021-11-09,20.07,Withdrawal POS #000000000023/AMAZON.COM*AU8ER6ZT3 SEATTLE WACard 2801,20.07
11/9/2021,,Withdrawal POS #000000024289/AMAZON.COM*784SZ89W3 SEATTLE WACard 2801,18.49,,Posted,443.9,2021-11-09,18.49,Withdrawal POS #000000247445/AMAZON.COM*A42ZY7OC3 SEATTLE WACard 2801,18.49
11/8/2021,,Withdrawal ACH PAYPAL/TYPE: INST XFER ID: PAYPALSI77CO: PAYPALEntry Class Code: WEB,24.99,,Posted,462.39,2021-11-08,24.99,Withdrawal ACH PAYPAL/TYPE: INST XFER ID: PAYPALSI77CO: PAYPALEntry Class Code: WEB,24.653333333333332
11/8/2021,,Withdrawal ACH PAYPAL/TYPE: INST XFER ID: PAYPALSI77CO: PAYPALEntry Class Code: WEB,12.0,,Posted,487.38,2021-11-08,12.0,Withdrawal ACH PAYPAL/TYPE: INST XFER ID: PAYPALSI77CO: PAYPALEntry Class Code: WEB,11.876666666666667
11/8/2021,,Recurring Withdrawal Bill Payment - #000032312626/PAYPAL *VIDIQ 2211 North First S SanCACard 2801,10.0,,Posted,499.38,2021-11-08,10.0,Recurring Withdrawal Bill Payment - #000045891971/PAYPAL *VIDIQ 2211 North First S SanCACard 2801,10.25
11/7/2021,,Withdrawal Debit Card MC Debit/WALGREENS #5024 800-289-2273 FLDate 11/05/21 0 1309931160 1 5912Card 2801,29.21,,Posted,509.38,2021-11-07,29.21,Withdrawal Debit Card MC Debit/WALGREENS #5024 800-289-2273 FLDate 05/21/22 0 2141999930 0 5912Card 2801,29.21
11/7/2021,,Withdrawal Debit Card MC Debit/AMAZON PRIME*QT9YK9973 AMZN.COM/BIL WADate 11/05/21 0 1309589789 2 5968Card 2801,13.08,,Posted,538.59,2021-11-07,13.08,Withdrawal Debit Card MC Debit/AMAZON PRIME*QT9YK9973 AMZN.COM/BIL WADate 11/05/21 0 1309589789 2 5968Card 2801,13.08
11/6/2021,,Withdrawal POS #000000099097/PUBLIX 5801 SW 75TH ST GAINESVILLE FLCard 2801,35.0,,Posted,551.67,2021-11-06,35.0,Withdrawal POS #000000036956/PUBLIX 5801 SW 75TH ST GAINESVILLE FLCard 2801,35.0
11/6/2021,,Withdrawal ATM Transaction,100.0,,Posted,586.67,2021-11-06,100.0,Withdrawal ATM Transaction,100.0
11/5/2021,,Withdrawal POS #000000015737/CIRCLE K # 06782 5 GAINESVILLE FLCard 2801,17.63,,Posted,686.67,2021-11-05,17.63,Withdrawal POS #000000882351/CIRCLE K # 06782 GAINESVILLE FLCard 1140,17.47
11/5/2021,,Withdrawal POS #000010337484/WALGREENS 2415 SW GAINESVILLE FLCard 2801,25.47,,Posted,704.3,2021-11-05,25.47,Withdrawal POS #000014264526/WALGREENS 2415 SW GAINESVILLE FLCard 2801,25.67
11/4/2021,,Withdrawal ACH PAYPAL/TYPE: INST XFER ID: PAYPALSI77CO: PAYPALEntry Class Code: WEB,14.95,,Posted,729.77,2021-11-04,14.95,Withdrawal ACH PAYPAL/TYPE: INST XFER ID: PAYPALSI77CO: PAYPALEntry Class Code: WEB,14.646666666666667
11/4/2021,,Withdrawal ACH PAYPAL/TYPE: INST XFER ID: PAYPALSI77CO: PAYPALEntry Class Code: WEB,2.99,,Posted,744.72,2021-11-04,2.99,Withdrawal ACH PAYPAL/TYPE: INST XFER ID: PAYPALSI77CO: PAYPALEntry Class Code: WEB,3.2266666666666666
11/2/2021,,Withdrawal Debit Card MC Debit/GRU/EZ-PAY WEB PYMT 352-334-3434 FLDate 11/01/21 0 1305577800 0 4900Card 2801,186.13,,Posted,747.71,2021-11-02,186.13,Withdrawal Debit Card MC Debit/GRU/EZ-PAY WEB PYMT 352-334-3434 FLDate 11/01/21 0 1305577800 0 4900Card 2801,186.13
11/2/2021,,Withdrawal ACH Watson Realty Co/TYPE: WEB PMTS ID: 9000321157CO: Watson Realty CoEntry Class Code: WEB,885.0,,Posted,933.84,2021-11-02,885.0,Withdrawal ACH Watson Realty Co/TYPE: WEB PMTS ID: 9000321157CO: Watson Realty CoEntry Class Code: WEB,885.0
11/2/2021,,Withdrawal ACH PAYPAL/TYPE: INST XFER ID: PAYPALSI77CO: PAYPALEntry Class Code: WEB,2.99,,Posted,1818.84,2021-11-02,2.99,Withdrawal ACH PAYPAL/TYPE: INST XFER ID: PAYPALSI77CO: PAYPALEntry Class Code: WEB,3.2266666666666666
11/1/2021,,Withdrawal Debit Card MC Debit/PUBLIX #1312 GAINESVILLE FLDate 10/31/21 0 1304501431 1 5411Card 2801,98.42,,Posted,1821.83,2021-11-01,98.42,Withdrawal Debit Card MC Debit/PUBLIX #1312 GAINESVILLE FLDate 12/24/21 0 1358678113 1 5411Card 2801,98.42
11/1/2021,,Withdrawal ACH BEST BUY/TYPE: PAYMENT ID: CITIGPUFDRCO: BEST BUYEntry Class Code: PPD,160.0,,Posted,1920.25,2021-11-01,160.0,Withdrawal ACH BEST BUY/TYPE: PAYMENT ID: CITIGPUFDRCO: BEST BUYEntry Class Code: TEL,160.0
11/1/2021,,Withdrawal ACH PAYPAL/TYPE: INST XFER ID: PAYPALSI77CO: PAYPALEntry Class Code: WEB,49.0,,Posted,2080.25,2021-11-01,49.0,Withdrawal ACH PAYPAL/TYPE: INST XFER ID: PAYPALSI77CO: PAYPALEntry Class Code: WEB,49.66
11/1/2021,,Withdrawal ACH PAYPAL/TYPE: INST XFER ID: PAYPALSI77CO: PAYPALEntry Class Code: WEB,24.99,,Posted,2129.25,2021-11-01,24.99,Withdrawal ACH PAYPAL/TYPE: INST XFER ID: PAYPALSI77CO: PAYPALEntry Class Code: WEB,24.653333333333332
11/1/2021,,Withdrawal ACH PAYPAL/TYPE: INST XFER ID: PAYPALSI77CO: PAYPALEntry Class Code: WEB,14.95,,Posted,2154.24,2021-11-01,14.95,Withdrawal ACH PAYPAL/TYPE: INST XFER ID: PAYPALSI77CO: PAYPALEntry Class Code: WEB,14.646666666666667
11/1/2021,,Withdrawal POS #000000062826/FAST TRACK #200 3960 SW ARCHER RDGAINESVILLE FLCard 2801,20.28,,Posted,2169.19,2021-11-01,20.28,Withdrawal POS #000000166784/FAST TRACK #200 3960 SW ARCHER RDGAINESVILLE FLCard 2801,19.865000000000002
10/30/2021,,Withdrawal POS #000000736697/AMAZON.COM*NF6QL3WJ3 SEATTLE WACard 2801,21.38,,Posted,2189.47,2021-10-30,21.38,Withdrawal POS #000000598647/AMAZON.COM*F565U8HW3 SEATTLE WACard 2801,20.89
10/29/2021,,Withdrawal ACH PAYPAL/TYPE: INST XFER ID: PAYPALSI77CO: PAYPALEntry Class Code: WEB,11.48,,Posted,2210.85,2021-10-29,11.48,Withdrawal ACH PAYPAL/TYPE: INST XFER ID: PAYPALSI77CO: PAYPALEntry Class Code: WEB,10.88
10/29/2021,,Withdrawal ACH PAYPAL/TYPE: INST XFER ID: PAYPALSI77CO: PAYPALEntry Class Code: WEB,2.99,,Posted,2222.33,2021-10-29,2.99,Withdrawal ACH PAYPAL/TYPE: INST XFER ID: PAYPALSI77CO: PAYPALEntry Class Code: WEB,3.2266666666666666
10/27/2021,,Recurring Withdrawal Debit Card MC Debit/HELP.HBOMAX.COM NEW YORK NYDate 10/27/21 0 1300655172 1 5815Card 2801,17.23,,Posted,2225.32,2021-10-27,17.23,Recurring Withdrawal Debit Card MC Debit/HELP.HBOMAX.COM NEW YORK NYDate 04/27/22 0 2117023223 1 5815Card 2801,17.23
10/27/2021,,Withdrawal ACH CANVA PTY LIMITE/CO: CANVA PTY LIMITEDTYPE: IAT PAYPAL ID: 770510487CEntry Class Code: IAT,12.99,,Posted,2242.55,2021-10-27,12.99,Withdrawal ACH CANVA PTY LIMITE/CO: CANVA PTY LIMITEDTYPE: IAT PAYPAL ID: 770510487CEntry Class Code: IAT,12.99
10/27/2021,,Withdrawal ACH PAYPAL/TYPE: INST XFER ID: PAYPALSI77CO: PAYPALEntry Class Code: WEB,2.99,,Posted,2255.54,2021-10-27,2.99,Withdrawal ACH PAYPAL/TYPE: INST XFER ID: PAYPALSI77CO: PAYPALEntry Class Code: WEB,3.2266666666666666
10/27/2021,,Withdrawal POS #000003510681/NNT URGENTVET - GAI000897 2680 CLARKBUTLER GAINESVILLE FLCard 2801,154.56,,Posted,258.53,2021-10-27,154.56,Withdrawal POS #000045519887/NNT URGENTVET - GAI002555 2680 CLARKBUTLER GAINESVILLE FLCard 2801,154.56
10/26/2021,,Withdrawal Debit Card MC Debit/COX GAINESVILLE COMM 800-234-3993 FLDate 10/25/21 0 1298159501 1 4899Card 2801,94.32,,Posted,413.09,2021-10-26,94.32,Withdrawal Debit Card MC Debit/COX GAINESVILLE COMM 800-234-3993 FLDate 01/27/22 0 2027240681 1 4899Card 2801,94.32
10/26/2021,,Withdrawal ACH PAYPAL/TYPE: INST XFER ID: PAYPALSI77CO: PAYPALEntry Class Code: WEB,39.99,,Posted,507.41,2021-10-26,39.99,Withdrawal ACH PAYPAL/TYPE: INST XFER ID: PAYPALSI77CO: PAYPALEntry Class Code: WEB,39.656666666666666
10/26/2021,,Withdrawal ACH PAYPAL/TYPE: INST XFER ID: PAYPALSI77CO: PAYPALEntry Class Code: WEB,39.99,,Posted,547.4,2021-10-26,39.99,Withdrawal ACH PAYPAL/TYPE: INST XFER ID: PAYPALSI77CO: PAYPALEntry Class Code: WEB,39.656666666666666
10/26/2021,,Withdrawal ACH PAYPAL/TYPE: INST XFER ID: PAYPALSI77CO: PAYPALEntry Class Code: WEB,4.99,,Posted,587.39,2021-10-26,4.99,Withdrawal ACH PAYPAL/TYPE: INST XFER ID: PAYPALSI77CO: PAYPALEntry Class Code: WEB,5.032
10/26/2021,,Withdrawal ACH PAYPAL/TYPE: INST XFER ID: PAYPALSI77CO: PAYPALEntry Class Code: WEB,4.5,,Posted,592.38,2021-10-26,4.5,Withdrawal ACH PAYPAL/TYPE: INST XFER ID: PAYPALSI77CO: PAYPALEntry Class Code: WEB,5.032
10/26/2021,,Withdrawal ACH PAYPAL/TYPE: INST XFER ID: PAYPALSI77CO: PAYPALEntry Class Code: WEB,2.99,,Posted,596.88,2021-10-26,2.99,Withdrawal ACH PAYPAL/TYPE: INST XFER ID: PAYPALSI77CO: PAYPALEntry Class Code: WEB,3.2266666666666666
10/25/2021,,Withdrawal ATM Transaction,100.0,,Posted,497.43,2021-10-25,100.0,Withdrawal ATM Transaction,100.0
10/25/2021,,Withdrawal POS #000000006078/CIRCLE K # 26162 7 GAINESVILLE FLCard 2801,41.18,,Posted,497.43,2021-10-25,41.18,Withdrawal POS #000000001638/CIRCLE K # 06527 9404 GAINESVILLE FLCard 2801,41.18
10/25/2021,,Recurring Withdrawal Debit Card MC Debit/WELLSAID LABS SEATTLE WADate 10/24/21 0 1297467927 1 5734Card 2801,49.0,,Posted,538.61,2021-10-25,49.0,Recurring Withdrawal Debit Card MC Debit/WELLSAID LABS SEATTLE WADate 11/24/21 0 1328159011 1 5734Card 2801,49.0
10/25/2021,,Withdrawal Debit Card MC Debit/KINDLE UNLTD*V90GA4Y53 866-321-8851 WADate 10/25/21 0 1298659612 1 5818Card 2801,9.99,,Posted,587.61,2021-10-25,9.99,Withdrawal Debit Card MC Debit/KINDLE UNLTD*439YD1353 866-321-8851 WADate 11/24/21 0 1328430085 1 5818Card 2801,9.99
10/25/2021,,Withdrawal ACH PAYPAL/TYPE: INST XFER ID: PAYPALSI77CO: PAYPALEntry Class Code: WEB,99.0,,Posted,597.6,2021-10-25,99.0,Withdrawal ACH PAYPAL/TYPE: INST XFER ID: PAYPALSI77CO: PAYPALEntry Class Code: WEB,99.66333333333334
10/25/2021,,Withdrawal ACH PAYPAL/TYPE: INST XFER ID: PAYPALSI77CO: PAYPALEntry Class Code: WEB,14.0,,Posted,696.6,2021-10-25,14.0,Withdrawal ACH PAYPAL/TYPE: INST XFER ID: PAYPALSI77CO: PAYPALEntry Class Code: WEB,14.646666666666667
10/25/2021,,Withdrawal POS #000000765754/FAST TRACK #200 3960 SW ARCHER RDGAINESVILLE FLCard 2801,23.6,,Posted,710.6,2021-10-25,23.6,Withdrawal POS #000000166784/FAST TRACK #200 3960 SW ARCHER RDGAINESVILLE FLCard 2801,23.6
10/25/2021,,Withdrawal POS #000000039469/PUBLIX 3930 SW ARCHER ROA GAINESVILLE FLCard 2801,20.43,,Posted,734.2,2021-10-25,20.43,Withdrawal POS #000000029500/PUBLIX 3930 SW ARCHER ROA GAINESVILLE FLCard 2801,20.43
10/22/2021,,Withdrawal ACH PAYPAL/TYPE: INST XFER ID: PAYPALSI77CO: PAYPALEntry Class Code: WEB,24.99,,Posted,354.63,2021-10-22,24.99,Withdrawal ACH PAYPAL/TYPE: INST XFER ID: PAYPALSI77CO: PAYPALEntry Class Code: WEB,24.653333333333332
10/21/2021,,Withdrawal POS #000000529868/FAST TRACK #200 3960 SW ARCHER RDGAINESVILLE FLCard 2801,14.21,,Posted,379.62,2021-10-21,14.21,Withdrawal POS #000000194488/FAST TRACK #200 3960 SW ARCHER RDGAINESVILLE FLCard 1140,14.350000000000001
10/21/2021,,Withdrawal ACH PAYPAL INC./CO: PAYPAL INC.TYPE: IAT PAYPAL ID: 770510487CEntry Class Code: IAT,13.0,,Posted,393.83,2021-10-21,13.0,Withdrawal ACH PAYPAL INC./CO: PAYPAL INC.TYPE: IAT PAYPAL ID: 770510487CEntry Class Code: IAT,13.0
10/21/2021,,Withdrawal ACH PAYPAL/TYPE: INST XFER ID: PAYPALSI77CO: PAYPALEntry Class Code: WEB,11.64,,Posted,406.83,2021-10-21,11.64,Withdrawal ACH PAYPAL/TYPE: INST XFER ID: PAYPALSI77CO: PAYPALEntry Class Code: WEB,11.876666666666667
10/21/2021,,Withdrawal ACH PAYPAL/TYPE: INST XFER ID: PAYPALSI77CO: PAYPALEntry Class Code: WEB,6.99,,Posted,418.47,2021-10-21,6.99,Withdrawal ACH PAYPAL/TYPE: INST XFER ID: PAYPALSI77CO: PAYPALEntry Class Code: WEB,6.995
10/20/2021,,Withdrawal ACH BEST BUY/TYPE: PAYMENT ID: CITIGPUFDRCO: BEST BUYEntry Class Code: PPD,75.0,,Posted,75.46,2021-10-20,75.0,Withdrawal ACH BEST BUY/TYPE: PAYMENT ID: CITIGPUFDRCO: BEST BUYEntry Class Code: TEL,75.0
10/19/2021,,Withdrawal ACH PAYPAL INC./CO: PAYPAL INC.TYPE: IAT PAYPAL ID: 770510487CEntry Class Code: IAT,21.0,,Posted,150.46,2021-10-19,21.0,Withdrawal ACH PAYPAL INC./CO: PAYPAL INC.TYPE: IAT PAYPAL ID: 770510487CEntry Class Code: IAT,20.5
10/19/2021,,Withdrawal ACH PAYPAL/TYPE: INST XFER ID: PAYPALSI77CO: PAYPALEntry Class Code: WEB,29.0,,Posted,171.46,2021-10-19,29.0,Withdrawal ACH PAYPAL/TYPE: INST XFER ID: PAYPALSI77CO: PAYPALEntry Class Code: WEB,29.0
10/19/2021,,Withdrawal ACH PAYPAL/TYPE: INST XFER ID: PAYPALSI77CO: PAYPALEntry Class Code: WEB,2.99,,Posted,200.46,2021-10-19,2.99,Withdrawal ACH PAYPAL/TYPE: INST XFER ID: PAYPALSI77CO: PAYPALEntry Class Code: WEB,3.2266666666666666
10/18/2021,,Withdrawal Debit Card MC Debit/PUBLIX #527 GAINESVILLE FLDate 10/17/21 0 1290523534 1 5411Card 2801,46.9,,Posted,203.45,2021-10-18,46.9,Withdrawal Debit Card MC Debit/PUBLIX #795 GAINESVILLE FLDate 03/07/22 0 2066965570 0 5411Card 2801,46.9
10/18/2021,,Withdrawal ACH PAYPAL/TYPE: INST XFER ID: PAYPALSI77CO: PAYPALEntry Class Code: WEB,108.95,,Posted,250.35,2021-10-18,108.95,Withdrawal ACH PAYPAL/TYPE: INST XFER ID: PAYPALSI77CO: PAYPALEntry Class Code: WEB,108.95
10/18/2021,,Withdrawal ACH PAYPAL/TYPE: INST XFER ID: PAYPALSI77CO: PAYPALEntry Class Code: WEB,50.0,,Posted,359.3,2021-10-18,50.0,Withdrawal ACH PAYPAL/TYPE: INST XFER ID: PAYPALSI77CO: PAYPALEntry Class Code: WEB,49.66
10/17/2021,,Withdrawal POS #000000181598/AMAZON.COM*2Y1M14JQ1 SEATTLE WACard 2801,34.22,,Posted,409.3,2021-10-17,34.22,Withdrawal POS #000000990788/AMAZON.COM*215VY1SG1 SEATTLE WACard 2801,34.22
10/17/2021,,Withdrawal POS #000000021687/CIRCLE K # 21142 3 GAINESVILLE FLCard 2801,19.08,,Posted,443.52,2021-10-17,19.08,Withdrawal POS #000000882351/CIRCLE K # 06782 GAINESVILLE FLCard 1140,19.08
10/17/2021,,Withdrawal POS #000000006950/CIRCLE K # 26162 7 GAINESVILLE FLCard 2801,17.63,,Posted,462.6,2021-10-17,17.63,Withdrawal POS #000000001638/CIRCLE K # 06527 9404 GAINESVILLE FLCard 2801,17.549999999999997
10/17/2021,,Recurring Withdrawal Debit Card MC Debit/JARVIS - CONVERSION.AI AUSTIN TXDate 10/16/21 0 1289123474 1 7399Card 2801,119.0,,Posted,480.23,2021-10-17,119.0,Recurring Withdrawal Debit Card MC Debit/JARVIS - CONVERSION.AI AUSTIN TXDate 12/16/21 0 1350165435 1 7399Card 2801,119.0
10/17/2021,,Withdrawal Debit Card MC Debit/COUNTRY CRITTERS - 3 GAINESVILLE FLDate 10/14/21 0 1287686337 4 0742Card 2801,141.5,,Posted,599.23,2021-10-17,141.5,Withdrawal Debit Card MC Debit/COUNTRY CRITTERS - 3 GAINESVILLE FLDate 10/14/21 0 1287686337 4 0742Card 2801,141.5
10/16/2021,,Withdrawal POS #000000031532/CIRCLE K # 26146 3 GAINESVILLE FLCard 2801,17.74,,Posted,740.73,2021-10-16,17.74,Withdrawal POS #000000011248/CIRCLE K # 23913 3424 GAINESVILLE FLCard 2801,17.36
10/16/2021,,Withdrawal POS #000000368530/FAST TRACK #200 3960 SW ARCHER RDGAINESVILLE FLCard 2801,9.63,,Posted,758.47,2021-10-16,9.63,Withdrawal POS #000000418393/FAST TRACK #200 3960 SW ARCHER RDGAINESVILLE FLCard 2801,9.420000000000002
10/15/2021,,Recurring Withdrawal Debit Card MC Debit/RYTR - AI WRITER WALNUT CADate 10/14/21 0 1287521485 0 7399Card 2801,29.0,,Posted,768.1,2021-10-15,29.0,Recurring Withdrawal Debit Card MC Debit/RYTR - AI WRITER WALNUT CADate 10/14/21 0 1287521485 0 7399Card 2801,29.0
10/15/2021,,Withdrawal ACH PAYPAL/TYPE: INST XFER ID: PAYPALSI77CO: PAYPALEntry Class Code: WEB,131.83,,Posted,797.1,2021-10-15,131.83,Withdrawal ACH PAYPAL/TYPE: INST XFER ID: PAYPALSI77CO: PAYPALEntry Class Code: WEB,131.83
10/15/2021,,Withdrawal POS #000000267441/FAST TRACK #200 3960 SW ARCHER RDGAINESVILLE FLCard 2801,12.18,,Posted,928.93,2021-10-15,12.18,Withdrawal POS #000000194488/FAST TRACK #200 3960 SW ARCHER RDGAINESVILLE FLCard 1140,12.175
10/14/2021,,Recurring Withdrawal Debit Card MC Debit/NETFLIX.COM 866-5797172 CADate 10/13/21 0 1286180130 1 4899Card 2801,9.88,,Posted,191.11,2021-10-14,9.88,Recurring Withdrawal Debit Card MC Debit/NETFLIX.COM 866-5797172 CADate 11/13/21 0 1317106681 1 4899Card 2801,9.88
10/14/2021,,Withdrawal ACH APPLECARD GSBANK/TYPE: PAYMENT ID: 9999999999CO: APPLECARD GSBANKEntry Class Code: WEB,80.0,,Posted,200.99,2021-10-14,80.0,Withdrawal ACH APPLECARD GSBANK/TYPE: PAYMENT ID: 9999999999 CO: APPLECARD GSBANK Entry Class Code: WEB,80.0
10/14/2021,,Withdrawal ACH DENES HALLOK/CO: DENES HALLOKTYPE: IAT PAYPAL ID: 770510487CEntry Class Code: IAT,2.0,,Posted,280.99,2021-10-14,2.0,Withdrawal ACH ENVATO/CO: ENVATOTYPE: IAT PAYPAL ID: 770510487CEntry Class Code: IAT,2.0
10/14/2021,,Withdrawal ACH PAYPAL/TYPE: INST XFER ID: PAYPALSI77CO: PAYPALEntry Class Code: WEB,33.17,,Posted,282.99,2021-10-14,33.17,Withdrawal ACH PAYPAL/TYPE: INST XFER ID: PAYPALSI77CO: PAYPALEntry Class Code: WEB,33.443333333333335
10/13/2021,102.0,Draft 102,860.0,,Posted,316.16,2021-10-13,860.0,Draft 102,860.0
10/13/2021,,Withdrawal POS #000000259511/AMAZON.COM*2776K9KH0 SEATTLE WACard 2801,37.44,,Posted,1176.16,2021-10-13,37.44,Withdrawal POS #000000259511/AMAZON.COM*2776K9KH0 SEATTLE WACard 2801,37.44
10/13/2021,,Withdrawal Debit Card MC Debit/PUBLIX #1312 GAINESVILLE FLDate 10/12/21 0 1285617424 1 5411Card 2801,80.41,,Posted,1213.6,2021-10-13,80.41,Withdrawal Debit Card MC Debit/PUBLIX #1312 GAINESVILLE FLDate 05/28/21 0 1148028662 2 5411Card 2801,80.41
10/13/2021,,Withdrawal Debit Card MC Debit/WALGREENS #5024 800-289-2273 FLDate 10/12/21 0 1285542496 1 5912Card 2801,4.5,,Posted,1294.01,2021-10-13,4.5,Withdrawal Debit Card MC Debit/WALGREENS #5024 800-289-2273 FLDate 12/19/22 0 2353181854 1 5912Card 2801,4.5
10/12/2021,,Recurring Withdrawal Debit Card Fee/MASTERCARD ISSUER CROSS-BORDER FEEDate 10/11/21 0 1284171856 1 5817Card 2801,0.05,,Posted,1298.51,2021-10-12,0.05,Recurring Withdrawal Debit Card Fee/MASTERCARD ISSUER CROSS-BORDER FEEDate 05/12/21 0 1132191600 1 7372Card 2801,0.09500000000000001
10/12/2021,,Recurring Withdrawal Debit Card MC Debit/PAYPAL *LINKTREE 4029357733 AUDate 10/11/21 0 1284171856 1 5817Card 2801,6.0,,Posted,1298.56,2021-10-12,6.0,Recurring Withdrawal Debit Card MC Debit/PAYPAL *LINKTREE 4029357733 AUDate 05/12/21 0 1132191600 1 7372Card 2801,6.0
10/12/2021,,Withdrawal Debit Card MC Debit/ELDERSCROLLSONLINE. 855-296-3170 MDDate 10/11/21 0 1284168828 1 7994Card 2801,14.99,,Posted,1304.56,2021-10-12,14.99,Withdrawal Debit Card MC Debit/ELDERSCROLLSONLINE. 855-296-3170 MDDate 11/09/21 0 1313300656 1 5816Card 2801,14.99
10/12/2021,,Withdrawal ACH BARCLAYCARD US/TYPE: CREDITCARD ID: 2510407970CO: BARCLAYCARD USEntry Class Code: WEB,82.94,,Posted,1319.55,2021-10-12,82.94,Withdrawal ACH BARCLAYCARD US/TYPE: CREDITCARD ID: 2510407970 CO: BARCLAYCARD US Entry Class Code: WEB,82.94
10/12/2021,,Withdrawal ACH CAPITAL ONE/TYPE: MOBILE PMT ID: 9279744980CO: CAPITAL ONEEntry Class Code: WEB,50.0,,Posted,1402.49,2021-10-12,50.0,Withdrawal ACH CAPITAL ONE/TYPE: MOBILE PMT ID: 9279744980CO: CAPITAL ONEEntry Class Code: WEB,50.0
10/12/2021,,Withdrawal ACH DISCOVER/TYPE: E-PAYMENT ID: 2510020270CO: DISCOVEREntry Class Code: WEB,65.0,,Posted,1452.49,2021-10-12,65.0,Withdrawal ACH DISCOVER/TYPE: E-PAYMENT ID: 2510020270CO: DISCOVEREntry Class Code: WEB,65.0
10/12/2021,,Withdrawal ACH PAYMENT FOR AMZ/TYPE: STORECARD ID: 9069872103CO: PAYMENT FOR AMZEntry Class Code: WEB,50.0,,Posted,1517.49,2021-10-12,50.0,Withdrawal ACH PAYMENT FOR AMZ/TYPE: STORECARD ID: 9069872103 CO: PAYMENT FOR AMZ Entry Class Code: WEB,50.0
10/12/2021,,Withdrawal ACH TARGET CARD SRVC/TYPE: BILL PAY ID: T510215170CO: TARGET CARD SRVCEntry Class Code: WEB,50.0,,Posted,1567.49,2021-10-12,50.0,Withdrawal ACH TARGET CARD SRVC/TYPE: BILL PAY ID: T510215170CO: TARGET CARD SRVCEntry Class Code: WEB,50.0
10/12/2021,,Withdrawal ACH DISCOVER/TYPE: E-PAYMENT ID: 2510020270CO: DISCOVEREntry Class Code: WEB,15.0,,Posted,1617.49,2021-10-12,15.0,Withdrawal ACH DISCOVER/TYPE: E-PAYMENT ID: 2510020270CO: DISCOVEREntry Class Code: WEB,15.0
10/12/2021,,Withdrawal ACH PAYPAL/TYPE: INST XFER ID: PAYPALSI77CO: PAYPALEntry Class Code: WEB,9.99,,Posted,1632.49,2021-10-12,9.99,Withdrawal ACH PAYPAL/TYPE: INST XFER ID: PAYPALSI77CO: PAYPALEntry Class Code: WEB,9.723333333333334
10/12/2021,,Withdrawal ACH PAYPAL/TYPE: INST XFER ID: PAYPALSI77CO: PAYPALEntry Class Code: WEB,9.18,,Posted,1642.48,2021-10-12,9.18,Withdrawal ACH PAYPAL/TYPE: INST XFER ID: PAYPALSI77CO: PAYPALEntry Class Code: WEB,9.723333333333334
10/12/2021,,Withdrawal ACH PAYPAL/TYPE: INST XFER ID: PAYPALSI77CO: PAYPALEntry Class Code: WEB,2.99,,Posted,1651.66,2021-10-12,2.99,Withdrawal ACH PAYPAL/TYPE: INST XFER ID: PAYPALSI77CO: PAYPALEntry Class Code: WEB,3.2266666666666666
10/12/2021,,Withdrawal ACH PAYPAL/TYPE: INST XFER ID: PAYPALSI77CO: PAYPALEntry Class Code: WEB,0.99,,Posted,1654.65,2021-10-12,0.99,Withdrawal ACH PAYPAL/TYPE: INST XFER ID: PAYPALSI77CO: PAYPALEntry Class Code: WEB,0.835
10/12/2021,,Withdrawal POS #000000838593/FAST TRACK #200 3960 SW ARCHER RDGAINESVILLE FLCard 2801,23.6,,Posted,1655.64,2021-10-12,23.6,Withdrawal POS #000000194488/FAST TRACK #200 3960 SW ARCHER RDGAINESVILLE FLCard 1140,23.51
10/9/2021,,Withdrawal POS #000000028122/FAST TRACK #200 3960 SW ARCHER RDGAINESVILLE FLCard 2801,23.6,,Posted,1679.24,2021-10-09,23.6,Withdrawal POS #000000374038/FAST TRACK #200 3960 SW ARCHER RDGAINESVILLE FLCard 2801,23.6
10/8/2021,,Withdrawal POS #000000099004/PUBLIX 5801 SW 75TH ST GAINESVILLE FLCard 2801,31.65,,Posted,1702.84,2021-10-08,31.65,Withdrawal POS #000000036956/PUBLIX 5801 SW 75TH ST GAINESVILLE FLCard 2801,31.744999999999997
10/8/2021,,Withdrawal Debit Card MC Debit/WALGREENS #5024 800-289-2273 FLDate 10/07/21 0 1280804151 1 5912Card 2801,15.0,,Posted,1734.49,2021-10-08,15.0,Withdrawal Debit Card MC Debit/WALGREENS #5024 800-289-2273 FLDate 12/19/22 0 2353181854 1 5912Card 2801,15.0
10/8/2021,,Recurring Withdrawal Bill Payment - #000014463277/PAYPAL *VIDIQ 2211 North First S SanCACard 2801,10.0,,Posted,1749.49,2021-10-08,10.0,Recurring Withdrawal Bill Payment - #000045891971/PAYPAL *VIDIQ 2211 North First S SanCACard 2801,10.25
10/7/2021,,Withdrawal POS #000000005212/CIRCLE K # 06782 5 GAINESVILLE FLCard 2801,23.36,,Posted,1759.49,2021-10-07,23.36,Withdrawal POS #000000882351/CIRCLE K # 06782 GAINESVILLE FLCard 1140,23.515
10/6/2021,,Withdrawal POS #000015449112/WALGREENS 2415 SW GAINESVILLE FLCard 2801,19.45,,Posted,1782.85,2021-10-06,19.45,Withdrawal POS #000014264526/WALGREENS 2415 SW GAINESVILLE FLCard 2801,19.52
10/6/2021,,Recurring Withdrawal Debit Card MC Debit/PLAYERAUCTIONS 800-342-0768 DEDate 10/05/21 0 1278513790 1 7993Card 2801,129.21,,Posted,1802.3,2021-10-06,129.21,Recurring Withdrawal Debit Card MC Debit/PLAYERAUCTIONS 800-342-0768 DEDate 09/23/21 0 1266586911 1 7993Card 2801,129.21
10/6/2021,,Recurring Withdrawal Debit Card MC Debit/AMAZON PRIME*279H43C10 AMZN.COM/BIL WADate 10/05/21 0 1278183532 1 5968Card 2801,13.08,,Posted,1931.51,2021-10-06,13.08,Recurring Withdrawal Debit Card MC Debit/AMAZON PRIME*2E90R5DC2 AMZN.COM/BIL WADate 07/27/21 0 1208211269 1 5968Card 2801,13.085
10/6/2021,,Withdrawal ACH PAYPAL/TYPE: INST XFER ID: PAYPALSI77CO: PAYPALEntry Class Code: WEB,58.0,,Posted,1944.59,2021-10-06,58.0,Withdrawal ACH PAYPAL/TYPE: INST XFER ID: PAYPALSI77CO: PAYPALEntry Class Code: WEB,57.705
10/5/2021,,Withdrawal POS #000000098717/GATE 1445 506 NW 1 GAINESVILLE FLCard 2801,18.17,,Posted,2002.59,2021-10-05,18.17,Withdrawal POS #000000183316/GATE 1445 506 NW 13TH GAINESVILLE FLCard 2801,18.346666666666668
10/5/2021,,Withdrawal ACH PAYPAL/TYPE: INST XFER ID: PAYPALSI77CO: PAYPALEntry Class Code: WEB,14.95,,Posted,2020.76,2021-10-05,14.95,Withdrawal ACH PAYPAL/TYPE: INST XFER ID: PAYPALSI77CO: PAYPALEntry Class Code: WEB,14.646666666666667
10/5/2021,,Withdrawal ACH PAYPAL/TYPE: INST XFER ID: PAYPALSI77CO: PAYPALEntry Class Code: WEB,2.99,,Posted,2035.71,2021-10-05,2.99,Withdrawal ACH PAYPAL/TYPE: INST XFER ID: PAYPALSI77CO: PAYPALEntry Class Code: WEB,3.2266666666666666
10/4/2021,,Withdrawal Debit Card MC Debit/PIZZA HUT 27918 3523739402 FLDate 10/03/21 0 1276852449 4 5812Card 2801,39.4,,Posted,2038.7,2021-10-04,39.4,Withdrawal Debit Card MC Debit/PIZZA HUT 27918 3523739402 FLDate 12/16/22 0 2350808582 1 5812Card 2801,38.876666666666665
10/4/2021,,Withdrawal Debit Card MC Debit/AMZN DIGITAL 888-802-3 888-802-3080 WADate 10/03/21 0 1276845465 4 5818Card 2801,49.99,,Posted,2078.1,2021-10-04,49.99,Withdrawal Debit Card MC Debit/AMZN DIGITAL 888-802-3 888-802-3080 WADate 10/03/21 0 1276845465 4 5818Card 2801,49.99
10/4/2021,,Withdrawal ACH TARGET CARD SRVC/TYPE: BILL PAY ID: T510215170CO: TARGET CARD SRVCEntry Class Code: WEB,105.0,,Posted,2128.09,2021-10-04,105.0,Withdrawal ACH TARGET CARD SRVC/TYPE: BILL PAY ID: T510215170CO: TARGET CARD SRVCEntry Class Code: WEB,105.0
10/4/2021,,Withdrawal ACH PAYMENT FOR AMZ/TYPE: STORECARD ID: 9069872103CO: PAYMENT FOR AMZEntry Class Code: WEB,100.0,,Posted,2233.09,2021-10-04,100.0,Withdrawal ACH PAYMENT FOR AMZ/TYPE: STORECARD ID: 9069872103 CO: PAYMENT FOR AMZ Entry Class Code: WEB,100.0
10/4/2021,,Withdrawal ACH PAYPAL/TYPE: INST XFER ID: PAYPALSI77CO: PAYPALEntry Class Code: WEB,99.99,,Posted,2333.09,2021-10-04,99.99,Withdrawal ACH PAYPAL/TYPE: INST XFER ID: PAYPALSI77CO: PAYPALEntry Class Code: WEB,99.66333333333334
10/4/2021,,Withdrawal ACH PAYPAL/TYPE: INST XFER ID: PAYPALSI77CO: PAYPALEntry Class Code: WEB,2.99,,Posted,2433.08,2021-10-04,2.99,Withdrawal ACH PAYPAL/TYPE: INST XFER ID: PAYPALSI77CO: PAYPALEntry Class Code: WEB,3.2266666666666666
10/3/2021,,Withdrawal POS #000000027220/CIRCLE K # 26146 3 GAINESVILLE FLCard 2801,23.5,,Posted,2436.07,2021-10-03,23.5,Withdrawal POS #000000011248/CIRCLE K # 23913 3424 GAINESVILLE FLCard 2801,23.5
10/3/2021,,Withdrawal ATM Transaction,200.0,,Posted,2459.57,2021-10-03,200.0,Withdrawal ATM Transaction,200.0
10/3/2021,,Withdrawal POS #000009352704/WALGREENS 2415 SW GAINESVILLE FLCard 2801,19.78,,Posted,2659.57,2021-10-03,19.78,Withdrawal POS #000014264526/WALGREENS 2415 SW GAINESVILLE FLCard 2801,19.52
10/1/2021,,Withdrawal ACH PAYPAL INC./CO: PAYPAL INC.TYPE: IAT PAYPAL ID: 770510487CEntry Class Code: IAT,59.99,,Posted,2679.35,2021-10-01,59.99,Withdrawal ACH PAYPAL INC./CO: PAYPAL INC.TYPE: IAT PAYPAL ID: 770510487CEntry Class Code: IAT,59.99
10/1/2021,,Withdrawal ACH PAYPAL/TYPE: INST XFER ID: PAYPALSI77CO: PAYPALEntry Class Code: WEB,14.95,,Posted,2739.34,2021-10-01,14.95,Withdrawal ACH PAYPAL/TYPE: INST XFER ID: PAYPALSI77CO: PAYPALEntry Class Code: WEB,14.646666666666667
9/30/2021,,Withdrawal Debit Card MC Debit/COUNTRY CRITTERS - 3 GAINESVILLE FLDate 09/29/21 0 1272704417 1 0742Card 2801,388.86,,Posted,2754.29,2021-09-30,388.86,Withdrawal Debit Card MC Debit/COUNTRY CRITTERS - 3 GAINESVILLE FLDate 10/14/21 0 1287686337 4 0742Card 2801,388.86
9/30/2021,,Withdrawal ACH PAYPAL/TYPE: INST XFER ID: PAYPALSI77CO: PAYPALEntry Class Code: WEB,19.99,,Posted,1143.15,2021-09-30,19.99,Withdrawal ACH PAYPAL/TYPE: INST XFER ID: PAYPALSI77CO: PAYPALEntry Class Code: WEB,19.99
9/29/2021,,Withdrawal POS #000015101412/GAINESVILLE RURAL KING 2801 NW 13TH STGAINESVILLE FLCard 2801,10.68,,Posted,1163.14,2021-09-29,10.68,Withdrawal POS #000015101412/GAINESVILLE RURAL KING 2801 NW 13TH STGAINESVILLE FLCard 2801,10.68
9/29/2021,,Withdrawal ACH PAYPAL INC./CO: PAYPAL INC.TYPE: IAT PAYPAL ID: 770510487CEntry Class Code: IAT,4.95,,Posted,62.71,2021-09-29,4.95,Withdrawal ACH PAYPAL INC./CO: PAYPAL INC.TYPE: IAT PAYPAL ID: 770510487CEntry Class Code: IAT,4.470000000000001
9/29/2021,,Withdrawal ACH PAYPAL INC./CO: PAYPAL INC.TYPE: IAT PAYPAL ID: 770510487CEntry Class Code: IAT,3.99,,Posted,67.66,2021-09-29,3.99,Withdrawal ACH PAYPAL INC./CO: PAYPAL INC.TYPE: IAT PAYPAL ID: 770510487CEntry Class Code: IAT,4.470000000000001
9/29/2021,,Withdrawal ACH TARGET CARD SRVC/TYPE: BILL PAY ID: T510215170CO: TARGET CARD SRVCEntry Class Code: WEB,105.0,,Posted,71.65,2021-09-29,105.0,Withdrawal ACH TARGET CARD SRVC/TYPE: BILL PAY ID: T510215170CO: TARGET CARD SRVCEntry Class Code: WEB,105.0
9/29/2021,,Withdrawal Transfer fee,8.0,,Posted,176.65,2021-09-29,8.0,Withdrawal Transfer fee,8.0
9/29/2021,,Withdrawal ACH PAYPAL/TYPE: INST XFER ID: PAYPALSI77CO: PAYPALEntry Class Code: WEB,11.48,,Posted,84.65,2021-09-29,11.48,Withdrawal ACH PAYPAL/TYPE: INST XFER ID: PAYPALSI77CO: PAYPALEntry Class Code: WEB,10.88
9/29/2021,,Withdrawal ACH PAYPAL/TYPE: INST XFER ID: PAYPALSI77CO: PAYPALEntry Class Code: WEB,2.99,,Posted,96.13,2021-09-29,2.99,Withdrawal ACH PAYPAL/TYPE: INST XFER ID: PAYPALSI77CO: PAYPALEntry Class Code: WEB,3.2266666666666666
9/28/2021,,Withdrawal Debit Card MC Debit/EIG*BLUEHOST.COM 888-4014678 UTDate 09/27/21 0 1270381943 1 5968Card 2801,59.4,,Posted,99.12,2021-09-28,59.4,Withdrawal Debit Card MC Debit/EIG*BLUEHOST.COM 888-4014678 UTDate 09/27/21 0 1270381943 1 5968Card 2801,59.4
9/28/2021,,Recurring Withdrawal Debit Card MC Debit/EIG*BLUEHOST.COM 888-4014678 UTDate 09/27/21 0 1270381942 1 5968Card 2801,13.75,,Posted,158.52,2021-09-28,13.75,Withdrawal Debit Card MC Debit/EIG*BLUEHOST.COM 888-4014678 UTDate 09/27/21 0 1270381943 1 5968Card 2801,13.75
9/28/2021,,Withdrawal Debit Card MC Debit/GRU/EZ-PAY WEB PYMT 352-334-3434 FLDate 09/27/21 0 1270573814 0 4900Card 2801,161.9,,Posted,172.27,2021-09-28,161.9,Withdrawal Debit Card MC Debit/GRU/EZ-PAY WEB PYMT 352-334-3434 FLDate 11/01/21 0 1305577800 0 4900Card 2801,161.9
9/28/2021,,Withdrawal ACH PAYPAL/TYPE: INST XFER ID: PAYPALSI77CO: PAYPALEntry Class Code: WEB,80.24,,Posted,334.17,2021-09-28,80.24,Withdrawal ACH PAYPAL/TYPE: INST XFER ID: PAYPALSI77CO: PAYPALEntry Class Code: WEB,80.24
9/28/2021,,Withdrawal ACH PAYPAL/TYPE: INST XFER ID: PAYPALSI77CO: PAYPALEntry Class Code: WEB,2.99,,Posted,414.41,2021-09-28,2.99,Withdrawal ACH PAYPAL/TYPE: INST XFER ID: PAYPALSI77CO: PAYPALEntry Class Code: WEB,3.2266666666666666
9/27/2021,,Withdrawal Debit Card MC Debit/IBLOCKLIST.COM MIAMI FLDate 09/26/21 0 1269652765 4 7372Card 2801,9.99,,Posted,417.4,2021-09-27,9.99,Withdrawal Debit Card MC Debit/IBLOCKLIST.COM MIAMI FLDate 09/26/21 0 1269652765 4 7372Card 2801,9.99
9/27/2021,,Recurring Withdrawal Debit Card MC Debit/HELP.HBOMAX.COM NEW YORK NYDate 09/27/21 0 1270428361 1 5815Card 2801,17.23,,Posted,427.39,2021-09-27,17.23,Recurring Withdrawal Debit Card MC Debit/HELP.HBOMAX.COM NEW YORK NYDate 04/27/22 0 2117023223 1 5815Card 2801,17.23
9/27/2021,,Withdrawal Debit Card MC Debit/FS *STARDOCK 877-3278914 CADate 09/26/21 0 1269698586 1 5734Card 2801,19.99,,Posted,444.62,2021-09-27,19.99,Withdrawal Debit Card MC Debit/FS *STARDOCK 877-3278914 CADate 09/26/21 0 1269698586 1 5734Card 2801,19.99
9/27/2021,,Withdrawal ACH PADDLE.COM MARKE/CO: PADDLE.COM MARKET LIMITEDTYPE: IAT PAYPAL ID: 770510487CEntry Class Code: IAT,9.99,,Posted,464.61,2021-09-27,9.99,Withdrawal ACH PADDLE.COM MARKE/CO: PADDLE.COM MARKET LIMITEDTYPE: IAT PAYPAL ID: 770510487CEntry Class Code: IAT,9.995000000000001
9/27/2021,,Withdrawal ACH PAYPAL/TYPE: INST XFER ID: PAYPALSI77CO: PAYPALEntry Class Code: WEB,58.5,,Posted,474.6,2021-09-27,58.5,Withdrawal ACH PAYPAL/TYPE: INST XFER ID: PAYPALSI77CO: PAYPALEntry Class Code: WEB,58.5
9/27/2021,,Withdrawal ACH PAYPAL/TYPE: INST XFER ID: PAYPALSI77CO: PAYPALEntry Class Code: WEB,23.99,,Posted,533.1,2021-09-27,23.99,Withdrawal ACH PAYPAL/TYPE: INST XFER ID: PAYPALSI77CO: PAYPALEntry Class Code: WEB,24.653333333333332
9/27/2021,,Withdrawal ACH PAYPAL/TYPE: INST XFER ID: PAYPALSI77CO: PAYPALEntry Class Code: WEB,7.0,,Posted,557.09,2021-09-27,7.0,Withdrawal ACH PAYPAL/TYPE: INST XFER ID: PAYPALSI77CO: PAYPALEntry Class Code: WEB,6.995
9/27/2021,,Withdrawal ACH PAYPAL/TYPE: INST XFER ID: PAYPALSI77CO: PAYPALEntry Class Code: WEB,7.0,,Posted,564.09,2021-09-27,7.0,Withdrawal ACH PAYPAL/TYPE: INST XFER ID: PAYPALSI77CO: PAYPALEntry Class Code: WEB,6.995
9/27/2021,,Withdrawal ACH PAYPAL/TYPE: INST XFER ID: PAYPALSI77CO: PAYPALEntry Class Code: WEB,4.5,,Posted,571.09,2021-09-27,4.5,Withdrawal ACH PAYPAL/TYPE: INST XFER ID: PAYPALSI77CO: PAYPALEntry Class Code: WEB,5.032
9/27/2021,,Withdrawal ACH PAYPAL/TYPE: INST XFER ID: PAYPALSI77CO: PAYPALEntry Class Code: WEB,2.99,,Posted,575.59,2021-09-27,2.99,Withdrawal ACH PAYPAL/TYPE: INST XFER ID: PAYPALSI77CO: PAYPALEntry Class Code: WEB,3.2266666666666666
9/26/2021,,Withdrawal Debit Card MC Debit/WELLSAID LABS SEATTLE WADate 09/24/21 0 1267254630 1 5734Card 2801,49.0,,Posted,578.58,2021-09-26,49.0,Recurring Withdrawal Debit Card MC Debit/WELLSAID LABS SEATTLE WADate 11/24/21 0 1328159011 1 5734Card 2801,49.0
9/26/2021,,Withdrawal Debit Card MC Debit/KINDLE UNLTD*2C1FL7AZ1 866-321-8851 WADate 09/24/21 0 1267679150 1 5818Card 2801,9.99,,Posted,627.58,2021-09-26,9.99,Withdrawal Debit Card MC Debit/KINDLE UNLTD*1N4IN7U80 866-321-8851 WADate 03/24/22 0 2083036398 1 5818Card 2801,9.99
9/24/2021,,Withdrawal Debit Card MC Debit/PUBLIX #680 GAINESVILLE FLDate 09/23/21 0 1266591030 1 5411Card 2801,114.19,,Posted,637.57,2021-09-24,114.19,Withdrawal Debit Card MC Debit/PUBLIX #1560 GAINESVILLE FLDate 09/04/21 0 1247836114 5 5411Card 2801,114.19
9/24/2021,,Withdrawal Debit Card MC Debit/GOOGLE DOMAINS MOUNTAIN VIE CADate 09/24/21 0 1267589971 1 5816Card 2801,12.0,,Posted,751.76,2021-09-24,12.0,Withdrawal Debit Card MC Debit/GOOGLE DOMAINS MOUNTAIN VIE CADate 09/24/21 0 1267589971 1 5816Card 2801,12.0
9/24/2021,,Recurring Withdrawal Debit Card MC Debit/PLAYERAUCTIONS 800-342-0768 DEDate 09/23/21 0 1266586911 1 7993Card 2801,59.13,,Posted,763.76,2021-09-24,59.13,Recurring Withdrawal Debit Card MC Debit/PLAYERAUCTIONS 800-342-0768 DEDate 09/23/21 0 1266586911 1 7993Card 2801,59.13
9/24/2021,,Withdrawal Debit Card MC Debit/COX GAINESVILLE COMM 800-234-3993 FLDate 09/24/21 0 1267730655 1 4899Card 2801,94.32,,Posted,822.89,2021-09-24,94.32,Withdrawal Debit Card MC Debit/COX GAINESVILLE COMM 800-234-3993 FLDate 01/27/22 0 2027240681 1 4899Card 2801,94.32
9/24/2021,,Withdrawal ACH PAYPAL/TYPE: INST XFER ID: PAYPALSI77CO: PAYPALEntry Class Code: WEB,99.99,,Posted,917.21,2021-09-24,99.99,Withdrawal ACH PAYPAL/TYPE: INST XFER ID: PAYPALSI77CO: PAYPALEntry Class Code: WEB,99.66333333333334
9/24/2021,,Withdrawal ACH PAYPAL/TYPE: INST XFER ID: PAYPALSI77CO: PAYPALEntry Class Code: WEB,39.99,,Posted,1017.2,2021-09-24,39.99,Withdrawal ACH PAYPAL/TYPE: INST XFER ID: PAYPALSI77CO: PAYPALEntry Class Code: WEB,39.656666666666666
9/23/2021,,Withdrawal POS #000000105340/GATE 1445 506 NW 1 GAINESVILLE FLCard 2801,13.74,,Posted,1057.19,2021-09-23,13.74,Withdrawal POS #000000183316/GATE 1445 506 NW 13TH GAINESVILLE FLCard 2801,13.655000000000001
9/21/2021,,Withdrawal ACH PAYPAL/TYPE: INST XFER ID: PAYPALSI77CO: PAYPALEntry Class Code: WEB,6.99,,Posted,1070.93,2021-09-21,6.99,Withdrawal ACH PAYPAL/TYPE: INST XFER ID: PAYPALSI77CO: PAYPALEntry Class Code: WEB,6.995
9/21/2021,,Withdrawal ACH PAYPAL/TYPE: INST XFER ID: PAYPALSI77CO: PAYPALEntry Class Code: WEB,2.99,,Posted,1077.92,2021-09-21,2.99,Withdrawal ACH PAYPAL/TYPE: INST XFER ID: PAYPALSI77CO: PAYPALEntry Class Code: WEB,3.2266666666666666
9/20/2021,,Withdrawal Debit Card MC Debit/CRONUSMAX COM 434-2274394 VADate 09/17/21 0 1260344951 5 5732Card 2801,49.98,,Posted,1080.91,2021-09-20,49.98,Withdrawal Debit Card MC Debit/CRONUSMAX COM 434-2274394 VADate 09/17/21 0 1260344951 5 5732Card 2801,49.98
9/20/2021,,Withdrawal ACH PAYPAL/TYPE: INST XFER ID: PAYPALSI77CO: PAYPALEntry Class Code: WEB,29.0,,Posted,1130.89,2021-09-20,29.0,Withdrawal ACH PAYPAL/TYPE: INST XFER ID: PAYPALSI77CO: PAYPALEntry Class Code: WEB,29.0
9/20/2021,,Withdrawal ACH PAYPAL/TYPE: INST XFER ID: PAYPALSI77CO: PAYPALEntry Class Code: WEB,26.75,,Posted,1159.89,2021-09-20,26.75,Withdrawal ACH PAYPAL/TYPE: INST XFER ID: PAYPALSI77CO: PAYPALEntry Class Code: WEB,26.75
9/19/2021,,"Withdrawal Debit Card MC Debit/DOG BYTES COMPUTERS, I GAINESVILLE FLDate 09/17/21 0 1260920418 1 5045Card 2801",267.5,,Posted,1186.64,2021-09-19,267.5,"Withdrawal Debit Card MC Debit/DOG BYTES COMPUTERS, I GAINESVILLE FLDate 09/17/21 0 1260920418 1 5045Card 2801",267.5
9/17/2021,,Withdrawal POS #000000132477/WAWA 5384 2305 NW 13TH ST GAINESVILLE FLCard 2801,26.75,,Posted,1186.14,2021-09-17,26.75,Withdrawal POS #000000132477/WAWA 5384 2305 NW 13TH ST GAINESVILLE FLCard 2801,26.75
9/17/2021,,Recurring Withdrawal Debit Card MC Debit/JARVIS - CONVERSION.AI AUSTIN TXDate 09/16/21 0 1259607288 1 7399Card 2801,88.09,,Posted,1212.89,2021-09-17,88.09,Recurring Withdrawal Debit Card MC Debit/JARVIS - CONVERSION.AI AUSTIN TXDate 12/16/21 0 1350165435 1 7399Card 2801,88.09
9/17/2021,,Withdrawal Debit Card MC Debit/JARVIS - CONVERSION.AI AUSTIN TXDate 09/16/21 0 1259239886 1 7399Card 2801,29.0,,Posted,1300.98,2021-09-17,29.0,Recurring Withdrawal Debit Card MC Debit/JARVIS - CONVERSION.AI AUSTIN TXDate 12/16/21 0 1350165435 1 7399Card 2801,29.0
9/17/2021,,Withdrawal ACH PAYPAL/TYPE: INST XFER ID: PAYPALSI77CO: PAYPALEntry Class Code: WEB,14.99,,Posted,1329.98,2021-09-17,14.99,Withdrawal ACH PAYPAL/TYPE: INST XFER ID: PAYPALSI77CO: PAYPALEntry Class Code: WEB,14.646666666666667
9/16/2021,101.0,Draft 101,860.0,,Posted,644.97,2021-09-16,860.0,Draft 102,860.0
9/16/2021,,Withdrawal Debit Card MC Debit/NAME-CHEAP.COM PHOENIX AZDate 09/15/21 0 1258539850 0 7372Card 2801,47.86,,Posted,1504.97,2021-09-16,47.86,Withdrawal Debit Card MC Debit/NAME-CHEAP.COM PHOENIX AZDate 09/15/21 0 1258539850 0 7372Card 2801,47.86
9/16/2021,,Withdrawal Debit Card MC Debit/PUBLIX #1312 GAINESVILLE FLDate 09/15/21 0 1258745311 1 5411Card 2801,74.7,,Posted,1552.83,2021-09-16,74.7,Withdrawal Debit Card MC Debit/PUBLIX #1312 GAINESVILLE FLDate 03/11/21 0 1070536058 1 5411Card 2801,74.7
9/16/2021,,Withdrawal ACH BEST BUY/TYPE: PAYMENT ID: CITIGPUFDRCO: BEST BUYEntry Class Code: PPD,180.0,,Posted,1627.53,2021-09-16,180.0,Withdrawal ACH BEST BUY/TYPE: PAYMENT ID: CITIGPUFDRCO: BEST BUYEntry Class Code: TEL,180.0
9/16/2021,,Withdrawal ACH PAYMENT FOR AMZ/TYPE: STORECARD ID: 9069872103CO: PAYMENT FOR AMZEntry Class Code: WEB,145.0,,Posted,1807.53,2021-09-16,145.0,Withdrawal ACH PAYMENT FOR AMZ/TYPE: STORECARD ID: 9069872103 CO: PAYMENT FOR AMZ Entry Class Code: WEB,145.0
9/15/2021,,Withdrawal POS #000000079769/TARGET T-0687 3970 SW Archer RdGainesville FLCard 2801,104.14,,Posted,852.53,2021-09-15,104.14,Withdrawal POS #000000079769/TARGET T-0687 3970 SW Archer RdGainesville FLCard 2801,104.14
9/15/2021,,Withdrawal Debit Card MC Debit/RYTR - AI WRITER WALNUT CADate 09/14/21 0 1257156154 1 7399Card 2801,29.0,,Posted,956.67,2021-09-15,29.0,Recurring Withdrawal Debit Card MC Debit/RYTR - AI WRITER WALNUT CADate 10/14/21 0 1287521485 0 7399Card 2801,29.0
9/15/2021,,Withdrawal Debit Card MC Debit/AMZN DIGITAL*2G2YK1811 888-802-3080 WADate 09/15/21 0 1258632245 1 5818Card 2801,1.99,,Posted,985.67,2021-09-15,1.99,Withdrawal Debit Card MC Debit/AMZN DIGITAL*2G2YK1811 888-802-3080 WADate 09/15/21 0 1258632245 1 5818Card 2801,1.49
9/15/2021,,Withdrawal ACH APPLECARD GSBANK/TYPE: PAYMENT ID: 9999999999CO: APPLECARD GSBANKEntry Class Code: WEB,100.0,,Posted,987.66,2021-09-15,100.0,Withdrawal ACH APPLECARD GSBANK/TYPE: PAYMENT ID: 9999999999 CO: APPLECARD GSBANK Entry Class Code: WEB,100.0
9/15/2021,,Withdrawal ACH BEST BUY/TYPE: PAYMENT ID: CITIGPUFDRCO: BEST BUYEntry Class Code: PPD,80.0,,Posted,1087.66,2021-09-15,80.0,Withdrawal ACH BEST BUY/TYPE: PAYMENT ID: CITIGPUFDRCO: BEST BUYEntry Class Code: TEL,80.0
9/15/2021,,Withdrawal ACH CAPITAL ONE/TYPE: ONLINE PMT ID: 9279744991CO: CAPITAL ONEEntry Class Code: WEB,75.0,,Posted,1167.66,2021-09-15,75.0,Withdrawal ACH CAPITAL ONE/TYPE: ONLINE PMT ID: 9279744991 CO: CAPITAL ONE Entry Class Code: WEB,75.0
9/15/2021,,Withdrawal ACH BARCLAYCARD US/TYPE: CREDITCARD ID: 2510407970CO: BARCLAYCARD USEntry Class Code: WEB,75.0,,Posted,1242.66,2021-09-15,75.0,Withdrawal ACH BARCLAYCARD US/TYPE: CREDITCARD ID: 2510407970 CO: BARCLAYCARD US Entry Class Code: WEB,75.0
9/15/2021,,Withdrawal ACH BEST BUY/TYPE: PAYMENT ID: CITIGPUFDRCO: BEST BUYEntry Class Code: PPD,120.0,,Posted,1317.66,2021-09-15,120.0,Withdrawal ACH BEST BUY/TYPE: PAYMENT ID: CITIGPUFDRCO: BEST BUYEntry Class Code: TEL,120.0
9/15/2021,,Withdrawal ACH TARGET CARD SRVC/TYPE: BILL PAY ID: 5411721813CO: TARGET CARD SRVCEntry Class Code: WEB,105.0,,Posted,1437.66,2021-09-15,105.0,Withdrawal ACH TARGET CARD SRVC/TYPE: BILL PAY ID: T510215170CO: TARGET CARD SRVCEntry Class Code: WEB,105.0
9/15/2021,,Withdrawal ACH PAYPAL/TYPE: INST XFER ID: PAYPALSI77CO: PAYPALEntry Class Code: WEB,99.99,,Posted,1542.66,2021-09-15,99.99,Withdrawal ACH PAYPAL/TYPE: INST XFER ID: PAYPALSI77CO: PAYPALEntry Class Code: WEB,99.66333333333334
9/15/2021,,Withdrawal ACH DISCOVER/TYPE: E-PAYMENT ID: 2510020270CO: DISCOVEREntry Class Code: WEB,75.0,,Posted,1642.65,2021-09-15,75.0,Withdrawal ACH DISCOVER/TYPE: E-PAYMENT ID: 2510020270CO: DISCOVEREntry Class Code: WEB,75.0
9/15/2021,,Withdrawal ACH PAYPAL/TYPE: INST XFER ID: PAYPALSI77CO: PAYPALEntry Class Code: WEB,9.99,,Posted,1717.65,2021-09-15,9.99,Withdrawal ACH PAYPAL/TYPE: INST XFER ID: PAYPALSI77CO: PAYPALEntry Class Code: WEB,9.723333333333334
9/14/2021,,Withdrawal POS #000000102669/GATE 1445 506 NW 1 GAINESVILLE FLCard 2801,18.54,,Posted,1727.64,2021-09-14,18.54,Withdrawal POS #000000183316/GATE 1445 506 NW 13TH GAINESVILLE FLCard 2801,18.346666666666668
9/14/2021,,Withdrawal ATM Transaction,180.0,,Posted,1746.18,2021-09-14,180.0,Withdrawal ATM Transaction,180.0
9/14/2021,,Withdrawal Debit Card MC Debit/WALGREENS #5024 800-289-2273 FLDate 09/13/21 0 1256616160 1 5912Card 2801,22.08,,Posted,1926.18,2021-09-14,22.08,Withdrawal Debit Card MC Debit/WALGREENS #5024 800-289-2273 FLDate 09/08/21 0 1251607416 1 5912Card 2801,22.08
9/14/2021,,Withdrawal Debit Card MC Debit/GRU/EZ-PAY WEB PYMT 352-334-3434 FLDate 09/13/21 0 1256503123 0 4900Card 2801,274.86,,Posted,1948.26,2021-09-14,274.86,Withdrawal Debit Card MC Debit/GRU/EZ-PAY WEB PYMT 352-334-3434 FLDate 11/01/21 0 1305577800 0 4900Card 2801,274.86
9/14/2021,,Withdrawal ACH PAYPAL/TYPE: INST XFER ID: PAYPALSI77CO: PAYPALEntry Class Code: WEB,39.99,,Posted,1223.12,2021-09-14,39.99,Withdrawal ACH PAYPAL/TYPE: INST XFER ID: PAYPALSI77CO: PAYPALEntry Class Code: WEB,39.656666666666666
9/14/2021,,Withdrawal ACH PAYPAL/TYPE: INST XFER ID: PAYPALSI77CO: PAYPALEntry Class Code: WEB,24.99,,Posted,1263.11,2021-09-14,24.99,Withdrawal ACH PAYPAL/TYPE: INST XFER ID: PAYPALSI77CO: PAYPALEntry Class Code: WEB,24.653333333333332
9/13/2021,,Withdrawal POS #000000865446/WAWA 5325 2373 SW ARCHER ROA GAINESVILLEFLCard 2801,13.38,,Posted,1288.1,2021-09-13,13.38,Withdrawal POS #000000188596/WAWA 5325 2373 SW ARCHER ROA GAINESVILLEFLCard 2801,13.195
9/13/2021,,Withdrawal Debit Card MC Debit/NETFLIX.COM LOS GATOS CADate 09/13/21 0 1256468518 1 4899Card 2801,9.88,,Posted,1101.48,2021-09-13,9.88,Withdrawal Debit Card MC Debit/NETFLIX.COM LOS GATOS CADate 09/13/21 0 1256468518 1 4899Card 2801,9.88
9/13/2021,,Recurring Withdrawal Debit Card Fee/MASTERCARD ISSUER CROSS-BORDER FEEDate 09/11/21 0 1254870514 0 5817Card 2801,0.05,,Posted,1111.36,2021-09-13,0.05,Recurring Withdrawal Debit Card Fee/MASTERCARD ISSUER CROSS-BORDER FEEDate 12/11/21 0 1345316936 1 5817Card 2801,0.08666666666666667
9/13/2021,,Recurring Withdrawal Debit Card MC Debit/PAYPAL *LINKTREE 4029357733 AUDate 09/11/21 0 1254870514 0 5817Card 2801,6.0,,Posted,1111.41,2021-09-13,6.0,Recurring Withdrawal Debit Card MC Debit/PAYPAL *LINKTREE 4029357733 AUDate 05/12/21 0 1132191600 1 7372Card 2801,6.0
9/13/2021,,Withdrawal Bill Payment #000012373398/GRU EZ PAY WEB PYMT GAINESVILLE FLCard 2801,209.53,,Posted,917.41,2021-09-13,209.53,Withdrawal Bill Payment #000012373398/GRU EZ PAY WEB PYMT GAINESVILLE FLCard 2801,209.53
9/13/2021,,Withdrawal ACH PAYPAL/TYPE: INST XFER ID: PAYPALSI77CO: PAYPALEntry Class Code: WEB,14.99,,Posted,1126.94,2021-09-13,14.99,Withdrawal ACH PAYPAL/TYPE: INST XFER ID: PAYPALSI77CO: PAYPALEntry Class Code: WEB,14.646666666666667
9/13/2021,,Withdrawal ACH PAYPAL/TYPE: INST XFER ID: PAYPALSI77CO: PAYPALEntry Class Code: WEB,9.18,,Posted,1141.93,2021-09-13,9.18,Withdrawal ACH PAYPAL/TYPE: INST XFER ID: PAYPALSI77CO: PAYPALEntry Class Code: WEB,9.723333333333334
9/12/2021,,Withdrawal Debit Card MC Debit/PUBLIX #435 GAINESVILLE FLDate 09/10/21 0 1253910743 1 5411Card 2801,80.03,,Posted,1151.11,2021-09-12,80.03,Withdrawal Debit Card MC Debit/PUBLIX #1560 GAINESVILLE FLDate 09/04/21 0 1247836114 5 5411Card 2801,80.03
9/10/2021,,Withdrawal POS #000000613712/FAST TRACK #200 3960 SW ARCHER RDGAINESVILLE FLCard 2801,18.43,,Posted,1032.9,2021-09-10,18.43,Withdrawal POS #000000418393/FAST TRACK #200 3960 SW ARCHER RDGAINESVILLE FLCard 2801,18.61
9/10/2021,,Withdrawal ATM Transaction,40.0,,Posted,1051.33,2021-09-10,40.0,Withdrawal ATM Transaction,40.0
9/10/2021,,Withdrawal Debit Card MC Debit/ELDERSCROLLSONLINE. 855-296-3170 MDDate 09/10/21 0 1253698432 1 7994Card 2801,14.99,,Posted,1091.33,2021-09-10,14.99,Withdrawal Debit Card MC Debit/ELDERSCROLLSONLINE. 855-296-3170 MDDate 11/09/21 0 1313300656 1 5816Card 2801,14.99
9/10/2021,,Withdrawal ACH TARGET CARD SRVC/TYPE: BILL PAY ID: T510215170CO: TARGET CARD SRVCEntry Class Code: WEB,25.0,,Posted,1106.32,2021-09-10,25.0,Withdrawal ACH TARGET CARD SRVC/TYPE: BILL PAY ID: T510215170CO: TARGET CARD SRVCEntry Class Code: WEB,25.0
9/9/2021,,Withdrawal Debit Card MC Debit/WALGREENS #5024 800-289-2273 FLDate 09/08/21 0 1251607416 1 5912Card 2801,15.0,,Posted,1131.32,2021-09-09,15.0,Withdrawal Debit Card MC Debit/WALGREENS #5024 800-289-2273 FLDate 09/08/21 0 1251607416 1 5912Card 2801,15.24
9/9/2021,,Withdrawal ACH PAYPAL/TYPE: INST XFER ID: PAYPALSI77CO: PAYPALEntry Class Code: WEB,19.99,,Posted,1146.32,2021-09-09,19.99,Withdrawal ACH PAYPAL/TYPE: INST XFER ID: PAYPALSI77CO: PAYPALEntry Class Code: WEB,19.99
9/8/2021,,Withdrawal POS #000000033932/PUBLIX 3930 SW ARCHER ROA GAINESVILLE FLCard 2801,25.7,,Posted,1166.31,2021-09-08,25.7,Withdrawal POS #000000029500/PUBLIX 3930 SW ARCHER ROA GAINESVILLE FLCard 2801,25.7
9/8/2021,,Withdrawal POS #000000014786/CIRCLE K # 06782 5 GAINESVILLE FLCard 2801,17.31,,Posted,1192.01,2021-09-08,17.31,Withdrawal POS #000000882351/CIRCLE K # 06782 GAINESVILLE FLCard 1140,17.47
9/8/2021,,Withdrawal POS #000018544628/WALGREENS 2415 SW GAINESVILLE FLCard 2801,21.01,,Posted,1209.32,2021-09-08,21.01,Withdrawal POS #000014264526/WALGREENS 2415 SW GAINESVILLE FLCard 2801,21.01
9/8/2021,,Withdrawal Bill Payment #000009103856/PAYPAL *VIDIQ San Jose CACard 2801,10.0,,Posted,1230.33,2021-09-08,10.0,Withdrawal Bill Payment #000005023648/PAYPAL *VIDIQ San Jose CACard 2801,10.0
9/7/2021,,Withdrawal ACH PAYPAL/TYPE: INST XFER ID: PAYPALSI77CO: PAYPALEntry Class Code: WEB,27.94,,Posted,1240.33,2021-09-07,27.94,Withdrawal ACH PAYPAL/TYPE: INST XFER ID: PAYPALSI77CO: PAYPALEntry Class Code: WEB,27.945
9/7/2021,,Withdrawal ACH PAYPAL/TYPE: INST XFER ID: PAYPALSI77CO: PAYPALEntry Class Code: WEB,5.99,,Posted,1268.27,2021-09-07,5.99,Withdrawal ACH PAYPAL/TYPE: INST XFER ID: PAYPALSI77CO: PAYPALEntry Class Code: WEB,5.766666666666667
9/7/2021,,Withdrawal ACH PAYPAL/TYPE: INST XFER ID: PAYPALSI77CO: PAYPALEntry Class Code: WEB,2.99,,Posted,1274.26,2021-09-07,2.99,Withdrawal ACH PAYPAL/TYPE: INST XFER ID: PAYPALSI77CO: PAYPALEntry Class Code: WEB,3.2266666666666666
9/6/2021,,Withdrawal Debit Card MC Debit/PUBLIX #1560 GAINESVILLE FLDate 09/04/21 0 1247836114 5 5411Card 2801,21.39,,Posted,1277.25,2021-09-06,21.39,Withdrawal Debit Card MC Debit/PUBLIX #1560 GAINESVILLE FLDate 09/04/21 0 1247836114 5 5411Card 2801,21.39
9/6/2021,,Recurring Withdrawal Debit Card MC Debit/AMAZON PRIME*253Y95IJ0 AMZN.COM/BIL WADate 09/05/21 0 1248819282 5 5968Card 2801,13.08,,Posted,1298.64,2021-09-06,13.08,Recurring Withdrawal Debit Card MC Debit/AMAZON PRIME*2E90R5DC2 AMZN.COM/BIL WADate 07/27/21 0 1208211269 1 5968Card 2801,13.085
9/6/2021,,Withdrawal Debit Card MC Debit/COX GAINESVILLE COMM 800-234-3993 FLDate 09/04/21 0 1247814189 5 4899Card 2801,94.32,,Posted,1311.72,2021-09-06,94.32,Withdrawal Debit Card MC Debit/COX GAINESVILLE COMM 800-234-3993 FLDate 01/27/22 0 2027240681 1 4899Card 2801,94.32
9/5/2021,,Withdrawal POS #000000634877/AMAZON.COM*251J42IJ0 SEATTLE WACard 2801,32.06,,Posted,1406.04,2021-09-05,32.06,Withdrawal POS #000000626675/AMAZON.COM*1F8259P12 SEATTLE WACard 2801,31.94
9/4/2021,,Withdrawal at ATM #000000000082/Columbia Gainesville 1 1250 W UniversityGainesville FLCard 2801,23.5,,Posted,1438.1,2021-09-04,23.5,Withdrawal at ATM #000000000082/Columbia Gainesville 1 1250 W UniversityGainesville FLCard 2801,23.5
9/4/2021,,Withdrawal POS #000000105125/WAWA 5325 2373 SW ARCHER ROA GAINESVILLEFLCard 2801,19.55,,Posted,1461.6,2021-09-04,19.55,Withdrawal POS #000000188596/WAWA 5325 2373 SW ARCHER ROA GAINESVILLEFLCard 2801,19.55
9/4/2021,,Withdrawal/Cash Disbursed 200.00,200.0,,Posted,1481.15,2021-09-04,200.0,Withdrawal/Cash Disbursed 35.00,200.0
9/3/2021,,Withdrawal Debit Card MC Debit/PUBLIX #1312 GAINESVILLE FLDate 09/02/21 0 1245874546 1 5411Card 2801,36.37,,Posted,1681.15,2021-09-03,36.37,Withdrawal Debit Card MC Debit/PUBLIX #1312 GAINESVILLE FLDate 03/11/21 0 1070536058 1 5411Card 2801,36.37
9/2/2021,,Withdrawal ACH PAYPAL/TYPE: INST XFER ID: PAYPALSI77CO: PAYPALEntry Class Code: WEB,60.07,,Posted,1717.52,2021-09-02,60.07,Withdrawal ACH PAYPAL/TYPE: INST XFER ID: PAYPALSI77CO: PAYPALEntry Class Code: WEB,60.07
9/1/2021,,Withdrawal POS #000000008021/CIRCLE K # 06782 5 GAINESVILLE FLCard 2801,21.08,,Posted,1777.59,2021-09-01,21.08,Withdrawal POS #000000882351/CIRCLE K # 06782 GAINESVILLE FLCard 1140,21.08
9/1/2021,,Withdrawal ACH PAYMENT FOR AMZ/TYPE: STORECARD ID: 9069872103CO: PAYMENT FOR AMZEntry Class Code: WEB,50.0,,Posted,1798.67,2021-09-01,50.0,Withdrawal ACH PAYMENT FOR AMZ/TYPE: STORECARD ID: 9069872103 CO: PAYMENT FOR AMZ Entry Class Code: WEB,50.0
8/31/2021,,Withdrawal ACH BARCLAYCARD US/TYPE: CREDITCARD ID: 2510407970CO: BARCLAYCARD USEntry Class Code: WEB,50.0,,Posted,1848.67,2021-08-31,50.0,Withdrawal ACH BARCLAYCARD US/TYPE: CREDITCARD ID: 2510407970 CO: BARCLAYCARD US Entry Class Code: WEB,50.0
8/31/2021,,Withdrawal ACH CAPITAL ONE/TYPE: MOBILE PMT ID: 9279744980CO: CAPITAL ONEEntry Class Code: WEB,25.0,,Posted,1898.67,2021-08-31,25.0,Withdrawal ACH CAPITAL ONE/TYPE: MOBILE PMT ID: 9279744980CO: CAPITAL ONEEntry Class Code: WEB,25.0
8/31/2021,,Withdrawal ACH TARGET CARD SRVC/TYPE: BILL PAY ID: 5411721813CO: TARGET CARD SRVCEntry Class Code: WEB,50.0,,Posted,1923.67,2021-08-31,50.0,Withdrawal ACH TARGET CARD SRVC/TYPE: BILL PAY ID: T510215170CO: TARGET CARD SRVCEntry Class Code: WEB,50.0
8/31/2021,,Withdrawal ACH DISCOVER/TYPE: E-PAYMENT ID: 2510020270CO: DISCOVEREntry Class Code: WEB,33.78,,Posted,1973.67,2021-08-31,33.78,Withdrawal ACH DISCOVER/TYPE: E-PAYMENT ID: 2510020270CO: DISCOVEREntry Class Code: WEB,33.78
8/30/2021,,Withdrawal ACH PAYPAL/TYPE: INST XFER ID: PAYPALSI77CO: PAYPALEntry Class Code: WEB,11.48,,Posted,4.7,2021-08-30,11.48,Withdrawal ACH PAYPAL/TYPE: INST XFER ID: PAYPALSI77CO: PAYPALEntry Class Code: WEB,10.88
8/30/2021,,Withdrawal ACH PAYPAL/TYPE: INST XFER ID: PAYPALSI77CO: PAYPALEntry Class Code: WEB,2.99,,Posted,16.18,2021-08-30,2.99,Withdrawal ACH PAYPAL/TYPE: INST XFER ID: PAYPALSI77CO: PAYPALEntry Class Code: WEB,3.2266666666666666
8/30/2021,,Withdrawal POS #000000731362/PUBLIX 9200 NW 39TH AVE GAINESVILLE FLCard 2801,18.71,,Posted,19.17,2021-08-30,18.71,Withdrawal POS #000000749592/PUBLIX 9200 NW 39TH AVE GAINESVILLE FLCard 2801,18.71
8/29/2021,,Withdrawal POS #000000601141/WAWA 5325 2373 SW ARCHER ROA GAINESVILLEFLCard 2801,18.3,,Posted,37.88,2021-08-29,18.3,Withdrawal POS #000000188596/WAWA 5325 2373 SW ARCHER ROA GAINESVILLEFLCard 2801,18.32
8/27/2021,,Recurring Withdrawal Debit Card MC Debit/HELP.HBOMAX.COM NEW YORK NYDate 08/27/21 0 1239858259 1 5815Card 2801,17.23,,Posted,49.18,2021-08-27,17.23,Recurring Withdrawal Debit Card MC Debit/HELP.HBOMAX.COM NEW YORK NYDate 04/27/22 0 2117023223 1 5815Card 2801,17.23
8/27/2021,,Withdrawal ACH PAYPAL/TYPE: INST XFER ID: PAYPALSI77CO: PAYPALEntry Class Code: WEB,2.99,,Posted,66.41,2021-08-27,2.99,Withdrawal ACH PAYPAL/TYPE: INST XFER ID: PAYPALSI77CO: PAYPALEntry Class Code: WEB,3.2266666666666666
8/26/2021,,Deposit Adjustment/FUNDS TRAN RET-INVALID ACCT #,30.0,,Posted,69.4,2021-08-26,30.0,Deposit Adjustment/FUNDS TRAN RET-INVALID ACCT #,30.0
8/26/2021,,Withdrawal ACH PAYPAL/TYPE: INST XFER ID: PAYPALSI77CO: PAYPALEntry Class Code: WEB,4.5,,Posted,99.4,2021-08-26,4.5,Withdrawal ACH PAYPAL/TYPE: INST XFER ID: PAYPALSI77CO: PAYPALEntry Class Code: WEB,5.032
8/24/2021,,Withdrawal ATM Fee/ASAI 318 Suite 8C NW 13 Gainesville FLCard 2801,2.0,,Posted,103.9,2021-08-24,2.0,Withdrawal ATM Fee/ASAI 318 Suite 8C NW 13 Gainesville FLCard 2801,2.0
8/24/2021,,Withdrawal at ATM #000000000902/ASAI 318 Suite 8C NW 13 Gainesville FLCard 2801,38.5,,Posted,105.9,2021-08-24,38.5,Withdrawal at ATM #000000000902/ASAI 318 Suite 8C NW 13 Gainesville FLCard 2801,38.5
8/24/2021,,Withdrawal POS #000000086864/GATE 1445 506 NW 1 GAINESVILLE FLCard 2801,22.62,,Posted,144.4,2021-08-24,22.62,Withdrawal POS #000000183316/GATE 1445 506 NW 13TH GAINESVILLE FLCard 2801,22.908
8/24/2021,,Withdrawal ACH PAYPAL/TYPE: INST XFER ID: PAYPALSI77CO: PAYPALEntry Class Code: WEB,57.41,,Posted,167.02,2021-08-24,57.41,Withdrawal ACH PAYPAL/TYPE: INST XFER ID: PAYPALSI77CO: PAYPALEntry Class Code: WEB,57.705
8/23/2021,,Withdrawal Debit Card MC Debit/WALGREENS #5024 800-289-2273 FLDate 08/22/21 0 1234711756 1 5912Card 2801,4.65,,Posted,194.43,2021-08-23,4.65,Withdrawal Debit Card MC Debit/WALGREENS #5024 800-289-2273 FLDate 09/08/21 0 1251607416 1 5912Card 2801,4.09
8/23/2021,,Withdrawal ATM Transaction,20.0,,Posted,99.08,2021-08-23,20.0,Withdrawal ATM Transaction,20.0
8/23/2021,,Withdrawal ACH PAYPAL/TYPE: INST XFER ID: PAYPALSI77CO: PAYPALEntry Class Code: WEB,6.99,,Posted,119.08,2021-08-23,6.99,Withdrawal ACH PAYPAL/TYPE: INST XFER ID: PAYPALSI77CO: PAYPALEntry Class Code: WEB,6.995
8/22/2021,,Withdrawal Debit Card MC Debit/PUBLIX #1312 GAINESVILLE FLDate 08/20/21 0 1232749566 1 5411Card 2801,71.42,,Posted,121.07,2021-08-22,71.42,Withdrawal Debit Card MC Debit/PUBLIX #1312 GAINESVILLE FLDate 03/11/21 0 1070536058 1 5411Card 2801,71.42
8/22/2021,,Withdrawal POS #000000035657/PUBLIX 5200 S W 34TH STRE GAINESVILLE FLCard 2801,30.96,,Posted,192.49,2021-08-22,30.96,Withdrawal POS #000000080373/PUBLIX 5200 S W 34TH STRE GAINESVILLE FLCard 1140,30.96
8/22/2021,,Withdrawal POS #000000010085/CIRCLE K # 06782 5 GAINESVILLE FLCard 2801,22.1,,Posted,223.45,2021-08-22,22.1,Withdrawal POS #000000882351/CIRCLE K # 06782 GAINESVILLE FLCard 1140,22.1
8/20/2021,,Withdrawal POS #000000825743/FAST TRACK #200 3960 SW ARCHER RDGAINESVILLE FLCard 2801,9.21,,Posted,145.55,2021-08-20,9.21,Withdrawal POS #000000418393/FAST TRACK #200 3960 SW ARCHER RDGAINESVILLE FLCard 2801,9.420000000000002
8/19/2021,100.0,Draft 100,850.0,,Posted,154.76,2021-08-19,850.0,Draft 102,850.0
8/19/2021,,Withdrawal ACH PAYPAL/TYPE: INST XFER ID: PAYPALSI77CO: PAYPALEntry Class Code: WEB,29.0,,Posted,1004.76,2021-08-19,29.0,Withdrawal ACH PAYPAL/TYPE: INST XFER ID: PAYPALSI77CO: PAYPALEntry Class Code: WEB,29.0
8/17/2021,,Withdrawal ACH PAYPAL/TYPE: INST XFER ID: PAYPALSI77CO: PAYPALEntry Class Code: WEB,31.27,,Posted,1033.76,2021-08-17,31.27,Withdrawal ACH PAYPAL/TYPE: INST XFER ID: PAYPALSI77CO: PAYPALEntry Class Code: WEB,30.884999999999998
8/16/2021,,Withdrawal Debit Card MC Debit/PIZZA HUT 27918 3523739402 FLDate 08/15/21 0 1227170071 4 5812Card 2801,30.79,,Posted,1065.03,2021-08-16,30.79,Withdrawal Debit Card MC Debit/PIZZA HUT 27918 3523739402 FLDate 12/16/22 0 2350808582 1 5812Card 2801,30.485
8/16/2021,,Withdrawal Debit Card MC Debit/NETFLIX.COM CADate 08/14/21 0 1226476915 2 4899Card 2801,9.88,,Posted,1095.82,2021-08-16,9.88,Withdrawal Debit Card MC Debit/NETFLIX.COM LOS GATOS CADate 09/13/21 0 1256468518 1 4899Card 2801,9.88
8/16/2021,,Withdrawal POS #000000084920/GATE 1445 506 NW 1 GAINESVILLE FLCard 2801,13.57,,Posted,1105.7,2021-08-16,13.57,Withdrawal POS #000000183316/GATE 1445 506 NW 13TH GAINESVILLE FLCard 2801,13.655000000000001
8/16/2021,,Withdrawal POS #000000023411/PUBLIX 203 NW 13TH STREET GAINESVILLE FLCard 2801,40.11,,Posted,1119.27,2021-08-16,40.11,Withdrawal POS #000000023411/PUBLIX 203 NW 13TH STREET GAINESVILLE FLCard 2801,40.11
8/16/2021,,Withdrawal ATM Transaction,80.0,,Posted,1159.38,2021-08-16,80.0,Withdrawal ATM Transaction,80.0
8/16/2021,,Withdrawal ACH PAYPAL/TYPE: INST XFER ID: PAYPALSI77CO: PAYPALEntry Class Code: WEB,5.99,,Posted,1099.76,2021-08-16,5.99,Withdrawal ACH PAYPAL/TYPE: INST XFER ID: PAYPALSI77CO: PAYPALEntry Class Code: WEB,5.766666666666667
8/14/2021,,Withdrawal POS #000011050060/WALGREENS 2415 SW GAINESVILLE FLCard 2801,7.56,,Posted,1105.75,2021-08-14,7.56,Withdrawal POS #000014264526/WALGREENS 2415 SW GAINESVILLE FLCard 2801,7.545
8/14/2021,,Withdrawal POS #000000084418/GATE 1445 506 NW 1 GAINESVILLE FLCard 2801,13.57,,Posted,1113.31,2021-08-14,13.57,Withdrawal POS #000000183316/GATE 1445 506 NW 13TH GAINESVILLE FLCard 2801,13.655000000000001
8/12/2021,,Recurring Withdrawal Debit Card Fee/MASTERCARD ISSUER CROSS-BORDER FEEDate 08/11/21 0 1223212559 1 5817Card 2801,0.05,,Posted,1119.79,2021-08-12,0.05,Recurring Withdrawal Debit Card Fee/MASTERCARD ISSUER CROSS-BORDER FEEDate 05/12/21 0 1132191600 1 7372Card 2801,0.09500000000000001
8/12/2021,,Recurring Withdrawal Debit Card MC Debit/PAYPAL *LINKTREE 4029357733 AUDate 08/11/21 0 1223212559 1 5817Card 2801,6.0,,Posted,1119.84,2021-08-12,6.0,Recurring Withdrawal Debit Card MC Debit/PAYPAL *LINKTREE 4029357733 AUDate 05/12/21 0 1132191600 1 7372Card 2801,6.0
8/11/2021,,Withdrawal ACH TURTLEBAYS MARKE/CO: TURTLEBAYS MARKETINGTYPE: IAT PAYPAL ID: 770510487CEntry Class Code: IAT,5.0,,Posted,1125.84,2021-08-11,5.0,Withdrawal ACH TURTLEBAYS MARKE/CO: TURTLEBAYS MARKETINGTYPE: IAT PAYPAL ID: 770510487CEntry Class Code: IAT,5.0
8/11/2021,,Withdrawal ACH PAYMENT FOR AMZ/TYPE: STORECARD ID: 9069872103CO: PAYMENT FOR AMZEntry Class Code: WEB,25.0,,Posted,1130.84,2021-08-11,25.0,Withdrawal ACH PAYMENT FOR AMZ/TYPE: STORECARD ID: 9069872103 CO: PAYMENT FOR AMZ Entry Class Code: WEB,25.0
8/11/2021,,Withdrawal ACH PAYPAL/TYPE: INST XFER ID: PAYPALSI77CO: PAYPALEntry Class Code: WEB,0.99,,Posted,1155.84,2021-08-11,0.99,Withdrawal ACH PAYPAL/TYPE: INST XFER ID: PAYPALSI77CO: PAYPALEntry Class Code: WEB,0.835
8/10/2021,,Withdrawal ACH PAYPAL/TYPE: INST XFER ID: PAYPALSI77CO: PAYPALEntry Class Code: WEB,3.69,,Posted,1156.83,2021-08-10,3.69,Withdrawal ACH PAYPAL/TYPE: INST XFER ID: PAYPALSI77CO: PAYPALEntry Class Code: WEB,3.2266666666666666
8/9/2021,,Withdrawal POS #000000002523/CIRCLE K # 06782 5 GAINESVILLE FLCard 2801,23.67,,Posted,1160.52,2021-08-09,23.67,Withdrawal POS #000000882351/CIRCLE K # 06782 GAINESVILLE FLCard 1140,23.515
8/9/2021,,Withdrawal POS #000013221697/WALGREENS 2415 SW GAINESVILLE FLCard 2801,16.85,,Posted,1184.19,2021-08-09,16.85,Withdrawal POS #000014264526/WALGREENS 2415 SW GAINESVILLE FLCard 2801,16.85
8/9/2021,,Withdrawal Debit Card MC Debit/WALGREENS #5024 800-289-2273 FLDate 08/08/21 0 1220489139 1 5912Card 2801,39.99,,Posted,1201.04,2021-08-09,39.99,Withdrawal Debit Card MC Debit/WALGREENS #5024 800-289-2273 FLDate 09/08/21 0 1251607416 1 5912Card 2801,39.99
8/8/2021,,Withdrawal at ATM #000000009758/CAMPUS 1900 SW 34TH ST GAINESVILLE FLCard 2801,120.0,,Posted,1241.03,2021-08-08,120.0,Withdrawal at ATM #000000009758/CAMPUS 1900 SW 34TH ST GAINESVILLE FLCard 2801,120.0
8/8/2021,,Withdrawal POS #000000054358/FAST TRACK #200 3960 SW ARCHER RDGAINESVILLE FLCard 2801,23.24,,Posted,1361.03,2021-08-08,23.24,Withdrawal POS #000000194488/FAST TRACK #200 3960 SW ARCHER RDGAINESVILLE FLCard 1140,23.51
8/8/2021,,Withdrawal POS #000000086361/PUBLIX 3930 SW ARCHER ROA GAINESVILLE FLCard 2801,40.21,,Posted,1384.27,2021-08-08,40.21,Withdrawal POS #000000086361/PUBLIX 3930 SW ARCHER ROA GAINESVILLE FLCard 2801,40.21
8/8/2021,,Withdrawal Bill Payment #000008044715/PAYPAL *VIDIQ San Jose CACard 2801,10.0,,Posted,1424.48,2021-08-08,10.0,Withdrawal Bill Payment #000005023648/PAYPAL *VIDIQ San Jose CACard 2801,10.0
8/6/2021,,Withdrawal ACH CAPITAL ONE/TYPE: MOBILE PMT ID: 9279744980CO: CAPITAL ONEEntry Class Code: WEB,25.0,,Posted,1434.48,2021-08-06,25.0,Withdrawal ACH CAPITAL ONE/TYPE: MOBILE PMT ID: 9279744980CO: CAPITAL ONEEntry Class Code: WEB,25.0
8/5/2021,,Withdrawal Debit Card MC Debit/PUBLIX #1312 GAINESVILLE FLDate 08/04/21 0 1216616412 1 5411Card 2801,52.11,,Posted,1459.48,2021-08-05,52.11,Withdrawal Debit Card MC Debit/PUBLIX #1312 GAINESVILLE FLDate 05/28/21 0 1148028662 2 5411Card 2801,52.11
8/5/2021,,Withdrawal ACH COX COMM GAN/TYPE: BANK DRAFT ID: 1581620085CO: COX COMM GANEntry Class Code: WEB,116.58,,Posted,1511.59,2021-08-05,116.58,Withdrawal ACH COX COMM GAN/TYPE: BANK DRAFT ID: 1581620085CO: COX COMM GANEntry Class Code: WEB,116.58
8/5/2021,,Withdrawal ACH APPLECARD GSBANK/TYPE: PAYMENT ID: 9999999999CO: APPLECARD GSBANKEntry Class Code: WEB,49.41,,Posted,1628.17,2021-08-05,49.41,Withdrawal ACH APPLECARD GSBANK/TYPE: PAYMENT ID: 9999999999 CO: APPLECARD GSBANK Entry Class Code: WEB,48.77
8/5/2021,,Withdrawal ACH PAYMENT FOR AMZ/TYPE: STORECARD ID: 9069872103CO: PAYMENT FOR AMZEntry Class Code: WEB,35.0,,Posted,1677.58,2021-08-05,35.0,Withdrawal ACH PAYMENT FOR AMZ/TYPE: STORECARD ID: 9069872103 CO: PAYMENT FOR AMZ Entry Class Code: WEB,35.045
8/4/2021,,Withdrawal POS #000000706259/FAST TRACK #200 3960 SW ARCHER RDGAINESVILLE FLCard 2801,21.98,,Posted,1712.58,2021-08-04,21.98,Withdrawal POS #000000779962/FAST TRACK #200 3960 SW ARCHER RDGAINESVILLE FLCard 2801,21.77
8/4/2021,,Withdrawal Bill Payment #000000712500/PHR*SIMEDHEALTHLLC GAINESVILLE FLCard 2801,45.0,,Posted,1734.56,2021-08-04,45.0,Withdrawal Bill Payment #000000712500/PHR*SIMEDHEALTHLLC GAINESVILLE FLCard 2801,45.0
8/4/2021,,Withdrawal ACH PAYPAL/TYPE: INST XFER ID: PAYPALSI77CO: PAYPALEntry Class Code: WEB,2.99,,Posted,1779.56,2021-08-04,2.99,Withdrawal ACH PAYPAL/TYPE: INST XFER ID: PAYPALSI77CO: PAYPALEntry Class Code: WEB,3.2266666666666666
8/4/2021,,Withdrawal POS #000000591903/KANGAROO EXPRESS 3913 3424 SW WILLISTONGAINESVILLE FLCard 2801,21.86,,Posted,1782.55,2021-08-04,21.86,Withdrawal POS #000000591903/KANGAROO EXPRESS 3913 3424 SW WILLISTONGAINESVILLE FLCard 2801,21.91
7/30/2021,,Withdrawal ACH BARCLAYCARD US/TYPE: CREDITCARD ID: 2510407970CO: BARCLAYCARD USEntry Class Code: WEB,36.02,,Posted,1804.41,2021-07-30,36.02,Withdrawal ACH BARCLAYCARD US/TYPE: CREDITCARD ID: 2510407970 CO: BARCLAYCARD US Entry Class Code: WEB,36.02
7/30/2021,,Withdrawal ACH CAPITAL ONE/TYPE: MOBILE PMT ID: 9279744980CO: CAPITAL ONEEntry Class Code: WEB,25.0,,Posted,1840.43,2021-07-30,25.0,Withdrawal ACH CAPITAL ONE/TYPE: MOBILE PMT ID: 9279744980CO: CAPITAL ONEEntry Class Code: WEB,25.0
7/30/2021,,Withdrawal ACH DISCOVER/TYPE: E-PAYMENT ID: 2510020270CO: DISCOVEREntry Class Code: WEB,31.0,,Posted,1865.43,2021-07-30,31.0,Withdrawal ACH DISCOVER/TYPE: E-PAYMENT ID: 2510020270CO: DISCOVEREntry Class Code: WEB,31.0
7/29/2021,,Withdrawal ATM Fee/COLUMBIA CAR-428486 318 NW 13TH STGAINESVILLE FLCard 2801,2.0,,Posted,1868.62,2021-07-29,2.0,Withdrawal ATM Fee/COLUMBIA CAR-428486 318 NW 13TH STGAINESVILLE FLCard 2801,2.0
7/29/2021,,Withdrawal at ATM #000000003731/COLUMBIA CAR-428486 318 NW 13TH STGAINESVILLE FLCard 2801,23.0,,Posted,1870.62,2021-07-29,23.0,Withdrawal at ATM #000000003731/COLUMBIA CAR-428486 318 NW 13TH STGAINESVILLE FLCard 2801,23.0
7/29/2021,,Withdrawal ATM Fee/COLUMBIA CAR-428486 318 NW 13TH STGAINESVILLE FLCard 2801,2.0,,Posted,1893.62,2021-07-29,2.0,Withdrawal ATM Fee/COLUMBIA CAR-428486 318 NW 13TH STGAINESVILLE FLCard 2801,2.0
7/29/2021,,Withdrawal at ATM #000000003730/COLUMBIA CAR-428486 318 NW 13TH STGAINESVILLE FLCard 2801,23.0,,Posted,1895.62,2021-07-29,23.0,Withdrawal at ATM #000000003731/COLUMBIA CAR-428486 318 NW 13TH STGAINESVILLE FLCard 2801,23.0
7/29/2021,,Withdrawal/Transactor: STEVEN J CHAPLINSKICash Disbursed 120.00,120.0,,Posted,1918.62,2021-07-29,120.0,Withdrawal/Transactor: STEVEN J CHAPLINSKICash Disbursed 120.00,120.0
7/29/2021,,Withdrawal POS #000000084284/PUBLIX 3930 SW ARCHER ROA GAINESVILLE FLCard 2801,56.69,,Posted,2038.62,2021-07-29,56.69,Withdrawal POS #000000021747/PUBLIX 3930 SW ARCHER ROA GAINESVILLE FLCard 2801,56.69
7/29/2021,,Withdrawal POS #000000166784/FAST TRACK #200 3960 SW ARCHER RDGAINESVILLE FLCard 2801,20.52,,Posted,2095.31,2021-07-29,20.52,Withdrawal POS #000000194488/FAST TRACK #200 3960 SW ARCHER RDGAINESVILLE FLCard 1140,20.52
7/29/2021,,Withdrawal ACH PAYPAL/TYPE: INST XFER ID: PAYPALSI77CO: PAYPALEntry Class Code: WEB,5.66,,Posted,102.75,2021-07-29,5.66,Withdrawal ACH PAYPAL/TYPE: INST XFER ID: PAYPALSI77CO: PAYPALEntry Class Code: WEB,5.766666666666667
7/29/2021,,Withdrawal ACH PAYPAL/TYPE: INST XFER ID: PAYPALSI77CO: PAYPALEntry Class Code: WEB,2.99,,Posted,108.41,2021-07-29,2.99,Withdrawal ACH PAYPAL/TYPE: INST XFER ID: PAYPALSI77CO: PAYPALEntry Class Code: WEB,3.2266666666666666
7/28/2021,,Recurring Withdrawal Debit Card MC Debit/AMAZON PRIME*2E90R5DC2 AMZN.COM/BIL WADate 07/27/21 0 1208211269 1 5968Card 2801,13.08,,Posted,111.4,2021-07-28,13.08,Recurring Withdrawal Debit Card MC Debit/AMAZON PRIME*2E90R5DC2 AMZN.COM/BIL WADate 07/27/21 0 1208211269 1 5968Card 2801,13.085
7/27/2021,,Withdrawal Fee/Deposited Check Returned Fee,35.0,,Posted,-175.52,2021-07-27,35.0,Withdrawal Fee/Deposited Check Returned Fee,35.0
7/27/2021,,Deposit Adjustment/FUNDS TRAN RET-ACCT CLOSED,350.0,,Posted,-140.52,2021-07-27,350.0,Deposit Adjustment/FUNDS TRAN RET-ACCT CLOSED,350.0
7/27/2021,,Recurring Withdrawal Debit Card MC Debit/HELP.HBOMAX.COM NEW YORK NYDate 07/27/21 0 1208512117 1 5815Card 2801,17.23,,Posted,209.48,2021-07-27,17.23,Recurring Withdrawal Debit Card MC Debit/HELP.HBOMAX.COM NEW YORK NYDate 04/27/22 0 2117023223 1 5815Card 2801,17.23
7/27/2021,,Withdrawal ACH CAPITAL ONE/TYPE: MOBILE PMT ID: 9279744980CO: CAPITAL ONEEntry Class Code: WEB,25.0,,Posted,226.71,2021-07-27,25.0,Withdrawal ACH CAPITAL ONE/TYPE: MOBILE PMT ID: 9279744980CO: CAPITAL ONEEntry Class Code: WEB,25.0
7/27/2021,,Withdrawal ACH eBay IncFXYBKQSU/TYPE: PAYMENTS ID: 8194689000CO: eBay IncFXYBKQSUEntry Class Code: WEB,180.01,,Posted,251.71,2021-07-27,180.01,Withdrawal ACH eBay IncFXYBKQSU/TYPE: PAYMENTS ID: 8194689000CO: eBay IncFXYBKQSUEntry Class Code: WEB,180.01
7/26/2021,,Withdrawal Debit Card MC Debit/PUBLIX #1312 GAINESVILLE FLDate 07/25/21 0 1206839939 1 5411Card 2801,45.59,,Posted,431.72,2021-07-26,45.59,Withdrawal Debit Card MC Debit/PUBLIX #1312 GAINESVILLE FLDate 03/11/21 0 1070536058 1 5411Card 2801,45.59
7/26/2021,,Withdrawal ACH BEST BUY/TYPE: PAYMENT ID: CITIGPUFDRCO: BEST BUYEntry Class Code: PPD,54.0,,Posted,477.31,2021-07-26,54.0,Withdrawal ACH BEST BUY/TYPE: PAYMENT ID: CITIGPUFDRCO: BEST BUYEntry Class Code: TEL,54.5
7/26/2021,,Withdrawal ACH APPLECARD GSBANK/TYPE: PAYMENT ID: 9999999999CO: APPLECARD GSBANKEntry Class Code: WEB,45.41,,Posted,531.31,2021-07-26,45.41,Withdrawal ACH APPLECARD GSBANK/TYPE: PAYMENT ID: 9999999999 CO: APPLECARD GSBANK Entry Class Code: WEB,45.41
7/26/2021,,Withdrawal ACH CREATIVE FABRICA/CO: CREATIVE FABRICA BVTYPE: IAT PAYPAL ID: 770510487CEntry Class Code: IAT,1.0,,Posted,576.72,2021-07-26,1.0,Withdrawal ACH CREATIVE FABRICA/CO: CREATIVE FABRICA BVTYPE: IAT PAYPAL ID: 770510487CEntry Class Code: IAT,1.0
7/26/2021,,Withdrawal ACH PAYPAL/TYPE: INST XFER ID: PAYPALSI77CO: PAYPALEntry Class Code: WEB,39.98,,Posted,577.72,2021-07-26,39.98,Withdrawal ACH PAYPAL/TYPE: INST XFER ID: PAYPALSI77CO: PAYPALEntry Class Code: WEB,39.656666666666666
7/26/2021,,Withdrawal ACH PAYPAL/TYPE: INST XFER ID: PAYPALSI77CO: PAYPALEntry Class Code: WEB,4.5,,Posted,617.7,2021-07-26,4.5,Withdrawal ACH PAYPAL/TYPE: INST XFER ID: PAYPALSI77CO: PAYPALEntry Class Code: WEB,5.032
7/25/2021,,Withdrawal POS #000000418393/FAST TRACK #200 3960 SW ARCHER RDGAINESVILLE FLCard 2801,20.52,,Posted,514.15,2021-07-25,20.52,Withdrawal POS #000000418393/FAST TRACK #200 3960 SW ARCHER RDGAINESVILLE FLCard 2801,20.52
7/25/2021,,Withdrawal POS #000013064597/WALGREENS 2415 SW GAINESVILLE FLCard 2801,6.06,,Posted,534.67,2021-07-25,6.06,Withdrawal POS #000014264526/WALGREENS 2415 SW GAINESVILLE FLCard 2801,5.705
7/24/2021,,Withdrawal Home Banking Transfer - To Share 0000/Funds Transfer via Mobile,25.0,,Posted,540.73,2021-07-24,25.0,Withdrawal Home Banking Transfer - To Share 0000/Funds Transfer via Online,25.0
7/22/2021,,Withdrawal POS #000000392386/AMAZON.COM*2E7IK9G82 SEATTLE WACard 2801,49.65,,Posted,166.08,2021-07-22,49.65,Withdrawal POS #000000259511/AMAZON.COM*2776K9KH0 SEATTLE WACard 2801,49.65
7/22/2021,,Withdrawal Debit Card MC Debit/PUBLIX #680 GAINESVILLE FLDate 07/21/21 0 1202694515 1 5411Card 2801,21.23,,Posted,215.73,2021-07-22,21.23,Withdrawal Debit Card MC Debit/PUBLIX #795 GAINESVILLE FLDate 03/07/22 0 2066965570 0 5411Card 2801,21.23
7/22/2021,,Withdrawal POS #000012308138/WALGREENS 2415 SW GAINESVILLE FLCard 2801,7.53,,Posted,236.96,2021-07-22,7.53,Withdrawal POS #000014264526/WALGREENS 2415 SW GAINESVILLE FLCard 2801,7.545
7/22/2021,,Withdrawal Courtesy Pay Fee/Entry Class Code: IAT,35.0,,Posted,-155.51,2021-07-22,35.0,Withdrawal Courtesy Pay Fee/Entry Class Code: WEB,35.0
7/22/2021,,Withdrawal ACH PHOTOPEA/CO: PHOTOPEATYPE: IAT PAYPAL ID: 770510487C,10.0,,Posted,-120.51,2021-07-22,10.0,Withdrawal ACH PHOTOPEA/CO: PHOTOPEATYPE: IAT PAYPAL ID: 770510487CEntry Class Code: IAT,9.5
7/21/2021,,Withdrawal Courtesy Pay fee,35.0,,Posted,-191.69,2021-07-21,35.0,Withdrawal Courtesy Pay Fee,35.0
7/21/2021,150.0,Draft 150,230.0,,Posted,-156.69,2021-07-21,230.0,Draft 102,230.0
7/21/2021,,Withdrawal Debit Card MC Debit/PUBLIX #1038 GAINESVILLE FLDate 07/20/21 0 1201696951 1 5411Card 2801,40.58,,Posted,61.61,2021-07-21,40.58,Withdrawal Debit Card MC Debit/PUBLIX #1560 GAINESVILLE FLDate 09/04/21 0 1247836114 5 5411Card 2801,40.72
7/21/2021,,Withdrawal POS #000000171121/TARGET T-0687 3970 SW Archer RdGainesville FLCard 2801,33.93,,Posted,102.19,2021-07-21,33.93,Withdrawal POS #000000079769/TARGET T-0687 3970 SW Archer RdGainesville FLCard 2801,33.93
7/21/2021,,Withdrawal ACH BARCLAYCARD US/TYPE: CREDITCARD ID: 2510407970CO: BARCLAYCARD USEntry Class Code: WEB,31.54,,Posted,111.12,2021-07-21,31.54,Withdrawal ACH BARCLAYCARD US/TYPE: CREDITCARD ID: 2510407970 CO: BARCLAYCARD US Entry Class Code: WEB,31.54
7/21/2021,,Withdrawal ACH MARIMURICASE/CO: MARIMURICASETYPE: IAT PAYPAL ID: 770510487CEntry Class Code: IAT,25.02,,Posted,142.66,2021-07-21,25.02,Withdrawal ACH MARIMURICASE/CO: MARIMURICASETYPE: IAT PAYPAL ID: 770510487CEntry Class Code: IAT,25.02
7/21/2021,,Withdrawal ACH PAYPAL/TYPE: INST XFER ID: PAYPALSI77CO: PAYPALEntry Class Code: WEB,33.71,,Posted,167.68,2021-07-21,33.71,Withdrawal ACH PAYPAL/TYPE: INST XFER ID: PAYPALSI77CO: PAYPALEntry Class Code: WEB,33.443333333333335
7/21/2021,,Withdrawal ACH PAYPAL/TYPE: INST XFER ID: PAYPALSI77CO: PAYPALEntry Class Code: WEB,6.99,,Posted,201.39,2021-07-21,6.99,Withdrawal ACH PAYPAL/TYPE: INST XFER ID: PAYPALSI77CO: PAYPALEntry Class Code: WEB,6.995
7/21/2021,,Withdrawal ACH PAYPAL/TYPE: INST XFER ID: PAYPALSI77CO: PAYPALEntry Class Code: WEB,5.65,,Posted,208.38,2021-07-21,5.65,Withdrawal ACH PAYPAL/TYPE: INST XFER ID: PAYPALSI77CO: PAYPALEntry Class Code: WEB,5.766666666666667
7/21/2021,,Withdrawal ACH PAYPAL/TYPE: INST XFER ID: PAYPALSI77CO: PAYPALEntry Class Code: WEB,1.0,,Posted,214.03,2021-07-21,1.0,Withdrawal ACH PAYPAL/TYPE: INST XFER ID: PAYPALSI77CO: PAYPALEntry Class Code: WEB,0.835
7/20/2021,,Withdrawal POS #000000089604/GATE 1445 506 NW 1 GAINESVILLE FLCard 2801,18.33,,Posted,94.03,2021-07-20,18.33,Withdrawal POS #000000183316/GATE 1445 506 NW 13TH GAINESVILLE FLCard 2801,18.346666666666668
7/20/2021,,Withdrawal/Cash Disbursed 200.00,200.0,,Posted,112.36,2021-07-20,200.0,Withdrawal/Cash Disbursed 35.00,200.0
7/20/2021,,"Withdrawal Transfer/To CHAPLINSKI,LEON 3496297 Share 0000",3000.0,,Posted,312.36,2021-07-20,3000.0,"Withdrawal Transfer/To CHAPLINSKI,LEON 3496297 Share 0000",3000.0
7/20/2021,,Withdrawal Bill Payment #000009336628/GRU EZ PAY WEB PYMT GAINESVILLE FLCard 2801,248.06,,Posted,3312.36,2021-07-20,248.06,Withdrawal Bill Payment #000012373398/GRU EZ PAY WEB PYMT GAINESVILLE FLCard 2801,248.06
7/20/2021,,Withdrawal POS #000000000019/AMAZON.COM*2E2N822T1 SEATTLE WACard 2801,34.9,,Posted,3560.42,2021-07-20,34.9,Withdrawal POS #000000000873/AMAZON.COM*HI8SN2DS2 SEATTLE WACard 2801,34.9
7/19/2021,,Withdrawal POS #000018233501/WALGREENS 2415 SW GAINESVILLE FLCard 2801,4.28,,Posted,3595.32,2021-07-19,4.28,Withdrawal POS #000014264526/WALGREENS 2415 SW GAINESVILLE FLCard 2801,4.78
7/19/2021,,Withdrawal POS #000000958582/WAWA 5325 2373 SW ARCHER ROA GAINESVILLEFLCard 2801,26.47,,Posted,3599.6,2021-07-19,26.47,Withdrawal POS #000000188596/WAWA 5325 2373 SW ARCHER ROA GAINESVILLEFLCard 2801,26.905
7/19/2021,,Withdrawal Debit Card MC Debit/CLKBANK*COM 63TKALGP 800-390-6035 IDDate 07/18/21 0 1199110294 5 5734Card 2801,1.0,,Posted,3626.07,2021-07-19,1.0,Withdrawal Debit Card MC Debit/CLKBANK*COM 63TKALGP 800-390-6035 IDDate 07/18/21 0 1199110294 5 5734Card 2801,1.0
7/19/2021,,Withdrawal ACH BARCLAYCARD US/TYPE: CREDITCARD ID: 2510407970CO: BARCLAYCARD USEntry Class Code: WEB,40.0,,Posted,3627.07,2021-07-19,40.0,Withdrawal ACH BARCLAYCARD US/TYPE: CREDITCARD ID: 2510407970 CO: BARCLAYCARD US Entry Class Code: WEB,39.5
7/19/2021,,Withdrawal ACH PADDLE.COM MARKE/CO: PADDLE.COM MARKET LIMITEDTYPE: IAT PAYPAL ID: 770510487CEntry Class Code: IAT,10.0,,Posted,3667.07,2021-07-19,10.0,Withdrawal ACH PADDLE.COM MARKE/CO: PADDLE.COM MARKET LIMITEDTYPE: IAT PAYPAL ID: 770510487CEntry Class Code: IAT,9.995000000000001
7/17/2021,,Withdrawal POS #000000793554/WAWA 5325 2373 SW ARCHER ROA GAINESVILLEFLCard 2801,15.51,,Posted,3677.07,2021-07-17,15.51,Withdrawal POS #000000188596/WAWA 5325 2373 SW ARCHER ROA GAINESVILLEFLCard 2801,15.51
7/16/2021,,Withdrawal Debit Card MC Debit/PUBLIX #1312 GAINESVILLE FLDate 07/15/21 0 1196703565 1 5411Card 2801,60.63,,Posted,306.45,2021-07-16,60.63,Withdrawal Debit Card MC Debit/PUBLIX #1312 GAINESVILLE FLDate 03/11/21 0 1070536058 1 5411Card 2801,60.63
7/15/2021,,Withdrawal POS #000000565069/FAST TRACK #200 3960 SW ARCHER RDGAINESVILLE FLCard 2801,10.68,,Posted,367.08,2021-07-15,10.68,Withdrawal POS #000088529500/FAST TRACK #200 3960 SW ARCHER RDGAINESVILLE FLCard 2801,10.280000000000001
7/15/2021,237.0,Draft 237,850.0,,Posted,338.16,2021-07-15,850.0,Draft 237,850.0
7/15/2021,,Withdrawal Debit Card MC Debit/WALGREENS #5024 800-289-2273 FLDate 07/14/21 0 1195641363 1 5912Card 2801,8.28,,Posted,1188.16,2021-07-15,8.28,Withdrawal Debit Card MC Debit/WALGREENS #5024 800-289-2273 FLDate 09/08/21 0 1251607416 1 5912Card 2801,8.28
7/15/2021,,Withdrawal ACH PADDLE.COM MARKE/CO: PADDLE.COM MARKET LIMITEDTYPE: IAT PAYPAL ID: 770510487CEntry Class Code: IAT,5.99,,Posted,1196.44,2021-07-15,5.99,Withdrawal ACH PADDLE.COM MARKE/CO: PADDLE.COM MARKET LIMITEDTYPE: IAT PAYPAL ID: 770510487CEntry Class Code: IAT,5.99
7/14/2021,,Withdrawal POS #000000032105/CIRCLE K # 06782 5 GAINESVILLE FLCard 2801,13.5,,Posted,1202.43,2021-07-14,13.5,Withdrawal POS #000000882351/CIRCLE K # 06782 GAINESVILLE FLCard 1140,13.165
7/13/2021,,Withdrawal POS #000000000020/AMAZON.COM*2E7J71TR1 SEATTLE WACard 2801,26.42,,Posted,1215.93,2021-07-13,26.42,Withdrawal POS #000000000007/AMAZON.COM*2864R4HI1 SEATTLE WACard 1140,26.42
7/12/2021,,Recurring Withdrawal Debit Card Fee/MASTERCARD ISSUER CROSS-BORDER FEEDate 07/11/21 0 1192439235 2 5817Card 2801,0.05,,Posted,1242.35,2021-07-12,0.05,Withdrawal Debit Card Fee/MASTERCARD ISSUER CROSS-BORDER FEEDate 04/19/21 0 1109184122 1 7311Card 2801,0.1281818181818182
7/12/2021,,Recurring Withdrawal Debit Card MC Debit/PAYPAL *LINKTREE 4029357733 AUDate 07/11/21 0 1192439235 2 5817Card 2801,6.0,,Posted,1242.4,2021-07-12,6.0,Recurring Withdrawal Debit Card MC Debit/PAYPAL *LINKTREE 4029357733 AUDate 05/12/21 0 1132191600 1 7372Card 2801,6.0
7/12/2021,,Withdrawal POS #000011047312/WALGREENS 2415 SW GAINESVILLE FLCard 2801,4.28,,Posted,1248.4,2021-07-12,4.28,Withdrawal POS #000014264526/WALGREENS 2415 SW GAINESVILLE FLCard 2801,4.78
7/12/2021,,Withdrawal ACH TECHLAIM SIA/CO: TECHLAIM SIATYPE: IAT PAYPAL ID: 770510487CEntry Class Code: IAT,1.49,,Posted,1252.68,2021-07-12,1.49,Withdrawal ACH TECHLAIM SIA/CO: TECHLAIM SIATYPE: IAT PAYPAL ID: 770510487CEntry Class Code: IAT,1.49
7/11/2021,,Withdrawal Debit Card MC Debit/PAYPAL *MUIREY03 4029357733 CADate 07/09/21 0 1190400088 1 7372Card 2801,0.99,,Posted,1254.17,2021-07-11,0.99,Withdrawal Debit Card MC Debit/PAYPAL *MUIREY03 4029357733 CADate 07/09/21 0 1190400088 1 7372Card 2801,0.99
7/9/2021,,Withdrawal POS #000000030309/CIRCLE K # 06782 5 GAINESVILLE FLCard 2801,13.5,,Posted,1255.16,2021-07-09,13.5,Withdrawal POS #000000882351/CIRCLE K # 06782 GAINESVILLE FLCard 1140,13.165
7/9/2021,,Withdrawal Debit Card MC Debit/PIZZA HUT 27918 3523739402 FLDate 07/07/21 0 1188191773 1 5812Card 2801,35.53,,Posted,1075.61,2021-07-09,35.53,Withdrawal Debit Card MC Debit/PIZZA HUT 27918 3523739402 FLDate 12/16/22 0 2350808582 1 5812Card 2801,35.78666666666667
7/9/2021,,Withdrawal Debit Card MC Debit/CANNAMD 855-4209170 FLDate 07/08/21 0 1189609701 1 8011Card 2801,195.0,,Posted,1111.14,2021-07-09,195.0,Withdrawal Debit Card MC Debit/CANNAMD 855-4209170 FLDate 04/07/23 0 3097109858 2 8011Card 2801,195.0
7/9/2021,,Withdrawal Debit Card MC Debit/WALGREENS #5024 800-289-2273 FLDate 07/08/21 0 1189597740 1 5912Card 2801,15.0,,Posted,1306.14,2021-07-09,15.0,Withdrawal Debit Card MC Debit/WALGREENS #5024 800-289-2273 FLDate 09/08/21 0 1251607416 1 5912Card 2801,15.24
7/9/2021,,Withdrawal Debit Card MC Debit/PRIME VIDEO*2920418O0 888-802-3080 WADate 07/08/21 0 1189605384 1 5818Card 2801,13.18,,Posted,1321.14,2021-07-09,13.18,Withdrawal Debit Card MC Debit/PRIME VIDEO*2920418O0 888-802-3080 WADate 07/08/21 0 1189605384 1 5818Card 2801,13.18
7/9/2021,,Withdrawal/Cash Disbursed 200.00,200.0,,Posted,1334.32,2021-07-09,200.0,Withdrawal/Cash Disbursed 35.00,200.0
7/9/2021,,Withdrawal ACH PAYPAL/TYPE: INST XFER ID: PAYPALSI77CO: PAYPALEntry Class Code: WEB,2.99,,Posted,1534.32,2021-07-09,2.99,Withdrawal ACH PAYPAL/TYPE: INST XFER ID: PAYPALSI77CO: PAYPALEntry Class Code: WEB,3.2266666666666666
7/9/2021,,Recurring Withdrawal Bill Payment - #000011827861/PAYPAL *VIDIQ 2211 North First S SanCACard 2801,10.0,,Posted,1537.31,2021-07-09,10.0,Recurring Withdrawal Bill Payment - #000045891971/PAYPAL *VIDIQ 2211 North First S SanCACard 2801,10.25
7/8/2021,,Withdrawal POS #000000040622/FAST TRACK #200 3960 SW ARCHER RDGAINESVILLE FLCard 2801,17.75,,Posted,1289.91,2021-07-08,17.75,Withdrawal POS #000000779962/FAST TRACK #200 3960 SW ARCHER RDGAINESVILLE FLCard 2801,17.75
7/8/2021,,Withdrawal POS #000000074419/PUBLIX 3930 SW ARCHER ROA GAINESVILLE FLCard 2801,18.43,,Posted,1307.66,2021-07-08,18.43,Withdrawal POS #000000021747/PUBLIX 3930 SW ARCHER ROA GAINESVILLE FLCard 2801,18.43
7/8/2021,,Withdrawal POS #000012253616/WALGREENS 2415 SW GAINESVILLE FLCard 2801,8.56,,Posted,1326.09,2021-07-08,8.56,Withdrawal POS #000014264526/WALGREENS 2415 SW GAINESVILLE FLCard 2801,8.620000000000001
7/8/2021,,Withdrawal ACH LAST.FM LTD/CO: LAST.FM LTDTYPE: IAT PAYPAL ID: 770510487CEntry Class Code: IAT,3.0,,Posted,1334.65,2021-07-08,3.0,Withdrawal ACH LAST.FM LTD/CO: LAST.FM LTDTYPE: IAT PAYPAL ID: 770510487CEntry Class Code: IAT,3.0
7/4/2021,,Recurring Withdrawal Debit Card MC Debit/VIACOMCBS STREAMING 8882745343 CADate 07/02/21 0 1183474018 1 4899Card 2801,52.43,,Posted,1337.65,2021-07-04,52.43,Recurring Withdrawal Debit Card MC Debit/VIACOMCBS STREAMING 8882745343 CADate 07/02/21 0 1183474018 1 4899Card 2801,52.43
7/4/2021,,Recurring Withdrawal Debit Card MC Debit/VIACOMCBS STREAMING 8882745343 CADate 07/02/21 0 1183474013 1 4899Card 2801,43.08,,Posted,1390.08,2021-07-04,43.08,Recurring Withdrawal Debit Card MC Debit/VIACOMCBS STREAMING 8882745343 CADate 07/02/21 0 1183474018 1 4899Card 2801,43.08
7/4/2021,,Withdrawal Debit Card MC Debit/VIACOMCBS STREAMING 8882745343 CADate 07/02/21 0 1183474012 1 4899Card 2801,10.5,,Posted,1433.16,2021-07-04,10.5,Recurring Withdrawal Debit Card MC Debit/VIACOMCBS STREAMING 8882745343 CADate 07/02/21 0 1183474018 1 4899Card 2801,10.5
7/4/2021,,Withdrawal POS #000000175298/FAST TRACK #200 3960 SW ARCHER RDGAINESVILLE FLCard 2801,22.57,,Posted,1443.66,2021-07-04,22.57,Withdrawal POS #000000194488/FAST TRACK #200 3960 SW ARCHER RDGAINESVILLE FLCard 1140,22.2575
7/2/2021,,Withdrawal ACH BARCLAYCARD US/TYPE: CREDITCARD ID: 2510407970CO: BARCLAYCARD USEntry Class Code: WEB,75.0,,Posted,1466.23,2021-07-02,75.0,Withdrawal ACH BARCLAYCARD US/TYPE: CREDITCARD ID: 2510407970 CO: BARCLAYCARD US Entry Class Code: WEB,75.0
7/2/2021,,Withdrawal ACH BEST BUY/TYPE: PAYMENT ID: CITIGPUFDRCO: BEST BUYEntry Class Code: PPD,75.0,,Posted,1541.23,2021-07-02,75.0,Withdrawal ACH BEST BUY/TYPE: PAYMENT ID: CITIGPUFDRCO: BEST BUYEntry Class Code: TEL,75.0
7/2/2021,,Withdrawal ACH BEST BUY/TYPE: PAYMENT ID: CITIGPUFDRCO: BEST BUYEntry Class Code: PPD,75.0,,Posted,1616.23,2021-07-02,75.0,Withdrawal ACH BEST BUY/TYPE: PAYMENT ID: CITIGPUFDRCO: BEST BUYEntry Class Code: TEL,75.0
7/2/2021,,Withdrawal ACH DISCOVER/TYPE: E-PAYMENT ID: 2510020270CO: DISCOVEREntry Class Code: WEB,75.0,,Posted,1691.23,2021-07-02,75.0,Withdrawal ACH DISCOVER/TYPE: E-PAYMENT ID: 2510020270CO: DISCOVEREntry Class Code: WEB,75.0
7/2/2021,,Withdrawal ACH TARGET CARD SRVC/TYPE: BILL PAY ID: T510215170CO: TARGET CARD SRVCEntry Class Code: WEB,75.0,,Posted,1766.23,2021-07-02,75.0,Withdrawal ACH TARGET CARD SRVC/TYPE: BILL PAY ID: T510215170CO: TARGET CARD SRVCEntry Class Code: WEB,75.0
7/2/2021,,Withdrawal ACH PAYMENT FOR AMZ/TYPE: STORECARD ID: 9069872103CO: PAYMENT FOR AMZEntry Class Code: WEB,75.0,,Posted,1841.23,2021-07-02,75.0,Withdrawal ACH PAYMENT FOR AMZ/TYPE: STORECARD ID: 9069872103 CO: PAYMENT FOR AMZ Entry Class Code: WEB,75.0
7/1/2021,,Withdrawal Debit Card MC Debit/PUBLIX #1038 GAINESVILLE FLDate 06/30/21 0 1181753574 1 5411Card 2801,41.29,,Posted,1916.23,2021-07-01,41.29,Withdrawal Debit Card MC Debit/PUBLIX #1560 GAINESVILLE FLDate 09/04/21 0 1247836114 5 5411Card 2801,40.72
7/1/2021,,Withdrawal ACH APPLECARD GSBANK/TYPE: PAYMENT ID: 9999999999CO: APPLECARD GSBANKEntry Class Code: WEB,75.0,,Posted,1957.52,2021-07-01,75.0,Withdrawal ACH APPLECARD GSBANK/TYPE: PAYMENT ID: 9999999999 CO: APPLECARD GSBANK Entry Class Code: WEB,75.0
7/1/2021,,Withdrawal ACH CAPITAL ONE/TYPE: MOBILE PMT ID: 9279744980CO: CAPITAL ONEEntry Class Code: WEB,75.0,,Posted,2032.52,2021-07-01,75.0,Withdrawal ACH CAPITAL ONE/TYPE: MOBILE PMT ID: 9279744980CO: CAPITAL ONEEntry Class Code: WEB,75.0
7/1/2021,,Withdrawal ACH PAYPAL/TYPE: INST XFER ID: PAYPALSI77CO: PAYPALEntry Class Code: WEB,49.98,,Posted,2107.52,2021-07-01,49.98,Withdrawal ACH PAYPAL/TYPE: INST XFER ID: PAYPALSI77CO: PAYPALEntry Class Code: WEB,49.66
6/30/2021,,Withdrawal POS #000000019103/CIRCLE K # 26146 3 GAINESVILLE FLCard 2801,16.98,,Posted,2157.5,2021-06-30,16.98,Withdrawal POS #000000011248/CIRCLE K # 23913 3424 GAINESVILLE FLCard 2801,17.36
6/30/2021,,Withdrawal Debit Card MC Debit/PUBLIX #1312 GAINESVILLE FLDate 06/29/21 0 1180625032 1 5411Card 2801,40.3,,Posted,2174.48,2021-06-30,40.3,Withdrawal Debit Card MC Debit/PUBLIX #1312 GAINESVILLE FLDate 03/11/21 0 1070536058 1 5411Card 2801,40.3
6/30/2021,,Withdrawal ACH COX COMM GAN/TYPE: BANK DRAFT ID: 1581620085CO: COX COMM GANEntry Class Code: WEB,5.03,,Posted,2214.78,2021-06-30,5.03,Withdrawal ACH COX COMM GAN/TYPE: BANK DRAFT ID: 1581620085CO: COX COMM GANEntry Class Code: WEB,5.03
6/30/2021,,Withdrawal ACH PAYPAL/TYPE: INST XFER ID: PAYPALSI77CO: PAYPALEntry Class Code: WEB,33.45,,Posted,219.81,2021-06-30,33.45,Withdrawal ACH PAYPAL/TYPE: INST XFER ID: PAYPALSI77CO: PAYPALEntry Class Code: WEB,33.443333333333335
6/29/2021,,Withdrawal Debit Card MC Debit/PUBLIX #1312 GAINESVILLE FLDate 06/28/21 0 1179522814 1 5411Card 2801,78.49,,Posted,253.26,2021-06-29,78.49,Withdrawal Debit Card MC Debit/PUBLIX #1312 GAINESVILLE FLDate 03/11/21 0 1070536058 1 5411Card 2801,78.49
6/29/2021,,Withdrawal Debit Card MC Debit/WALGREENS #5024 800-289-2273 FLDate 06/28/21 0 1179519487 1 5912Card 2801,4.65,,Posted,331.75,2021-06-29,4.65,Withdrawal Debit Card MC Debit/WALGREENS #5024 800-289-2273 FLDate 09/08/21 0 1251607416 1 5912Card 2801,4.09
6/29/2021,,Withdrawal ACH PADDLE.COM MARKE/CO: PADDLE.COM MARKET LIMITEDTYPE: IAT PAYPAL ID: 770510487CEntry Class Code: IAT,5.99,,Posted,336.4,2021-06-29,5.99,Withdrawal ACH PADDLE.COM MARKE/CO: PADDLE.COM MARKET LIMITEDTYPE: IAT PAYPAL ID: 770510487CEntry Class Code: IAT,5.99
6/29/2021,,Withdrawal ACH PAYPAL/TYPE: INST XFER ID: PAYPALSI77CO: PAYPALEntry Class Code: WEB,5.66,,Posted,342.39,2021-06-29,5.66,Withdrawal ACH PAYPAL/TYPE: INST XFER ID: PAYPALSI77CO: PAYPALEntry Class Code: WEB,5.766666666666667
6/29/2021,,Withdrawal POS #000000000000/AMAZON PAYMENTS SEATTLE WACard 2801,5.74,,Posted,348.05,2021-06-29,5.74,Withdrawal POS #000000000000/AMAZON PAYMENTS SEATTLE WACard 2801,5.74
6/28/2021,,Recurring Withdrawal Debit Card MC Debit/HELP.HBOMAX.COM NEW YORK NYDate 06/27/21 0 1178683424 5 5815Card 2801,17.23,,Posted,353.79,2021-06-28,17.23,Recurring Withdrawal Debit Card MC Debit/HELP.HBOMAX.COM NEW YORK NYDate 04/27/22 0 2117023223 1 5815Card 2801,17.23
6/28/2021,,Recurring Withdrawal Debit Card MC Debit/AMAZON PRIME*217157D82 AMZN.COM/BIL WADate 06/27/21 0 1178669271 5 5968Card 2801,13.09,,Posted,371.02,2021-06-28,13.09,Recurring Withdrawal Debit Card MC Debit/AMAZON PRIME*2E90R5DC2 AMZN.COM/BIL WADate 07/27/21 0 1208211269 1 5968Card 2801,13.085
6/28/2021,,Withdrawal POS #000000066157/GATE 1445 506 NW 1 GAINESVILLE FLCard 2801,8.76,,Posted,384.11,2021-06-28,8.76,Withdrawal POS #000000183316/GATE 1445 506 NW 13TH GAINESVILLE FLCard 2801,9.0
6/28/2021,,Withdrawal/Transactor: STEVEN J CHAPLINSKICash Disbursed 120.00,120.0,,Posted,392.87,2021-06-28,120.0,Withdrawal/Transactor: STEVEN J CHAPLINSKICash Disbursed 120.00,120.0
6/28/2021,,Withdrawal ACH PAYPAL/TYPE: INST XFER ID: PAYPALSI77CO: PAYPALEntry Class Code: WEB,39.99,,Posted,262.87,2021-06-28,39.99,Withdrawal ACH PAYPAL/TYPE: INST XFER ID: PAYPALSI77CO: PAYPALEntry Class Code: WEB,39.656666666666666
6/27/2021,,Withdrawal POS #000000000000/AMAZON PAYMENTS SEATTLE WACard 2801,5.74,,Posted,302.86,2021-06-27,5.74,Withdrawal POS #000000000000/AMAZON PAYMENTS SEATTLE WACard 2801,5.74
6/25/2021,,Withdrawal POS #000000073587/GATE 1445 506 NW 1 GAINESVILLE FLCard 2801,22.33,,Posted,308.6,2021-06-25,22.33,Withdrawal POS #000000183316/GATE 1445 506 NW 13TH GAINESVILLE FLCard 2801,22.908
6/25/2021,,Withdrawal at ATM #000000006161/CAMPUS 1900 SW 34TH ST GAINESVILLE FLCard 2801,60.0,,Posted,330.93,2021-06-25,60.0,Withdrawal at ATM #000000009758/CAMPUS 1900 SW 34TH ST GAINESVILLE FLCard 2801,60.0
6/23/2021,,Withdrawal ACH APPLECARD GSBANK/TYPE: PAYMENT ID: 9999999999CO: APPLECARD GSBANKEntry Class Code: WEB,25.0,,Posted,345.0,2021-06-23,25.0,Withdrawal ACH APPLECARD GSBANK/TYPE: PAYMENT ID: 9999999999 CO: APPLECARD GSBANK Entry Class Code: WEB,25.0
6/22/2021,,Withdrawal ACH Vertiec Solution/TYPE: B2P*FLDOH ID: 0000486349CO: Vertiec SolutionEntry Class Code: WEB,77.75,,Posted,370.0,2021-06-22,77.75,Withdrawal ACH Vertiec Solution/TYPE: B2P*FLDOH ID: 0000486349CO: Vertiec SolutionEntry Class Code: WEB,77.75
6/21/2021,,Withdrawal ACH PAYMENT FOR AMZ/TYPE: STORECARD ID: 9069872103CO: PAYMENT FOR AMZEntry Class Code: WEB,100.0,,Posted,94.55,2021-06-21,100.0,Withdrawal ACH PAYMENT FOR AMZ/TYPE: STORECARD ID: 9069872103 CO: PAYMENT FOR AMZ Entry Class Code: WEB,100.0
6/21/2021,,Withdrawal Transfer fee,8.0,,Posted,194.55,2021-06-21,8.0,Withdrawal Transfer fee,8.0
6/21/2021,,Withdrawal ACH PAYPAL/TYPE: INST XFER ID: PAYPALSI77CO: PAYPALEntry Class Code: WEB,6.99,,Posted,2.55,2021-06-21,6.99,Withdrawal ACH PAYPAL/TYPE: INST XFER ID: PAYPALSI77CO: PAYPALEntry Class Code: WEB,6.995
6/21/2021,,Withdrawal ACH PAYPAL/TYPE: INST XFER ID: PAYPALSI77CO: PAYPALEntry Class Code: WEB,1.99,,Posted,9.54,2021-06-21,1.99,Withdrawal ACH PAYPAL/TYPE: INST XFER ID: PAYPALSI77CO: PAYPALEntry Class Code: WEB,1.99
6/21/2021,,Withdrawal POS #000000990788/AMAZON.COM*215VY1SG1 SEATTLE WACard 2801,45.93,,Posted,11.53,2021-06-21,45.93,Withdrawal POS #000000990788/AMAZON.COM*215VY1SG1 SEATTLE WACard 2801,45.93
6/20/2021,,Withdrawal POS #000000880685/FAST TRACK #200 3960 SW ARCHER RDGAINESVILLE FLCard 2801,22.57,,Posted,57.46,2021-06-20,22.57,Withdrawal POS #000088529500/FAST TRACK #200 3960 SW ARCHER RDGAINESVILLE FLCard 2801,22.57
6/20/2021,,Withdrawal POS #000000029500/PUBLIX 3930 SW ARCHER ROA GAINESVILLE FLCard 2801,44.46,,Posted,80.03,2021-06-20,44.46,Withdrawal POS #000000029500/PUBLIX 3930 SW ARCHER ROA GAINESVILLE FLCard 2801,44.129999999999995
6/20/2021,,Withdrawal Debit Card MC Debit/PUBLIX #1312 GAINESVILLE FLDate 06/18/21 0 1169764423 1 5411Card 2801,41.91,,Posted,124.49,2021-06-20,41.91,Withdrawal Debit Card MC Debit/PUBLIX #1312 GAINESVILLE FLDate 03/11/21 0 1070536058 1 5411Card 2801,41.795
6/20/2021,,Withdrawal Debit Card MC Debit/AMZN DIGITAL*213334Z60 888-802-3080 WADate 06/18/21 0 1169422634 1 5818Card 2801,100.0,,Posted,166.4,2021-06-20,100.0,Withdrawal Debit Card MC Debit/AMZN DIGITAL*2G2YK1811 888-802-3080 WADate 09/15/21 0 1258632245 1 5818Card 2801,100.0
6/20/2021,,Withdrawal Debit Card MC Debit/PAYPAL *EBAY US 4029357733 CADate 06/17/21 0 1168417789 1 5311Card 2801,839.99,,Posted,266.4,2021-06-20,839.99,Withdrawal Debit Card MC Debit/PAYPAL *EBAY US 4029357733 CADate 06/17/21 0 1168417789 1 5311Card 2801,839.99
6/20/2021,,Withdrawal POS #000000350216/AMAZON.COM*210N16AL0 SEATTLE WACard 2801,12.81,,Posted,1106.39,2021-06-20,12.81,Withdrawal POS #000000259511/AMAZON.COM*2776K9KH0 SEATTLE WACard 2801,12.55
6/20/2021,,Recurring Withdrawal Bill Payment - #000097791799/PAYPAL *TUBEBUDDY TUBEBUD 2211 NorthS San Jose CACard 2801,4.5,,Posted,1119.2,2021-06-20,4.5,Recurring Withdrawal Bill Payment - #000097791799/PAYPAL *TUBEBUDDY TUBEBUD 2211 NorthS San Jose CACard 2801,4.5
6/20/2021,,Withdrawal Bill Payment #000011160011/PAYPAL *GUMROAD EXOARTIC 2211 NorthS San Jose CACard 2801,1.0,,Posted,1123.7,2021-06-20,1.0,Withdrawal Bill Payment #000011160011/PAYPAL *GUMROAD EXOARTIC 2211 NorthS San Jose CACard 2801,1.0
6/18/2021,,Withdrawal ACH APPLECARD GSBANK/TYPE: PAYMENT ID: 9999999999CO: APPLECARD GSBANKEntry Class Code: WEB,125.0,,Posted,1124.7,2021-06-18,125.0,Withdrawal ACH APPLECARD GSBANK/TYPE: PAYMENT ID: 9999999999 CO: APPLECARD GSBANK Entry Class Code: WEB,125.0
6/18/2021,,Withdrawal ACH CAPITAL ONE/TYPE: MOBILE PMT ID: 9279744980CO: CAPITAL ONEEntry Class Code: WEB,100.0,,Posted,1249.7,2021-06-18,100.0,Withdrawal ACH CAPITAL ONE/TYPE: MOBILE PMT ID: 9279744980CO: CAPITAL ONEEntry Class Code: WEB,100.0
6/18/2021,,Withdrawal ACH BARCLAYCARD US/TYPE: CREDITCARD ID: 2510407970CO: BARCLAYCARD USEntry Class Code: WEB,100.0,,Posted,1349.7,2021-06-18,100.0,Withdrawal ACH BARCLAYCARD US/TYPE: CREDITCARD ID: 2510407970 CO: BARCLAYCARD US Entry Class Code: WEB,100.0
6/18/2021,,Withdrawal POS #000000712796/WAWA 5325 2373 SW ARCHER ROA GAINESVILLEFLCard 2801,27.34,,Posted,1449.7,2021-06-18,27.34,Withdrawal POS #000000188596/WAWA 5325 2373 SW ARCHER ROA GAINESVILLEFLCard 2801,26.905
6/18/2021,,Withdrawal Bill Payment #000011116970/PAYPAL *STRLABSITES PRIME 2211 NorthS San Jose CACard 2801,19.0,,Posted,1477.04,2021-06-18,19.0,Withdrawal Bill Payment #000011116970/PAYPAL *STRLABSITES PRIME 2211 NorthS San Jose CACard 2801,19.0
6/18/2021,,Withdrawal ACH DISCOVER/TYPE: E-PAYMENT ID: 2510020270CO: DISCOVEREntry Class Code: WEB,100.0,,Posted,1496.04,2021-06-18,100.0,Withdrawal ACH DISCOVER/TYPE: E-PAYMENT ID: 2510020270CO: DISCOVEREntry Class Code: WEB,100.0
6/18/2021,,Withdrawal ACH TARGET CARD SRVC/TYPE: BILL PAY ID: T510215170CO: TARGET CARD SRVCEntry Class Code: WEB,100.0,,Posted,1596.04,2021-06-18,100.0,Withdrawal ACH TARGET CARD SRVC/TYPE: BILL PAY ID: T510215170CO: TARGET CARD SRVCEntry Class Code: WEB,100.0
6/17/2021,236.0,Draft 236,850.0,,Posted,1696.04,2021-06-17,850.0,Draft 237,850.0
6/16/2021,,Withdrawal Debit Card MC Debit/PAYPAL *EBAY US 4029357733 CADate 06/15/21 0 1166635234 1 5311Card 2801,765.1,,Posted,1780.94,2021-06-16,765.1,Withdrawal Debit Card MC Debit/PAYPAL *EBAY US 4029357733 CADate 06/17/21 0 1168417789 1 5311Card 2801,765.1
6/16/2021,,Withdrawal POS #000000415870/CK 2726162 7302 SW ARCHER RD GAINESVILLEFLCard 2801,23.35,,Posted,2546.04,2021-06-16,23.35,Withdrawal POS #000000006070/KOHLS 1242 3501 SW ARCHER RD GAINESVILLEFLCard 2801,23.35
6/15/2021,,Withdrawal Debit Card MC Debit/WALGREENS #5024 800-289-2273 FLDate 06/14/21 0 1165512347 1 5912Card 2801,4.0,,Posted,1186.79,2021-06-15,4.0,Withdrawal Debit Card MC Debit/WALGREENS #5024 800-289-2273 FLDate 09/17/22 0 2260124597 1 5912Card 2801,4.0
6/15/2021,,Withdrawal ACH TARGET CARD SRVC/TYPE: BILL PAY ID: T510215170CO: TARGET CARD SRVCEntry Class Code: WEB,75.0,,Posted,1190.79,2021-06-15,75.0,Withdrawal ACH TARGET CARD SRVC/TYPE: BILL PAY ID: T510215170CO: TARGET CARD SRVCEntry Class Code: WEB,75.0
6/15/2021,,Withdrawal Bill Payment #000007279958/PAYPAL *ZENIMAX ONL San Jose CACard 2801,14.99,,Posted,1265.79,2021-06-15,14.99,Withdrawal Bill Payment #000007279958/PAYPAL *ZENIMAX ONL San Jose CACard 2801,14.99
6/15/2021,,Withdrawal POS #000012283703/GOOGLE *Domains Mountain View CACard 2801,6.0,,Posted,1260.98,2021-06-15,6.0,Withdrawal POS #000012283703/GOOGLE *Domains Mountain View CACard 2801,6.0
6/14/2021,,Withdrawal Debit Card MC Debit/PUBLIX #1312 GAINESVILLE FLDate 06/12/21 0 1163798447 2 5411Card 2801,25.51,,Posted,1265.48,2021-06-14,25.51,Withdrawal Debit Card MC Debit/PUBLIX #1312 GAINESVILLE FLDate 05/28/21 0 1148028662 2 5411Card 2801,25.51
6/14/2021,,Withdrawal Debit Card MC Debit/PRIME VIDEO*215X323P1 888-802-3080 WADate 06/13/21 0 1164704725 1 5818Card 2801,5.67,,Posted,1290.99,2021-06-14,5.67,Withdrawal Debit Card MC Debit/PRIME VIDEO*2920418O0 888-802-3080 WADate 07/08/21 0 1189605384 1 5818Card 2801,5.67
6/14/2021,,Recurring Withdrawal Debit Card MC Debit/VZWRLSS*BILL PAY V FOLSOM CADate 06/12/21 0 1163011733 4 4814Card 2801,113.49,,Posted,1296.66,2021-06-14,113.49,Recurring Withdrawal Debit Card MC Debit/VZWRLSS*BILL PAY V FOLSOM CADate 06/12/21 0 1163011733 4 4814Card 2801,113.49
6/14/2021,,Withdrawal POS #000000081607/GATE 1445 506 NW 1 GAINESVILLE FLCard 2801,22.33,,Posted,1410.15,2021-06-14,22.33,Withdrawal POS #000000183316/GATE 1445 506 NW 13TH GAINESVILLE FLCard 2801,22.908
6/14/2021,,Withdrawal ACH PAYPAL/TYPE: INST XFER ID: PAYPALSI77CO: PAYPALEntry Class Code: WEB,27.95,,Posted,1432.48,2021-06-14,27.95,Withdrawal ACH PAYPAL/TYPE: INST XFER ID: PAYPALSI77CO: PAYPALEntry Class Code: WEB,27.945
6/14/2021,,Withdrawal Bill Payment #000001265801/PAYPAL *PACKIX San Jose CACard 2801,0.99,,Posted,1460.43,2021-06-14,0.99,Withdrawal Bill Payment #000007279958/PAYPAL *ZENIMAX ONL San Jose CACard 2801,0.99
6/14/2021,,Withdrawal Bill Payment #000012264962/PAYPAL *PACKIX San Jose CACard 2801,1.99,,Posted,1461.42,2021-06-14,1.99,Withdrawal Bill Payment #000005023648/PAYPAL *VIDIQ San Jose CACard 2801,1.99
6/13/2021,,Recurring Withdrawal Debit Card Fee/MASTERCARD ISSUER CROSS-BORDER FEEDate 06/11/21 0 1162482595 1 7372Card 2801,0.05,,Posted,1463.41,2021-06-13,0.05,Withdrawal Debit Card Fee/MASTERCARD ISSUER CROSS-BORDER FEEDate 04/19/21 0 1109184122 1 7311Card 2801,0.1281818181818182
6/13/2021,,Recurring Withdrawal Debit Card MC Debit/PAYPAL *LINKTREE 4029357733 AUDate 06/11/21 0 1162482595 1 7372Card 2801,6.0,,Posted,1463.46,2021-06-13,6.0,Recurring Withdrawal Debit Card MC Debit/PAYPAL *LINKTREE 4029357733 AUDate 05/12/21 0 1132191600 1 7372Card 2801,6.0
6/10/2021,,Withdrawal Debit Card MC Debit/WALGREENS #5024 800-289-2273 FLDate 06/09/21 0 1160510538 1 5912Card 2801,19.28,,Posted,1119.46,2021-06-10,19.28,Withdrawal Debit Card MC Debit/WALGREENS #5024 800-289-2273 FLDate 09/08/21 0 1251607416 1 5912Card 2801,19.28
6/10/2021,,Withdrawal Bill Payment #000027794161/PAYPAL *LH TRADING 2211 North First SJose CACard 2801,62.48,,Posted,1138.74,2021-06-10,62.48,Withdrawal Bill Payment #000027794161/PAYPAL *LH TRADING 2211 North First SJose CACard 2801,62.48
6/9/2021,,Withdrawal POS #000000009559/CIRCLE K # 06782 5 GAINESVILLE FLCard 2801,15.98,,Posted,1201.22,2021-06-09,15.98,Withdrawal POS #000000882351/CIRCLE K # 06782 GAINESVILLE FLCard 1140,16.37
6/9/2021,,Withdrawal Debit Card MC Debit/PUBLIX #680 GAINESVILLE FLDate 06/08/21 0 1159576254 1 5411Card 2801,34.23,,Posted,1217.2,2021-06-09,34.23,Withdrawal Debit Card MC Debit/PUBLIX #1312 GAINESVILLE FLDate 06/18/21 0 1169764423 1 5411Card 2801,34.23
6/9/2021,,Withdrawal Debit Card MC Debit/PUBLIX #1312 GAINESVILLE FLDate 06/08/21 0 1159576147 1 5411Card 2801,31.78,,Posted,1251.43,2021-06-09,31.78,Withdrawal Debit Card MC Debit/PUBLIX #1312 GAINESVILLE FLDate 06/18/21 0 1169764423 1 5411Card 2801,31.78
6/9/2021,,Withdrawal ACH APPLECARD GSBANK/TYPE: PAYMENT ID: 9999999999CO: APPLECARD GSBANKEntry Class Code: WEB,75.0,,Posted,1283.21,2021-06-09,75.0,Withdrawal ACH APPLECARD GSBANK/TYPE: PAYMENT ID: 9999999999 CO: APPLECARD GSBANK Entry Class Code: WEB,75.0
6/9/2021,,Withdrawal ACH BEST BUY/TYPE: PAYMENT ID: CITIGPUFDRCO: BEST BUYEntry Class Code: PPD,75.0,,Posted,1358.21,2021-06-09,75.0,Withdrawal ACH BEST BUY/TYPE: PAYMENT ID: CITIGPUFDRCO: BEST BUYEntry Class Code: TEL,75.0
6/9/2021,,Withdrawal ACH TARGET CARD SRVC/TYPE: BILL PAY ID: T510215170CO: TARGET CARD SRVCEntry Class Code: WEB,75.0,,Posted,1433.21,2021-06-09,75.0,Withdrawal ACH TARGET CARD SRVC/TYPE: BILL PAY ID: T510215170CO: TARGET CARD SRVCEntry Class Code: WEB,75.0
6/9/2021,,Withdrawal ACH BEST BUY/TYPE: PAYMENT ID: CITIGPUFDRCO: BEST BUYEntry Class Code: PPD,75.0,,Posted,1508.21,2021-06-09,75.0,Withdrawal ACH BEST BUY/TYPE: PAYMENT ID: CITIGPUFDRCO: BEST BUYEntry Class Code: TEL,75.0
6/9/2021,,Withdrawal ACH PAYPAL/TYPE: INST XFER ID: PAYPALSI77CO: PAYPALEntry Class Code: WEB,2.99,,Posted,1583.21,2021-06-09,2.99,Withdrawal ACH PAYPAL/TYPE: INST XFER ID: PAYPALSI77CO: PAYPALEntry Class Code: WEB,3.2266666666666666
6/8/2021,,Withdrawal Debit Card MC Debit/PUBLIX #1038 GAINESVILLE FLDate 06/07/21 0 1158510821 1 5411Card 2801,41.48,,Posted,1586.2,2021-06-08,41.48,Withdrawal Debit Card MC Debit/PUBLIX #1560 GAINESVILLE FLDate 09/04/21 0 1247836114 5 5411Card 2801,41.48
6/8/2021,,Withdrawal POS #000000518006/AMAZON.COM*2X3C172M1 SEATTLE WACard 2801,35.98,,Posted,1627.68,2021-06-08,35.98,Withdrawal POS #000000173052/AMAZON.COM*H21U27Y71 SEATTLE WACard 2801,35.98
6/8/2021,,Withdrawal POS #000000000004/AMAZON.COM*2X0BQ00N0 SEATTLE WACard 2801,26.42,,Posted,1663.66,2021-06-08,26.42,Withdrawal POS #000000000005/AMAZON.COM*HY2208FJ0 SEATTLE WACard 2801,26.42
6/8/2021,,Withdrawal POS #000000010537/CIRCLE K # 26146 3 GAINESVILLE FLCard 2801,15.98,,Posted,1690.08,2021-06-08,15.98,Withdrawal POS #000000001537/CIRCLE K # 21303 2320 GAINESVILLE FLCard 2801,15.98
6/7/2021,,Withdrawal Debit Card MC Debit/PUBLIX #1312 GAINESVILLE FLDate 06/05/21 0 1156594073 2 5411Card 2801,42.87,,Posted,1706.06,2021-06-07,42.87,Withdrawal Debit Card MC Debit/PUBLIX #1312 GAINESVILLE FLDate 05/28/21 0 1148028662 2 5411Card 2801,42.595
6/7/2021,,Withdrawal ACH BEST BUY/TYPE: PAYMENT ID: CITIGPUFDRCO: BEST BUYEntry Class Code: PPD,75.0,,Posted,1748.93,2021-06-07,75.0,Withdrawal ACH BEST BUY/TYPE: PAYMENT ID: CITIGPUFDRCO: BEST BUYEntry Class Code: TEL,75.0
6/7/2021,,Withdrawal ACH LAST.FM LTD/CO: LAST.FM LTDTYPE: IAT PAYPAL ID: 770510487CEntry Class Code: IAT,3.0,,Posted,1823.93,2021-06-07,3.0,Withdrawal ACH LAST.FM LTD/CO: LAST.FM LTDTYPE: IAT PAYPAL ID: 770510487CEntry Class Code: IAT,3.0
6/7/2021,,Withdrawal ACH BEST BUY/TYPE: PAYMENT ID: CITIGPUFDRCO: BEST BUYEntry Class Code: PPD,75.0,,Posted,1826.93,2021-06-07,75.0,Withdrawal ACH BEST BUY/TYPE: PAYMENT ID: CITIGPUFDRCO: BEST BUYEntry Class Code: TEL,75.0
6/5/2021,,Withdrawal POS #000000044185/FAST TRACK #200 3960 SW ARCHER RDGAINESVILLE FLCard 2801,22.56,,Posted,1901.93,2021-06-05,22.56,Withdrawal POS #000000194488/FAST TRACK #200 3960 SW ARCHER RDGAINESVILLE FLCard 1140,22.2575
6/3/2021,,Withdrawal ACH CAPITAL ONE/TYPE: MOBILE PMT ID: 9279744980CO: CAPITAL ONEEntry Class Code: WEB,75.0,,Posted,1924.49,2021-06-03,75.0,Withdrawal ACH CAPITAL ONE/TYPE: MOBILE PMT ID: 9279744980CO: CAPITAL ONEEntry Class Code: WEB,75.0
6/3/2021,,Withdrawal POS #000000480551/AMAZON.COM*2R8QH9Y70 SEATTLE WACard 2801,16.04,,Posted,1999.49,2021-06-03,16.04,Withdrawal POS #000000259511/AMAZON.COM*2776K9KH0 SEATTLE WACard 2801,16.04
6/2/2021,,Withdrawal ACH BARCLAYCARD US/TYPE: CREDITCARD ID: 2510407970CO: BARCLAYCARD USEntry Class Code: WEB,75.0,,Posted,2015.53,2021-06-02,75.0,Withdrawal ACH BARCLAYCARD US/TYPE: CREDITCARD ID: 2510407970 CO: BARCLAYCARD US Entry Class Code: WEB,75.0
6/2/2021,,Withdrawal ACH DISCOVER/TYPE: E-PAYMENT ID: 2510020270CO: DISCOVEREntry Class Code: WEB,75.0,,Posted,2090.53,2021-06-02,75.0,Withdrawal ACH DISCOVER/TYPE: E-PAYMENT ID: 2510020270CO: DISCOVEREntry Class Code: WEB,75.0
6/2/2021,,Withdrawal ACH TARGET CARD SRVC/TYPE: BILL PAY ID: T510215170CO: TARGET CARD SRVCEntry Class Code: WEB,75.0,,Posted,2165.53,2021-06-02,75.0,Withdrawal ACH TARGET CARD SRVC/TYPE: BILL PAY ID: T510215170CO: TARGET CARD SRVCEntry Class Code: WEB,75.0
6/1/2021,,Withdrawal POS #000000063975/PUBLIX 3930 SW ARCHER ROA GAINESVILLE FLCard 2801,32.08,,Posted,2240.53,2021-06-01,32.08,Withdrawal POS #000000029500/PUBLIX 3930 SW ARCHER ROA GAINESVILLE FLCard 2801,32.18
6/1/2021,,Withdrawal ACH CITY OF GAINESVI/TYPE: 2000-6637- ID: 5330903620CO: CITY OF GAINESVIEntry Class Code: WEB,178.73,,Posted,2272.61,2021-06-01,178.73,Withdrawal ACH CITY OF GAINESVI/TYPE: 2000-6637- ID: 5330903620CO: CITY OF GAINESVIEntry Class Code: WEB,179.225
6/1/2021,,Withdrawal ACH APPLECARD GSBANK/TYPE: PAYMENT ID: 9999999999CO: APPLECARD GSBANKEntry Class Code: WEB,75.0,,Posted,2451.34,2021-06-01,75.0,Withdrawal ACH APPLECARD GSBANK/TYPE: PAYMENT ID: 9999999999 CO: APPLECARD GSBANK Entry Class Code: WEB,75.0
6/1/2021,,Withdrawal ACH CAPITAL ONE/TYPE: MOBILE PMT ID: 9279744980CO: CAPITAL ONEEntry Class Code: WEB,75.0,,Posted,2526.34,2021-06-01,75.0,Withdrawal ACH CAPITAL ONE/TYPE: MOBILE PMT ID: 9279744980CO: CAPITAL ONEEntry Class Code: WEB,75.0
6/1/2021,,Withdrawal POS #000000061707/GATE 1445 506 NW 1 GAINESVILLE FLCard 2801,13.57,,Posted,2601.34,2021-06-01,13.57,Withdrawal POS #000000183316/GATE 1445 506 NW 13TH GAINESVILLE FLCard 2801,13.655000000000001
6/1/2021,,Withdrawal ACH PAYPAL/TYPE: INST XFER ID: PAYPALSI77CO: PAYPALEntry Class Code: WEB,5.66,,Posted,2614.91,2021-06-01,5.66,Withdrawal ACH PAYPAL/TYPE: INST XFER ID: PAYPALSI77CO: PAYPALEntry Class Code: WEB,5.766666666666667
5/30/2021,,Withdrawal Debit Card MC Debit/PUBLIX #1312 GAINESVILLE FLDate 05/28/21 0 1148028662 2 5411Card 2801,42.32,,Posted,2620.57,2021-05-30,42.32,Withdrawal Debit Card MC Debit/PUBLIX #1312 GAINESVILLE FLDate 05/28/21 0 1148028662 2 5411Card 2801,42.595
5/29/2021,,Withdrawal POS #000000000009/AMAZON PAYMENTS SEATTLE WACard 2801,5.74,,Posted,662.89,2021-05-29,5.74,Withdrawal POS #000000000000/AMAZON PAYMENTS SEATTLE WACard 2801,5.74
5/28/2021,,Withdrawal POS #000000000005/AMAZON.COM*2X1HX9OW1 SEATTLE WACard 2801,17.11,,Posted,668.63,2021-05-28,17.11,Withdrawal POS #000000000007/AMAZON.COM*2864R4HI1 SEATTLE WACard 1140,16.61
5/28/2021,,Recurring Withdrawal Debit Card MC Debit/AMAZON PRIME*2R8PP9GG2 AMZN.COM/BIL WADate 05/27/21 0 1147410671 1 5968Card 2801,13.09,,Posted,685.74,2021-05-28,13.09,Recurring Withdrawal Debit Card MC Debit/AMAZON PRIME*2E90R5DC2 AMZN.COM/BIL WADate 07/27/21 0 1208211269 1 5968Card 2801,13.085
5/28/2021,,Withdrawal ACH BEST BUY/TYPE: PAYMENT ID: CITIGPUFDRCO: BEST BUYEntry Class Code: PPD,100.0,,Posted,698.83,2021-05-28,100.0,Withdrawal ACH BEST BUY/TYPE: PAYMENT ID: CITIGPUFDRCO: BEST BUYEntry Class Code: TEL,100.0
5/28/2021,,Withdrawal ACH BEST BUY/TYPE: PAYMENT ID: CITIGPUFDRCO: BEST BUYEntry Class Code: PPD,75.0,,Posted,798.83,2021-05-28,75.0,Withdrawal ACH BEST BUY/TYPE: PAYMENT ID: CITIGPUFDRCO: BEST BUYEntry Class Code: TEL,75.0
5/28/2021,,Withdrawal ACH BEST BUY/TYPE: PAYMENT ID: CITIGPUFDRCO: BEST BUYEntry Class Code: PPD,100.0,,Posted,873.83,2021-05-28,100.0,Withdrawal ACH BEST BUY/TYPE: PAYMENT ID: CITIGPUFDRCO: BEST BUYEntry Class Code: TEL,100.0
5/28/2021,,Recurring Withdrawal Bill Payment - #000027450528/PAYPAL *PPLUS 2211 North First S SanCACard 2801,10.5,,Posted,973.83,2021-05-28,10.5,Recurring Withdrawal Bill Payment - #000045891971/PAYPAL *VIDIQ 2211 North First S SanCACard 2801,10.25
5/28/2021,,Withdrawal POS #000000200940/WAWA 5325 2373 SW ARCHER ROA GAINESVILLEFLCard 2801,20.74,,Posted,984.33,2021-05-28,20.74,Withdrawal POS #000000188596/WAWA 5325 2373 SW ARCHER ROA GAINESVILLEFLCard 2801,20.74
5/27/2021,,Recurring Withdrawal Debit Card MC Debit/HELP.HBOMAX.COM NEW YORK NYDate 05/27/21 0 1147530392 1 5815Card 2801,17.23,,Posted,1005.07,2021-05-27,17.23,Recurring Withdrawal Debit Card MC Debit/HELP.HBOMAX.COM NEW YORK NYDate 04/27/22 0 2117023223 1 5815Card 2801,17.23
5/27/2021,,Withdrawal ACH COX COMM GAN/TYPE: BANK DRAFT ID: 1581620085CO: COX COMM GANEntry Class Code: WEB,105.03,,Posted,1022.3,2021-05-27,105.03,Withdrawal ACH COX COMM GAN/TYPE: BANK DRAFT ID: 1581620085CO: COX COMM GANEntry Class Code: WEB,105.03
5/27/2021,,Withdrawal POS #000000000009/AMAZON PAYMENTS SEATTLE WACard 2801,5.74,,Posted,1127.33,2021-05-27,5.74,Withdrawal POS #000000000000/AMAZON PAYMENTS SEATTLE WACard 2801,5.74
5/27/2021,,Withdrawal ACH PAYMENT FOR AMZ/TYPE: STORECARD ID: 9069872103CO: PAYMENT FOR AMZEntry Class Code: WEB,150.0,,Posted,1133.07,2021-05-27,150.0,Withdrawal ACH PAYMENT FOR AMZ/TYPE: STORECARD ID: 9069872103 CO: PAYMENT FOR AMZ Entry Class Code: WEB,150.0
5/26/2021,,Withdrawal POS #000000510071/CK 2726162 7302 SW ARCHER RD GAINESVILLEFLCard 2801,6.83,,Posted,1283.07,2021-05-26,6.83,Withdrawal POS #000000006070/KOHLS 1242 3501 SW ARCHER RD GAINESVILLEFLCard 2801,6.83
5/26/2021,,Withdrawal POS #000018316544/WALGREENS 2415 SW GAINESVILLE FLCard 2801,25.87,,Posted,1289.9,2021-05-26,25.87,Withdrawal POS #000014264526/WALGREENS 2415 SW GAINESVILLE FLCard 2801,25.67
5/26/2021,,Withdrawal Debit Card MC Debit/COUNTRY CRITTERS - 4 OCALA FLDate 05/25/21 0 1145668660 1 0742Card 2801,30.0,,Posted,1315.77,2021-05-26,30.0,Withdrawal Debit Card MC Debit/COUNTRY CRITTERS - 4 OCALA FLDate 05/25/21 0 1145668660 1 0742Card 2801,30.0
5/26/2021,,Withdrawal Debit Card MC Debit/VZWRLSS*MY VZ VE P 800-922-0204 FLDate 05/26/21 0 1146663586 1 4814Card 2801,473.28,,Posted,1345.77,2021-05-26,473.28,Withdrawal Debit Card MC Debit/VZWRLSS*MY VZ VE P 800-922-0204 FLDate 05/26/21 0 1146663586 1 4814Card 2801,473.28
5/26/2021,,Withdrawal POS #000000481097/CK 2726162 7302 SW ARCHER RD GAINESVILLEFLCard 2801,30.62,,Posted,1819.05,2021-05-26,30.62,Withdrawal POS #000000006070/KOHLS 1242 3501 SW ARCHER RD GAINESVILLEFLCard 2801,30.62
5/26/2021,,Withdrawal ACH CAPITAL ONE/TYPE: MOBILE PMT ID: 9279744980CO: CAPITAL ONEEntry Class Code: WEB,250.0,,Posted,1849.67,2021-05-26,250.0,Withdrawal ACH CAPITAL ONE/TYPE: MOBILE PMT ID: 9279744980CO: CAPITAL ONEEntry Class Code: WEB,250.0
5/26/2021,,Withdrawal ACH BARCLAYCARD US/TYPE: CREDITCARD ID: 2510407970CO: BARCLAYCARD USEntry Class Code: WEB,150.0,,Posted,2099.67,2021-05-26,150.0,Withdrawal ACH BARCLAYCARD US/TYPE: CREDITCARD ID: 2510407970 CO: BARCLAYCARD US Entry Class Code: WEB,150.0
5/26/2021,,Withdrawal ACH APPLECARD GSBANK/TYPE: PAYMENT ID: 9999999999CO: APPLECARD GSBANKEntry Class Code: WEB,125.0,,Posted,2249.67,2021-05-26,125.0,Withdrawal ACH APPLECARD GSBANK/TYPE: PAYMENT ID: 9999999999 CO: APPLECARD GSBANK Entry Class Code: WEB,125.0
5/26/2021,,Withdrawal ACH DISCOVER/TYPE: E-PAYMENT ID: 2510020270CO: DISCOVEREntry Class Code: WEB,175.0,,Posted,2374.67,2021-05-26,175.0,Withdrawal ACH DISCOVER/TYPE: E-PAYMENT ID: 2510020270CO: DISCOVEREntry Class Code: WEB,175.0
5/26/2021,,Withdrawal ACH TARGET CARD SRVC/TYPE: BILL PAY ID: T510215170CO: TARGET CARD SRVCEntry Class Code: WEB,150.0,,Posted,2549.67,2021-05-26,150.0,Withdrawal ACH TARGET CARD SRVC/TYPE: BILL PAY ID: T510215170CO: TARGET CARD SRVCEntry Class Code: WEB,150.0
5/26/2021,,Withdrawal ACH EXXONMOBIL/TYPE: ONLINE PMT ID: CITICTPCO: EXXONMOBILEntry Class Code: WEB,13.31,,Posted,2699.67,2021-05-26,13.31,Withdrawal ACH EXXONMOBIL/TYPE: ONLINE PMT ID: CITICTPCO: EXXONMOBILEntry Class Code: WEB,13.31
5/24/2021,,Withdrawal Debit Card MC Debit/PUBLIX #1312 GAINESVILLE FLDate 05/23/21 0 1143498988 1 5411Card 2801,77.88,,Posted,237.98,2021-05-24,77.88,Withdrawal Debit Card MC Debit/PUBLIX #1312 GAINESVILLE FLDate 05/28/21 0 1148028662 2 5411Card 2801,77.88
5/24/2021,,Recurring Withdrawal Debit Card MC Debit/SOUNDCLOUD INC SAN FRANCISC CADate 05/24/21 0 1144498667 1 4899Card 2801,4.99,,Posted,315.86,2021-05-24,4.99,Recurring Withdrawal Debit Card MC Debit/SOUNDCLOUD INC SAN FRANCISC CADate 05/24/21 0 1144498667 1 4899Card 2801,4.99
5/24/2021,,Withdrawal Debit Card MC Debit/ONLYFANS 8886880458 FLDate 05/20/21 0 1140808102 5 5967Card 2801,10.49,,Posted,320.85,2021-05-24,10.49,Withdrawal Debit Card MC Debit/ONLYFANS 8886880458 FLDate 05/20/21 0 1140808102 5 5967Card 2801,10.49
5/24/2021,,Withdrawal Debit Card MC Debit/AMZN DIGITAL*2R8ES6LA2 888-802-3080 WADate 05/23/21 0 1143736262 1 5818Card 2801,0.99,,Posted,331.34,2021-05-24,0.99,Withdrawal Debit Card MC Debit/AMZN DIGITAL*2G2YK1811 888-802-3080 WADate 09/15/21 0 1258632245 1 5818Card 2801,1.49
5/24/2021,,Withdrawal ACH PAYMENT FOR AMZ/TYPE: STORECARD ID: 9069872103CO: PAYMENT FOR AMZEntry Class Code: WEB,65.0,,Posted,332.33,2021-05-24,65.0,Withdrawal ACH PAYMENT FOR AMZ/TYPE: STORECARD ID: 9069872103 CO: PAYMENT FOR AMZ Entry Class Code: WEB,65.0
5/24/2021,,Withdrawal ACH EXXONMOBIL/TYPE: ONLINE PMT ID: CITICTPCO: EXXONMOBILEntry Class Code: WEB,7.78,,Posted,397.33,2021-05-24,7.78,Withdrawal ACH EXXONMOBIL/TYPE: ONLINE PMT ID: CITICTPCO: EXXONMOBILEntry Class Code: WEB,7.78
5/23/2021,,Withdrawal Bill Payment #000010440934/PAYPAL *PACKIX 2211 North First S SanCACard 2801,3.0,,Posted,286.31,2021-05-23,3.0,Withdrawal Bill Payment #000010440934/PAYPAL *PACKIX 2211 North First S SanCACard 2801,3.0
5/22/2021,,Withdrawal ATM Fee/COLUMBIA CAR-428486 318 NW 13TH STGAINESVILLE FLCard 2801,2.0,,Posted,289.31,2021-05-22,2.0,Withdrawal ATM Fee/COLUMBIA CAR-428486 318 NW 13TH STGAINESVILLE FLCard 2801,2.0
5/22/2021,,Withdrawal at ATM #000000003405/COLUMBIA CAR-428486 318 NW 13TH STGAINESVILLE FLCard 2801,23.0,,Posted,291.31,2021-05-22,23.0,Withdrawal at ATM #000000003731/COLUMBIA CAR-428486 318 NW 13TH STGAINESVILLE FLCard 2801,23.0
5/22/2021,,Withdrawal POS #000000059894/GATE 1445 506 NW 1 GAINESVILLE FLCard 2801,23.31,,Posted,314.31,2021-05-22,23.31,Withdrawal POS #000000183316/GATE 1445 506 NW 13TH GAINESVILLE FLCard 2801,22.908
5/22/2021,,Withdrawal at ATM #000000001544/CAMPUS 1900 SW 34TH ST GAINESVILLE FLCard 2801,200.0,,Posted,337.62,2021-05-22,200.0,Withdrawal at ATM #000000005364/CAMPUS 5725 SW 75TH ST GAINESVILLE FLCard 1140,200.0
5/21/2021,,Withdrawal Debit Card MC Debit/PUBLIX #1312 GAINESVILLE FLDate 05/20/21 0 1140623440 1 5411Card 2801,27.92,,Posted,537.62,2021-05-21,27.92,Withdrawal Debit Card MC Debit/PUBLIX #1312 GAINESVILLE FLDate 03/11/21 0 1070536058 1 5411Card 2801,28.405
5/21/2021,,Withdrawal ACH BARCLAYCARD US/TYPE: CREDITCARD ID: 2510407970CO: BARCLAYCARD USEntry Class Code: WEB,65.0,,Posted,565.54,2021-05-21,65.0,Withdrawal ACH BARCLAYCARD US/TYPE: CREDITCARD ID: 2510407970 CO: BARCLAYCARD US Entry Class Code: WEB,65.0
5/21/2021,,Withdrawal ACH CAPITAL ONE/TYPE: MOBILE PMT ID: 9279744980CO: CAPITAL ONEEntry Class Code: WEB,65.0,,Posted,630.54,2021-05-21,65.0,Withdrawal ACH CAPITAL ONE/TYPE: MOBILE PMT ID: 9279744980CO: CAPITAL ONEEntry Class Code: WEB,65.0
5/21/2021,,Withdrawal ACH APPLECARD GSBANK/TYPE: PAYMENT ID: 9999999999CO: APPLECARD GSBANKEntry Class Code: WEB,50.0,,Posted,695.54,2021-05-21,50.0,Withdrawal ACH APPLECARD GSBANK/TYPE: PAYMENT ID: 9999999999 CO: APPLECARD GSBANK Entry Class Code: WEB,50.0
5/21/2021,,Withdrawal ACH APPLECARD GSBANK/TYPE: PAYMENT ID: 9999999999CO: APPLECARD GSBANKEntry Class Code: WEB,27.0,,Posted,745.54,2021-05-21,27.0,Withdrawal ACH APPLECARD GSBANK/TYPE: PAYMENT ID: 9999999999 CO: APPLECARD GSBANK Entry Class Code: WEB,27.0
5/21/2021,,Withdrawal ACH DISCOVER/TYPE: E-PAYMENT ID: 2510020270CO: DISCOVEREntry Class Code: WEB,65.0,,Posted,772.54,2021-05-21,65.0,Withdrawal ACH DISCOVER/TYPE: E-PAYMENT ID: 2510020270CO: DISCOVEREntry Class Code: WEB,65.0
5/21/2021,,Withdrawal ACH TARGET CARD SRVC/TYPE: BILL PAY ID: T510215170CO: TARGET CARD SRVCEntry Class Code: WEB,65.0,,Posted,837.54,2021-05-21,65.0,Withdrawal ACH TARGET CARD SRVC/TYPE: BILL PAY ID: T510215170CO: TARGET CARD SRVCEntry Class Code: WEB,65.0
5/20/2021,,Withdrawal Debit Card MC Debit/PIZZA HUT 27918 3523739402 FLDate 05/18/21 0 1138211165 1 5812Card 2801,21.67,,Posted,855.55,2021-05-20,21.67,Withdrawal Debit Card MC Debit/PIZZA HUT 27918 3523739402 FLDate 12/16/22 0 2350808582 1 5812Card 2801,21.67
5/20/2021,,Withdrawal Bill Payment #000097602382/PAYPAL *ANDREACABIB EBAY 2211 NorthS San Jose CACard 2801,33.45,,Posted,877.22,2021-05-20,33.45,Withdrawal Bill Payment #000097602382/PAYPAL *ANDREACABIB EBAY 2211 NorthS San Jose CACard 2801,33.45
5/20/2021,,Withdrawal ACH PAYPAL/TYPE: INST XFER ID: PAYPALSI77CO: PAYPALEntry Class Code: WEB,4.96,,Posted,910.67,2021-05-20,4.96,Withdrawal ACH PAYPAL/TYPE: INST XFER ID: PAYPALSI77CO: PAYPALEntry Class Code: WEB,5.032
5/19/2021,,Withdrawal POS #000000000009/AMAZON PAYMENTS SEATTLE WACard 2801,15.48,,Posted,915.63,2021-05-19,15.48,Withdrawal POS #000000000000/AMAZON PAYMENTS SEATTLE WACard 2801,15.48
5/18/2021,235.0,Draft 235,850.0,,Posted,230.11,2021-05-18,850.0,Draft 237,850.0
5/18/2021,,Withdrawal Bill Payment #000027209306/PAYPAL *STRLABSITES PRIME 2211 NorthS San Jose CACard 2801,19.0,,Posted,1080.11,2021-05-18,19.0,Withdrawal Bill Payment #000011116970/PAYPAL *STRLABSITES PRIME 2211 NorthS San Jose CACard 2801,19.0
5/18/2021,,Withdrawal Debit Card MC Debit/PUBLIX #1312 GAINESVILLE FLDate 05/17/21 0 1137551809 1 5411Card 2801,33.94,,Posted,1099.11,2021-05-18,33.94,Withdrawal Debit Card MC Debit/PUBLIX #1312 GAINESVILLE FLDate 03/11/21 0 1070536058 1 5411Card 2801,33.94
5/18/2021,,Withdrawal Debit Card MC Debit/252PEPSIVEN9147678600 GAINESVILLE FLDate 05/17/21 0 1137547304 1 5814Card 2801,3.0,,Posted,1133.05,2021-05-18,3.0,Withdrawal Debit Card MC Debit/252PEPSIVEN9147678600 GAINESVILLE FLDate 05/17/21 0 1137547304 1 5814Card 2801,3.0
5/18/2021,,Withdrawal Debit Card MC Debit/CHEVRON 0042059 GAINESVILLE FLDate 05/17/21 0 1137621286 0 5541Card 2801,23.07,,Posted,1136.05,2021-05-18,23.07,Withdrawal Debit Card MC Debit/CHEVRON 0042059 GAINESVILLE FLDate 05/17/21 0 1137621286 0 5541Card 2801,23.07
5/18/2021,,Withdrawal/Cash Disbursed 100.00,100.0,,Posted,1159.12,2021-05-18,100.0,Withdrawal/Cash Disbursed 35.00,100.0
5/18/2021,,Withdrawal POS #000000273457/AMAZON.COM*2L8JS8IK0 SEATTLE WACard 2801,46.99,,Posted,1189.12,2021-05-18,46.99,Withdrawal POS #000000259511/AMAZON.COM*2776K9KH0 SEATTLE WACard 2801,46.99
5/17/2021,,Withdrawal ACH PAYPAL/TYPE: INST XFER ID: PAYPALSI77CO: PAYPALEntry Class Code: WEB,14.99,,Posted,1201.46,2021-05-17,14.99,Withdrawal ACH PAYPAL/TYPE: INST XFER ID: PAYPALSI77CO: PAYPALEntry Class Code: WEB,14.646666666666667
5/16/2021,,Withdrawal Debit Card MC Debit/PAYPAL *KINBUNDOLIM 4029357733 CADate 05/13/21 0 1133245705 1 5945Card 2801,3.0,,Posted,1216.45,2021-05-16,3.0,Withdrawal Debit Card MC Debit/PAYPAL *KINBUNDOLIM 4029357733 CADate 05/13/21 0 1133245705 1 5945Card 2801,3.0
5/15/2021,,Withdrawal POS #000007249569/GOOGLE *Domains Mountain View CACard 2801,12.0,,Posted,1219.45,2021-05-15,12.0,Withdrawal POS #000012283703/GOOGLE *Domains Mountain View CACard 2801,12.0
5/13/2021,,Withdrawal Debit Card MC Debit/PIZZA HUT 27918 3523739402 FLDate 05/11/21 0 1131193007 1 5812Card 2801,35.53,,Posted,1231.45,2021-05-13,35.53,Withdrawal Debit Card MC Debit/PIZZA HUT 27918 3523739402 FLDate 12/16/22 0 2350808582 1 5812Card 2801,35.78666666666667
5/13/2021,,Withdrawal Debit Card MC Debit/PUBLIX #1312 GAINESVILLE FLDate 05/12/21 0 1132606317 1 5411Card 2801,149.68,,Posted,1266.98,2021-05-13,149.68,Withdrawal Debit Card MC Debit/PUBLIX #1312 GAINESVILLE FLDate 03/11/21 0 1070536058 1 5411Card 2801,149.68
5/13/2021,,Recurring Withdrawal Debit Card Fee/MASTERCARD ISSUER CROSS-BORDER FEEDate 05/12/21 0 1132191600 1 7372Card 2801,0.05,,Posted,1416.66,2021-05-13,0.05,Withdrawal Debit Card Fee/MASTERCARD ISSUER CROSS-BORDER FEEDate 04/19/21 0 1109184122 1 7311Card 2801,0.1281818181818182
5/13/2021,,Recurring Withdrawal Debit Card MC Debit/PAYPAL *LINKTREE 4029357733 AUDate 05/12/21 0 1132191600 1 7372Card 2801,6.0,,Posted,1416.71,2021-05-13,6.0,Recurring Withdrawal Debit Card MC Debit/PAYPAL *LINKTREE 4029357733 AUDate 05/12/21 0 1132191600 1 7372Card 2801,6.0
5/13/2021,,Withdrawal Debit Card MC Debit/PAYPAL *ETSY.COM 4029357733 NYDate 05/12/21 0 1132187934 1 5699Card 2801,10.15,,Posted,1422.71,2021-05-13,10.15,Withdrawal Debit Card MC Debit/PAYPAL *ETSY.COM 4029357733 NYDate 05/12/21 0 1132187934 1 5699Card 2801,10.015
5/13/2021,,Withdrawal Debit Card MC Debit/PAYPAL *ETSY.COM 4029357733 NYDate 05/12/21 0 1132187933 1 5699Card 2801,5.31,,Posted,1432.86,2021-05-13,5.31,Withdrawal Debit Card MC Debit/PAYPAL *ETSY.COM 4029357733 NYDate 05/12/21 0 1132187934 1 5699Card 2801,5.31
5/13/2021,,Withdrawal ACH PAYPAL/TYPE: INST XFER ID: PAYPALSI77CO: PAYPALEntry Class Code: WEB,4.99,,Posted,1438.17,2021-05-13,4.99,Withdrawal ACH PAYPAL/TYPE: INST XFER ID: PAYPALSI77CO: PAYPALEntry Class Code: WEB,5.032
5/12/2021,,Withdrawal/Cash Disbursed 225.00,225.0,,Posted,1290.16,2021-05-12,225.0,Withdrawal/Cash Disbursed 35.00,225.0
5/12/2021,,Withdrawal Debit Card MC Debit/WALGREENS #5024 800-289-2273 FLDate 05/11/21 0 1131607093 1 5912Card 2801,18.17,,Posted,1515.16,2021-05-12,18.17,Withdrawal Debit Card MC Debit/WALGREENS #5024 800-289-2273 FLDate 09/08/21 0 1251607416 1 5912Card 2801,18.17
5/12/2021,,Withdrawal ACH PAYPAL/TYPE: INST XFER ID: PAYPALSI77CO: PAYPALEntry Class Code: WEB,6.99,,Posted,1183.33,2021-05-12,6.99,Withdrawal ACH PAYPAL/TYPE: INST XFER ID: PAYPALSI77CO: PAYPALEntry Class Code: WEB,6.995
5/12/2021,,Withdrawal Bill Payment #000057401651/PAYPAL *ETSY.COM 2211 North First S SanJose CACard 2801,3.97,,Posted,1190.32,2021-05-12,3.97,Withdrawal Bill Payment #000057401651/PAYPAL *ETSY.COM 2211 North First S SanJose CACard 2801,3.97
5/10/2021,,Withdrawal Debit Card MC Debit/PUBLIX #1312 GAINESVILLE FLDate 05/09/21 0 1129440869 1 5411Card 2801,18.96,,Posted,1075.49,2021-05-10,18.96,Withdrawal Debit Card MC Debit/PUBLIX #1312 GAINESVILLE FLDate 05/28/21 0 1148028662 2 5411Card 2801,18.96
5/10/2021,,Withdrawal ACH PAYPAL/TYPE: INST XFER ID: PAYPALSI77CO: PAYPALEntry Class Code: WEB,2.99,,Posted,1094.45,2021-05-10,2.99,Withdrawal ACH PAYPAL/TYPE: INST XFER ID: PAYPALSI77CO: PAYPALEntry Class Code: WEB,3.2266666666666666
5/7/2021,,Withdrawal Debit Card MC Debit/PIZZA HUT 27918 GAINESVILLE FLDate 05/05/21 0 1125274587 1 5812Card 2801,27.53,,Posted,1097.44,2021-05-07,27.53,Withdrawal Debit Card MC Debit/PIZZA HUT 27918 GAINESVILLE FLDate 05/20/23 0 3140936778 0 5812Card 2801,27.53
5/7/2021,,Withdrawal ACH LAST.FM LTD/CO: LAST.FM LTDTYPE: IAT PAYPAL ID: 770510487CEntry Class Code: IAT,3.0,,Posted,1124.97,2021-05-07,3.0,Withdrawal ACH LAST.FM LTD/CO: LAST.FM LTDTYPE: IAT PAYPAL ID: 770510487CEntry Class Code: IAT,3.0
5/6/2021,,Withdrawal Debit Card MC Debit/PUBLIX #1312 GAINESVILLE FLDate 05/05/21 0 1125577276 1 5411Card 2801,13.07,,Posted,1127.97,2021-05-06,13.07,Withdrawal Debit Card MC Debit/PUBLIX #1312 GAINESVILLE FLDate 04/27/23 0 3117072013 1 5411Card 2801,13.07
5/6/2021,,Withdrawal Debit Card MC Debit/AMZN DIGITAL*2K12D5QG3 888-802-3080 WADate 05/05/21 0 1125320932 1 5818Card 2801,1.99,,Posted,1141.04,2021-05-06,1.99,Withdrawal Debit Card MC Debit/AMZN DIGITAL*2G2YK1811 888-802-3080 WADate 09/15/21 0 1258632245 1 5818Card 2801,1.49
5/6/2021,,Withdrawal ACH COX COMM GAN/TYPE: BANK DRAFT ID: 1581620085CO: COX COMM GANEntry Class Code: WEB,127.52,,Posted,1143.03,2021-05-06,127.52,Withdrawal ACH COX COMM GAN/TYPE: BANK DRAFT ID: 1581620085CO: COX COMM GANEntry Class Code: WEB,127.34
5/6/2021,,Withdrawal ACH PAYMENT FOR AMZ/TYPE: STORECARD ID: 9069872103CO: PAYMENT FOR AMZEntry Class Code: WEB,65.0,,Posted,1270.55,2021-05-06,65.0,Withdrawal ACH PAYMENT FOR AMZ/TYPE: STORECARD ID: 9069872103 CO: PAYMENT FOR AMZ Entry Class Code: WEB,65.0
5/5/2021,,Withdrawal Debit Card MC Debit/PAYPAL *DARKSHAMASH 4029357733 CADate 05/04/21 0 1124714581 1 8999Card 2801,18.5,,Posted,1335.55,2021-05-05,18.5,Withdrawal Debit Card MC Debit/PAYPAL *DARKSHAMASH 4029357733 CADate 05/04/21 0 1124714581 1 8999Card 2801,18.5
5/5/2021,,Withdrawal ACH CITY OF GAINESVI/TYPE: 2000-6637- ID: 5330903620CO: CITY OF GAINESVIEntry Class Code: WEB,171.4,,Posted,1354.05,2021-05-05,171.4,Withdrawal ACH CITY OF GAINESVI/TYPE: 2000-6637- ID: 5330903620CO: CITY OF GAINESVIEntry Class Code: WEB,171.4
5/5/2021,,Withdrawal ACH BARCLAYCARD US/TYPE: CREDITCARD ID: 2510407970CO: BARCLAYCARD USEntry Class Code: WEB,65.0,,Posted,1525.45,2021-05-05,65.0,Withdrawal ACH BARCLAYCARD US/TYPE: CREDITCARD ID: 2510407970 CO: BARCLAYCARD US Entry Class Code: WEB,65.0
5/5/2021,,Withdrawal ACH CAPITAL ONE/TYPE: MOBILE PMT ID: 9279744980CO: CAPITAL ONEEntry Class Code: WEB,65.0,,Posted,1590.45,2021-05-05,65.0,Withdrawal ACH CAPITAL ONE/TYPE: MOBILE PMT ID: 9279744980CO: CAPITAL ONEEntry Class Code: WEB,65.0
5/5/2021,,Withdrawal ACH BEST BUY/TYPE: PAYMENT ID: CITIGPUFDRCO: BEST BUYEntry Class Code: PPD,65.0,,Posted,1655.45,2021-05-05,65.0,Withdrawal ACH BEST BUY/TYPE: PAYMENT ID: CITIGPUFDRCO: BEST BUYEntry Class Code: TEL,65.0
5/5/2021,,Withdrawal ACH APPLECARD GSBANK/TYPE: PAYMENT ID: 9999999999CO: APPLECARD GSBANKEntry Class Code: WEB,55.0,,Posted,1720.45,2021-05-05,55.0,Withdrawal ACH APPLECARD GSBANK/TYPE: PAYMENT ID: 9999999999 CO: APPLECARD GSBANK Entry Class Code: WEB,55.0
5/5/2021,,Withdrawal ACH TARGET CARD SRVC/TYPE: BILL PAY ID: T510215170CO: TARGET CARD SRVCEntry Class Code: WEB,65.0,,Posted,1775.45,2021-05-05,65.0,Withdrawal ACH TARGET CARD SRVC/TYPE: BILL PAY ID: T510215170CO: TARGET CARD SRVCEntry Class Code: WEB,65.0
5/5/2021,,Withdrawal ACH BEST BUY/TYPE: PAYMENT ID: CITIGPUFDRCO: BEST BUYEntry Class Code: PPD,65.0,,Posted,1840.45,2021-05-05,65.0,Withdrawal ACH BEST BUY/TYPE: PAYMENT ID: CITIGPUFDRCO: BEST BUYEntry Class Code: TEL,65.0
5/5/2021,,Withdrawal ACH DISCOVER/TYPE: E-PAYMENT ID: 2510020270CO: DISCOVEREntry Class Code: WEB,55.0,,Posted,1905.45,2021-05-05,55.0,Withdrawal ACH DISCOVER/TYPE: E-PAYMENT ID: 2510020270CO: DISCOVEREntry Class Code: WEB,55.0
5/4/2021,,Withdrawal POS #000000073420/GATE 1445 506 NW 1 GAINESVILLE FLCard 2801,30.57,,Posted,1960.45,2021-05-04,30.57,Withdrawal POS #000000183316/GATE 1445 506 NW 13TH GAINESVILLE FLCard 2801,30.57
5/4/2021,,Withdrawal/Cash Disbursed 225.00,225.0,,Posted,1991.02,2021-05-04,225.0,Withdrawal/Cash Disbursed 35.00,225.0
5/4/2021,,Withdrawal POS #000000069797/PUBLIX 5200 S W 34TH STRE GAINESVILLE FLCard 2801,29.95,,Posted,2216.02,2021-05-04,29.95,Withdrawal POS #000000080373/PUBLIX 5200 S W 34TH STRE GAINESVILLE FLCard 1140,29.78333333333333
5/4/2021,,Withdrawal POS #000000228165/USPS PO 11322705 4600 SW 34TH STGAINESVILLE FLCard 2801,11.0,,Posted,2245.97,2021-05-04,11.0,Withdrawal POS #000000228165/USPS PO 11322705 4600 SW 34TH STGAINESVILLE FLCard 2801,11.0
5/4/2021,,Withdrawal ACH PAYPAL/TYPE: INST XFER ID: PAYPALSI77CO: PAYPALEntry Class Code: WEB,2.99,,Posted,2256.97,2021-05-04,2.99,Withdrawal ACH PAYPAL/TYPE: INST XFER ID: PAYPALSI77CO: PAYPALEntry Class Code: WEB,3.2266666666666666
5/3/2021,,Withdrawal POS #000000000023/AMAZON.COM*AU8ER6ZT3 SEATTLE WACard 2801,10.67,,Posted,2259.96,2021-05-03,10.67,Withdrawal POS #000000000023/AMAZON.COM*AU8ER6ZT3 SEATTLE WACard 2801,10.4725
5/3/2021,,Withdrawal ACH PAYPAL/TYPE: INST XFER ID: PAYPALSI77CO: PAYPALEntry Class Code: WEB,4.99,,Posted,2270.63,2021-05-03,4.99,Withdrawal ACH PAYPAL/TYPE: INST XFER ID: PAYPALSI77CO: PAYPALEntry Class Code: WEB,5.032
4/30/2021,,Withdrawal Debit Card MC Debit/COUNTRY CRITTERS - 4 OCALA FLDate 04/29/21 0 1119660197 1 0742Card 2801,30.0,,Posted,2275.62,2021-04-30,30.0,Withdrawal Debit Card MC Debit/COUNTRY CRITTERS - 4 OCALA FLDate 05/25/21 0 1145668660 1 0742Card 2801,30.0
4/29/2021,,Withdrawal Debit Card MC Debit/PAYPAL *ETSY.COM 4029357733 CADate 04/28/21 0 1118146596 1 5699Card 2801,21.03,,Posted,305.62,2021-04-29,21.03,Withdrawal Debit Card MC Debit/PAYPAL *ETSY.COM 4029357733 NYDate 05/12/21 0 1132187934 1 5699Card 2801,21.03
4/29/2021,,Withdrawal ACH PAYPAL/TYPE: INST XFER ID: PAYPALSI77CO: PAYPALEntry Class Code: WEB,5.66,,Posted,326.65,2021-04-29,5.66,Withdrawal ACH PAYPAL/TYPE: INST XFER ID: PAYPALSI77CO: PAYPALEntry Class Code: WEB,5.766666666666667
4/28/2021,,Recurring Withdrawal Debit Card MC Debit/AMAZON PRIME*2E7QP6VV3 AMZN.COM/BIL WADate 04/27/21 0 1117994890 0 5968Card 2801,13.09,,Posted,238.26,2021-04-28,13.09,Recurring Withdrawal Debit Card MC Debit/AMAZON PRIME*2E90R5DC2 AMZN.COM/BIL WADate 07/27/21 0 1208211269 1 5968Card 2801,13.085
4/28/2021,,Withdrawal Debit Card MC Debit/PAYPAL *TWITCHOVRLY 4029357733 CADate 04/27/21 0 1117666694 1 7372Card 2801,11.25,,Posted,251.35,2021-04-28,11.25,Withdrawal Debit Card MC Debit/PAYPAL *BLVCKLNGS 4029357733 CADate 04/14/21 0 1104117516 1 7372Card 2801,11.25
4/28/2021,,Withdrawal ACH PAYPAL/TYPE: INST XFER ID: PAYPALSI77CO: PAYPALEntry Class Code: WEB,24.98,,Posted,262.6,2021-04-28,24.98,Withdrawal ACH PAYPAL/TYPE: INST XFER ID: PAYPALSI77CO: PAYPALEntry Class Code: WEB,24.653333333333332
4/27/2021,,Withdrawal/Cash Disbursed 300.00,300.0,,Posted,162.58,2021-04-27,300.0,Withdrawal/Cash Disbursed 35.00,300.0
4/27/2021,,Withdrawal Debit Card MC Debit/PUBLIX #1312 GAINESVILLE FLDate 04/26/21 0 1116509094 1 5411Card 2801,88.25,,Posted,462.58,2021-04-27,88.25,Withdrawal Debit Card MC Debit/PUBLIX #1312 GAINESVILLE FLDate 06/18/21 0 1169764423 1 5411Card 2801,88.25
4/27/2021,,Recurring Withdrawal Debit Card MC Debit/HELP.HBOMAX.COM NEW YORK NYDate 04/27/21 0 1117509004 1 5815Card 2801,17.23,,Posted,550.83,2021-04-27,17.23,Recurring Withdrawal Debit Card MC Debit/HELP.HBOMAX.COM NEW YORK NYDate 04/27/22 0 2117023223 1 5815Card 2801,17.23
4/26/2021,,Withdrawal POS #000000494673/FAST TRACK #200 3960 SW ARCHER RDGAINESVILLE FLCard 2801,13.94,,Posted,568.06,2021-04-26,13.94,Withdrawal POS #000000418393/FAST TRACK #200 3960 SW ARCHER RDGAINESVILLE FLCard 2801,13.94
4/26/2021,,Withdrawal Bill Payment #000009548880/PAYPAL *DISNEY PLUS 2211 North First SJose CACard 2801,9.18,,Posted,582.0,2021-04-26,9.18,Withdrawal Bill Payment #000009548880/PAYPAL *DISNEY PLUS 2211 North First SJose CACard 2801,9.18
4/25/2021,,Recurring Withdrawal Debit Card MC Debit/SOUNDCLOUD INC SAN FRANCISC CADate 04/24/21 0 1114766563 1 4899Card 2801,4.99,,Posted,591.18,2021-04-25,4.99,Recurring Withdrawal Debit Card MC Debit/SOUNDCLOUD INC SAN FRANCISC CADate 05/24/21 0 1144498667 1 4899Card 2801,4.99
4/21/2021,,Withdrawal Debit Card MC Debit/WORDPRESS 0XFKTN2K1Z SAN FRANCISC CADate 04/20/21 0 1110163691 1 7372Card 2801,48.0,,Posted,596.17,2021-04-21,48.0,Withdrawal Debit Card MC Debit/WORDPRESS 0XFKTN2K1Z SAN FRANCISC CADate 04/20/21 0 1110163691 1 7372Card 2801,48.0
4/21/2021,,Withdrawal Debit Card MC Debit/PAYPAL *BLVCKLNGS 4029357733 CADate 04/20/21 0 1110159483 1 7372Card 2801,1.49,,Posted,644.17,2021-04-21,1.49,Withdrawal Debit Card MC Debit/PAYPAL *BLVCKLNGS 4029357733 CADate 04/14/21 0 1104117516 1 7372Card 2801,1.5933333333333335
4/20/2021,,Withdrawal Debit Card Fee/MASTERCARD ISSUER CROSS-BORDER FEEDate 04/19/21 0 1109184122 1 7311Card 2801,0.06,,Posted,645.66,2021-04-20,0.06,Withdrawal Debit Card Fee/MASTERCARD ISSUER CROSS-BORDER FEEDate 04/19/21 0 1109184122 1 7311Card 2801,0.1281818181818182
4/20/2021,,Withdrawal Debit Card MC Debit/MIXCLOUD PREM LONDON LNDate 04/19/21 0 1109184122 1 7311Card 2801,7.99,,Posted,645.72,2021-04-20,7.99,Withdrawal Debit Card MC Debit/MIXCLOUD PREM LONDON LNDate 04/19/21 0 1109184122 1 7311Card 2801,7.99
4/19/2021,202.0,Draft 202,850.0,,Posted,653.71,2021-04-19,850.0,Draft 204,850.0
4/19/2021,,Withdrawal POS #000000094697/PUBLIX 3930 SW ARCHER ROA GAINESVILLE FLCard 2801,108.31,,Posted,1503.71,2021-04-19,108.31,Withdrawal POS #000000021747/PUBLIX 3930 SW ARCHER ROA GAINESVILLE FLCard 2801,108.31
4/19/2021,,Withdrawal/Cash Disbursed 260.00,260.0,,Posted,1612.02,2021-04-19,260.0,Withdrawal/Cash Disbursed 35.00,260.0
4/19/2021,,Withdrawal Debit Card MC Debit/PIZZA HUT 27918 3523739402 FLDate 04/16/21 0 1106310415 3 5812Card 2801,42.88,,Posted,1872.02,2021-04-19,42.88,Withdrawal Debit Card MC Debit/PIZZA HUT 27918 3523739402 FLDate 12/16/22 0 2350808582 1 5812Card 2801,42.88
4/19/2021,,Withdrawal Debit Card Fee/MASTERCARD ISSUER CROSS-BORDER FEEDate 04/18/21 0 1108306909 3 5734Card 2801,0.03,,Posted,1914.9,2021-04-19,0.03,Withdrawal Debit Card Fee/MASTERCARD ISSUER CROSS-BORDER FEEDate 04/19/21 0 1109184122 1 7311Card 2801,0.1281818181818182
4/19/2021,,Withdrawal Debit Card MC Debit/PAYPAL *CHARIZ JOHN ZA 4029357733 AUDate 04/18/21 0 1108306909 3 5734Card 2801,3.99,,Posted,1914.93,2021-04-19,3.99,Withdrawal Debit Card MC Debit/PAYPAL *CHARIZ JOHN ZA 4029357733 AUDate 04/18/21 0 1108306909 3 5734Card 2801,3.49
4/19/2021,,Withdrawal ACH APPLECARD GSBANK/TYPE: PAYMENT ID: 9999999999CO: APPLECARD GSBANKEntry Class Code: WEB,100.0,,Posted,1918.92,2021-04-19,100.0,Withdrawal ACH APPLECARD GSBANK/TYPE: PAYMENT ID: 9999999999 CO: APPLECARD GSBANK Entry Class Code: WEB,100.0
4/19/2021,,Withdrawal ACH PAYPAL/TYPE: INST XFER ID: PAYPALSI77CO: PAYPALEntry Class Code: WEB,39.98,,Posted,2018.92,2021-04-19,39.98,Withdrawal ACH PAYPAL/TYPE: INST XFER ID: PAYPALSI77CO: PAYPALEntry Class Code: WEB,39.656666666666666
4/19/2021,,Withdrawal ACH PAYPAL/TYPE: INST XFER ID: PAYPALSI77CO: PAYPALEntry Class Code: WEB,14.99,,Posted,2058.9,2021-04-19,14.99,Withdrawal ACH PAYPAL/TYPE: INST XFER ID: PAYPALSI77CO: PAYPALEntry Class Code: WEB,14.646666666666667
4/16/2021,,Withdrawal POS #000016554225/WALGREENS 2415 SW GAINESVILLE FLCard 2801,22.24,,Posted,2073.89,2021-04-16,22.24,Withdrawal POS #000014264526/WALGREENS 2415 SW GAINESVILLE FLCard 2801,22.24
4/16/2021,,Withdrawal POS #000000053120/GATE 1445 506 NW 1 GAINESVILLE FLCard 2801,21.57,,Posted,2096.13,2021-04-16,21.57,Withdrawal POS #000000183316/GATE 1445 506 NW 13TH GAINESVILLE FLCard 2801,21.335
4/16/2021,,Withdrawal POS #000000205538/AMAZON.COM*QN3DZ9HU3 SEATTLE WACard 2801,12.29,,Posted,2117.7,2021-04-16,12.29,Withdrawal POS #000000259511/AMAZON.COM*2776K9KH0 SEATTLE WACard 2801,12.55
4/16/2021,,Withdrawal POS #000000205514/AMAZON.COM*401V98BH3 SEATTLE WACard 2801,34.23,,Posted,2129.99,2021-04-16,34.23,Withdrawal POS #000000259511/AMAZON.COM*2776K9KH0 SEATTLE WACard 2801,34.23
4/15/2021,,Withdrawal Debit Card MC Debit/COUNTRY CRITTERS - 4 OCALA FLDate 04/14/21 0 1104613761 1 0742Card 2801,30.0,,Posted,2164.22,2021-04-15,30.0,Withdrawal Debit Card MC Debit/COUNTRY CRITTERS - 4 OCALA FLDate 05/25/21 0 1145668660 1 0742Card 2801,30.0
4/15/2021,,Withdrawal Debit Card Fee/MASTERCARD ISSUER CROSS-BORDER FEEDate 04/14/21 0 1104120823 1 5999Card 2801,0.16,,Posted,2194.22,2021-04-15,0.16,Withdrawal Debit Card Fee/MASTERCARD ISSUER CROSS-BORDER FEEDate 04/19/21 0 1109184122 1 7311Card 2801,0.1281818181818182
4/15/2021,,Withdrawal Debit Card MC Debit/PAYPAL *PADDLE.COM 35314369001 GBDate 04/14/21 0 1104120823 1 5999Card 2801,19.99,,Posted,2194.38,2021-04-15,19.99,Withdrawal Debit Card MC Debit/PAYPAL *PADDLE.COM 35314369001 GBDate 04/14/21 0 1104120823 1 5999Card 2801,19.99
4/15/2021,,Withdrawal Debit Card MC Debit/PAYPAL *BLVCKLNGS 4029357733 CADate 04/14/21 0 1104117516 1 7372Card 2801,1.5,,Posted,2214.37,2021-04-15,1.5,Withdrawal Debit Card MC Debit/PAYPAL *BLVCKLNGS 4029357733 CADate 04/14/21 0 1104117516 1 7372Card 2801,1.5933333333333335
4/14/2021,,"Withdrawal Debit Card MC Debit/TUMBLR, INC. 5120800053 CADate 04/13/21 0 1103571649 1 5045Card 2801",19.0,,Posted,2215.87,2021-04-14,19.0,"Withdrawal Debit Card MC Debit/TUMBLR, INC. 5120800053 CADate 04/13/21 0 1103571649 1 5045Card 2801",19.0
4/14/2021,,Withdrawal Bill Payment #000026034417/PAYPAL *BULLETHOUND 2211 North First SJose CACard 2801,5.0,,Posted,2184.87,2021-04-14,5.0,Withdrawal Bill Payment #000027794161/PAYPAL *LH TRADING 2211 North First SJose CACard 2801,5.0
4/14/2021,,Withdrawal POS #000000035070/PUBLIX 3930 SW ARCHER ROA GAINESVILLE FLCard 2801,90.53,,Posted,2189.87,2021-04-14,90.53,Withdrawal POS #000000029500/PUBLIX 3930 SW ARCHER ROA GAINESVILLE FLCard 2801,90.53
4/13/2021,,Withdrawal Debit Card MC Debit/PIZZA HUT 27918 3523739402 FLDate 04/12/21 0 1102132047 1 5812Card 2801,35.46,,Posted,2280.4,2021-04-13,35.46,Withdrawal Debit Card MC Debit/PIZZA HUT 27918 3523739402 FLDate 12/16/22 0 2350808582 1 5812Card 2801,35.78666666666667
4/13/2021,,Withdrawal Debit Card MC Debit/WALGREENS #5024 800-289-2273 FLDate 04/12/21 0 1102547509 1 5912Card 2801,28.86,,Posted,2315.86,2021-04-13,28.86,Withdrawal Debit Card MC Debit/WALGREENS #5024 800-289-2273 FLDate 09/17/22 0 2260124597 1 5912Card 2801,28.86
4/13/2021,,Withdrawal Debit Card MC Debit/PAYPAL *BLVCKLNGS 4029357733 CADate 04/12/21 0 1102539061 1 7372Card 2801,1.79,,Posted,2344.72,2021-04-13,1.79,Withdrawal Debit Card MC Debit/PAYPAL *BLVCKLNGS 4029357733 CADate 04/14/21 0 1104117516 1 7372Card 2801,1.5933333333333335
4/13/2021,,Withdrawal ACH APPLECARD GSBANK/TYPE: PAYMENT ID: 9999999999CO: APPLECARD GSBANKEntry Class Code: WEB,100.0,,Posted,2346.51,2021-04-13,100.0,Withdrawal ACH APPLECARD GSBANK/TYPE: PAYMENT ID: 9999999999 CO: APPLECARD GSBANK Entry Class Code: WEB,100.0
4/13/2021,,Withdrawal Bill Payment #000026002088/PAYPAL *ETSY 2211 North First S San JoseCACard 2801,11.6,,Posted,2446.51,2021-04-13,11.6,Withdrawal Bill Payment #000026002088/PAYPAL *ETSY 2211 North First S San JoseCACard 2801,11.6
4/13/2021,,Withdrawal Bill Payment #000056898461/PAYPAL *ETSY.COM 2211 North First S SanJose CACard 2801,14.95,,Posted,2458.11,2021-04-13,14.95,Withdrawal Bill Payment #000057401651/PAYPAL *ETSY.COM 2211 North First S SanJose CACard 2801,14.95
4/12/2021,,Withdrawal/Cash Disbursed 150.00,150.0,,Posted,2473.06,2021-04-12,150.0,Withdrawal/Cash Disbursed 35.00,150.0
4/12/2021,,Withdrawal POS #000010324719/WALGREENS 2415 SW GAINESVILLE FLCard 2801,5.35,,Posted,2623.06,2021-04-12,5.35,Withdrawal POS #000014264526/WALGREENS 2415 SW GAINESVILLE FLCard 2801,5.705
4/11/2021,,Withdrawal Debit Card MC Debit/PIZZA HUT 27918 3523739402 FLDate 04/08/21 0 1098358049 1 5812Card 2801,30.18,,Posted,2628.41,2021-04-11,30.18,Withdrawal Debit Card MC Debit/PIZZA HUT 27918 3523739402 FLDate 12/16/22 0 2350808582 1 5812Card 2801,30.485
4/9/2021,,Withdrawal ACH PAYPAL/TYPE: INST XFER ID: PAYPALSI77CO: PAYPALEntry Class Code: WEB,2.99,,Posted,2658.59,2021-04-09,2.99,Withdrawal ACH PAYPAL/TYPE: INST XFER ID: PAYPALSI77CO: PAYPALEntry Class Code: WEB,3.2266666666666666
4/7/2021,,Withdrawal ACH E*TRADE BANK/TYPE: TRANSFER ID: 9658390001CO: E*TRADE BANKEntry Class Code: CCD,0.57,,Posted,2661.58,2021-04-07,0.57,Withdrawal ACH E*TRADE BANK/TYPE: TRANSFER ID: 9658390001CO: E*TRADE BANKEntry Class Code: CCD,0.57
4/6/2021,,Withdrawal ACH BEST BUY/TYPE: PAYMENT ID: CITIGPUFDRCO: BEST BUYEntry Class Code: PPD,55.0,,Posted,911.58,2021-04-06,55.0,Withdrawal ACH BEST BUY/TYPE: PAYMENT ID: CITIGPUFDRCO: BEST BUYEntry Class Code: TEL,54.5
4/6/2021,,Withdrawal ACH LAST.FM LTD/CO: LAST.FM LTDTYPE: IAT PAYPAL ID: 770510487CEntry Class Code: IAT,3.0,,Posted,966.58,2021-04-06,3.0,Withdrawal ACH LAST.FM LTD/CO: LAST.FM LTDTYPE: IAT PAYPAL ID: 770510487CEntry Class Code: IAT,3.0
4/6/2021,,Withdrawal ACH BEST BUY/TYPE: PAYMENT ID: CITIGPUFDRCO: BEST BUYEntry Class Code: PPD,55.0,,Posted,969.58,2021-04-06,55.0,Withdrawal ACH BEST BUY/TYPE: PAYMENT ID: CITIGPUFDRCO: BEST BUYEntry Class Code: TEL,54.5
4/5/2021,,Withdrawal Bill Payment #000000563201/Microsoft Corporation Eve MICROSOFT*XBOXREDMOND WACard 2801,4.98,,Posted,1024.58,2021-04-05,4.98,Withdrawal Bill Payment #000000563201/Microsoft Corporation Eve MICROSOFT*XBOXREDMOND WACard 2801,4.98
4/5/2021,,Withdrawal Bill Payment #000008850166/PAYPAL *ZENIMAX ONL 2211 North First SJose CACard 2801,27.99,,Posted,1029.56,2021-04-05,27.99,Withdrawal Bill Payment #000009548880/PAYPAL *DISNEY PLUS 2211 North First SJose CACard 2801,27.99
4/5/2021,,Withdrawal/Cash Disbursed 150.00,150.0,,Posted,1057.55,2021-04-05,150.0,Withdrawal/Cash Disbursed 35.00,150.0
4/5/2021,,Withdrawal POS #000000416024/AMAZON.COM*DI1C22RF3 SEATTLE WACard 2801,12.29,,Posted,1207.55,2021-04-05,12.29,Withdrawal POS #000000400824/AMAZON.COM*HC3O110O2 SEATTLE WACard 2801,12.29
4/5/2021,,Withdrawal ACH PAYMENT FOR AMZ/TYPE: STORECARD ID: 9069872103CO: PAYMENT FOR AMZEntry Class Code: WEB,65.0,,Posted,1219.84,2021-04-05,65.0,Withdrawal ACH PAYMENT FOR AMZ/TYPE: STORECARD ID: 9069872103 CO: PAYMENT FOR AMZ Entry Class Code: WEB,65.0
4/2/2021,,Withdrawal Debit Card MC Debit/AMZN DIGITAL*IT6ER04C3 888-802-3080 WADate 04/01/21 0 1091315345 1 5818Card 2801,9.99,,Posted,1284.84,2021-04-02,9.99,Withdrawal Debit Card MC Debit/AMZN DIGITAL*2G2YK1811 888-802-3080 WADate 09/15/21 0 1258632245 1 5818Card 2801,9.99
4/2/2021,,Withdrawal ACH CITY OF GAINESVI/TYPE: 2000-6637- ID: 5330903620CO: CITY OF GAINESVIEntry Class Code: WEB,169.52,,Posted,1294.83,2021-04-02,169.52,Withdrawal ACH CITY OF GAINESVI/TYPE: 2000-6637- ID: 5330903620CO: CITY OF GAINESVIEntry Class Code: WEB,169.52
4/2/2021,,Withdrawal ACH COX COMM GAN/TYPE: BANK DRAFT ID: 1581620085CO: COX COMM GANEntry Class Code: WEB,127.52,,Posted,1464.35,2021-04-02,127.52,Withdrawal ACH COX COMM GAN/TYPE: BANK DRAFT ID: 1581620085CO: COX COMM GANEntry Class Code: WEB,127.34
4/2/2021,,Withdrawal ACH CAPITAL ONE/TYPE: MOBILE PMT ID: 9279744980CO: CAPITAL ONEEntry Class Code: WEB,55.0,,Posted,1591.87,2021-04-02,55.0,Withdrawal ACH CAPITAL ONE/TYPE: MOBILE PMT ID: 9279744980CO: CAPITAL ONEEntry Class Code: WEB,55.0
4/2/2021,,Withdrawal ACH BARCLAYCARD US/TYPE: CREDITCARD ID: 2510407970CO: BARCLAYCARD USEntry Class Code: WEB,55.0,,Posted,1646.87,2021-04-02,55.0,Withdrawal ACH BARCLAYCARD US/TYPE: CREDITCARD ID: 2510407970 CO: BARCLAYCARD US Entry Class Code: WEB,55.0
4/2/2021,,Withdrawal ACH TARGET CARD SRVC/TYPE: BILL PAY ID: T510215170CO: TARGET CARD SRVCEntry Class Code: WEB,55.0,,Posted,1701.87,2021-04-02,55.0,Withdrawal ACH TARGET CARD SRVC/TYPE: BILL PAY ID: T510215170CO: TARGET CARD SRVCEntry Class Code: WEB,55.0
4/2/2021,,Withdrawal ACH ROBINHOOD/TYPE: Funds ID: 1464364776 CO: ROBINHOODEntry Class Code: WEB,55.0,,Posted,1756.87,2021-04-02,55.0,Withdrawal ACH ROBINHOOD/TYPE: Funds ID: 1464364776 CO: ROBINHOODEntry Class Code: WEB,55.0
4/2/2021,,Withdrawal ACH DISCOVER/TYPE: E-PAYMENT ID: 2510020270CO: DISCOVEREntry Class Code: WEB,53.0,,Posted,1811.87,2021-04-02,53.0,Withdrawal ACH DISCOVER/TYPE: E-PAYMENT ID: 2510020270CO: DISCOVEREntry Class Code: WEB,53.0
4/2/2021,,Withdrawal ACH E*TRADE/TYPE: ACH TRNSFR ID: 1391321258CO: E*TRADEEntry Class Code: PPD,50.0,,Posted,1864.87,2021-04-02,50.0,Withdrawal ACH E*TRADE/TYPE: ACH TRNSFR ID: 1391321258CO: E*TRADEEntry Class Code: PPD,50.0
4/1/2021,,Withdrawal POS #000000912507/AMAZON.COM*489RL5UZ3 SEATTLE WACard 2801,23.11,,Posted,1914.87,2021-04-01,23.11,Withdrawal POS #000000247445/AMAZON.COM*A42ZY7OC3 SEATTLE WACard 2801,23.11
4/1/2021,,Withdrawal Debit Card MC Debit/PAYPAL *IPMOSKINAEL 4029357733 CADate 03/31/21 0 1090624209 1 7395Card 2801,21.5,,Posted,1937.98,2021-04-01,21.5,Withdrawal Debit Card MC Debit/PAYPAL *IPMOSKINAEL 4029357733 CADate 03/31/21 0 1090624209 1 7395Card 2801,21.5
4/1/2021,,Withdrawal POS #000000598647/AMAZON.COM*F565U8HW3 SEATTLE WACard 2801,16.47,,Posted,1959.48,2021-04-01,16.47,Withdrawal POS #000000598647/AMAZON.COM*F565U8HW3 SEATTLE WACard 2801,16.546666666666667
4/1/2021,,Withdrawal ACH PAYPAL/TYPE: INST XFER ID: PAYPALSI77CO: PAYPALEntry Class Code: WEB,89.99,,Posted,1975.95,2021-04-01,89.99,Withdrawal ACH PAYPAL/TYPE: INST XFER ID: PAYPALSI77CO: PAYPALEntry Class Code: WEB,89.99
4/1/2021,,Withdrawal ACH PAYPAL/TYPE: INST XFER ID: PAYPALSI77CO: PAYPALEntry Class Code: WEB,14.99,,Posted,2065.94,2021-04-01,14.99,Withdrawal ACH PAYPAL/TYPE: INST XFER ID: PAYPALSI77CO: PAYPALEntry Class Code: WEB,14.646666666666667
4/1/2021,,Withdrawal Bill Payment #000008689195/PAYPAL *PACKIX 2211 North First S SanCACard 2801,1.99,,Posted,2080.93,2021-04-01,1.99,Withdrawal Bill Payment #000010440934/PAYPAL *PACKIX 2211 North First S SanCACard 2801,1.99
3/31/2021,,Withdrawal ACH APPLECARD GSBANK/TYPE: PAYMENT ID: 9999999999CO: APPLECARD GSBANKEntry Class Code: WEB,50.0,,Posted,2082.51,2021-03-31,50.0,Withdrawal ACH APPLECARD GSBANK/TYPE: PAYMENT ID: 9999999999 CO: APPLECARD GSBANK Entry Class Code: WEB,50.0
3/31/2021,,Withdrawal ACH PAYPAL/TYPE: INST XFER ID: PAYPALSI77CO: PAYPALEntry Class Code: WEB,3.0,,Posted,2132.51,2021-03-31,3.0,Withdrawal ACH PAYPAL/TYPE: INST XFER ID: PAYPALSI77CO: PAYPALEntry Class Code: WEB,3.2266666666666666
3/31/2021,,Withdrawal ACH PAYPAL/TYPE: INST XFER ID: PAYPALSI77CO: PAYPALEntry Class Code: WEB,1.99,,Posted,2135.51,2021-03-31,1.99,Withdrawal ACH PAYPAL/TYPE: INST XFER ID: PAYPALSI77CO: PAYPALEntry Class Code: WEB,1.99
3/30/2021,,Withdrawal ACH BARCLAYCARD US/TYPE: CREDITCARD ID: 2510407970CO: BARCLAYCARD USEntry Class Code: WEB,45.0,,Posted,2137.5,2021-03-30,45.0,Withdrawal ACH BARCLAYCARD US/TYPE: CREDITCARD ID: 2510407970 CO: BARCLAYCARD US Entry Class Code: WEB,45.0
3/30/2021,,Withdrawal ACH PAYPAL/TYPE: INST XFER ID: PAYPALSI77CO: PAYPALEntry Class Code: WEB,39.99,,Posted,182.5,2021-03-30,39.99,Withdrawal ACH PAYPAL/TYPE: INST XFER ID: PAYPALSI77CO: PAYPALEntry Class Code: WEB,39.656666666666666
3/30/2021,,Withdrawal ACH PAYPAL/TYPE: INST XFER ID: PAYPALSI77CO: PAYPALEntry Class Code: WEB,39.99,,Posted,222.49,2021-03-30,39.99,Withdrawal ACH PAYPAL/TYPE: INST XFER ID: PAYPALSI77CO: PAYPALEntry Class Code: WEB,39.656666666666666
3/30/2021,,Withdrawal ACH PAYPAL/TYPE: INST XFER ID: PAYPALSI77CO: PAYPALEntry Class Code: WEB,39.99,,Posted,262.48,2021-03-30,39.99,Withdrawal ACH PAYPAL/TYPE: INST XFER ID: PAYPALSI77CO: PAYPALEntry Class Code: WEB,39.656666666666666
3/29/2021,,Withdrawal ATM Fee/COLUMBIA CAR-428486 318 NW 13TH STGAINESVILLE FLCard 2801,2.0,,Posted,98.27,2021-03-29,2.0,Withdrawal ATM Fee/COLUMBIA CAR-428486 318 NW 13TH STGAINESVILLE FLCard 2801,2.0
3/29/2021,,Withdrawal at ATM #000000003096/COLUMBIA CAR-428486 318 NW 13TH STGAINESVILLE FLCard 2801,23.0,,Posted,100.27,2021-03-29,23.0,Withdrawal at ATM #000000003731/COLUMBIA CAR-428486 318 NW 13TH STGAINESVILLE FLCard 2801,23.0
3/29/2021,,Withdrawal at ATM #000000006380/CAMPUS 1900 SW 34TH ST GAINESVILLE FLCard 2801,180.0,,Posted,123.27,2021-03-29,180.0,Withdrawal at ATM #000000009758/CAMPUS 1900 SW 34TH ST GAINESVILLE FLCard 2801,180.0
3/29/2021,,Withdrawal Debit Card MC Debit/SCRUBS CARWASH - GAINE GAINESVILLE FLDate 03/28/21 0 1087445829 1 7542Card 2801,4.0,,Posted,303.27,2021-03-29,4.0,Withdrawal Debit Card MC Debit/SCRUBS CARWASH - GAINE GAINESVILLE FLDate 03/26/23 0 3085900969 0 7542Card 2801,4.5
3/29/2021,,Withdrawal ACH PAYPAL/TYPE: INST XFER ID: PAYPALSI77CO: PAYPALEntry Class Code: WEB,39.99,,Posted,188.47,2021-03-29,39.99,Withdrawal ACH PAYPAL/TYPE: INST XFER ID: PAYPALSI77CO: PAYPALEntry Class Code: WEB,39.656666666666666
3/29/2021,,Withdrawal ACH PAYPAL/TYPE: INST XFER ID: PAYPALSI77CO: PAYPALEntry Class Code: WEB,39.99,,Posted,228.46,2021-03-29,39.99,Withdrawal ACH PAYPAL/TYPE: INST XFER ID: PAYPALSI77CO: PAYPALEntry Class Code: WEB,39.656666666666666
3/29/2021,,Withdrawal ACH PAYPAL/TYPE: INST XFER ID: PAYPALSI77CO: PAYPALEntry Class Code: WEB,10.5,,Posted,268.45,2021-03-29,10.5,Withdrawal ACH PAYPAL/TYPE: INST XFER ID: PAYPALSI77CO: PAYPALEntry Class Code: WEB,10.88
3/29/2021,,Withdrawal ACH PAYPAL/TYPE: INST XFER ID: PAYPALSI77CO: PAYPALEntry Class Code: WEB,5.66,,Posted,278.95,2021-03-29,5.66,Withdrawal ACH PAYPAL/TYPE: INST XFER ID: PAYPALSI77CO: PAYPALEntry Class Code: WEB,5.766666666666667
3/29/2021,,Withdrawal Bill Payment #000000050750/Microsoft Corporation Eve MICROSOFT*XBOXREDMOND WACard 2801,0.46,,Posted,284.61,2021-03-29,0.46,Withdrawal Bill Payment #000000563201/Microsoft Corporation Eve MICROSOFT*XBOXREDMOND WACard 2801,0.46
3/28/2021,,Withdrawal POS #000000032515/PUBLIX 3930 SW ARCHER ROA GAINESVILLE FLCard 2801,26.81,,Posted,285.07,2021-03-28,26.81,Withdrawal POS #000000029500/PUBLIX 3930 SW ARCHER ROA GAINESVILLE FLCard 2801,26.81
3/28/2021,,Recurring Withdrawal Debit Card MC Debit/HELP.HBOMAX.COM NEW YORK NYDate 03/27/21 0 1086822896 1 5815Card 2801,17.23,,Posted,311.88,2021-03-28,17.23,Recurring Withdrawal Debit Card MC Debit/HELP.HBOMAX.COM NEW YORK NYDate 04/27/22 0 2117023223 1 5815Card 2801,17.23
3/28/2021,,Withdrawal Debit Card MC Debit/KINDLE UNLTD*R11JK1VA3 866-321-8851 WADate 03/26/21 0 1085800614 1 5818Card 2801,9.99,,Posted,329.11,2021-03-28,9.99,Withdrawal Debit Card MC Debit/KINDLE UNLTD*1N4IN7U80 866-321-8851 WADate 03/24/22 0 2083036398 1 5818Card 2801,9.99
3/26/2021,,Withdrawal Bill Payment #000008479811/PAYPAL *DISNEY PLUS 2211 North First SJose CACard 2801,9.18,,Posted,339.1,2021-03-26,9.18,Withdrawal Bill Payment #000009548880/PAYPAL *DISNEY PLUS 2211 North First SJose CACard 2801,9.18
3/25/2021,,Recurring Withdrawal Debit Card MC Debit/SOUNDCLOUD INC SAN FRANCISC CADate 03/25/21 0 1084556042 1 4899Card 2801,4.99,,Posted,348.28,2021-03-25,4.99,Recurring Withdrawal Debit Card MC Debit/SOUNDCLOUD INC SAN FRANCISC CADate 05/24/21 0 1144498667 1 4899Card 2801,4.99
3/25/2021,,Withdrawal Bill Payment #000025333228/PAYPAL *LH TRADING 2211 North First SJose CACard 2801,44.94,,Posted,353.27,2021-03-25,44.94,Withdrawal Bill Payment #000027794161/PAYPAL *LH TRADING 2211 North First SJose CACard 2801,44.94
3/22/2021,,Withdrawal POS #000000859166/AMAZON.COM*2V8XI38S3 SEATTLE WACard 2801,2.24,,Posted,398.21,2021-03-22,2.24,Withdrawal POS #000000630901/AMAZON.COM*ZA2053S23 SEATTLE WACard 2801,2.24
3/22/2021,,Withdrawal at ATM #000000005674/CAMPUS 1900 SW 34TH ST GAINESVILLE FLCard 2801,120.0,,Posted,400.45,2021-03-22,120.0,Withdrawal at ATM #000000005364/CAMPUS 5725 SW 75TH ST GAINESVILLE FLCard 1140,120.0
3/22/2021,,Withdrawal POS #000000212218/USPS PO 11322705 4600 SW 34TH STGAINESVILLE FLCard 2801,8.5,,Posted,520.45,2021-03-22,8.5,Withdrawal POS #000000228165/USPS PO 11322705 4600 SW 34TH STGAINESVILLE FLCard 2801,8.5
3/19/2021,,Withdrawal Debit Card MC Debit/PAYPAL *SJCHAPLINSKI 4029357733 CADate 03/18/21 0 1077230483 1 4829Card 2801,0.02,,Posted,278.95,2021-03-19,0.02,Withdrawal Debit Card MC Debit/PAYPAL *SJCHAPLINSKI 4029357733 CADate 03/18/21 0 1077230483 1 4829Card 2801,0.02
3/18/2021,,Withdrawal Debit Card MC Debit/GNV CITY CENTER LLC-GA GAINESVILLE FLDate 03/16/21 0 1075510897 0 7523Card 2801,6.0,,Posted,261.88,2021-03-18,6.0,Withdrawal Debit Card MC Debit/GNV CITY CENTER LLC-GA GAINESVILLE FLDate 03/16/21 0 1075510897 0 7523Card 2801,6.0
3/18/2021,,Withdrawal at ATM #000000008720/CAMPUS 1900 SW 34TH ST GAINESVILLE FLCard 2801,80.0,,Posted,267.88,2021-03-18,80.0,Withdrawal at ATM #000000009758/CAMPUS 1900 SW 34TH ST GAINESVILLE FLCard 2801,80.0
3/18/2021,,Withdrawal ACH PAYPAL/TYPE: INST XFER ID: PAYPALSI77CO: PAYPALEntry Class Code: WEB,14.99,,Posted,347.88,2021-03-18,14.99,Withdrawal ACH PAYPAL/TYPE: INST XFER ID: PAYPALSI77CO: PAYPALEntry Class Code: WEB,14.646666666666667
3/17/2021,,Withdrawal/Cash Disbursed 30.00,30.0,,Posted,244.07,2021-03-17,30.0,Withdrawal/Cash Disbursed 35.00,30.0
3/17/2021,,Withdrawal POS #000000000005/AMAZON.COM*G25PN8NF3 SEATTLE WACard 2801,12.29,,Posted,274.07,2021-03-17,12.29,Withdrawal POS #000000000005/AMAZON.COM*HY2208FJ0 SEATTLE WACard 2801,12.29
3/17/2021,,Withdrawal Debit Card MC Debit/COUNTRY CRITTERS - 4 OCALA FLDate 03/16/21 0 1075495944 1 0742Card 2801,75.0,,Posted,286.36,2021-03-17,75.0,Withdrawal Debit Card MC Debit/COUNTRY CRITTERS - 4 OCALA FLDate 05/25/21 0 1145668660 1 0742Card 2801,75.0
3/17/2021,,Withdrawal Debit Card Fee/MASTERCARD ISSUER CROSS-BORDER FEEDate 03/15/21 0 1074114177 1 5734Card 2801,0.02,,Posted,361.36,2021-03-17,0.02,Withdrawal Debit Card Fee/MASTERCARD ISSUER CROSS-BORDER FEEDate 04/19/21 0 1109184122 1 7311Card 2801,0.1281818181818182
3/17/2021,,Withdrawal Debit Card MC Debit/PAYPAL *CHARIZ 4029357733 AUDate 03/15/21 0 1074114177 1 5734Card 2801,2.99,,Posted,361.38,2021-03-17,2.99,Withdrawal Debit Card MC Debit/PAYPAL *CHARIZ JOHN ZA 4029357733 AUDate 04/18/21 0 1108306909 3 5734Card 2801,3.49
3/17/2021,,Withdrawal ACH PAYPAL/TYPE: INST XFER ID: PAYPALSI77CO: PAYPALEntry Class Code: WEB,39.99,,Posted,364.37,2021-03-17,39.99,Withdrawal ACH PAYPAL/TYPE: INST XFER ID: PAYPALSI77CO: PAYPALEntry Class Code: WEB,39.656666666666666
3/16/2021,,Withdrawal Debit Card MC Debit/PAYPAL *IPMOSKINAEL 4029357733 CADate 03/14/21 0 1073119936 1 7395Card 2801,45.5,,Posted,217.07,2021-03-16,45.5,Withdrawal Debit Card MC Debit/PAYPAL *IPMOSKINAEL 4029357733 CADate 03/31/21 0 1090624209 1 7395Card 2801,45.5
3/16/2021,,Withdrawal Debit Card MC Debit/PAYPAL *ETSY.COM 4029357733 CADate 03/14/21 0 1073119864 1 5699Card 2801,9.88,,Posted,262.57,2021-03-16,9.88,Withdrawal Debit Card MC Debit/PAYPAL *ETSY.COM 4029357733 NYDate 05/12/21 0 1132187934 1 5699Card 2801,10.015
3/16/2021,,Withdrawal Debit Card MC Debit/PAYPAL *ETSY.COM 4029357733 CADate 03/14/21 0 1073119863 1 5699Card 2801,13.34,,Posted,272.45,2021-03-16,13.34,Withdrawal Debit Card MC Debit/PAYPAL *ETSY.COM 4029357733 NYDate 05/12/21 0 1132187934 1 5699Card 2801,13.34
3/16/2021,,Withdrawal ACH CAPITAL ONE/TYPE: MOBILE PMT ID: 9279744980CO: CAPITAL ONEEntry Class Code: WEB,50.0,,Posted,285.79,2021-03-16,50.0,Withdrawal ACH CAPITAL ONE/TYPE: MOBILE PMT ID: 9279744980CO: CAPITAL ONEEntry Class Code: WEB,50.0
3/16/2021,,Withdrawal POS #000000418543/WAWA 5325 2373 SW ARCHER ROA GAINESVILLEFLCard 2801,13.01,,Posted,335.79,2021-03-16,13.01,Withdrawal POS #000000188596/WAWA 5325 2373 SW ARCHER ROA GAINESVILLEFLCard 2801,13.195
3/16/2021,,Withdrawal ACH PAYMENT FOR AMZ/TYPE: STORECARD ID: 9069872103CO: PAYMENT FOR AMZEntry Class Code: WEB,125.0,,Posted,348.8,2021-03-16,125.0,Withdrawal ACH PAYMENT FOR AMZ/TYPE: STORECARD ID: 9069872103 CO: PAYMENT FOR AMZ Entry Class Code: WEB,125.0
3/16/2021,,Withdrawal ACH TARGET CARD SRVC/TYPE: BILL PAY ID: T510215170CO: TARGET CARD SRVCEntry Class Code: WEB,75.0,,Posted,473.8,2021-03-16,75.0,Withdrawal ACH TARGET CARD SRVC/TYPE: BILL PAY ID: T510215170CO: TARGET CARD SRVCEntry Class Code: WEB,75.0
3/15/2021,,Withdrawal POS #000000000008/AMAZON.COM*6Q23J5RT3 SEATTLE WACard 2801,12.29,,Posted,548.8,2021-03-15,12.29,Withdrawal POS #000000000023/AMAZON.COM*AU8ER6ZT3 SEATTLE WACard 2801,12.489999999999998
3/15/2021,,Withdrawal Bill Payment #000008081950/PAYPAL *liuwentj 2211 North First S SanJose CACard 2801,874.95,,Posted,561.09,2021-03-15,874.95,Withdrawal Bill Payment #000057401651/PAYPAL *ETSY.COM 2211 North First S SanJose CACard 2801,874.95
3/15/2021,,Withdrawal Debit Card MC Debit/SCRUBS CARWASH - GAINE GAINESVILLE FLDate 03/13/21 0 1072703495 5 7542Card 2801,5.0,,Posted,1436.04,2021-03-15,5.0,Withdrawal Debit Card MC Debit/SCRUBS CARWASH - GAINE GAINESVILLE FLDate 03/26/23 0 3085900969 0 7542Card 2801,4.5
3/15/2021,,Withdrawal Debit Card MC Debit/WALGREENS #5024 800-289-2273 FLDate 03/13/21 0 1072695425 5 5912Card 2801,18.17,,Posted,1441.04,2021-03-15,18.17,Withdrawal Debit Card MC Debit/WALGREENS #5024 800-289-2273 FLDate 04/03/23 0 3093023575 1 5912Card 2801,18.17
3/15/2021,,Withdrawal Debit Card MC Debit/PAYPAL *IPKAMENALEX 4029357733 CADate 03/14/21 0 1073417945 1 5099Card 2801,19.99,,Posted,1459.21,2021-03-15,19.99,Withdrawal Debit Card MC Debit/PAYPAL *IPMOSKINAEL 4029357733 CADate 03/31/21 0 1090624209 1 7395Card 2801,19.99
3/15/2021,,Withdrawal Bill Payment #000024967779/PAYPAL *PACKIX 2211 North First S SanCACard 2801,1.99,,Posted,1479.2,2021-03-15,1.99,Withdrawal Bill Payment #000010440934/PAYPAL *PACKIX 2211 North First S SanCACard 2801,1.99
3/15/2021,,Withdrawal ACH BARCLAYCARD US/TYPE: CREDITCARD ID: 2510407970CO: BARCLAYCARD USEntry Class Code: WEB,55.0,,Posted,1481.19,2021-03-15,55.0,Withdrawal ACH BARCLAYCARD US/TYPE: CREDITCARD ID: 2510407970 CO: BARCLAYCARD US Entry Class Code: WEB,55.0
3/15/2021,,Withdrawal ACH APPLECARD GSBANK/TYPE: PAYMENT ID: 9999999999CO: APPLECARD GSBANKEntry Class Code: WEB,55.0,,Posted,1536.19,2021-03-15,55.0,Withdrawal ACH APPLECARD GSBANK/TYPE: PAYMENT ID: 9999999999 CO: APPLECARD GSBANK Entry Class Code: WEB,55.0
3/15/2021,,Withdrawal ACH TARGET CARD SRVC/TYPE: BILL PAY ID: T510215170CO: TARGET CARD SRVCEntry Class Code: WEB,55.0,,Posted,1591.19,2021-03-15,55.0,Withdrawal ACH TARGET CARD SRVC/TYPE: BILL PAY ID: T510215170CO: TARGET CARD SRVCEntry Class Code: WEB,55.0
3/15/2021,,Withdrawal ACH DISCOVER/TYPE: E-PAYMENT ID: 2510020270CO: DISCOVEREntry Class Code: WEB,50.0,,Posted,1646.19,2021-03-15,50.0,Withdrawal ACH DISCOVER/TYPE: E-PAYMENT ID: 2510020270CO: DISCOVEREntry Class Code: WEB,50.0
3/15/2021,,Withdrawal ACH PAYPAL/TYPE: INST XFER ID: PAYPALSI77CO: PAYPALEntry Class Code: WEB,39.99,,Posted,1696.19,2021-03-15,39.99,Withdrawal ACH PAYPAL/TYPE: INST XFER ID: PAYPALSI77CO: PAYPALEntry Class Code: WEB,39.656666666666666
3/15/2021,,Withdrawal ACH PAYPAL/TYPE: INST XFER ID: PAYPALSI77CO: PAYPALEntry Class Code: WEB,37.95,,Posted,1736.18,2021-03-15,37.95,Withdrawal ACH PAYPAL/TYPE: INST XFER ID: PAYPALSI77CO: PAYPALEntry Class Code: WEB,37.95
3/15/2021,,Withdrawal ACH PAYPAL/TYPE: INST XFER ID: PAYPALSI77CO: PAYPALEntry Class Code: WEB,10.0,,Posted,1774.13,2021-03-15,10.0,Withdrawal ACH PAYPAL/TYPE: INST XFER ID: PAYPALSI77CO: PAYPALEntry Class Code: WEB,9.723333333333334
3/14/2021,,Withdrawal Debit Card MC Debit/FIT2RUN GAINESVILLE GAINESVILLE FLDate 03/12/21 0 1071790100 1 5655Card 2801,53.45,,Posted,1784.13,2021-03-14,53.45,Withdrawal Debit Card MC Debit/FIT2RUN GAINESVILLE GAINESVILLE FLDate 03/12/21 0 1071790100 1 5655Card 2801,53.45
3/13/2021,,Withdrawal ATM Fee/COLUMBIA CAR-428486 318 NW 13TH STGAINESVILLE FLCard 2801,2.0,,Posted,1387.58,2021-03-13,2.0,Withdrawal ATM Fee/COLUMBIA CAR-428486 318 NW 13TH STGAINESVILLE FLCard 2801,2.0
3/13/2021,,Withdrawal at ATM #000000003023/COLUMBIA CAR-428486 318 NW 13TH STGAINESVILLE FLCard 2801,23.0,,Posted,1389.58,2021-03-13,23.0,Withdrawal at ATM #000000003731/COLUMBIA CAR-428486 318 NW 13TH STGAINESVILLE FLCard 2801,23.0
3/13/2021,,Withdrawal ATM Fee/COLUMBIA CAR-428486 318 NW 13TH STGAINESVILLE FLCard 2801,2.0,,Posted,1412.58,2021-03-13,2.0,Withdrawal ATM Fee/COLUMBIA CAR-428486 318 NW 13TH STGAINESVILLE FLCard 2801,2.0
3/13/2021,,Withdrawal at ATM #000000003022/COLUMBIA CAR-428486 318 NW 13TH STGAINESVILLE FLCard 2801,63.0,,Posted,1414.58,2021-03-13,63.0,Withdrawal at ATM #000000003731/COLUMBIA CAR-428486 318 NW 13TH STGAINESVILLE FLCard 2801,63.0
3/12/2021,,Withdrawal POS #000021000016/FIT2RUN GAINESVILLE 6419 NEWBERRY RDGAINESVILLE FLCard 2801,53.45,,Posted,1477.58,2021-03-12,53.45,Withdrawal POS #000021000016/FIT2RUN GAINESVILLE 6419 NEWBERRY RDGAINESVILLE FLCard 2801,53.45
3/12/2021,,Withdrawal at ATM #000000004681/CAMPUS 1900 SW 34TH ST GAINESVILLE FLCard 2801,40.0,,Posted,1006.03,2021-03-12,40.0,Withdrawal at ATM #000000009758/CAMPUS 1900 SW 34TH ST GAINESVILLE FLCard 2801,40.0
3/12/2021,,Withdrawal Debit Card MC Debit/PUBLIX #1312 GAINESVILLE FLDate 03/11/21 0 1070536058 1 5411Card 2801,28.89,,Posted,1046.03,2021-03-12,28.89,Withdrawal Debit Card MC Debit/PUBLIX #1312 GAINESVILLE FLDate 03/11/21 0 1070536058 1 5411Card 2801,28.405
3/12/2021,,Withdrawal Debit Card MC Debit/COUNTRY CRITTERS - 3 GAINESVILLE FLDate 03/11/21 0 1070535457 1 0742Card 2801,366.22,,Posted,1074.92,2021-03-12,366.22,Withdrawal Debit Card MC Debit/COUNTRY CRITTERS - 3 GAINESVILLE FLDate 10/14/21 0 1287686337 4 0742Card 2801,366.22
3/11/2021,,Withdrawal POS #000053110997/SHELL SERVICE S GAINESVILLE FLCard 2801,27.49,,Posted,1441.14,2021-03-11,27.49,Withdrawal POS #000019892829/SHELL SERVICE S GAINESVILLE FLCard 2801,27.49
3/9/2021,,Withdrawal Debit Card MC Debit/WALGREENS #5024 GAINESVILLE FLDate 03/08/21 0 1067438890 1 5912Card 2801,12.88,,Posted,1468.63,2021-03-09,12.88,Withdrawal Debit Card MC Debit/WALGREENS #5024 GAINESVILLE FLDate 06/23/23 0 3174465834 2 5912Card 2801,12.88
3/9/2021,,Withdrawal ACH PAYPAL/TYPE: INST XFER ID: PAYPALSI77CO: PAYPALEntry Class Code: WEB,2.99,,Posted,1481.51,2021-03-09,2.99,Withdrawal ACH PAYPAL/TYPE: INST XFER ID: PAYPALSI77CO: PAYPALEntry Class Code: WEB,3.2266666666666666
3/8/2021,,Withdrawal POS #000000060760/GATE 1445 506 NW 1 GAINESVILLE FLCard 2801,4.82,,Posted,1484.5,2021-03-08,4.82,Withdrawal POS #000000183316/GATE 1445 506 NW 13TH GAINESVILLE FLCard 2801,4.82
3/8/2021,,Withdrawal ACH LAST.FM LTD/CO: LAST.FM LTDTYPE: IAT PAYPAL ID: 770510487CEntry Class Code: IAT,3.0,,Posted,1489.32,2021-03-08,3.0,Withdrawal ACH LAST.FM LTD/CO: LAST.FM LTDTYPE: IAT PAYPAL ID: 770510487CEntry Class Code: IAT,3.0
3/3/2021,,Recurring Withdrawal Debit Card MC Debit/HELP.HBOMAX.COM NEW YORK NYDate 03/03/21 0 1062476710 1 5815Card 2801,17.23,,Posted,1492.32,2021-03-03,17.23,Recurring Withdrawal Debit Card MC Debit/HELP.HBOMAX.COM NEW YORK NYDate 04/27/22 0 2117023223 1 5815Card 2801,17.23
3/2/2021,,Withdrawal ACH CITY OF GAINESVI/TYPE: 2000-6637- ID: 5330903620CO: CITY OF GAINESVIEntry Class Code: WEB,179.72,,Posted,659.55,2021-03-02,179.72,Withdrawal ACH CITY OF GAINESVI/TYPE: 2000-6637- ID: 5330903620CO: CITY OF GAINESVIEntry Class Code: WEB,179.225
3/2/2021,,Withdrawal ACH COX COMM GAN/TYPE: BANK DRAFT ID: 1581620085CO: COX COMM GANEntry Class Code: WEB,127.52,,Posted,839.27,2021-03-02,127.52,Withdrawal ACH COX COMM GAN/TYPE: BANK DRAFT ID: 1581620085CO: COX COMM GANEntry Class Code: WEB,127.34
3/2/2021,,Withdrawal ACH BEST BUY/TYPE: PAYMENT ID: CITIGPUFDRCO: BEST BUYEntry Class Code: PPD,55.0,,Posted,966.79,2021-03-02,55.0,Withdrawal ACH BEST BUY/TYPE: PAYMENT ID: CITIGPUFDRCO: BEST BUYEntry Class Code: TEL,54.5
3/2/2021,,Withdrawal ACH CAPITAL ONE/TYPE: MOBILE PMT ID: 9279744980CO: CAPITAL ONEEntry Class Code: WEB,50.0,,Posted,1021.79,2021-03-02,50.0,Withdrawal ACH CAPITAL ONE/TYPE: MOBILE PMT ID: 9279744980CO: CAPITAL ONEEntry Class Code: WEB,50.0
3/2/2021,,Withdrawal ACH BARCLAYCARD US/TYPE: CREDITCARD ID: 2510407970CO: BARCLAYCARD USEntry Class Code: WEB,50.0,,Posted,1071.79,2021-03-02,50.0,Withdrawal ACH BARCLAYCARD US/TYPE: CREDITCARD ID: 2510407970 CO: BARCLAYCARD US Entry Class Code: WEB,50.0
3/2/2021,,Withdrawal ACH APPLECARD GSBANK/TYPE: PAYMENT ID: 9999999999CO: APPLECARD GSBANKEntry Class Code: WEB,25.0,,Posted,1121.79,2021-03-02,25.0,Withdrawal ACH APPLECARD GSBANK/TYPE: PAYMENT ID: 9999999999 CO: APPLECARD GSBANK Entry Class Code: WEB,25.0
3/2/2021,,Withdrawal ACH SANTA FE COLLEGE/TYPE: SCHOOLFEES ID: 5591207627CO: SANTA FE COLLEGEEntry Class Code: WEB,350.31,,Posted,1146.79,2021-03-02,350.31,Withdrawal ACH SANTA FE COLLEGE/TYPE: SCHOOLFEES ID: 5591207627CO: SANTA FE COLLEGEEntry Class Code: WEB,350.31
3/2/2021,,Withdrawal ACH WAWA CREDIT CARD/TYPE: ONLINE PMT ID: CITICTPCO: WAWA CREDIT CARDEntry Class Code: WEB,105.14,,Posted,1497.1,2021-03-02,105.14,Withdrawal ACH WAWA CREDIT CARD/TYPE: PAYMENT ID: CITIGPUFDRCO: WAWA CREDIT CARDEntry Class Code: PPD,105.14
3/2/2021,,Withdrawal ACH PAYMENT FOR AMZ/TYPE: STORECARD ID: 9069872103CO: PAYMENT FOR AMZEntry Class Code: WEB,75.0,,Posted,1602.24,2021-03-02,75.0,Withdrawal ACH PAYMENT FOR AMZ/TYPE: STORECARD ID: 9069872103 CO: PAYMENT FOR AMZ Entry Class Code: WEB,75.0
3/2/2021,,Withdrawal ACH DISCOVER/TYPE: E-PAYMENT ID: 2510020270CO: DISCOVEREntry Class Code: WEB,50.0,,Posted,1677.24,2021-03-02,50.0,Withdrawal ACH DISCOVER/TYPE: E-PAYMENT ID: 2510020270CO: DISCOVEREntry Class Code: WEB,50.0
3/2/2021,,Withdrawal ACH TARGET CARD SRVC/TYPE: BILL PAY ID: T510215170CO: TARGET CARD SRVCEntry Class Code: WEB,50.0,,Posted,1727.24,2021-03-02,50.0,Withdrawal ACH TARGET CARD SRVC/TYPE: BILL PAY ID: T510215170CO: TARGET CARD SRVCEntry Class Code: WEB,50.0
3/2/2021,,Withdrawal ACH PAYPAL/TYPE: INST XFER ID: PAYPALSI77CO: PAYPALEntry Class Code: WEB,5.66,,Posted,1777.24,2021-03-02,5.66,Withdrawal ACH PAYPAL/TYPE: INST XFER ID: PAYPALSI77CO: PAYPALEntry Class Code: WEB,5.766666666666667
3/1/2021,,Recurring Withdrawal Debit Card MC Debit/SOUNDCLOUD INC SAN FRANCISC CADate 03/01/21 0 1060311701 1 4899Card 2801,4.99,,Posted,1782.9,2021-03-01,4.99,Recurring Withdrawal Debit Card MC Debit/SOUNDCLOUD INC SAN FRANCISC CADate 05/24/21 0 1144498667 1 4899Card 2801,4.99
3/1/2021,,Withdrawal Debit Card MC Debit/ELDERSCROLLSONLINE. 855-296-3170 MDDate 03/01/21 0 1060309446 1 7994Card 2801,49.99,,Posted,1787.89,2021-03-01,49.99,Withdrawal Debit Card MC Debit/ELDERSCROLLSONLINE. 855-296-3170 MDDate 11/09/21 0 1313300656 1 5816Card 2801,49.99
3/1/2021,,Withdrawal Debit Card MC Debit/ELDERSCROLLSONLINE. 855-296-3170 MDDate 03/01/21 0 1060309445 1 7994Card 2801,39.99,,Posted,1837.88,2021-03-01,39.99,Withdrawal Debit Card MC Debit/ELDERSCROLLSONLINE. 855-296-3170 MDDate 11/09/21 0 1313300656 1 5816Card 2801,39.99
3/1/2021,,Withdrawal ACH PAYPAL/TYPE: INST XFER ID: PAYPALSI77CO: PAYPALEntry Class Code: WEB,99.99,,Posted,1877.87,2021-03-01,99.99,Withdrawal ACH PAYPAL/TYPE: INST XFER ID: PAYPALSI77CO: PAYPALEntry Class Code: WEB,99.66333333333334
3/1/2021,,Withdrawal ACH PAYPAL/TYPE: INST XFER ID: PAYPALSI77CO: PAYPALEntry Class Code: WEB,39.0,,Posted,1977.86,2021-03-01,39.0,Withdrawal ACH PAYPAL/TYPE: INST XFER ID: PAYPALSI77CO: PAYPALEntry Class Code: WEB,39.656666666666666
3/1/2021,,Withdrawal ACH PAYPAL/TYPE: INST XFER ID: PAYPALSI77CO: PAYPALEntry Class Code: WEB,39.0,,Posted,2016.86,2021-03-01,39.0,Withdrawal ACH PAYPAL/TYPE: INST XFER ID: PAYPALSI77CO: PAYPALEntry Class Code: WEB,39.656666666666666
3/1/2021,,Withdrawal ACH PAYPAL/TYPE: INST XFER ID: PAYPALSI77CO: PAYPALEntry Class Code: WEB,10.5,,Posted,2055.86,2021-03-01,10.5,Withdrawal ACH PAYPAL/TYPE: INST XFER ID: PAYPALSI77CO: PAYPALEntry Class Code: WEB,10.88
3/1/2021,,Withdrawal ACH PAYPAL/TYPE: INST XFER ID: PAYPALSI77CO: PAYPALEntry Class Code: WEB,8.03,,Posted,2066.36,2021-03-01,8.03,Withdrawal ACH PAYPAL/TYPE: INST XFER ID: PAYPALSI77CO: PAYPALEntry Class Code: WEB,8.03
3/1/2021,,Withdrawal POS #000000702758/AMAZON.COM*6V06K3643 SEATTLE WACard 2801,17.09,,Posted,2074.39,2021-03-01,17.09,Withdrawal POS #000000247445/AMAZON.COM*A42ZY7OC3 SEATTLE WACard 2801,17.09
2/28/2021,,Withdrawal POS #000000018130/PUBLIX 3930 SW ARCHER ROA GAINESVILLE FLCard 2801,15.63,,Posted,2091.48,2021-02-28,15.63,Withdrawal POS #000000086361/PUBLIX 3930 SW ARCHER ROA GAINESVILLE FLCard 2801,15.63
2/26/2021,,Withdrawal Bill Payment #000007470833/PAYPAL *ASKNET INC 2211 North First SJose CACard 2801,19.99,,Posted,2107.11,2021-02-26,19.99,Withdrawal Bill Payment #000009548880/PAYPAL *DISNEY PLUS 2211 North First SJose CACard 2801,19.99
2/24/2021,,Withdrawal ACH PAYPAL/TYPE: INST XFER ID: PAYPALSI77CO: PAYPALEntry Class Code: WEB,44.99,,Posted,127.1,2021-02-24,44.99,Withdrawal ACH PAYPAL/TYPE: INST XFER ID: PAYPALSI77CO: PAYPALEntry Class Code: WEB,44.99
2/23/2021,,Withdrawal ACH BEST BUY/TYPE: PAYMENT ID: CITIGPUFDRCO: BEST BUYEntry Class Code: PPD,55.0,,Posted,172.09,2021-02-23,55.0,Withdrawal ACH BEST BUY/TYPE: PAYMENT ID: CITIGPUFDRCO: BEST BUYEntry Class Code: TEL,54.5
2/23/2021,,Withdrawal ACH PAYPAL/TYPE: INST XFER ID: PAYPALSI77CO: PAYPALEntry Class Code: WEB,100.0,,Posted,227.09,2021-02-23,100.0,Withdrawal ACH PAYPAL/TYPE: INST XFER ID: PAYPALSI77CO: PAYPALEntry Class Code: WEB,99.66333333333334
2/23/2021,,Withdrawal ACH PAYPAL/TYPE: INST XFER ID: PAYPALSI77CO: PAYPALEntry Class Code: WEB,50.0,,Posted,327.09,2021-02-23,50.0,Withdrawal ACH PAYPAL/TYPE: INST XFER ID: PAYPALSI77CO: PAYPALEntry Class Code: WEB,49.66
2/23/2021,,Withdrawal ACH KLARNA INC/TYPE: KLARNA ID: 0009259410CO: KLARNA INCEntry Class Code: WEB,34.7,,Posted,377.09,2021-02-23,34.7,Withdrawal ACH KLARNA INC/TYPE: KLARNA ID: 0009259410CO: KLARNA INCEntry Class Code: WEB,34.7
2/23/2021,,Withdrawal ACH PAYPAL/TYPE: INST XFER ID: PAYPALSI77CO: PAYPALEntry Class Code: WEB,24.99,,Posted,411.79,2021-02-23,24.99,Withdrawal ACH PAYPAL/TYPE: INST XFER ID: PAYPALSI77CO: PAYPALEntry Class Code: WEB,24.653333333333332
2/23/2021,,Withdrawal ACH PAYPAL/TYPE: INST XFER ID: PAYPALSI77CO: PAYPALEntry Class Code: WEB,2.99,,Posted,436.78,2021-02-23,2.99,Withdrawal ACH PAYPAL/TYPE: INST XFER ID: PAYPALSI77CO: PAYPALEntry Class Code: WEB,3.2266666666666666
2/22/2021,,Withdrawal ACH BEST BUY/TYPE: PAYMENT ID: CITIGPUFDRCO: BEST BUYEntry Class Code: PPD,125.0,,Posted,439.77,2021-02-22,125.0,Withdrawal ACH BEST BUY/TYPE: PAYMENT ID: CITIGPUFDRCO: BEST BUYEntry Class Code: TEL,125.0
2/22/2021,,Withdrawal ACH BARCLAYCARD US/TYPE: CREDITCARD ID: 2510407970CO: BARCLAYCARD USEntry Class Code: WEB,100.0,,Posted,564.77,2021-02-22,100.0,Withdrawal ACH BARCLAYCARD US/TYPE: CREDITCARD ID: 2510407970 CO: BARCLAYCARD US Entry Class Code: WEB,100.0
2/22/2021,,Withdrawal ACH CAPITAL ONE/TYPE: MOBILE PMT ID: 9279744980CO: CAPITAL ONEEntry Class Code: WEB,65.0,,Posted,664.77,2021-02-22,65.0,Withdrawal ACH CAPITAL ONE/TYPE: MOBILE PMT ID: 9279744980CO: CAPITAL ONEEntry Class Code: WEB,65.0
2/22/2021,,Withdrawal ACH APPLECARD GSBANK/TYPE: PAYMENT ID: 9999999999CO: APPLECARD GSBANKEntry Class Code: WEB,25.0,,Posted,729.77,2021-02-22,25.0,Withdrawal ACH APPLECARD GSBANK/TYPE: PAYMENT ID: 9999999999 CO: APPLECARD GSBANK Entry Class Code: WEB,25.0
2/22/2021,,Withdrawal ACH DISCOVER/TYPE: E-PAYMENT ID: 2510020270CO: DISCOVEREntry Class Code: WEB,100.0,,Posted,754.77,2021-02-22,100.0,Withdrawal ACH DISCOVER/TYPE: E-PAYMENT ID: 2510020270CO: DISCOVEREntry Class Code: WEB,100.0
2/22/2021,,Withdrawal ACH TARGET DEBIT CRD/Location - TARGET -0687GAINESVILLE FL / Terminal ID: 174TYPE: ACH TRAN ID: 1410215170CO: TARGET DEBIT CRDEntry Class C,75.44,,Posted,854.77,2021-02-22,75.44,Withdrawal ACH TARGET DEBIT CRD/Location - TARGET -0687GAINESVILLE FL / Terminal ID: 071TYPE: ACH TRAN ID: 1410215170CO: TARGET DEBIT CRD,75.44
2/22/2021,,Withdrawal ACH KLARNA INC/TYPE: KLARNA ID: 0009259410CO: KLARNA INCEntry Class Code: WEB,50.24,,Posted,930.21,2021-02-22,50.24,Withdrawal ACH KLARNA INC/TYPE: KLARNA ID: 0009259410CO: KLARNA INCEntry Class Code: WEB,50.24
2/22/2021,,Withdrawal ACH PAYPAL/TYPE: INST XFER ID: PAYPALSI77CO: PAYPALEntry Class Code: WEB,36.0,,Posted,980.45,2021-02-22,36.0,Withdrawal ACH PAYPAL/TYPE: INST XFER ID: PAYPALSI77CO: PAYPALEntry Class Code: WEB,35.995000000000005
2/22/2021,,Withdrawal ACH PAYPAL/TYPE: INST XFER ID: PAYPALSI77CO: PAYPALEntry Class Code: WEB,30.5,,Posted,1016.45,2021-02-22,30.5,Withdrawal ACH PAYPAL/TYPE: INST XFER ID: PAYPALSI77CO: PAYPALEntry Class Code: WEB,30.884999999999998
2/22/2021,,Withdrawal ACH PAYPAL/TYPE: INST XFER ID: PAYPALSI77CO: PAYPALEntry Class Code: WEB,10.0,,Posted,1046.95,2021-02-22,10.0,Withdrawal ACH PAYPAL/TYPE: INST XFER ID: PAYPALSI77CO: PAYPALEntry Class Code: WEB,9.723333333333334
2/22/2021,,Withdrawal ACH PAYPAL/TYPE: INST XFER ID: PAYPALSI77CO: PAYPALEntry Class Code: WEB,9.99,,Posted,1056.95,2021-02-22,9.99,Withdrawal ACH PAYPAL/TYPE: INST XFER ID: PAYPALSI77CO: PAYPALEntry Class Code: WEB,9.723333333333334
2/22/2021,,Withdrawal POS #000000002120/AMAZON.COM*PU23M49W3 SEATTLE WACard 2801,16.99,,Posted,1066.94,2021-02-22,16.99,Withdrawal POS #000000630901/AMAZON.COM*ZA2053S23 SEATTLE WACard 2801,16.835
2/22/2021,,Withdrawal POS #000000000073/AMAZON.COM*FJ68I73A3 SEATTLE WACard 2801,27.53,,Posted,1083.93,2021-02-22,27.53,Withdrawal POS #000000000023/AMAZON.COM*AU8ER6ZT3 SEATTLE WACard 2801,27.53
2/21/2021,,Withdrawal Debit Card MC Debit/PUBLIX #125 GAINESVILLE FLDate 02/19/21 0 1050582715 1 5411Card 2801,89.25,,Posted,1111.46,2021-02-21,89.25,Withdrawal Debit Card MC Debit/PUBLIX #1312 GAINESVILLE FLDate 03/11/21 0 1070536058 1 5411Card 2801,89.25
2/21/2021,,Withdrawal Debit Card Fee/VISA INTERNATIONAL SERVICE ASSESSMENTDate 02/18/21Card 1140,0.04,,Posted,1200.71,2021-02-21,0.04,Withdrawal Debit Card Fee/VISA INTERNATIONAL SERVICE ASSESSMENTDate 02/18/21Card 1140,0.08
2/21/2021,,Withdrawal Debit Card Signature Debit/PAYPAL *BLVCKLNGS 0635308003 FRDate 02/18/21 0 1049951415 4 7372Card 1140,4.99,,Posted,1200.75,2021-02-21,4.99,Withdrawal Debit Card Signature Debit/PAYPAL *BLVCKLNGS 0635308003 FRDate 02/18/21 0 1049951415 4 7372Card 1140,4.99
2/19/2021,,Withdrawal ATM Fee/COLUMBIA CAR-428486 318 NW 13TH STGAINESVILLE FLCard 2801,2.0,,Posted,1205.74,2021-02-19,2.0,Withdrawal ATM Fee/COLUMBIA CAR-428486 318 NW 13TH STGAINESVILLE FLCard 2801,2.0
2/19/2021,,Withdrawal at ATM #000000002930/COLUMBIA CAR-428486 318 NW 13TH STGAINESVILLE FLCard 2801,63.0,,Posted,1207.74,2021-02-19,63.0,Withdrawal at ATM #000000003731/COLUMBIA CAR-428486 318 NW 13TH STGAINESVILLE FLCard 2801,63.0
2/19/2021,,Withdrawal at ATM #000000002923/CAMPUS 1900 SW 34TH ST GAINESVILLE FLCard 1140,180.0,,Posted,1270.74,2021-02-19,180.0,Withdrawal at ATM #000000001619/CAMPUS 1900 SW 34TH ST GAINESVILLE FL Card 1140,180.0
2/19/2021,,Recurring Withdrawal Debit Card - Signature Debit/Netflix.com netflix.com CADate 02/18/21 0 1049010069 2 4899Card 1140,9.88,,Posted,1450.74,2021-02-19,9.88,Recurring Withdrawal Debit Card - Signature Debit/Netflix.com netflix.com CADate 02/18/21 0 1049010069 2 4899Card 1140,9.88
2/19/2021,,Withdrawal Debit Card Signature Debit/PP*GOOGLE GOOGLE STORA 402-935-7733 CADate 02/17/21 0 1048851676 3 5815Card 1140,1.99,,Posted,1460.62,2021-02-19,1.99,Withdrawal Debit Card Signature Debit/PP*GOOGLE GOOGLE STORA 402-935-7733 CADate 02/17/21 0 1048851676 3 5815Card 1140,1.99
2/18/2021,,Withdrawal Debit Card Signature Debit/Amazon.com*IP4NA1P03 Amzn.com/bill WADate 02/17/21 0 1048699217 3 5942Card 1140,5.62,,Posted,512.61,2021-02-18,5.62,Withdrawal Debit Card Signature Debit/Amazon.com*IP4NA1P03 Amzn.com/bill WADate 02/17/21 0 1048699217 3 5942Card 1140,5.62
2/18/2021,,Withdrawal Debit Card Signature Debit/PAYPAL *COCOATECH 402-935-7733 CADate 02/17/21 0 1048441651 0 5734Card 1140,18.0,,Posted,518.23,2021-02-18,18.0,Withdrawal Debit Card Signature Debit/PAYPAL *COCOATECH 402-935-7733 CADate 02/17/21 0 1048441651 0 5734Card 1140,18.0
2/18/2021,,Withdrawal Debit Card Signature Debit/PUBLIX #680 863-688-1188 FLDate 02/17/21 0 1048047561 0 5411Card 1140,68.08,,Posted,536.23,2021-02-18,68.08,Withdrawal Debit Card Signature Debit/PUBLIX #680 863-688-1188 FLDate 02/17/21 0 1048047561 0 5411Card 1140,68.08
2/17/2021,232.0,Draft 232,850.0,,Posted,604.31,2021-02-17,850.0,Draft 229,850.0
2/17/2021,,Withdrawal/Cash Disbursed 160.00,160.0,,Posted,1454.31,2021-02-17,160.0,Withdrawal/Cash Disbursed 35.00,160.0
2/17/2021,,Withdrawal Debit Card Signature Debit/SP * NOMNOMNOW INC. NOMNOMNOW.MYS CADate 02/16/21 0 1047900235 3 5995Card 1140,30.0,,Posted,1614.31,2021-02-17,30.0,Withdrawal Debit Card Signature Debit/SP * NOMNOMNOW INC. NOMNOMNOW.MYS CADate 02/16/21 0 1047900235 3 5995Card 1140,30.0
2/17/2021,,Withdrawal Debit Card Signature Debit/THEFARMERSDOG.COM THEFARMERSDOG NYDate 02/16/21 0 1047900234 3 5995Card 1140,37.24,,Posted,1644.31,2021-02-17,37.24,Withdrawal Debit Card Signature Debit/THEFARMERSDOG.COM THEFARMERSDOG NYDate 02/16/21 0 1047900234 3 5995Card 1140,37.24
2/17/2021,,Withdrawal Debit Card Signature Debit/PAYPAL *UBER 402-935-7733 CADate 02/16/21 0 1047729063 2 4121Card 1140,10.0,,Posted,1681.55,2021-02-17,10.0,Withdrawal Debit Card Signature Debit/PAYPAL *UBER 402-935-7733 CADate 02/16/21 0 1047729063 2 4121Card 1140,10.0
2/17/2021,,Withdrawal Debit Card Signature Debit/HONDA OF GAINESVILLE GAINESVILLE FLDate 02/16/21 0 1047363243 0 5511Card 1140,261.31,,Posted,1691.55,2021-02-17,261.31,Withdrawal Debit Card Signature Debit/HONDA OF GAINESVILLE GAINESVILLE FLDate 02/16/21 0 1047363243 0 5511Card 1140,261.31
2/17/2021,,Recurring Withdrawal Debit Card Fee/VISA INTERNATIONAL SERVICE ASSESSMENTDate 02/17/21Card 1140,0.06,,Posted,1952.86,2021-02-17,0.06,Withdrawal Debit Card Fee/VISA INTERNATIONAL SERVICE ASSESSMENTDate 02/18/21Card 1140,0.08
2/17/2021,,Recurring Withdrawal Debit Card - Signature Debit/MIXCLOUD PREM LONDON GBDate 02/17/21 0 1048115255 0 7311Card 1140,7.99,,Posted,1952.92,2021-02-17,7.99,Recurring Withdrawal Debit Card - Signature Debit/MIXCLOUD PREM LONDON GBDate 02/17/21 0 1048115255 0 7311Card 1140,7.99
2/17/2021,,Recurring Withdrawal Debit Card Fee/VISA INTERNATIONAL SERVICE ASSESSMENTDate 02/16/21Card 1140,0.08,,Posted,1960.91,2021-02-17,0.08,Withdrawal Debit Card Fee/VISA INTERNATIONAL SERVICE ASSESSMENTDate 02/18/21Card 1140,0.08
2/17/2021,,Recurring Withdrawal Debit Card - Signature Debit/PAYPAL *PADDLE.COM 35314369001 GBDate 02/16/21 0 1047089045 0 5999Card 1140,9.99,,Posted,1960.99,2021-02-17,9.99,Recurring Withdrawal Debit Card - Signature Debit/PAYPAL *PADDLE.COM 35314369001 GBDate 02/16/21 0 1047089045 0 5999Card 1140,9.99
2/16/2021,,Withdrawal Debit Card Signature Debit/PAYPAL *UBER 402-935-7733 CADate 02/15/21 0 1046547924 2 4121Card 1140,10.0,,Posted,1970.98,2021-02-16,10.0,Withdrawal Debit Card Signature Debit/PAYPAL *UBER 402-935-7733 CADate 02/16/21 0 1047729063 2 4121Card 1140,10.0
2/16/2021,,Withdrawal Debit Card Signature Debit/PAYPAL *UBER 402-935-7733 CADate 02/15/21 0 1046547923 2 4121Card 1140,15.18,,Posted,1980.98,2021-02-16,15.18,Withdrawal Debit Card Signature Debit/PAYPAL *UBER 402-935-7733 CADate 02/16/21 0 1047729063 2 4121Card 1140,15.18
2/16/2021,,Withdrawal ACH PAYPAL/TYPE: INST XFER ID: PAYPALSI77CO: PAYPALEntry Class Code: WEB,14.99,,Posted,1459.16,2021-02-16,14.99,Withdrawal ACH PAYPAL/TYPE: INST XFER ID: PAYPALSI77CO: PAYPALEntry Class Code: WEB,14.646666666666667
2/14/2021,,Withdrawal Debit Card Signature Debit/PLAYSTATION NETWORK 800-345-7669 CADate 02/13/21 0 1044014505 4 5816Card 1140,29.98,,Posted,1474.15,2021-02-14,29.98,Withdrawal Debit Card Signature Debit/PLAYSTATION NETWORK 800-345-7669 CADate 02/13/21 0 1044014505 4 5816Card 1140,29.98
2/14/2021,,Withdrawal Debit Card Signature Debit/PAYPAL *PACKIX 402-935-7733 NJDate 02/12/21 0 1043242483 4 5816Card 1140,0.49,,Posted,1504.13,2021-02-14,0.49,Withdrawal Debit Card Signature Debit/PAYPAL *PACKIX 402-935-7733 NJDate 02/12/21 0 1043242483 4 5816Card 1140,0.49
2/14/2021,,Withdrawal Debit Card Signature Debit/PAYPAL *BANDCAMP 402-935-7733 CADate 02/12/21 0 1043019773 8 5735Card 1140,5.0,,Posted,1504.62,2021-02-14,5.0,Withdrawal Debit Card Signature Debit/PAYPAL *UBER 402-935-7733 CADate 02/16/21 0 1047729063 2 4121Card 1140,5.0
2/13/2021,,Withdrawal POS #000000032127/PUBLIX 3930 SW ARCHER ROA GAINESVILLE FLCard 1140,83.99,,Posted,1509.62,2021-02-13,83.99,Withdrawal POS #000000116993/PUBLIX 3930 SW ARCHER ROA GAINESVILLE FLCard 1140,83.99
2/12/2021,,Withdrawal POS #000000472169/AMAZON.COM*UY7Z21W73 SEATTLE WACard 1140,34.99,,Posted,1593.61,2021-02-12,34.99,Withdrawal POS #000000472169/AMAZON.COM*UY7Z21W73 SEATTLE WACard 1140,34.99
2/12/2021,,Withdrawal POS #000000015702/WALGREENS STORE 2415 SW 7 GAINESVILLE FLCard 1140,18.17,,Posted,1628.6,2021-02-12,18.17,Withdrawal POS #000000305411/WALGREENS STORE 3455 SW A GAINESVILLE FLCard 1140,17.840000000000003
2/12/2021,,Withdrawal POS #000000426947/WALGREENS STORE 2415 SW 7 GAINESVILLE FLCard 1140,19.03,,Posted,1646.77,2021-02-12,19.03,Withdrawal POS #000000218861/WALGREENS STORE 2415 SW 7 GAINESVILLE FL Card 1140,18.6
2/12/2021,,Withdrawal Debit Card Signature Debit/WALGREENS #5024 800-289-2273 FLDate 02/11/21 0 1042872537 0 5912Card 1140,22.76,,Posted,1665.8,2021-02-12,22.76,Withdrawal Debit Card Signature Debit/WALGREENS #5024 800-289-2273 FLDate 02/11/21 0 1042872537 0 5912Card 1140,22.76
2/9/2021,,Withdrawal Debit Card Signature Debit/KLARNA *PAYMENTS 844-5527621 NYDate 02/08/21 0 1039629075 2 5999Card 1140,17.35,,Posted,1688.56,2021-02-09,17.35,Withdrawal Debit Card Signature Debit/KLARNA *PAYMENTS 844-5527621 NYDate 02/08/21 0 1039629075 2 5999Card 1140,17.345
2/9/2021,,Withdrawal Debit Card Signature Debit/KLARNA *PAYMENTS 844-5527621 NYDate 02/08/21 0 1039586381 2 5999Card 1140,25.12,,Posted,1705.91,2021-02-09,25.12,Withdrawal Debit Card Signature Debit/KLARNA *PAYMENTS 844-5527621 NYDate 02/08/21 0 1039629075 2 5999Card 1140,25.12
2/8/2021,,Withdrawal ACH BARCLAYCARD US/TYPE: CREDITCARD ID: 2510407970CO: BARCLAYCARD USEntry Class Code: WEB,100.0,,Posted,1731.03,2021-02-08,100.0,Withdrawal ACH BARCLAYCARD US/TYPE: CREDITCARD ID: 2510407970 CO: BARCLAYCARD US Entry Class Code: WEB,100.0
2/8/2021,,Withdrawal ACH APPLECARD GSBANK/TYPE: PAYMENT ID: 9999999999CO: APPLECARD GSBANKEntry Class Code: WEB,94.06,,Posted,1831.03,2021-02-08,94.06,Withdrawal ACH APPLECARD GSBANK/TYPE: PAYMENT ID: 9999999999 CO: APPLECARD GSBANK Entry Class Code: WEB,94.53
2/8/2021,,Withdrawal ACH CAPITAL ONE/TYPE: MOBILE PMT ID: 9279744980CO: CAPITAL ONEEntry Class Code: WEB,65.0,,Posted,1925.09,2021-02-08,65.0,Withdrawal ACH CAPITAL ONE/TYPE: MOBILE PMT ID: 9279744980CO: CAPITAL ONEEntry Class Code: WEB,65.0
2/8/2021,,Withdrawal ACH PAYMENT FOR AMZ/TYPE: STORECARD ID: 9069872103CO: PAYMENT FOR AMZEntry Class Code: WEB,158.84,,Posted,1990.09,2021-02-08,158.84,Withdrawal ACH PAYMENT FOR AMZ/TYPE: STORECARD ID: 9069872103 CO: PAYMENT FOR AMZ Entry Class Code: WEB,158.84
2/8/2021,,Withdrawal ACH DISCOVER/TYPE: E-PAYMENT ID: 2510020270CO: DISCOVEREntry Class Code: WEB,55.0,,Posted,2148.93,2021-02-08,55.0,Withdrawal ACH DISCOVER/TYPE: E-PAYMENT ID: 2510020270CO: DISCOVEREntry Class Code: WEB,55.0
2/8/2021,,Withdrawal ACH ZIPLINE NPCA/TYPE: PREAUTHPMT ID: 1263732506CO: ZIPLINE NPCAEntry Class Code: PPD,0.04,,Posted,2203.93,2021-02-08,0.04,Withdrawal ACH ZIPLINE NPCA/TYPE: PREAUTHPMT ID: 1263732506CO: ZIPLINE NPCAEntry Class Code: PPD,0.04
2/7/2021,,Withdrawal Debit Card Signature Debit/PP*APPLE.COM/BILL 402-935-7733 CADate 02/05/21 0 1036909336 5 5735Card 1140,14.99,,Posted,2195.96,2021-02-07,14.99,Withdrawal Debit Card Signature Debit/PP*APPLE.COM/BILL 402-935-7733 CADate 02/05/21 0 1036909336 5 5735Card 1140,14.99
2/5/2021,,Withdrawal ATM Fee/COLUMBIA CAR-428486 318 NW 13TH STGAINESVILLE FLCard 1140,2.0,,Posted,2210.95,2021-02-05,2.0,Withdrawal ATM Fee/COLUMBIA CAR-428486 318 NW 13TH STGAINESVILLE FLCard 2801,2.0
2/5/2021,,Withdrawal at ATM #000000002889/COLUMBIA CAR-428486 318 NW 13TH STGAINESVILLE FLCard 1140,63.0,,Posted,2212.95,2021-02-05,63.0,Withdrawal at ATM #000000003731/COLUMBIA CAR-428486 318 NW 13TH STGAINESVILLE FLCard 2801,63.0
2/5/2021,,Withdrawal POS #000000737724/GATE 1445 GAINESVILLE FLCard 1140,13.57,,Posted,2275.95,2021-02-05,13.57,Withdrawal POS #000000737724/GATE 1445 GAINESVILLE FLCard 1140,13.57
2/5/2021,,Withdrawal/Cash Disbursed 240.00,240.0,,Posted,2289.52,2021-02-05,240.0,Withdrawal/Cash Disbursed 35.00,240.0
2/4/2021,,Withdrawal Debit Card Signature Debit/PP*APPLE.COM/BILL 402-935-7733 CADate 02/02/21 0 1033536402 4 5735Card 1140,2.99,,Posted,1993.53,2021-02-04,2.99,Withdrawal Debit Card Signature Debit/PP*APPLE.COM/BILL 402-935-7733 CADate 02/05/21 0 1036909336 5 5735Card 1140,2.99
2/4/2021,,Withdrawal Debit Card Signature Debit/VALENCIA COL TUITION 407-582-1200 FLDate 02/03/21 0 1034400793 1 8220Card 1140,3.0,,Posted,1996.52,2021-02-04,3.0,Withdrawal Debit Card Signature Debit/VALENCIA COL TUITION 407-582-1200 FLDate 02/03/21 0 1034400793 1 8220Card 1140,3.0
2/4/2021,,Withdrawal ACH CITY OF GAINESVI/TYPE: 2000-6637- ID: 5330903620CO: CITY OF GAINESVIEntry Class Code: WEB,212.01,,Posted,1999.52,2021-02-04,212.01,Withdrawal ACH CITY OF GAINESVI/TYPE: 2000-6637- ID: 5330903620CO: CITY OF GAINESVIEntry Class Code: WEB,212.01
2/4/2021,,Withdrawal ACH WAWA CREDIT CARD/TYPE: ONLINE PMT ID: CITICTPCO: WAWA CREDIT CARDEntry Class Code: WEB,55.0,,Posted,2211.53,2021-02-04,55.0,Withdrawal ACH WAWA CREDIT CARD/TYPE: PAYMENT ID: CITIGPUFDRCO: WAWA CREDIT CARDEntry Class Code: PPD,55.0
2/3/2021,,Withdrawal Debit Card Signature Debit/Amazon.com*6Y0NL43T3 Amzn.com/bill WADate 02/02/21 0 1033833008 2 5942Card 1140,11.51,,Posted,2266.53,2021-02-03,11.51,Withdrawal Debit Card Signature Debit/Amazon.com*IP4NA1P03 Amzn.com/bill WADate 02/17/21 0 1048699217 3 5942Card 1140,11.51
2/3/2021,,Withdrawal Debit Card Signature Debit/PLAYSTATION NETWORK 800-345-7669 CADate 02/02/21 0 1033829432 1 5816Card 1140,49.99,,Posted,2278.04,2021-02-03,49.99,Withdrawal Debit Card Signature Debit/PLAYSTATION NETWORK 800-345-7669 CADate 02/13/21 0 1044014505 4 5816Card 1140,49.99
2/3/2021,,Withdrawal Debit Card Signature Debit/PAYPAL *CDKEYS.COM 402-935-7733 CADate 02/02/21 0 1033152790 2 5816Card 1140,39.98,,Posted,2328.03,2021-02-03,39.98,Withdrawal Debit Card Signature Debit/PAYPAL *CDKEYS.COM 402-935-7733 CADate 01/27/21 0 1027000963 4 5816Card 1140,39.98
2/3/2021,,Withdrawal ACH APPLECARD GSBANK/TYPE: PAYMENT ID: 9999999999CO: APPLECARD GSBANKEntry Class Code: WEB,100.0,,Posted,2368.01,2021-02-03,100.0,Withdrawal ACH APPLECARD GSBANK/TYPE: PAYMENT ID: 9999999999 CO: APPLECARD GSBANK Entry Class Code: WEB,100.0
2/3/2021,,Withdrawal POS #000000305411/WALGREENS STORE 3455 SW A GAINESVILLE FLCard 1140,31.0,,Posted,2468.01,2021-02-03,31.0,Withdrawal POS #000000305411/WALGREENS STORE 3455 SW A GAINESVILLE FLCard 1140,31.0
2/3/2021,,Withdrawal POS #000000000008/AMAZON.COM*6172X07C3 SEATTLE WACard 1140,17.3,,Posted,2499.01,2021-02-03,17.3,Withdrawal POS #000000000007/AMAZON.COM*2864R4HI1 SEATTLE WACard 1140,17.3
2/3/2021,,Withdrawal POS #000000784817/Microsoft 1 Microsoft Way Redmond WACard 1140,44.99,,Posted,2419.31,2021-02-03,44.99,Withdrawal POS #000000784817/Microsoft 1 Microsoft Way Redmond WACard 1140,44.99
2/2/2021,,Withdrawal POS #000000092568/PUBLIX 3930 SW ARCHER ROA GAINESVILLE FLCard 1140,118.4,,Posted,2464.3,2021-02-02,118.4,Withdrawal POS #000000116993/PUBLIX 3930 SW ARCHER ROA GAINESVILLE FLCard 1140,118.4
2/2/2021,,Withdrawal POS #000000716344/KANGAROO EXPRESS 3913 3424 SW WILLISTONGAINESVILLE FLCard 1140,21.96,,Posted,2582.7,2021-02-02,21.96,Withdrawal POS #000000591903/KANGAROO EXPRESS 3913 3424 SW WILLISTONGAINESVILLE FLCard 2801,21.91
2/2/2021,,Withdrawal POS #000000088866/AMAZON.COM*JY31Z2TN3 SEATTLE WACard 1140,47.95,,Posted,2604.66,2021-02-02,47.95,Withdrawal POS #000000705676/AMAZON.COM*4J55D8I53 SEATTLE WACard 1140,47.95
2/1/2021,,Recurring Withdrawal Debit Card Fee/VISA INTERNATIONAL SERVICE ASSESSMENTDate 02/01/21Card 1140,0.06,,Posted,2652.61,2021-02-01,0.06,Withdrawal Debit Card Fee/VISA INTERNATIONAL SERVICE ASSESSMENTDate 02/18/21Card 1140,0.08
2/1/2021,,Recurring Withdrawal Debit Card - Signature Debit/MIXCLOUD PREM LONDON GBDate 02/01/21 0 1032208242 0 7311Card 1140,7.99,,Posted,2652.67,2021-02-01,7.99,Recurring Withdrawal Debit Card - Signature Debit/MIXCLOUD PREM LONDON GBDate 02/17/21 0 1048115255 0 7311Card 1140,7.99
1/31/2021,,Withdrawal Debit Card Signature Debit/PP*APPLE.COM/BILL 402-935-7733 CADate 01/28/21 0 1028007161 9 5735Card 1140,2.99,,Posted,453.25,2021-01-31,2.99,Withdrawal Debit Card Signature Debit/PP*APPLE.COM/BILL 402-935-7733 CADate 02/05/21 0 1036909336 5 5735Card 1140,2.99
1/31/2021,,Withdrawal Debit Card Signature Debit/PP*APPLE.COM/BILL 402-935-7733 CADate 01/28/21 0 1028007160 9 5735Card 1140,5.99,,Posted,456.24,2021-01-31,5.99,Withdrawal Debit Card Signature Debit/PP*APPLE.COM/BILL 402-935-7733 CADate 02/05/21 0 1036909336 5 5735Card 1140,5.49
1/31/2021,,Withdrawal Debit Card Fee/VISA INTERNATIONAL SERVICE ASSESSMENTDate 01/29/21Card 1140,0.03,,Posted,462.23,2021-01-31,0.03,Withdrawal Debit Card Fee/VISA INTERNATIONAL SERVICE ASSESSMENTDate 02/18/21Card 1140,0.08
1/31/2021,,Withdrawal Debit Card Signature Debit/PAYPAL *NEXUSMODS 35314369001 GBDate 01/29/21 0 1029525776 4 5999Card 1140,4.28,,Posted,462.26,2021-01-31,4.28,Withdrawal Debit Card Signature Debit/PAYPAL *NEXUSMODS 35314369001 GBDate 01/29/21 0 1029525776 4 5999Card 1140,4.28
1/29/2021,,Withdrawal Debit Card Signature Debit/PP*APPLE.COM/BILL 402-935-7733 CADate 01/27/21 0 1027398929 4 5735Card 1140,2.99,,Posted,466.54,2021-01-29,2.99,Withdrawal Debit Card Signature Debit/PP*APPLE.COM/BILL 402-935-7733 CADate 02/05/21 0 1036909336 5 5735Card 1140,2.99
1/29/2021,,Withdrawal Debit Card Signature Debit/PAYPAL *CDKEYS.COM 402-935-7733 CADate 01/27/21 0 1027000963 4 5816Card 1140,32.99,,Posted,469.53,2021-01-29,32.99,Withdrawal Debit Card Signature Debit/PAYPAL *CDKEYS.COM 402-935-7733 CADate 01/27/21 0 1027000963 4 5816Card 1140,32.99
1/29/2021,,Withdrawal ACH PAYPAL/TYPE: INST XFER ID: PAYPALSI77CO: PAYPALEntry Class Code: WEB,5.47,,Posted,502.52,2021-01-29,5.47,Withdrawal ACH PAYPAL/TYPE: INST XFER ID: PAYPALSI77CO: PAYPALEntry Class Code: WEB,5.032
1/28/2021,,Withdrawal Debit Card Signature Debit/AMZN Mktp US*BX8429043 Amzn.com/bill WADate 01/27/21 0 1027477510 4 5942Card 1140,11.19,,Posted,507.99,2021-01-28,11.19,Withdrawal Debit Card Signature Debit/AMZN Mktp US*BX8429043 Amzn.com/bill WADate 01/27/21 0 1027477510 4 5942Card 1140,11.19
1/28/2021,,Recurring Withdrawal Debit Card - Signature Debit/HELP.HBOMAX.COM HTTPSHBOMAX.C NYDate 01/27/21 0 1027769244 4 5815Card 1140,17.23,,Posted,519.18,2021-01-28,17.23,Recurring Withdrawal Debit Card - Signature Debit/HELP.HBOMAX.COM HTTPSHBOMAX.C NYDate 01/27/21 0 1027769244 4 5815Card 1140,17.23
1/27/2021,,Withdrawal POS #000000037988/PUBLIX 3930 SW ARCHER ROA GAINESVILLE FLCard 1140,74.05,,Posted,536.41,2021-01-27,74.05,Withdrawal POS #000000059255/PUBLIX 3930 SW ARCHER ROA GAINESVILLE FLCard 1140,74.05
1/27/2021,,Withdrawal Debit Card Signature Debit/KLARNA *PAYMENTS 844-5527621 NYDate 01/25/21 0 1025084452 3 5999Card 1140,17.34,,Posted,2.7,2021-01-27,17.34,Withdrawal Debit Card Signature Debit/KLARNA *PAYMENTS 844-5527621 NYDate 02/08/21 0 1039629075 2 5999Card 1140,17.345
1/27/2021,,Withdrawal Debit Card Signature Debit/KLARNA *PAYMENTS 844-5527621 NYDate 01/25/21 0 1025053210 3 5999Card 1140,25.12,,Posted,20.04,2021-01-27,25.12,Withdrawal Debit Card Signature Debit/KLARNA *PAYMENTS 844-5527621 NYDate 02/08/21 0 1039629075 2 5999Card 1140,25.12
1/27/2021,,Withdrawal Debit Card Fee/VISA INTERNATIONAL SERVICE ASSESSMENTDate 01/26/21Card 1140,0.18,,Posted,45.16,2021-01-27,0.18,Withdrawal Debit Card Fee/VISA INTERNATIONAL SERVICE ASSESSMENTDate 02/18/21Card 1140,0.08
1/27/2021,,Withdrawal Debit Card Signature Debit/CDKEYS.COM CDK2156 NLDate 01/26/21 0 1026148347 0 5816Card 1140,22.99,,Posted,45.34,2021-01-27,22.99,Withdrawal Debit Card Signature Debit/CDKEYS.COM CDK2156 NLDate 01/26/21 0 1026148347 0 5816Card 1140,22.99
1/27/2021,,Withdrawal Debit Card Signature Debit/Kindle Unltd*F70ZQ4XE3 866-321-8851 WADate 01/26/21 0 1026566593 2 5818Card 1140,9.99,,Posted,68.33,2021-01-27,9.99,Withdrawal Debit Card Signature Debit/Kindle Unltd*F70ZQ4XE3 866-321-8851 WADate 01/26/21 0 1026566593 2 5818Card 1140,9.99
1/27/2021,,Withdrawal Debit Card Signature Debit/PARCHMENT-UNIV DOCS 480-719-1646 AZDate 01/26/21 0 1026065594 2 7372Card 1140,3.15,,Posted,78.32,2021-01-27,3.15,Withdrawal Debit Card Signature Debit/PARCHMENT-UNIV DOCS 480-719-1646 AZDate 01/26/21 0 1026065594 2 7372Card 1140,3.15
1/27/2021,,Withdrawal Debit Card Signature Debit/PARCHMENT-UNIV DOCS 480-719-1646 AZDate 01/26/21 0 1026065575 2 7372Card 1140,3.15,,Posted,81.47,2021-01-27,3.15,Withdrawal Debit Card Signature Debit/PARCHMENT-UNIV DOCS 480-719-1646 AZDate 01/26/21 0 1026065594 2 7372Card 1140,3.15
1/27/2021,,Withdrawal Debit Card Signature Debit/PAYPAL *JUSTANSWER 402-935-7733 CADate 01/25/21 0 1025892931 3 7311Card 1140,1.0,,Posted,84.62,2021-01-27,1.0,Withdrawal Debit Card Signature Debit/PAYPAL *PLAYSTATION 402-935-7733 CADate 01/02/21 0 1002296098 3 7994Card 1140,1.0
1/27/2021,,Withdrawal Debit Card Signature Debit/PAYPAL *GEARBEST 402-935-7733 CADate 01/25/21 0 1025892930 3 5331Card 1140,257.76,,Posted,85.62,2021-01-27,257.76,Withdrawal Debit Card Signature Debit/PAYPAL *PLAYSTATION 402-935-7733 CADate 01/02/21 0 1002296098 3 7994Card 1140,257.76
1/27/2021,,Withdrawal Transfer fee,8.0,,Posted,343.38,2021-01-27,8.0,Withdrawal Transfer fee,8.0
1/27/2021,,Withdrawal Debit Card Signature Debit/CU DENVER ONLINE 303-315-1800 CODate 01/26/21 0 1026820220 2 8220Card 1140,50.0,,Posted,51.38,2021-01-27,50.0,Withdrawal Debit Card Signature Debit/CU DENVER ONLINE 303-315-1800 CODate 01/26/21 0 1026820220 2 8220Card 1140,50.0
1/27/2021,,Withdrawal Transfer fee,8.0,,Posted,101.38,2021-01-27,8.0,Withdrawal Transfer fee,8.0
1/27/2021,,Recurring Withdrawal Debit Card - Signature Debit/SoundCloud Inc 347-9866607 CADate 01/27/21 0 1027695366 0 4899Card 1140,4.99,,Posted,9.38,2021-01-27,4.99,Recurring Withdrawal Debit Card - Signature Debit/SoundCloud Inc 347-9866607 CADate 01/27/21 0 1027695366 0 4899Card 1140,4.99
1/27/2021,,Withdrawal ACH COX COMM GAN/TYPE: BANK DRAFT ID: 1581620085CO: COX COMM GANEntry Class Code: WEB,127.52,,Posted,14.37,2021-01-27,127.52,Withdrawal ACH COX COMM GAN/TYPE: BANK DRAFT ID: 1581620085CO: COX COMM GANEntry Class Code: WEB,127.34
1/27/2021,,Withdrawal ACH GEARBEST/CO: GEARBESTTYPE: IAT PAYPAL ID: 770510487CEntry Class Code: IAT,207.41,,Posted,141.89,2021-01-27,207.41,Withdrawal ACH ENVATO/CO: ENVATOTYPE: IAT PAYPAL ID: 770510487CEntry Class Code: IAT,207.41
1/27/2021,,Withdrawal POS #000000705676/AMAZON.COM*4J55D8I53 SEATTLE WACard 1140,42.62,,Posted,349.3,2021-01-27,42.62,Withdrawal POS #000000705676/AMAZON.COM*4J55D8I53 SEATTLE WACard 1140,42.62
1/27/2021,,Withdrawal ACH PAYMENT FOR AMZ/TYPE: STORECARD ID: 9069872103CO: PAYMENT FOR AMZEntry Class Code: WEB,211.68,,Posted,391.92,2021-01-27,211.68,Withdrawal ACH PAYMENT FOR AMZ/TYPE: STORECARD ID: 9069872103 CO: PAYMENT FOR AMZ Entry Class Code: WEB,211.68
1/27/2021,,Withdrawal ACH PAYPAL/TYPE: INST XFER ID: PAYPALSI77CO: PAYPALEntry Class Code: WEB,8.03,,Posted,603.6,2021-01-27,8.03,Withdrawal ACH PAYPAL/TYPE: INST XFER ID: PAYPALSI77CO: PAYPALEntry Class Code: WEB,8.03
1/27/2021,,Withdrawal ACH PAYPAL/TYPE: INST XFER ID: PAYPALSI77CO: PAYPALEntry Class Code: WEB,5.24,,Posted,611.63,2021-01-27,5.24,Withdrawal ACH PAYPAL/TYPE: INST XFER ID: PAYPALSI77CO: PAYPALEntry Class Code: WEB,5.032
1/26/2021,,Withdrawal POS #000000804619/Microsoft 1 Microsoft Way Redmond WACard 1140,2.99,,Posted,616.87,2021-01-26,2.99,Withdrawal POS #000000784817/Microsoft 1 Microsoft Way Redmond WACard 1140,2.99
1/26/2021,,Withdrawal Debit Card Signature Debit/PLAYSTATION NETWORK 800-345-7669 CADate 01/25/21 0 1025060429 2 5816Card 1140,39.99,,Posted,619.86,2021-01-26,39.99,Withdrawal Debit Card Signature Debit/PLAYSTATION NETWORK 800-345-7669 CADate 02/13/21 0 1044014505 4 5816Card 1140,39.99
1/26/2021,,Withdrawal Debit Card Signature Debit/PP*APPLE.COM/BILL 402-935-7733 CADate 01/24/21 0 1024118718 4 5735Card 1140,4.99,,Posted,659.85,2021-01-26,4.99,Withdrawal Debit Card Signature Debit/PP*APPLE.COM/BILL 402-935-7733 CADate 02/05/21 0 1036909336 5 5735Card 1140,5.49
1/26/2021,,Withdrawal Debit Card Signature Debit/PIZZA HUT 27918 GAINESVILLE FLDate 01/24/21 0 1024669920 4 5812Card 1140,12.13,,Posted,664.84,2021-01-26,12.13,Withdrawal Debit Card Signature Debit/PIZZA HUT 27918 GAINESVILLE FLDate 01/24/21 0 1024669920 4 5812Card 1140,12.13
1/26/2021,,Withdrawal Debit Card Signature Debit/BESTBUYCOM806417860706 RICHFIELD MNDate 01/25/21 0 1025000124 0 5732Card 1140,103.77,,Posted,676.97,2021-01-26,103.77,Withdrawal Debit Card Signature Debit/BESTBUYCOM806417860706 RICHFIELD MNDate 01/25/21 0 1025000124 0 5732Card 1140,103.77
1/26/2021,,Withdrawal Debit Card Signature Debit/CANNAMD 855-4209170 FLDate 01/25/21 0 1025978219 1 8011Card 1140,195.0,,Posted,780.74,2021-01-26,195.0,Withdrawal Debit Card Signature Debit/CANNAMD 855-4209170 FLDate 01/25/21 0 1025978219 1 8011Card 1140,195.0
1/26/2021,,Withdrawal ACH BARCLAYCARD US/TYPE: CREDITCARD ID: 2510407970CO: BARCLAYCARD USEntry Class Code: WEB,97.51,,Posted,975.74,2021-01-26,97.51,Withdrawal ACH BARCLAYCARD US/TYPE: CREDITCARD ID: 2510407970 CO: BARCLAYCARD US Entry Class Code: WEB,97.51
1/26/2021,,Withdrawal ACH CAPITAL ONE/TYPE: MOBILE PMT ID: 9279744980CO: CAPITAL ONEEntry Class Code: WEB,65.0,,Posted,1073.25,2021-01-26,65.0,Withdrawal ACH CAPITAL ONE/TYPE: MOBILE PMT ID: 9279744980CO: CAPITAL ONEEntry Class Code: WEB,65.0
1/26/2021,,Withdrawal ACH BEST BUY/TYPE: PAYMENT ID: CITIGPUFDRCO: BEST BUYEntry Class Code: PPD,55.0,,Posted,1138.25,2021-01-26,55.0,Withdrawal ACH BEST BUY/TYPE: PAYMENT ID: CITIGPUFDRCO: BEST BUYEntry Class Code: TEL,54.5
1/26/2021,,Withdrawal ACH APPLECARD GSBANK/TYPE: PAYMENT ID: 9999999999CO: APPLECARD GSBANKEntry Class Code: WEB,48.41,,Posted,1193.25,2021-01-26,48.41,Withdrawal ACH APPLECARD GSBANK/TYPE: PAYMENT ID: 9999999999 CO: APPLECARD GSBANK Entry Class Code: WEB,48.77
1/26/2021,,Withdrawal ACH OMNYEX ECOMMERCE/CO: OMNYEX ECOMMERCE DMCCTYPE: IAT PAYPAL ID: 770510487CEntry Class Code: IAT,49.67,,Posted,1241.66,2021-01-26,49.67,Withdrawal ACH OMNYEX ECOMMERCE/CO: OMNYEX ECOMMERCE DMCCTYPE: IAT PAYPAL ID: 770510487CEntry Class Code: IAT,49.67
1/26/2021,,Withdrawal ACH PAYPAL/TYPE: INST XFER ID: PAYPALSI77CO: PAYPALEntry Class Code: WEB,69.98,,Posted,1291.33,2021-01-26,69.98,Withdrawal ACH PAYPAL/TYPE: INST XFER ID: PAYPALSI77CO: PAYPALEntry Class Code: WEB,69.98
1/26/2021,,Withdrawal ACH DISCOVER/TYPE: E-PAYMENT ID: 2510020270CO: DISCOVEREntry Class Code: WEB,55.0,,Posted,1361.31,2021-01-26,55.0,Withdrawal ACH DISCOVER/TYPE: E-PAYMENT ID: 2510020270CO: DISCOVEREntry Class Code: WEB,55.0
1/26/2021,,Withdrawal ACH WAWA CREDIT CARD/TYPE: ONLINE PMT ID: CITICTPCO: WAWA CREDIT CARDEntry Class Code: WEB,45.0,,Posted,1416.31,2021-01-26,45.0,Withdrawal ACH WAWA CREDIT CARD/TYPE: PAYMENT ID: CITIGPUFDRCO: WAWA CREDIT CARDEntry Class Code: PPD,45.0
1/26/2021,,Withdrawal ACH PAYPAL/TYPE: INST XFER ID: PAYPALSI77CO: PAYPALEntry Class Code: WEB,10.66,,Posted,1461.31,2021-01-26,10.66,Withdrawal ACH PAYPAL/TYPE: INST XFER ID: PAYPALSI77CO: PAYPALEntry Class Code: WEB,10.88
1/25/2021,,Withdrawal at ATM #000000000882/CAMPUS 1900 SW 34TH ST GAINESVILLE FLCard 1140,120.0,,Posted,1471.97,2021-01-25,120.0,Withdrawal at ATM #000000008812/CAMPUS 1900 SW 34TH ST GAINESVILLE FLCard 1140,120.0
1/25/2021,,Withdrawal Debit Card Signature Debit/PRIVATEINTERNETACCESS WWW.PRIVATEIN CODate 01/24/21 0 1024716002 0 5734Card 1140,9.95,,Posted,91.97,2021-01-25,9.95,Withdrawal Debit Card Signature Debit/PRIVATEINTERNETACCESS WWW.PRIVATEIN CODate 01/24/21 0 1024716002 0 5734Card 1140,9.95
1/24/2021,,Withdrawal POS #000000060308/PUBLIX 3930 SW ARCHER ROA GAINESVILLE FLCard 1140,33.72,,Posted,101.92,2021-01-24,33.72,Withdrawal POS #000000116993/PUBLIX 3930 SW ARCHER ROA GAINESVILLE FLCard 1140,33.923333333333325
1/21/2021,,Recurring Withdrawal Debit Card - Signature Debit/DisneyPLUS 888-9057888 CADate 01/20/21 0 1020042692 3 5815Card 1140,8.03,,Posted,135.64,2021-01-21,8.03,Recurring Withdrawal Debit Card - Signature Debit/DisneyPLUS 888-9057888 CADate 01/20/21 0 1020042692 3 5815Card 1140,8.03
1/21/2021,,Withdrawal Debit Card Signature Debit/PIZZA HUT 27918 https://ipcha FLDate 01/20/21 0 1020658789 3 5812Card 1140,28.18,,Posted,143.67,2021-01-21,28.18,Withdrawal Debit Card Signature Debit/PIZZA HUT 27918 https://ipcha FLDate 01/20/21 0 1020658789 3 5812Card 1140,28.18
1/21/2021,,Withdrawal Debit Card Signature Debit/VALENCIA COL TUITION 407-582-1200 FLDate 01/20/21 0 1020526264 1 8220Card 1140,3.0,,Posted,171.85,2021-01-21,3.0,Withdrawal Debit Card Signature Debit/VALENCIA COL TUITION 407-582-1200 FLDate 02/03/21 0 1034400793 1 8220Card 1140,3.0
1/21/2021,,Withdrawal Debit Card Fee/VISA INTERNATIONAL SERVICE ASSESSMENTDate 01/19/21Card 1140,0.02,,Posted,174.85,2021-01-21,0.02,Withdrawal Debit Card Fee/VISA INTERNATIONAL SERVICE ASSESSMENTDate 02/18/21Card 1140,0.08
1/21/2021,,Withdrawal Debit Card Signature Debit/PAYPAL *CHARIZ 4029357733 AUDate 01/19/21 0 1019815671 3 5734Card 1140,1.99,,Posted,174.87,2021-01-21,1.99,Withdrawal Debit Card Signature Debit/PAYPAL *COCOATECH 402-935-7733 CADate 02/17/21 0 1048441651 0 5734Card 1140,1.99
1/20/2021,,Withdrawal POS #000000055460/PUBLIX 125 SW 34TH ST GAINESVILLE FLCard 1140,29.37,,Posted,77.86,2021-01-20,29.37,Withdrawal POS #000000080373/PUBLIX 5200 S W 34TH STRE GAINESVILLE FLCard 1140,29.78333333333333
1/20/2021,,Withdrawal at ATM #000000005364/CAMPUS 5725 SW 75TH ST GAINESVILLE FLCard 1140,120.0,,Posted,107.23,2021-01-20,120.0,Withdrawal at ATM #000000005364/CAMPUS 5725 SW 75TH ST GAINESVILLE FLCard 1140,120.0
1/19/2021,,Withdrawal POS #000000848961/SHELL SERVICE STATION GAINESVILLE FLCard 1140,13.47,,Posted,54.23,2021-01-19,13.47,Withdrawal POS #000000848961/SHELL SERVICE STATION GAINESVILLE FLCard 1140,13.47
1/19/2021,,Withdrawal ACH PAYPAL/TYPE: INST XFER ID: PAYPALSI77CO: PAYPALEntry Class Code: WEB,78.21,,Posted,67.7,2021-01-19,78.21,Withdrawal ACH PAYPAL/TYPE: INST XFER ID: PAYPALSI77CO: PAYPALEntry Class Code: WEB,78.1
1/19/2021,,Withdrawal ACH TARGET DEBIT CRD/Location - TARGET -0687GAINESVILLE FL / Terminal ID: 173TYPE: ACH TRAN ID: 1410215170CO: TARGET DEBIT CRDEntry Class C,30.68,,Posted,145.91,2021-01-19,30.68,Withdrawal ACH TARGET DEBIT CRD/Location - TARGET -0687GAINESVILLE FL / Terminal ID: 071TYPE: ACH TRAN ID: 1410215170CO: TARGET DEBIT CRD,30.68
1/19/2021,,Withdrawal ACH PAYPAL/TYPE: INST XFER ID: PAYPALSI77CO: PAYPALEntry Class Code: WEB,14.99,,Posted,176.59,2021-01-19,14.99,Withdrawal ACH PAYPAL/TYPE: INST XFER ID: PAYPALSI77CO: PAYPALEntry Class Code: WEB,14.646666666666667
1/17/2021,,Withdrawal Debit Card Signature Debit/PAYPAL *ETSY 402-935-7733 NYDate 01/15/21 0 1015973311 7 5970Card 1140,35.99,,Posted,191.58,2021-01-17,35.99,Withdrawal Debit Card Signature Debit/PAYPAL *ETSY 402-935-7733 NYDate 01/15/21 0 1015973311 7 5970Card 1140,35.99
1/16/2021,,Withdrawal POS #000000076634/PUBLIX 3930 SW ARCHER ROA GAINESVILLE FLCard 1140,76.4,,Posted,227.57,2021-01-16,76.4,Withdrawal POS #000000116993/PUBLIX 3930 SW ARCHER ROA GAINESVILLE FLCard 1140,76.4
1/15/2021,231.0,Draft 231,850.0,,Posted,303.97,2021-01-15,850.0,Draft 237,850.0
1/15/2021,,Withdrawal Debit Card Signature Debit/PLAYSTATION NETWORK 800-345-7669 CADate 01/14/21 0 1014956750 4 5816Card 1140,39.99,,Posted,1153.97,2021-01-15,39.99,Withdrawal Debit Card Signature Debit/PLAYSTATION NETWORK 800-345-7669 CADate 02/13/21 0 1044014505 4 5816Card 1140,39.99
1/15/2021,,Withdrawal Debit Card Signature Debit/AMZN Mktp US*445QJ1OQ3 Amzn.com/bill WADate 01/14/21 0 1014794191 2 5942Card 1140,3.24,,Posted,1193.96,2021-01-15,3.24,Withdrawal Debit Card Signature Debit/AMZN Mktp US*BX8429043 Amzn.com/bill WADate 01/27/21 0 1027477510 4 5942Card 1140,3.24
1/15/2021,,Withdrawal Debit Card Signature Debit/COUNTRY CRITTERS - 3 GAINESVILLE FLDate 01/13/21 0 1013755966 4 0742Card 1140,284.94,,Posted,1197.2,2021-01-15,284.94,Withdrawal Debit Card Signature Debit/COUNTRY CRITTERS - 3 GAINESVILLE FLDate 01/13/21 0 1013755966 4 0742Card 1140,284.94
1/14/2021,,Withdrawal POS #000000785293/GATE 1445 GAINESVILLE FLCard 1140,15.53,,Posted,1069.14,2021-01-14,15.53,Withdrawal POS #000000737724/GATE 1445 GAINESVILLE FLCard 1140,15.53
1/14/2021,,Withdrawal at ATM #000000000023/CAMPUS 1900 SW 34TH ST GAINESVILLE FLCard 1140,160.0,,Posted,1084.67,2021-01-14,160.0,Withdrawal at ATM #000000008812/CAMPUS 1900 SW 34TH ST GAINESVILLE FLCard 1140,160.0
1/14/2021,,Withdrawal Debit Card Signature Debit/COUNTRY CRITTERS - 4 OCALA FLDate 01/12/21 0 1012710902 4 0742Card 1140,30.0,,Posted,1244.67,2021-01-14,30.0,Withdrawal Debit Card Signature Debit/COUNTRY CRITTERS - 4 OCALA FLDate 11/04/20 0 0309046964 5 0742Card 1140,30.0
1/14/2021,,Withdrawal ACH VERIZON WIRELESS/TYPE: PAYMENTS ID: 1223344794CO: VERIZON WIRELESSEntry Class Code: PPD,117.38,,Posted,1274.67,2021-01-14,117.38,Withdrawal ACH VERIZON WIRELESS/TYPE: PAYMENTS ID: 1223344794CO: VERIZON WIRELESSEntry Class Code: PPD,117.38
1/13/2021,,Withdrawal POS #000000034006/PUBLIX 3930 SW ARCHER ROA GAINESVILLE FLCard 1140,6.87,,Posted,1392.05,2021-01-13,6.87,Withdrawal POS #000000077534/PUBLIX 3930 SW ARCHER ROA GAINESVILLE FLCard 1140,6.87
1/13/2021,,Withdrawal POS #000000882351/CIRCLE K # 06782 GAINESVILLE FLCard 1140,18.77,,Posted,1398.92,2021-01-13,18.77,Withdrawal POS #000000882351/CIRCLE K # 06782 GAINESVILLE FLCard 1140,19.08
1/13/2021,,Withdrawal POS #000000146905/WALGREENS STORE 2415 SW 7 GAINESVILLE FLCard 1140,18.17,,Posted,1417.69,2021-01-13,18.17,Withdrawal POS #000000218861/WALGREENS STORE 2415 SW 7 GAINESVILLE FL Card 1140,18.6
1/13/2021,,Withdrawal POS #000000037324/WALGREENS STORE 2415 SW 7 GAINESVILLE FLCard 1140,2.13,,Posted,1435.86,2021-01-13,2.13,Withdrawal POS #000000305411/WALGREENS STORE 3455 SW A GAINESVILLE FLCard 1140,2.13
1/12/2021,,Withdrawal POS #000000075022/PUBLIX 3930 SW ARCHER ROA GAINESVILLE FLCard 1140,38.68,,Posted,1437.99,2021-01-12,38.68,Withdrawal POS #000000059255/PUBLIX 3930 SW ARCHER ROA GAINESVILLE FLCard 1140,38.68
1/11/2021,,Withdrawal POS #000000060900/WALGREENS STORE 2415 SW 7 GAINESVILLE FLCard 1140,6.41,,Posted,1476.67,2021-01-11,6.41,Withdrawal POS #000000305411/WALGREENS STORE 3455 SW A GAINESVILLE FLCard 1140,6.41
1/11/2021,,Withdrawal POS #000000597575/GATE 1445 GAINESVILLE FLCard 1140,11.4,,Posted,1483.08,2021-01-11,11.4,Withdrawal POS #000000737724/GATE 1445 GAINESVILLE FLCard 1140,11.4
1/11/2021,,Withdrawal/Cash Disbursed 40.00,40.0,,Posted,1494.48,2021-01-11,40.0,Withdrawal/Cash Disbursed 35.00,40.0
1/11/2021,,Withdrawal ACH PAYMENT FOR AMZ/TYPE: STORECARD ID: 9069872103CO: PAYMENT FOR AMZEntry Class Code: WEB,25.0,,Posted,1534.48,2021-01-11,25.0,Withdrawal ACH PAYMENT FOR AMZ/TYPE: STORECARD ID: 9069872103 CO: PAYMENT FOR AMZ Entry Class Code: WEB,25.0
1/10/2021,,Withdrawal POS #000000432658/WALGREENS STORE 2415 SW 7 GAINESVILLE FLCard 1140,33.26,,Posted,1559.48,2021-01-10,33.26,Withdrawal POS #000000218861/WALGREENS STORE 2415 SW 7 GAINESVILLE FL Card 1140,33.26
1/10/2021,,Withdrawal at ATM #000000009730/CAMPUS 1900 SW 34TH ST GAINESVILLE FLCard 1140,60.0,,Posted,1592.74,2021-01-10,60.0,Withdrawal at ATM #000000001619/CAMPUS 1900 SW 34TH ST GAINESVILLE FL Card 1140,60.0
1/10/2021,,Withdrawal Debit Card Signature Debit/PP*APPLE.COM/BILL 402-935-7733 CADate 01/08/21 0 1008510062 7 5735Card 1140,2.99,,Posted,1652.74,2021-01-10,2.99,Withdrawal Debit Card Signature Debit/PP*APPLE.COM/BILL 402-935-7733 CADate 02/05/21 0 1036909336 5 5735Card 1140,2.99
1/8/2021,,Withdrawal POS #000000072582/PUBLIX 3930 SW ARCHER ROA GAINESVILLE FLCard 1140,32.05,,Posted,1655.73,2021-01-08,32.05,Withdrawal POS #000000059255/PUBLIX 3930 SW ARCHER ROA GAINESVILLE FLCard 1140,32.05
1/8/2021,,Withdrawal at ATM #000000004249/CAMPUS 1900 SW 34TH ST GAINESVILLE FLCard 1140,100.0,,Posted,1687.78,2021-01-08,100.0,Withdrawal at ATM #000000001619/CAMPUS 1900 SW 34TH ST GAINESVILLE FL Card 1140,100.0
1/7/2021,,Withdrawal POS #000000859266/CIRCLE K # 26146 GAINESVILLE FLCard 1140,19.18,,Posted,1187.78,2021-01-07,19.18,Withdrawal POS #000000991864/CIRCLE K # 21142 GAINESVILLE FL Card 1140,19.643333333333334
1/7/2021,,Withdrawal at ATM #000000009454/CAMPUS 1900 SW 34TH ST GAINESVILLE FLCard 1140,40.0,,Posted,1206.96,2021-01-07,40.0,Withdrawal at ATM #000000001619/CAMPUS 1900 SW 34TH ST GAINESVILLE FL Card 1140,40.0
1/7/2021,,Withdrawal POS #000000114747/WALGREENS STORE 2415 SW 7 GAINESVILLE FLCard 1140,5.12,,Posted,1246.96,2021-01-07,5.12,Withdrawal POS #000000218861/WALGREENS STORE 2415 SW 7 GAINESVILLE FL Card 1140,4.8500000000000005
1/5/2021,,Withdrawal Debit Card Signature Debit/PIZZA HUT 27918 https://ipcha FLDate 01/03/21 0 1003886326 4 5812Card 1140,35.53,,Posted,1252.08,2021-01-05,35.53,Withdrawal Debit Card Signature Debit/PIZZA HUT 27918 https://ipcha FLDate 01/20/21 0 1020658789 3 5812Card 1140,35.53
1/5/2021,,Withdrawal ACH BEST BUY/TYPE: PAYMENT ID: CITIGPUFDRCO: BEST BUYEntry Class Code: PPD,44.96,,Posted,1287.61,2021-01-05,44.96,Withdrawal ACH BEST BUY/TYPE: PAYMENT ID: CITIGPUFDRCO: BEST BUYEntry Class Code: TEL,44.980000000000004
1/4/2021,,Withdrawal ACH CITY OF GAINESVI/TYPE: 2000-6637- ID: 5330903620CO: CITY OF GAINESVIEntry Class Code: WEB,188.56,,Posted,1332.57,2021-01-04,188.56,Withdrawal ACH CITY OF GAINESVI/TYPE: 2000-6637- ID: 5330903620CO: CITY OF GAINESVIEntry Class Code: WEB,188.125
1/4/2021,,Withdrawal ACH COX COMM GAN/TYPE: BANK DRAFT ID: 1581620085CO: COX COMM GANEntry Class Code: WEB,127.52,,Posted,1521.13,2021-01-04,127.52,Withdrawal ACH COX COMM GAN/TYPE: BANK DRAFT ID: 1581620085CO: COX COMM GANEntry Class Code: WEB,127.34
1/4/2021,,Withdrawal ACH CAPITAL ONE/TYPE: MOBILE PMT ID: 9279744980CO: CAPITAL ONEEntry Class Code: WEB,25.0,,Posted,1648.65,2021-01-04,25.0,Withdrawal ACH CAPITAL ONE/TYPE: MOBILE PMT ID: 9279744980CO: CAPITAL ONEEntry Class Code: WEB,25.0
1/4/2021,,Withdrawal ACH BARCLAYCARD US/TYPE: CREDITCARD ID: 2510407970CO: BARCLAYCARD USEntry Class Code: WEB,25.0,,Posted,1673.65,2021-01-04,25.0,Withdrawal ACH BARCLAYCARD US/TYPE: CREDITCARD ID: 2510407970 CO: BARCLAYCARD US Entry Class Code: WEB,25.0
1/4/2021,,Withdrawal ACH LAST.FM LTD./CO: LAST.FM LTD.TYPE: IAT PAYPAL ID: 770510487CEntry Class Code: IAT,3.0,,Posted,1698.65,2021-01-04,3.0,Withdrawal ACH LAST.FM LTD/CO: LAST.FM LTDTYPE: IAT PAYPAL ID: 770510487CEntry Class Code: IAT,3.0
1/4/2021,,Withdrawal Debit Card Signature Debit/PP*APPLE.COM/BILL 402-935-7733 CADate 01/02/21 0 1002730349 4 5735Card 1140,2.99,,Posted,1701.65,2021-01-04,2.99,Withdrawal Debit Card Signature Debit/PP*APPLE.COM/BILL 402-935-7733 CADate 02/05/21 0 1036909336 5 5735Card 1140,2.99
1/4/2021,,Withdrawal Debit Card Signature Debit/PAYPAL *PLAYSTATION 402-935-7733 CADate 01/02/21 0 1002730348 4 7994Card 1140,27.99,,Posted,1704.64,2021-01-04,27.99,Withdrawal Debit Card Signature Debit/PAYPAL *PLAYSTATION 402-935-7733 CADate 01/02/21 0 1002296098 3 7994Card 1140,27.99
1/4/2021,,Withdrawal ACH DISCOVER/TYPE: E-PAYMENT ID: 2510020270CO: DISCOVEREntry Class Code: WEB,58.0,,Posted,1732.63,2021-01-04,58.0,Withdrawal ACH DISCOVER/TYPE: E-PAYMENT ID: 2510020270CO: DISCOVEREntry Class Code: WEB,57.5
1/4/2021,,Withdrawal ACH PAYMENT FOR AMZ/TYPE: STORECARD ID: 9069872103CO: PAYMENT FOR AMZEntry Class Code: WEB,25.0,,Posted,1790.63,2021-01-04,25.0,Withdrawal ACH PAYMENT FOR AMZ/TYPE: STORECARD ID: 9069872103 CO: PAYMENT FOR AMZ Entry Class Code: WEB,25.0
1/4/2021,,Withdrawal ACH WAWA CREDIT CARD/TYPE: ONLINE PMT ID: CITICTPCO: WAWA CREDIT CARDEntry Class Code: WEB,25.0,,Posted,1815.63,2021-01-04,25.0,Withdrawal ACH WAWA CREDIT CARD/TYPE: PAYMENT ID: CITIGPUFDRCO: WAWA CREDIT CARDEntry Class Code: PPD,25.0
1/3/2021,,Withdrawal Debit Card Signature Debit/AMZN Digital*Z91A589A3 888-802-3080 WADate 01/02/21 0 1002482689 3 5818Card 1140,50.0,,Posted,1840.63,2021-01-03,50.0,Withdrawal Debit Card Signature Debit/AMZN Digital*Z91A589A3 888-802-3080 WADate 01/02/21 0 1002482689 3 5818Card 1140,50.0
1/3/2021,,Withdrawal Debit Card Signature Debit/PAYPAL *PLAYSTATION 402-935-7733 CADate 01/02/21 0 1002296098 3 7994Card 1140,5.83,,Posted,1890.63,2021-01-03,5.83,Withdrawal Debit Card Signature Debit/PAYPAL *PLAYSTATION 402-935-7733 CADate 01/02/21 0 1002296098 3 7994Card 1140,5.4
1/3/2021,,Withdrawal Debit Card Signature Debit/PAYPAL *DAMIENGEMIN 402-935-7733 CADate 01/02/21 0 1002416949 2 7333Card 1140,3.49,,Posted,1896.46,2021-01-03,3.49,Withdrawal Debit Card Signature Debit/PAYPAL *PLAYSTATION 402-935-7733 CADate 01/02/21 0 1002296098 3 7994Card 1140,3.49
1/2/2021,,Withdrawal Bill Payment #000015518667/Dave Inc 1265 South Cochran Los AngelesCard 1140,1.0,,Posted,1899.95,2021-01-02,1.0,Withdrawal Bill Payment #000015518667/Dave Inc 1265 South Cochran Los AngelesCard 1140,1.0
1/2/2021,,Withdrawal POS #000000092202/PUBLIX 3930 SW ARCHER ROA GAINESVILLE FLCard 1140,58.09,,Posted,1900.95,2021-01-02,58.09,Withdrawal POS #000000059255/PUBLIX 3930 SW ARCHER ROA GAINESVILLE FLCard 1140,58.09
1/2/2021,,Withdrawal POS #000000067357/WAWA 5325 2373 SW ARCHER ROA GAINESVILLEFLCard 1140,13.01,,Posted,1959.04,2021-01-02,13.01,Withdrawal POS #000000806824/WAWA 5325 2373 SW ARCHER ROA GAINESVILLE FL Card 1140,13.01
1/2/2021,,Withdrawal at ATM #000000008957/CAMPUS 1900 SW 34TH ST GAINESVILLE FLCard 1140,100.0,,Posted,1972.05,2021-01-02,100.0,Withdrawal at ATM #000000001619/CAMPUS 1900 SW 34TH ST GAINESVILLE FL Card 1140,100.0
1/2/2021,,Withdrawal Home Banking Transfer - To Share 0000/Funds Transfer via Online,10.0,,Posted,2072.05,2021-01-02,10.0,Withdrawal Home Banking Transfer - To Share 0000/Funds Transfer via Online,10.0
12/30/2020,,Withdrawal Debit Card Signature Debit/Amazon Prime*TX05X6Z43 Amzn.com/bill WADate 12/29/20 0 0364465851 2 5968Card 1140,13.11,,Posted,2072.06,2020-12-30,13.11,Withdrawal Debit Card Signature Debit/Amazon Prime*TX05X6Z43 Amzn.com/bill WADate 12/29/20 0 0364465851 2 5968Card 1140,13.11
12/29/2020,,Withdrawal Debit Card Signature Debit/PP*APPLE.COM/BILL 402-935-7733 CADate 12/28/20 0 0363032762 3 5735Card 1140,2.99,,Posted,85.17,2020-12-29,2.99,Withdrawal Debit Card Signature Debit/PP*APPLE.COM/BILL 402-935-7733 CADate 02/05/21 0 1036909336 5 5735Card 1140,2.99
12/29/2020,,Withdrawal Debit Card Signature Debit/PP*APPLE.COM/BILL 402-935-7733 CADate 12/28/20 0 0363706923 0 5735Card 1140,9.99,,Posted,88.16,2020-12-29,9.99,Withdrawal Debit Card Signature Debit/PP*APPLE.COM/BILL 402-935-7733 CADate 02/05/21 0 1036909336 5 5735Card 1140,9.99
12/29/2020,,Withdrawal ACH BARCLAYCARD US/TYPE: CREDITCARD ID: 2510407970CO: BARCLAYCARD USEntry Class Code: WEB,20.0,,Posted,98.15,2020-12-29,20.0,Withdrawal ACH BARCLAYCARD US/TYPE: CREDITCARD ID: 2510407970 CO: BARCLAYCARD US Entry Class Code: WEB,20.0
12/29/2020,,Withdrawal ACH NOSSKIRNEH/CO: NOSSKIRNEHTYPE: IAT PAYPAL ID: 770510487CEntry Class Code: IAT,2.75,,Posted,118.15,2020-12-29,2.75,Withdrawal ACH NOSSKIRNEH/CO: NOSSKIRNEHTYPE: IAT PAYPAL ID: 770510487CEntry Class Code: IAT,2.75
12/29/2020,,Withdrawal ACH PAYPAL/TYPE: INST XFER ID: PAYPALSI77CO: PAYPALEntry Class Code: WEB,5.47,,Posted,120.9,2020-12-29,5.47,Withdrawal ACH PAYPAL/TYPE: INST XFER ID: PAYPALSI77CO: PAYPALEntry Class Code: WEB,5.032
12/28/2020,,Withdrawal ACH APPLECARD GSBANK/TYPE: PAYMENT ID: 9999999999CO: APPLECARD GSBANKEntry Class Code: WEB,46.93,,Posted,126.37,2020-12-28,46.93,Withdrawal ACH APPLECARD GSBANK/TYPE: PAYMENT ID: 9999999999 CO: APPLECARD GSBANK Entry Class Code: WEB,46.93
12/28/2020,,Withdrawal ACH BARCLAYCARD US/TYPE: CREDITCARD ID: 2510407970CO: BARCLAYCARD USEntry Class Code: WEB,30.0,,Posted,173.3,2020-12-28,30.0,Withdrawal ACH BARCLAYCARD US/TYPE: CREDITCARD ID: 2510407970 CO: BARCLAYCARD US Entry Class Code: WEB,30.0
12/28/2020,,Withdrawal ACH CAPITAL ONE/TYPE: MOBILE PMT ID: 9279744980CO: CAPITAL ONEEntry Class Code: WEB,30.0,,Posted,203.3,2020-12-28,30.0,Withdrawal ACH CAPITAL ONE/TYPE: MOBILE PMT ID: 9279744980CO: CAPITAL ONEEntry Class Code: WEB,30.0
12/28/2020,,Withdrawal ACH DISCOVER/TYPE: E-PAYMENT ID: 2510020270CO: DISCOVEREntry Class Code: WEB,25.0,,Posted,233.3,2020-12-28,25.0,Withdrawal ACH DISCOVER/TYPE: E-PAYMENT ID: 2510020270CO: DISCOVEREntry Class Code: WEB,25.5
12/28/2020,,Withdrawal ACH TIGI SOFTWARE/CO: TIGI SOFTWARETYPE: IAT PAYPAL ID: 770510487CEntry Class Code: IAT,5.99,,Posted,258.3,2020-12-28,5.99,Withdrawal ACH TIGI SOFTWARE/CO: TIGI SOFTWARETYPE: IAT PAYPAL ID: 770510487CEntry Class Code: IAT,5.99
12/28/2020,,Withdrawal ACH PAYPAL/TYPE: INST XFER ID: PAYPALSI77CO: PAYPALEntry Class Code: WEB,8.03,,Posted,264.29,2020-12-28,8.03,Withdrawal ACH PAYPAL/TYPE: INST XFER ID: PAYPALSI77CO: PAYPALEntry Class Code: WEB,8.03
12/28/2020,,Withdrawal ACH PAYPAL/TYPE: INST XFER ID: PAYPALSI77CO: PAYPALEntry Class Code: WEB,5.24,,Posted,272.32,2020-12-28,5.24,Withdrawal ACH PAYPAL/TYPE: INST XFER ID: PAYPALSI77CO: PAYPALEntry Class Code: WEB,5.032
12/27/2020,,Withdrawal Debit Card Signature Debit/Kindle Unltd*J96LZ7343 866-321-8851 WADate 12/26/20 0 0361073141 2 5818Card 1140,9.99,,Posted,277.56,2020-12-27,9.99,Withdrawal Debit Card Signature Debit/Kindle Unltd*J96LZ7343 866-321-8851 WADate 12/26/20 0 0361073141 2 5818Card 1140,9.99
12/27/2020,,Recurring Withdrawal Debit Card - Signature Debit/HELP.HBOMAX.COM HTTPSHBOMAX.C NYDate 12/27/20 0 0362847245 0 5815Card 1140,17.23,,Posted,287.55,2020-12-27,17.23,Recurring Withdrawal Debit Card - Signature Debit/HELP.HBOMAX.COM HTTPSHBOMAX.C NYDate 01/27/21 0 1027769244 4 5815Card 1140,17.23
12/26/2020,,Withdrawal POS #000018946300/WAWA 5325 2373 SW ARCHER ROA GAINESVILLEFLCard 1140,8.32,,Posted,304.78,2020-12-26,8.32,Withdrawal POS #000000188596/WAWA 5325 2373 SW ARCHER ROA GAINESVILLEFLCard 2801,8.32
12/26/2020,,Withdrawal POS #000000012006/PUBLIX 3930 SW ARCHER ROA GAINESVILLE FLCard 1140,20.72,,Posted,313.1,2020-12-26,20.72,Withdrawal POS #000000116993/PUBLIX 3930 SW ARCHER ROA GAINESVILLE FLCard 1140,20.72
12/26/2020,,Withdrawal at ATM #000000003580/CAMPUS 5725 SW 75TH ST GAINESVILLE FLCard 1140,60.0,,Posted,333.82,2020-12-26,60.0,Withdrawal at ATM #000000005364/CAMPUS 5725 SW 75TH ST GAINESVILLE FLCard 1140,60.0
12/26/2020,,Withdrawal POS #000000036214/CVS/PHARMACY #03 03255--3404 SW ArcGainesville FLCard 1140,10.14,,Posted,122.47,2020-12-26,10.14,Withdrawal POS #000000036214/CVS/PHARMACY #03 03255--3404 SW ArcGainesville FLCard 1140,10.14
12/25/2020,,Withdrawal POS #000000194488/FAST TRACK #200 3960 SW ARCHER RDGAINESVILLE FLCard 1140,6.72,,Posted,40.61,2020-12-25,6.72,Withdrawal POS #000000224049/FAST TRACK #200 3960 SW ARCHER RD GAINESVILLE FL Card 1140,6.72
12/25/2020,,Withdrawal Debit Card Signature Debit/PRIVATEINTERNETACCESS WWW.PRIVATEIN CODate 12/24/20 0 0359965689 0 5734Card 1140,9.95,,Posted,19.33,2020-12-25,9.95,Withdrawal Debit Card Signature Debit/PRIVATEINTERNETACCESS WWW.PRIVATEIN CODate 01/24/21 0 1024716002 0 5734Card 1140,9.95
12/22/2020,,Withdrawal POS #000077034486/PETSMART # 0303 3736 SW ARCHER ROAGAINESVILLE FLCard 1140,5.22,,Posted,29.28,2020-12-22,5.22,Withdrawal POS #000077034486/PETSMART # 0303 3736 SW ARCHER ROAGAINESVILLE FLCard 1140,5.22
12/22/2020,,Withdrawal POS #000079034482/PETSMART # 0303 3736 SW ARCHER ROAGAINESVILLE FLCard 1140,27.43,,Posted,34.5,2020-12-22,27.43,Withdrawal POS #000077034486/PETSMART # 0303 3736 SW ARCHER ROAGAINESVILLE FLCard 1140,27.43
12/22/2020,,Withdrawal POS #000000098960/PUBLIX 3930 SW ARCHER ROA GAINESVILLE FLCard 1140,16.04,,Posted,11.93,2020-12-22,16.04,Withdrawal POS #000000116993/PUBLIX 3930 SW ARCHER ROA GAINESVILLE FLCard 1140,16.04
12/21/2020,,Recurring Withdrawal Debit Card - Signature Debit/DisneyPLUS 888-9057888 CADate 12/20/20 0 0355628518 3 5815Card 1140,8.03,,Posted,27.97,2020-12-21,8.03,Recurring Withdrawal Debit Card - Signature Debit/DisneyPLUS 888-9057888 CADate 01/20/21 0 1020042692 3 5815Card 1140,8.03
12/21/2020,,Withdrawal Debit Card Signature Debit/PP*APPLE.COM/BILL 402-935-7733 CADate 12/20/20 0 0355571920 4 5735Card 1140,9.99,,Posted,36.0,2020-12-21,9.99,Withdrawal Debit Card Signature Debit/PP*APPLE.COM/BILL 402-935-7733 CADate 02/05/21 0 1036909336 5 5735Card 1140,9.99
12/20/2020,,Withdrawal Courtesy Pay fee,35.0,,Posted,-54.01,2020-12-20,35.0,Withdrawal Courtesy Pay Fee,35.0
12/20/2020,,Withdrawal Debit Card Signature Debit/PIZZA HUT 27918 https://ipcha FLDate 12/17/20 1 0352063781 1 5812Card 1140,25.03,,Posted,-19.01,2020-12-20,25.03,Withdrawal Debit Card Signature Debit/PIZZA HUT 27918 https://ipcha FLDate 12/17/20 1 0352063781 1 5812Card 1140,25.03
12/20/2020,,Withdrawal Debit Card Fee/VISA INTERNATIONAL SERVICE ASSESSMENTDate 12/17/20Card 1140,0.02,,Posted,6.02,2020-12-20,0.02,Withdrawal Debit Card Fee/VISA INTERNATIONAL SERVICE ASSESSMENTDate 02/18/21Card 1140,0.08
12/20/2020,,Withdrawal Debit Card Signature Debit/PAYPAL *BLVCKLNGS 0635308003 FRDate 12/17/20 0 0352264903 6 7372Card 1140,2.0,,Posted,6.04,2020-12-20,2.0,Withdrawal Debit Card Signature Debit/PAYPAL *BLVCKLNGS 0635308003 FRDate 02/18/21 0 1049951415 4 7372Card 1140,1.58
12/19/2020,,Withdrawal POS #000000011100/PUBLIX 3930 SW ARCHER ROA GAINESVILLE FLCard 1140,8.87,,Posted,8.04,2020-12-19,8.87,Withdrawal POS #000000116993/PUBLIX 3930 SW ARCHER ROA GAINESVILLE FLCard 1140,8.87
12/19/2020,,Withdrawal POS #000041017673/PETSMART # 0303 3736 SW ARCHER ROAGAINESVILLE FLCard 1140,25.24,,Posted,16.91,2020-12-19,25.24,Withdrawal POS #000077034486/PETSMART # 0303 3736 SW ARCHER ROAGAINESVILLE FLCard 1140,25.24
12/19/2020,,Withdrawal POS #000000891192/CIRCLE K # 26146 GAINESVILLE FLCard 1140,13.3,,Posted,42.15,2020-12-19,13.3,Withdrawal POS #000000991864/CIRCLE K # 21142 GAINESVILLE FL Card 1140,13.002500000000001
12/19/2020,,Withdrawal at ATM #000000007770/CAMPUS 1900 SW 34TH ST GAINESVILLE FLCard 1140,20.0,,Posted,55.45,2020-12-19,20.0,Withdrawal at ATM #000000008812/CAMPUS 1900 SW 34TH ST GAINESVILLE FLCard 1140,20.0
12/18/2020,,Withdrawal ACH PAYPAL/TYPE: INST XFER ID: PAYPALSI77CO: PAYPALEntry Class Code: WEB,14.99,,Posted,61.85,2020-12-18,14.99,Withdrawal ACH PAYPAL/TYPE: INST XFER ID: PAYPALSI77CO: PAYPALEntry Class Code: WEB,14.646666666666667
12/17/2020,,Withdrawal Courtesy Pay fee,35.0,,Posted,-128.16,2020-12-17,35.0,Withdrawal Courtesy Pay Fee,35.0
12/17/2020,,Withdrawal Debit Card Signature Debit/PAYPAL *USPOSTALSER 402-935-7733 CADate 12/16/20 0 0351885402 4 9399Card 1140,13.6,,Posted,-93.16,2020-12-17,13.6,Withdrawal Debit Card Signature Debit/PAYPAL *USPOSTALSER 402-935-7733 CADate 12/16/20 0 0351885402 4 9399Card 1140,13.6
12/17/2020,,Withdrawal Courtesy Pay fee,35.0,,Posted,-79.56,2020-12-17,35.0,Withdrawal Courtesy Pay Fee,35.0
12/17/2020,,Withdrawal Debit Card Signature Debit/PAYPAL *PACKIX 402-935-7733 NJDate 12/15/20 0 0350885401 4 5816Card 1140,1.8,,Posted,-44.56,2020-12-17,1.8,Withdrawal Debit Card Signature Debit/PAYPAL *PACKIX 402-935-7733 NJDate 02/12/21 0 1043242483 4 5816Card 1140,1.8
12/17/2020,,Withdrawal Debit Card Fee/VISA INTERNATIONAL SERVICE ASSESSMENTDate 12/16/20Card 1140,0.01,,Posted,-42.76,2020-12-17,0.01,Withdrawal Debit Card Fee/VISA INTERNATIONAL SERVICE ASSESSMENTDate 02/18/21Card 1140,0.08
12/17/2020,,Withdrawal Courtesy Pay fee,35.0,,Posted,-42.75,2020-12-17,35.0,Withdrawal Courtesy Pay Fee,35.0
12/17/2020,,Withdrawal Debit Card Signature Debit/PAYPAL *BLVCKLNGS 0635308003 FRDate 12/16/20 0 0351083434 0 7372Card 1140,1.49,,Posted,-7.75,2020-12-17,1.49,Withdrawal Debit Card Signature Debit/PAYPAL *BLVCKLNGS 0635308003 FRDate 02/18/21 0 1049951415 4 7372Card 1140,1.58
12/17/2020,,Withdrawal ACH TARGET DEBIT CRD/Location - TARGET -0687GAINESVILLE FL / Terminal ID: 073TYPE: ACH TRAN ID: 1410215170CO: TARGET DEBIT CRDEntry Class C,28.24,,Posted,-6.26,2020-12-17,28.24,Withdrawal ACH TARGET DEBIT CRD/Location - TARGET -0687GAINESVILLE FL / Terminal ID: 071TYPE: ACH TRAN ID: 1410215170CO: TARGET DEBIT CRD,28.24
12/17/2020,,Withdrawal Transfer fee,8.0,,Posted,21.98,2020-12-17,8.0,Withdrawal Transfer fee,8.0
12/17/2020,,Withdrawal ACH WAWA CREDIT CARD/TYPE: ONLINE PMT ID: CITICTPCO: WAWA CREDIT CARDEntry Class Code: WEB,15.0,,Posted,24.98,2020-12-17,15.0,Withdrawal ACH WAWA CREDIT CARD/TYPE: PAYMENT ID: CITIGPUFDRCO: WAWA CREDIT CARDEntry Class Code: PPD,15.0
12/16/2020,,Withdrawal POS #000000361072/WAWA 5325 2373 SW ARCHER ROA GAINESVILLEFLCard 1140,19.99,,Posted,39.98,2020-12-16,19.99,Withdrawal POS #000000806824/WAWA 5325 2373 SW ARCHER ROA GAINESVILLE FL Card 1140,19.99
12/16/2020,,Withdrawal Debit Card Signature Debit/WALGREENS #5024 800-289-2273 FLDate 12/15/20 0 0350645392 0 5912Card 1140,18.17,,Posted,59.97,2020-12-16,18.17,Withdrawal Debit Card Signature Debit/WALGREENS #5024 800-289-2273 FLDate 02/11/21 0 1042872537 0 5912Card 1140,18.17
12/14/2020,,Withdrawal POS #000000079889/PUBLIX 3930 SW ARCHER ROA GAINESVILLE FLCard 1140,50.39,,Posted,78.14,2020-12-14,50.39,Withdrawal POS #000000116993/PUBLIX 3930 SW ARCHER ROA GAINESVILLE FLCard 1140,50.33
12/13/2020,,Withdrawal POS #000000437349/AMAZON.COM*CV3OL7443 SEATTLE WACard 1140,27.99,,Posted,128.53,2020-12-13,27.99,Withdrawal POS #000000472169/AMAZON.COM*UY7Z21W73 SEATTLE WACard 1140,27.765
12/13/2020,,Withdrawal POS #000000160265/FAST TRACK #200 3960 SW ARCHER RDGAINESVILLE FLCard 1140,14.49,,Posted,156.52,2020-12-13,14.49,Withdrawal POS #000000194488/FAST TRACK #200 3960 SW ARCHER RDGAINESVILLE FLCard 1140,14.350000000000001
12/13/2020,,Withdrawal at ATM #000000007208/CAMPUS 1900 SW 34TH ST GAINESVILLE FLCard 1140,40.0,,Posted,171.01,2020-12-13,40.0,Withdrawal at ATM #000000008812/CAMPUS 1900 SW 34TH ST GAINESVILLE FLCard 1140,40.0
12/13/2020,,Withdrawal Debit Card Signature Debit/PIZZA HUT 27918 https://ipcha FLDate 12/11/20 0 0346936172 4 5812Card 1140,34.53,,Posted,211.01,2020-12-13,34.53,Withdrawal Debit Card Signature Debit/PIZZA HUT 27918 https://ipcha FLDate 12/17/20 1 0352063781 1 5812Card 1140,34.53
12/11/2020,230.0,Draft 230,850.0,,Posted,245.54,2020-12-11,850.0,Draft 204,850.0
12/10/2020,,Withdrawal at ATM #000000006937/CAMPUS 1900 SW 34TH ST GAINESVILLE FLCard 1140,60.0,,Posted,1095.54,2020-12-10,60.0,Withdrawal at ATM #000000001619/CAMPUS 1900 SW 34TH ST GAINESVILLE FL Card 1140,60.0
12/10/2020,,Withdrawal Debit Card Fee/VISA INTERNATIONAL SERVICE ASSESSMENTDate 12/09/20Card 1140,0.22,,Posted,1155.54,2020-12-10,0.22,Withdrawal Debit Card Fee/VISA INTERNATIONAL SERVICE ASSESSMENTDate 02/18/21Card 1140,0.08
12/10/2020,,Withdrawal Debit Card Signature Debit/NCX*D UNLOCK LTD USD DROITWICH GBDate 12/09/20 0 0344098255 0 7372Card 1140,28.0,,Posted,1155.76,2020-12-10,28.0,Withdrawal Debit Card Signature Debit/NCX*D UNLOCK LTD USD DROITWICH GBDate 12/09/20 0 0344098255 0 7372Card 1140,28.0
12/9/2020,,Withdrawal Debit Card Signature Debit/PP*APPLE.COM/BILL 402-935-7733 CADate 12/08/20 0 0343653547 0 5735Card 1140,2.99,,Posted,1183.76,2020-12-09,2.99,Withdrawal Debit Card Signature Debit/PP*APPLE.COM/BILL 402-935-7733 CADate 02/05/21 0 1036909336 5 5735Card 1140,2.99
12/8/2020,,Withdrawal POS #000000508145/USPS PO 11322705 4600 SW GAINESVILLE FLCard 1140,46.2,,Posted,1186.75,2020-12-08,46.2,Withdrawal POS #000000508145/USPS PO 11322705 4600 SW GAINESVILLE FLCard 1140,46.2
12/8/2020,,Withdrawal at ATM #000000006744/CAMPUS 1900 SW 34TH ST GAINESVILLE FLCard 1140,60.0,,Posted,1232.95,2020-12-08,60.0,Withdrawal at ATM #000000001619/CAMPUS 1900 SW 34TH ST GAINESVILLE FL Card 1140,60.0
12/7/2020,,Withdrawal ACH BLVCKLNGS/CO: BLVCKLNGSTYPE: IAT PAYPAL ID: 770510487CEntry Class Code: IAT,1.0,,Posted,892.95,2020-12-07,1.0,Withdrawal ACH BRAINLY/CO: BRAINLYTYPE: IAT PAYPAL ID: 770510487CEntry Class Code: IAT,1.0
12/7/2020,,Withdrawal ACH PAYPAL/TYPE: VERIFYBANK ID: PAYPALRD33CO: PAYPALEntry Class Code: PPD,0.24,,Posted,893.95,2020-12-07,0.24,Withdrawal ACH PAYPAL/TYPE: VERIFYBANK ID: PAYPALRD33CO: PAYPALEntry Class Code: PPD,0.24
12/5/2020,,Withdrawal POS #000000067282/PUBLIX 3930 SW ARCHER ROA GAINESVILLE FLCard 1140,9.44,,Posted,893.95,2020-12-05,9.44,Withdrawal POS #000000059255/PUBLIX 3930 SW ARCHER ROA GAINESVILLE FLCard 1140,9.44
12/5/2020,,Withdrawal at ATM #000000006569/CAMPUS 1900 SW 34TH ST GAINESVILLE FLCard 1140,100.0,,Posted,883.39,2020-12-05,100.0,Withdrawal at ATM #000000001619/CAMPUS 1900 SW 34TH ST GAINESVILLE FL Card 1140,100.0
12/3/2020,,Withdrawal Debit Card Signature Debit/PIZZA HUT 27918 https://ipcha FLDate 12/01/20 0 0336616109 5 5812Card 1140,28.69,,Posted,983.39,2020-12-03,28.69,Withdrawal Debit Card Signature Debit/PIZZA HUT 27918 https://ipcha FLDate 12/17/20 1 0352063781 1 5812Card 1140,28.69
12/3/2020,,Withdrawal ACH INSPIREGOODIES/CO: INSPIREGOODIESTYPE: IAT PAYPAL ID: 770510487CEntry Class Code: IAT,45.9,,Posted,1012.08,2020-12-03,45.9,Withdrawal ACH NOSSKIRNEH/CO: NOSSKIRNEHTYPE: IAT PAYPAL ID: 770510487CEntry Class Code: IAT,45.9
12/3/2020,,"Withdrawal ACH Dave, Inc/TYPE: DEBIT ID: 1465396710 CO: Dave, IncEntry Class Code: WEB",1.0,,Posted,1057.98,2020-12-03,1.0,"Withdrawal ACH Dave, Inc/TYPE: DEBIT ID: 1465396710 CO: Dave, IncEntry Class Code: WEB",1.0
12/2/2020,,Withdrawal ACH CITY OF GAINESVI/TYPE: 2000-6637- ID: 5330903620CO: CITY OF GAINESVIEntry Class Code: WEB,190.49,,Posted,1058.98,2020-12-02,190.49,Withdrawal ACH CITY OF GAINESVI/TYPE: 2000-6637- ID: 5330903620CO: CITY OF GAINESVIEntry Class Code: WEB,190.49
12/2/2020,,Withdrawal ACH LAST.FM LTD./CO: LAST.FM LTD.TYPE: IAT PAYPAL ID: 770510487CEntry Class Code: IAT,3.0,,Posted,1249.47,2020-12-02,3.0,Withdrawal ACH LAST.FM LTD/CO: LAST.FM LTDTYPE: IAT PAYPAL ID: 770510487CEntry Class Code: IAT,3.0
12/1/2020,,Withdrawal ACH CAPITAL ONE/TYPE: ONLINE PMT ID: 9279744991CO: CAPITAL ONEEntry Class Code: WEB,25.0,,Posted,1252.47,2020-12-01,25.0,Withdrawal ACH CAPITAL ONE/TYPE: ONLINE PMT ID: 9279744991 CO: CAPITAL ONE Entry Class Code: WEB,25.0
11/30/2020,,Withdrawal Debit Card Signature Debit/PAYPAL *PLAYSTATION 402-935-7733 CADate 11/28/20 0 0333327342 4 7994Card 1140,4.97,,Posted,1277.38,2020-11-30,4.97,Withdrawal Debit Card Signature Debit/PAYPAL *PLAYSTATION 402-935-7733 CADate 01/02/21 0 1002296098 3 7994Card 1140,5.4
11/30/2020,,Withdrawal Debit Card Signature Debit/BESTBUYCOM806382028639 RICHFIELD MNDate 11/29/20 0 0334909097 3 5732Card 1140,32.09,,Posted,1282.35,2020-11-30,32.09,Withdrawal Debit Card Signature Debit/BESTBUYCOM806382028639 RICHFIELD MNDate 11/29/20 0 0334909097 3 5732Card 1140,32.09
11/30/2020,,Withdrawal Debit Card Signature Debit/SCRUBS CARWASH - GAINE GAINESVILLE FLDate 11/28/20 0 0333771640 3 7542Card 1140,6.25,,Posted,1314.44,2020-11-30,6.25,Withdrawal Debit Card Signature Debit/SCRUBS CARWASH - GAINE GAINESVILLE FLDate 11/28/20 0 0333771640 3 7542Card 1140,6.25
11/30/2020,,Withdrawal ACH COX COMM GAN/TYPE: BANK DRAFT ID: 1581620085CO: COX COMM GANEntry Class Code: WEB,127.16,,Posted,1320.69,2020-11-30,127.16,Withdrawal ACH COX COMM GAN/TYPE: BANK DRAFT ID: 1581620085CO: COX COMM GANEntry Class Code: WEB,127.34
11/30/2020,,Withdrawal ACH BEST BUY/TYPE: PAYMENT ID: CITIGPUFDRCO: BEST BUYEntry Class Code: PPD,45.0,,Posted,1447.85,2020-11-30,45.0,Withdrawal ACH BEST BUY/TYPE: PAYMENT ID: CITIGPUFDRCO: BEST BUYEntry Class Code: TEL,44.980000000000004
11/30/2020,,Withdrawal ACH APPLECARD GSBANK/TYPE: PAYMENT ID: 9999999999CO: APPLECARD GSBANKEntry Class Code: WEB,22.61,,Posted,1492.85,2020-11-30,22.61,Withdrawal ACH APPLECARD GSBANK/TYPE: PAYMENT ID: 9999999999 CO: APPLECARD GSBANK Entry Class Code: WEB,22.61
11/29/2020,,Withdrawal POS #000000501613/LOWE'S #3278 GAINESVILLE FLCard 1140,42.32,,Posted,1515.46,2020-11-29,42.32,Withdrawal POS #000000501613/LOWE'S #3278 GAINESVILLE FLCard 1140,42.32
11/29/2020,,Withdrawal POS #000000043153/PUBLIX 3930 SW ARCHER ROA GAINESVILLE FLCard 1140,144.31,,Posted,1557.78,2020-11-29,144.31,Withdrawal POS #000000116993/PUBLIX 3930 SW ARCHER ROA GAINESVILLE FLCard 1140,144.31
11/28/2020,,Withdrawal POS #000020284741/SQ *VC GAINESVILLE SQUARE PURCHASEGAINESVILLE FLCard 1140,48.15,,Posted,1702.09,2020-11-28,48.15,Withdrawal POS #000020284741/SQ *VC GAINESVILLE SQUARE PURCHASEGAINESVILLE FLCard 1140,48.15
11/28/2020,,Withdrawal POS #000016040840/BEST BUY #424 3750 SE ARCHER ROAGAINSVILLE FLCard 1140,117.67,,Posted,1750.24,2020-11-28,117.67,Withdrawal POS #000016040840/BEST BUY #424 3750 SE ARCHER ROAGAINSVILLE FLCard 1140,117.67
11/28/2020,,Withdrawal at ATM #000000005987/CAMPUS 1900 SW 34TH ST GAINESVILLE FLCard 1140,180.0,,Posted,1867.91,2020-11-28,180.0,Withdrawal at ATM #000000001619/CAMPUS 1900 SW 34TH ST GAINESVILLE FL Card 1140,180.0
11/27/2020,,Withdrawal ACH PAYPAL/TYPE: INST XFER ID: PAYPALSI77CO: PAYPALEntry Class Code: WEB,9.99,,Posted,47.91,2020-11-27,9.99,Withdrawal ACH PAYPAL/TYPE: INST XFER ID: PAYPALSI77CO: PAYPALEntry Class Code: WEB,9.723333333333334
11/25/2020,,Withdrawal Debit Card Signature Debit/PRIVATEINTERNETACCESS WWW.PRIVATEIN CODate 11/24/20 0 0329683764 0 5734Card 1140,9.95,,Posted,57.9,2020-11-25,9.95,Withdrawal Debit Card Signature Debit/PRIVATEINTERNETACCESS WWW.PRIVATEIN CODate 01/24/21 0 1024716002 0 5734Card 1140,9.95
11/22/2020,,Withdrawal POS #000000057608/PUBLIX 3930 SW ARCHER ROA GAINESVILLE FLCard 1140,74.8,,Posted,67.85,2020-11-22,74.8,Withdrawal POS #000000098960/PUBLIX 3930 SW ARCHER ROA GAINESVILLE FLCard 1140,74.8
11/22/2020,,Withdrawal at ATM #000000005597/CAMPUS 1900 SW 34TH ST GAINESVILLE FLCard 1140,80.0,,Posted,142.65,2020-11-22,80.0,Withdrawal at ATM #000000001619/CAMPUS 1900 SW 34TH ST GAINESVILLE FL Card 1140,80.0
11/22/2020,,Recurring Withdrawal Debit Card - Signature Debit/DisneyPLUS 888-9057888 CADate 11/20/20 0 0325477906 9 5815Card 1140,8.03,,Posted,122.65,2020-11-22,8.03,Recurring Withdrawal Debit Card - Signature Debit/DisneyPLUS 888-9057888 CADate 01/20/21 0 1020042692 3 5815Card 1140,8.03
11/22/2020,,Withdrawal Debit Card Signature Debit/EXXONMOBIL 96724869 GAINESVILLE FLDate 11/19/20 0 0324879059 4 5541Card 1140,22.11,,Posted,130.68,2020-11-22,22.11,Withdrawal Debit Card Signature Debit/EXXONMOBIL 96724869 GAINESVILLE FLDate 11/19/20 0 0324879059 4 5541Card 1140,22.11
11/20/2020,,Withdrawal at ATM #000000005443/CAMPUS 1900 SW 34TH ST GAINESVILLE FLCard 1140,120.0,,Posted,83.79,2020-11-20,120.0,Withdrawal at ATM #000000005364/CAMPUS 5725 SW 75TH ST GAINESVILLE FLCard 1140,120.0
11/20/2020,,Withdrawal ACH PAYPAL/TYPE: INST XFER ID: PAYPALSI77CO: PAYPALEntry Class Code: WEB,0.74,,Posted,153.79,2020-11-20,0.74,Withdrawal ACH PAYPAL/TYPE: INST XFER ID: PAYPALSI77CO: PAYPALEntry Class Code: WEB,0.835
11/19/2020,,Withdrawal POS #000000080373/PUBLIX 5200 S W 34TH STRE GAINESVILLE FLCard 1140,10.54,,Posted,154.53,2020-11-19,10.54,Withdrawal POS #000000080373/PUBLIX 5200 S W 34TH STRE GAINESVILLE FLCard 1140,10.62
11/19/2020,,Withdrawal at ATM #000000005316/CAMPUS 1900 SW 34TH ST GAINESVILLE FLCard 1140,80.0,,Posted,165.07,2020-11-19,80.0,Withdrawal at ATM #000000001619/CAMPUS 1900 SW 34TH ST GAINESVILLE FL Card 1140,80.0
11/18/2020,,Withdrawal POS #000000310184/WALGREENS STORE 2415 SW 7 GAINESVILLE FLCard 1140,4.61,,Posted,115.07,2020-11-18,4.61,Withdrawal POS #000000218861/WALGREENS STORE 2415 SW 7 GAINESVILLE FL Card 1140,4.8500000000000005
11/18/2020,,Withdrawal POS #000000364576/WALGREENS STORE 2415 SW 7 GAINESVILLE FLCard 1140,60.5,,Posted,119.68,2020-11-18,60.5,Withdrawal POS #000000305411/WALGREENS STORE 3455 SW A GAINESVILLE FLCard 1140,60.5
11/18/2020,,Withdrawal Debit Card Signature Debit/CHIPOTLE 0793 GAINESVILLE FLDate 11/17/20 0 0322184035 0 5814Card 1140,7.49,,Posted,180.18,2020-11-18,7.49,Withdrawal Debit Card Signature Debit/CHIPOTLE 0793 GAINESVILLE FLDate 11/17/20 0 0322184035 0 5814Card 1140,7.49
11/18/2020,,Withdrawal ACH APPLECARD GSBANK/TYPE: PAYMENT ID: 9999999999CO: APPLECARD GSBANKEntry Class Code: WEB,50.0,,Posted,187.67,2020-11-18,50.0,Withdrawal ACH APPLECARD GSBANK/TYPE: PAYMENT ID: 9999999999 CO: APPLECARD GSBANK Entry Class Code: WEB,50.0
11/18/2020,,Withdrawal ACH DISCOVER/TYPE: E-PAYMENT ID: 2510020270CO: DISCOVEREntry Class Code: WEB,26.0,,Posted,237.67,2020-11-18,26.0,Withdrawal ACH DISCOVER/TYPE: E-PAYMENT ID: 2510020270CO: DISCOVEREntry Class Code: WEB,25.5
11/18/2020,,Withdrawal ACH CAPITAL ONE/TYPE: MOBILE PMT ID: 9279744980CO: CAPITAL ONEEntry Class Code: WEB,25.0,,Posted,263.67,2020-11-18,25.0,Withdrawal ACH CAPITAL ONE/TYPE: MOBILE PMT ID: 9279744980CO: CAPITAL ONEEntry Class Code: WEB,25.0
11/18/2020,,Withdrawal ACH PAYMENT FOR AMZ/TYPE: STORECARD ID: 9069872103CO: PAYMENT FOR AMZEntry Class Code: WEB,112.84,,Posted,288.67,2020-11-18,112.84,Withdrawal ACH PAYMENT FOR AMZ/TYPE: STORECARD ID: 9069872103 CO: PAYMENT FOR AMZ Entry Class Code: WEB,112.84
11/17/2020,,Withdrawal POS #000070022099/PETSMART # 0303 3736 SW ARCHER ROAGAINESVILLE FLCard 1140,77.0,,Posted,401.51,2020-11-17,77.0,Withdrawal POS #000077034486/PETSMART # 0303 3736 SW ARCHER ROAGAINESVILLE FLCard 1140,77.0
11/17/2020,,Withdrawal POS #000000975560/FAST TRACK #200 3960 SW ARCHER RDGAINESVILLE FLCard 1140,22.23,,Posted,478.51,2020-11-17,22.23,Withdrawal POS #000000194488/FAST TRACK #200 3960 SW ARCHER RDGAINESVILLE FLCard 1140,22.2575
11/16/2020,229.0,Draft 229,850.0,,Posted,50.74,2020-11-16,850.0,Draft 229,850.0
11/16/2020,,Withdrawal POS #000000232872/WALGREENS STORE 2415 SW 7 GAINESVILLE FLCard 1140,20.4,,Posted,900.74,2020-11-16,20.4,Withdrawal POS #000000305411/WALGREENS STORE 3455 SW A GAINESVILLE FLCard 1140,20.4
11/16/2020,,Withdrawal ACH CAPITAL ONE/TYPE: ONLINE PMT ID: 9279744991CO: CAPITAL ONEEntry Class Code: WEB,25.0,,Posted,921.14,2020-11-16,25.0,Withdrawal ACH CAPITAL ONE/TYPE: ONLINE PMT ID: 9279744991 CO: CAPITAL ONE Entry Class Code: WEB,25.0
11/15/2020,,Withdrawal POS #000000030367/PUBLIX 3930 SW ARCHER ROA GAINESVILLE FLCard 1140,82.73,,Posted,946.14,2020-11-15,82.73,Withdrawal POS #000000032127/PUBLIX 3930 SW ARCHER ROA GAINESVILLE FLCard 1140,82.73
11/15/2020,,Withdrawal Debit Card Signature Debit/WALGREENS #5024 800-289-2273 FLDate 11/13/20 0 0318366262 6 5912Card 1140,13.28,,Posted,1028.87,2020-11-15,13.28,Withdrawal Debit Card Signature Debit/WALGREENS #5024 800-289-2273 FLDate 02/11/21 0 1042872537 0 5912Card 1140,13.28
11/12/2020,,Withdrawal ACH BARCLAYCARD US/TYPE: CREDITCARD ID: 2510407970CO: BARCLAYCARD USEntry Class Code: WEB,27.0,,Posted,1042.15,2020-11-12,27.0,Withdrawal ACH BARCLAYCARD US/TYPE: CREDITCARD ID: 2510407970 CO: BARCLAYCARD US Entry Class Code: WEB,27.0
11/11/2020,,Withdrawal POS #000000347509/WALGREENS STORE 2415 SW 7 GAINESVILLE FLCard 1140,17.19,,Posted,1069.15,2020-11-11,17.19,Withdrawal POS #000000305411/WALGREENS STORE 3455 SW A GAINESVILLE FLCard 1140,17.840000000000003
11/11/2020,,Withdrawal at ATM #000000000429/CAMPUS 1900 SW 34TH ST GAINESVILLE FLCard 1140,140.0,,Posted,1086.34,2020-11-11,140.0,Withdrawal at ATM #000000008812/CAMPUS 1900 SW 34TH ST GAINESVILLE FLCard 1140,140.0
11/10/2020,,Withdrawal POS #000000072181/PUBLIX 3930 SW ARCHER ROA GAINESVILLE FLCard 1140,50.27,,Posted,1226.34,2020-11-10,50.27,Withdrawal POS #000000116993/PUBLIX 3930 SW ARCHER ROA GAINESVILLE FLCard 1140,50.33
11/10/2020,,Withdrawal ACH COX COMM GAN/TYPE: BANK DRAFT ID: 1581620085CO: COX COMM GANEntry Class Code: WEB,125.94,,Posted,1276.61,2020-11-10,125.94,Withdrawal ACH COX COMM GAN/TYPE: BANK DRAFT ID: 1581620085CO: COX COMM GANEntry Class Code: WEB,125.94
11/10/2020,,Withdrawal ACH APPLECARD GSBANK/TYPE: PAYMENT ID: 9999999999CO: APPLECARD GSBANKEntry Class Code: WEB,50.0,,Posted,1402.55,2020-11-10,50.0,Withdrawal ACH APPLECARD GSBANK/TYPE: PAYMENT ID: 9999999999 CO: APPLECARD GSBANK Entry Class Code: WEB,50.0
11/10/2020,,Withdrawal ACH VZ WIRELESS VE/TYPE: VZW WEBPAY ID: 0000751800CO: VZ WIRELESS VEEntry Class Code: WEB,55.55,,Posted,1452.55,2020-11-10,55.55,Withdrawal ACH VZ WIRELESS VE/TYPE: VZW WEBPAY ID: 0000751800CO: VZ WIRELESS VEEntry Class Code: WEB,55.55
11/9/2020,,Withdrawal ACH WAWA CREDIT CARD/TYPE: ONLINE PMT ID: CITICTPCO: WAWA CREDIT CARDEntry Class Code: WEB,25.0,,Posted,1508.1,2020-11-09,25.0,Withdrawal ACH WAWA CREDIT CARD/TYPE: PAYMENT ID: CITIGPUFDRCO: WAWA CREDIT CARDEntry Class Code: PPD,25.0
11/8/2020,,Withdrawal POS #000000013173/CVS/PHARMACY #03 03255--3404 SW ArcGainesville FLCard 1140,19.37,,Posted,1533.1,2020-11-08,19.37,Withdrawal POS #000000036214/CVS/PHARMACY #03 03255--3404 SW ArcGainesville FLCard 1140,19.37
11/8/2020,,Withdrawal POS #000000226085/WAWA 5325 2373 SW ARCHER ROA GAINESVILLEFLCard 1140,15.18,,Posted,1552.47,2020-11-08,15.18,Withdrawal POS #000000806824/WAWA 5325 2373 SW ARCHER ROA GAINESVILLE FL Card 1140,15.18
11/6/2020,,Withdrawal Debit Card Signature Debit/COUNTRY CRITTERS - 4 OCALA FLDate 11/04/20 0 0309046964 5 0742Card 1140,35.0,,Posted,1567.65,2020-11-06,35.0,Withdrawal Debit Card Signature Debit/COUNTRY CRITTERS - 4 OCALA FLDate 11/04/20 0 0309046964 5 0742Card 1140,35.0
11/6/2020,,Withdrawal ACH WAWA CREDIT CARD/TYPE: ONLINE PMT ID: CITICTPCO: WAWA CREDIT CARDEntry Class Code: WEB,29.0,,Posted,1602.65,2020-11-06,29.0,Withdrawal ACH WAWA CREDIT CARD/TYPE: PAYMENT ID: CITIGPUFDRCO: WAWA CREDIT CARDEntry Class Code: PPD,28.563333333333333
11/4/2020,,Withdrawal POS #000000254082/WALGREENS STORE 2415 SW 7 GAINESVILLE FLCard 1140,43.28,,Posted,1631.65,2020-11-04,43.28,Withdrawal POS #000000305411/WALGREENS STORE 3455 SW A GAINESVILLE FLCard 1140,43.28
11/4/2020,,Withdrawal POS #000000000007/AMAZON.COM*2864R4HI1 SEATTLE WACard 1140,63.76,,Posted,1674.93,2020-11-04,63.76,Withdrawal POS #000000000007/AMAZON.COM*2864R4HI1 SEATTLE WACard 1140,63.76
11/4/2020,,Withdrawal POS #000000081495/PUBLIX 3930 SW ARCHER ROA GAINESVILLE FLCard 1140,33.79,,Posted,1738.69,2020-11-04,33.79,Withdrawal POS #000000116993/PUBLIX 3930 SW ARCHER ROA GAINESVILLE FLCard 1140,33.923333333333325
11/3/2020,,Withdrawal ACH CITY OF GAINESVI/TYPE: 2000-6637- ID: 5330903620CO: CITY OF GAINESVIEntry Class Code: WEB,187.69,,Posted,1772.48,2020-11-03,187.69,Withdrawal ACH CITY OF GAINESVI/TYPE: 2000-6637- ID: 5330903620CO: CITY OF GAINESVIEntry Class Code: WEB,188.125
11/1/2020,,Withdrawal POS #000000077534/PUBLIX 3930 SW ARCHER ROA GAINESVILLE FLCard 1140,64.86,,Posted,1960.17,2020-11-01,64.86,Withdrawal POS #000000077534/PUBLIX 3930 SW ARCHER ROA GAINESVILLE FLCard 1140,64.86
10/27/2020,,Withdrawal POS #000000059255/PUBLIX 3930 SW ARCHER ROA GAINESVILLE FLCard 1140,23.0,,Posted,25.03,2020-10-27,23.0,Withdrawal POS #000000059255/PUBLIX 3930 SW ARCHER ROA GAINESVILLE FLCard 1140,23.11
10/25/2020,,Withdrawal Debit Card Signature Debit/PRIVATEINTERNETACCESS WWW.PRIVATEIN CODate 10/24/20 0 0298109598 1 5734Card 1140,9.95,,Posted,48.03,2020-10-25,9.95,Withdrawal Debit Card Signature Debit/PRIVATEINTERNETACCESS WWW.PRIVATEIN CODate 01/24/21 0 1024716002 0 5734Card 1140,9.95
10/25/2020,,Withdrawal Debit Card Signature Debit/CHIPOTLE 0793 GAINESVILLE FLDate 10/24/20 0 0298193830 0 5814Card 1140,1.98,,Posted,57.98,2020-10-25,1.98,Withdrawal Debit Card Signature Debit/CHIPOTLE 0793 GAINESVILLE FLDate 11/17/20 0 0322184035 0 5814Card 1140,1.98
10/25/2020,,Withdrawal POS #000000058653/PUBLIX 5200 S W 34TH STRE GAINESVILLE FLCard 1140,10.7,,Posted,59.96,2020-10-25,10.7,Withdrawal POS #000000080373/PUBLIX 5200 S W 34TH STRE GAINESVILLE FLCard 1140,10.62
10/24/2020,,"Withdrawal at ATM #000000002048/PAI ISO 3401 SW 34TH ST., GAINESVILLE FLCard 1140",187.75,,Posted,70.66,2020-10-24,187.75,"Withdrawal at ATM #000000002048/PAI ISO 3401 SW 34TH ST., GAINESVILLE FLCard 1140",187.75
10/24/2020,,Withdrawal POS #000000072174/PUBLIX 3930 SW ARCHER ROA GAINESVILLE FLCard 1140,87.92,,Posted,158.41,2020-10-24,87.92,Withdrawal POS #000000077534/PUBLIX 3930 SW ARCHER ROA GAINESVILLE FLCard 1140,87.92
10/21/2020,,"Withdrawal at ATM #000000000718/PAI ISO 3401 SW 34TH ST., GAINESVILLE FLCard 1140",132.75,,Posted,229.83,2020-10-21,132.75,"Withdrawal at ATM #000000002048/PAI ISO 3401 SW 34TH ST., GAINESVILLE FLCard 1140",132.75
10/21/2020,,Recurring Withdrawal Debit Card - Signature Debit/DisneyPLUS 888-9057888 CADate 10/20/20 0 0294801035 3 5815Card 1140,8.03,,Posted,362.58,2020-10-21,8.03,Recurring Withdrawal Debit Card - Signature Debit/DisneyPLUS 888-9057888 CA Date 07/20/20 0 0202385035 3 5815 Card 1140,8.03
10/19/2020,,Withdrawal Debit Card Signature Debit/PAYPAL *TAMRIELTRAD 402-935-7733 CADate 10/18/20 0 0292162909 4 5945Card 1140,2.0,,Posted,370.61,2020-10-19,2.0,Withdrawal Debit Card Signature Debit/PAYPAL *TAMRIELTRAD 402-935-7733 CADate 10/18/20 0 0292162909 4 5945Card 1140,2.0
10/19/2020,,Withdrawal ACH TARGET DEBIT CRD/Location - TARGET -0687GAINESVILLE FL / Terminal ID: 172TYPE: ACH TRAN ID: 1410215170CO: TARGET DEBIT CRDEntry Class C,107.44,,Posted,372.61,2020-10-19,107.44,Withdrawal ACH TARGET DEBIT CRD/Location - TARGET -0687GAINESVILLE FL / Terminal ID: 071TYPE: ACH TRAN ID: 1410215170CO: TARGET DEBIT CRD,107.44
10/19/2020,,Withdrawal ACH PAYMENT FOR AMZ/TYPE: STORECARD ID: 9069872103CO: PAYMENT FOR AMZEntry Class Code: WEB,55.0,,Posted,480.05,2020-10-19,55.0,Withdrawal ACH PAYMENT FOR AMZ/TYPE: STORECARD ID: 9069872103 CO: PAYMENT FOR AMZ Entry Class Code: WEB,55.0
10/18/2020,,Withdrawal Debit Card Signature Debit/WALGREENS #5024 800-289-2273 FLDate 10/17/20 0 0291406395 1 5912Card 1140,15.0,,Posted,535.05,2020-10-18,15.0,Withdrawal Debit Card Signature Debit/WALGREENS #5024 800-289-2273 FLDate 02/11/21 0 1042872537 0 5912Card 1140,15.0
10/18/2020,,Withdrawal Debit Card Signature Debit/WALGREENS #5024 800-289-2273 FLDate 10/16/20 0 0290778380 6 5912Card 1140,3.17,,Posted,550.05,2020-10-18,3.17,Withdrawal Debit Card Signature Debit/WALGREENS #5024 800-289-2273 FLDate 02/11/21 0 1042872537 0 5912Card 1140,3.17
10/17/2020,,Withdrawal at ATM #000000008812/CAMPUS 1900 SW 34TH ST GAINESVILLE FLCard 1140,140.0,,Posted,553.22,2020-10-17,140.0,Withdrawal at ATM #000000008812/CAMPUS 1900 SW 34TH ST GAINESVILLE FLCard 1140,140.0
10/16/2020,,Withdrawal POS #000000361865/WALGREENS STORE 2415 SW 7 GAINESVILLE FLCard 1140,12.83,,Posted,193.22,2020-10-16,12.83,Withdrawal POS #000000218861/WALGREENS STORE 2415 SW 7 GAINESVILLE FL Card 1140,12.83
10/15/2020,,"Withdrawal at ATM #000000000637/PAI ISO 3401 SW 34TH ST., GAINESVILLE FLCard 1140",117.75,,Posted,206.05,2020-10-15,117.75,"Withdrawal at ATM #000000002048/PAI ISO 3401 SW 34TH ST., GAINESVILLE FLCard 1140",117.75
10/15/2020,,Withdrawal POS #000000106065/PUBLIX 3930 SW ARCHER ROA GAINESVILLE FLCard 1140,55.67,,Posted,323.8,2020-10-15,55.67,Withdrawal POS #000000116993/PUBLIX 3930 SW ARCHER ROA GAINESVILLE FLCard 1140,55.67
10/11/2020,,Withdrawal POS #000000054244/PUBLIX 3930 SW ARCHER ROA GAINESVILLE FLCard 1140,64.02,,Posted,379.47,2020-10-11,64.02,Withdrawal POS #000000059255/PUBLIX 3930 SW ARCHER ROA GAINESVILLE FLCard 1140,64.02
10/9/2020,228.0,Draft 228,850.0,,Posted,443.49,2020-10-09,850.0,Draft 229,850.0
10/7/2020,,Withdrawal ACH DISCOVER/TYPE: E-PAYMENT ID: 2510020270CO: DISCOVEREntry Class Code: WEB,55.0,,Posted,1293.49,2020-10-07,55.0,Withdrawal ACH DISCOVER/TYPE: E-PAYMENT ID: 2510020270CO: DISCOVEREntry Class Code: WEB,55.0
10/7/2020,,Withdrawal ACH PAYMENT FOR AMZ/TYPE: STORECARD ID: 9069872103CO: PAYMENT FOR AMZEntry Class Code: WEB,115.0,,Posted,1348.49,2020-10-07,115.0,Withdrawal ACH PAYMENT FOR AMZ/TYPE: STORECARD ID: 9069872103 CO: PAYMENT FOR AMZ Entry Class Code: WEB,115.0
10/6/2020,,Withdrawal ACH APPLECARD GSBANK/TYPE: PAYMENT ID: 9999999999CO: APPLECARD GSBANKEntry Class Code: WEB,100.0,,Posted,1463.49,2020-10-06,100.0,Withdrawal ACH APPLECARD GSBANK/TYPE: PAYMENT ID: 9999999999 CO: APPLECARD GSBANK Entry Class Code: WEB,100.0
10/6/2020,,Withdrawal ACH DISCOVER/TYPE: E-PAYMENT ID: 2510020270CO: DISCOVEREntry Class Code: WEB,55.0,,Posted,1563.49,2020-10-06,55.0,Withdrawal ACH DISCOVER/TYPE: E-PAYMENT ID: 2510020270CO: DISCOVEREntry Class Code: WEB,55.0
10/6/2020,,Withdrawal ACH CAPITAL ONE/TYPE: MOBILE PMT ID: 9279744980CO: CAPITAL ONEEntry Class Code: WEB,55.0,,Posted,1618.49,2020-10-06,55.0,Withdrawal ACH CAPITAL ONE/TYPE: MOBILE PMT ID: 9279744980CO: CAPITAL ONEEntry Class Code: WEB,55.0
10/6/2020,,Withdrawal ACH BEST BUY/TYPE: PAYMENT ID: CITIGPUFDRCO: BEST BUYEntry Class Code: PPD,55.0,,Posted,1673.49,2020-10-06,55.0,Withdrawal ACH BEST BUY/TYPE: PAYMENT ID: CITIGPUFDRCO: BEST BUYEntry Class Code: TEL,54.5
10/6/2020,,Withdrawal ACH BARCLAYCARD US/TYPE: CREDITCARD ID: 2510407970CO: BARCLAYCARD USEntry Class Code: WEB,55.0,,Posted,1728.49,2020-10-06,55.0,Withdrawal ACH BARCLAYCARD US/TYPE: CREDITCARD ID: 2510407970 CO: BARCLAYCARD US Entry Class Code: WEB,55.0
10/6/2020,,Withdrawal ACH CAPITAL ONE/TYPE: MOBILE PMT ID: 9279744980CO: CAPITAL ONEEntry Class Code: WEB,45.0,,Posted,1783.49,2020-10-06,45.0,Withdrawal ACH CAPITAL ONE/TYPE: MOBILE PMT ID: 9279744980CO: CAPITAL ONEEntry Class Code: WEB,45.0
10/6/2020,,Withdrawal ACH VZ WIRELESS VE/TYPE: VZW WEBPAY ID: 0000751800CO: VZ WIRELESS VEEntry Class Code: WEB,265.96,,Posted,1828.49,2020-10-06,265.96,Withdrawal ACH VZ WIRELESS VE/TYPE: VZW WEBPAY ID: 0000751800CO: VZ WIRELESS VEEntry Class Code: WEB,265.96
10/6/2020,,Withdrawal ACH WAWA CREDIT CARD/TYPE: ONLINE PMT ID: CITICTPCO: WAWA CREDIT CARDEntry Class Code: WEB,55.0,,Posted,2094.45,2020-10-06,55.0,Withdrawal ACH WAWA CREDIT CARD/TYPE: PAYMENT ID: CITIGPUFDRCO: WAWA CREDIT CARDEntry Class Code: PPD,55.0
10/5/2020,,Withdrawal POS #000000031030/PUBLIX 3930 SW ARCHER ROA GAINESVILLE FLCard 1140,27.32,,Posted,2149.45,2020-10-05,27.32,Withdrawal POS #000000116993/PUBLIX 3930 SW ARCHER ROA GAINESVILLE FLCard 1140,27.255000000000003
10/5/2020,,"Withdrawal at ATM #000000001919/PAI ISO 3401 SW 34TH ST., GAINESVILLE FLCard 1140",62.75,,Posted,2176.77,2020-10-05,62.75,"Withdrawal at ATM #000000002048/PAI ISO 3401 SW 34TH ST., GAINESVILLE FLCard 1140",62.75
10/5/2020,,Withdrawal/Cash Disbursed 100.00,100.0,,Posted,2239.52,2020-10-05,100.0,Withdrawal/Cash Disbursed 35.00,100.0
10/5/2020,,Withdrawal POS #000000079405/PUBLIX 3930 SW ARCHER ROA GAINESVILLE FLCard 1140,16.04,,Posted,2339.52,2020-10-05,16.04,Withdrawal POS #000000059255/PUBLIX 3930 SW ARCHER ROA GAINESVILLE FLCard 1140,16.04
10/1/2020,,"Withdrawal at ATM #000000001877/PAI ISO 3401 SW 34TH ST., GAINESVILLE FLCard 1140",77.75,,Posted,2355.56,2020-10-01,77.75,"Withdrawal at ATM #000000002048/PAI ISO 3401 SW 34TH ST., GAINESVILLE FLCard 1140",77.75
9/29/2020,,"Withdrawal at ATM #000000001850/PAI ISO 3401 SW 34TH ST., GAINESVILLE FLCard 1140",42.75,,Posted,433.31,2020-09-29,42.75,"Withdrawal at ATM #000000002048/PAI ISO 3401 SW 34TH ST., GAINESVILLE FLCard 1140",42.75
9/28/2020,,Withdrawal ACH CITY OF GAINESVI/TYPE: 2000-6637- ID: 5330903620CO: CITY OF GAINESVIEntry Class Code: WEB,227.08,,Posted,476.06,2020-09-28,227.08,Withdrawal ACH CITY OF GAINESVI/TYPE: 2000-6637- ID: 5330903620CO: CITY OF GAINESVIEntry Class Code: WEB,227.08
9/26/2020,,"Withdrawal at ATM #000000000401/PAI ISO 3401 SW 34TH ST., GAINESVILLE FLCard 1140",192.75,,Posted,278.14,2020-09-26,192.75,"Withdrawal at ATM #000000002048/PAI ISO 3401 SW 34TH ST., GAINESVILLE FLCard 1140",192.75
9/25/2020,,Withdrawal POS #000000016427/PUBLIX 5200 S W 34TH STRE GAINESVILLE FLCard 1140,35.57,,Posted,240.89,2020-09-25,35.57,Withdrawal POS #000000080373/PUBLIX 5200 S W 34TH STRE GAINESVILLE FLCard 1140,35.485
9/25/2020,,Withdrawal Debit Card Signature Debit/PRIVATEINTERNETACCESS WWW.PRIVATEIN CODate 09/24/20 0 0268436352 0 5734Card 1140,9.95,,Posted,276.46,2020-09-25,9.95,Withdrawal Debit Card Signature Debit/PRIVATEINTERNETACCESS WWW.PRIVATEIN CODate 01/24/21 0 1024716002 0 5734Card 1140,9.95
9/24/2020,,Withdrawal at ATM #000000001010/CAMPUS 1900 SW 34TH ST GAINESVILLE FLCard 1140,60.0,,Posted,201.34,2020-09-24,60.0,Withdrawal at ATM #000000001619/CAMPUS 1900 SW 34TH ST GAINESVILLE FL Card 1140,60.0
9/21/2020,,"Withdrawal at ATM #000000001776/PAI ISO 3401 SW 34TH ST., GAINESVILLE FLCard 1140",42.75,,Posted,261.34,2020-09-21,42.75,"Withdrawal at ATM #000000002048/PAI ISO 3401 SW 34TH ST., GAINESVILLE FLCard 1140",42.75
9/21/2020,,Recurring Withdrawal Debit Card - Signature Debit/DisneyPLUS 888-9057888 CADate 09/20/20 0 0264389714 3 5815Card 1140,8.03,,Posted,54.09,2020-09-21,8.03,Recurring Withdrawal Debit Card - Signature Debit/DisneyPLUS 888-9057888 CA Date 07/20/20 0 0202385035 3 5815 Card 1140,8.03
9/21/2020,,Withdrawal Debit Card Fee/VISA INTERNATIONAL SERVICE ASSESSMENTDate 09/20/20Card 1140,0.04,,Posted,62.12,2020-09-21,0.04,Withdrawal Debit Card Fee/VISA INTERNATIONAL SERVICE ASSESSMENTDate 02/18/21Card 1140,0.08
9/21/2020,,Withdrawal Debit Card Signature Debit/PAYPAL *GOG 35314369001 PLDate 09/20/20 0 0264165259 0 5816Card 1140,5.0,,Posted,62.16,2020-09-21,5.0,Withdrawal Debit Card Signature Debit/PAYPAL *GOG 35314369001 PLDate 09/20/20 0 0264165259 0 5816Card 1140,5.0
9/21/2020,,Withdrawal ACH CAPITAL ONE/TYPE: MOBILE PMT ID: 9279744980CO: CAPITAL ONEEntry Class Code: WEB,544.43,,Posted,67.16,2020-09-21,544.43,Withdrawal ACH CAPITAL ONE/TYPE: MOBILE PMT ID: 9279744980CO: CAPITAL ONEEntry Class Code: WEB,544.43
9/21/2020,,Withdrawal ACH DISCOVER/TYPE: E-PAYMENT ID: 2510020270CO: DISCOVEREntry Class Code: WEB,455.55,,Posted,611.59,2020-09-21,455.55,Withdrawal ACH DISCOVER/TYPE: E-PAYMENT ID: 2510020270CO: DISCOVEREntry Class Code: WEB,455.55
9/21/2020,,Withdrawal ACH APPLECARD GSBANK/TYPE: PAYMENT ID: 9999999999CO: APPLECARD GSBANKEntry Class Code: WEB,150.0,,Posted,1067.14,2020-09-21,150.0,Withdrawal ACH APPLECARD GSBANK/TYPE: PAYMENT ID: 9999999999 CO: APPLECARD GSBANK Entry Class Code: WEB,150.0
9/21/2020,,Withdrawal ACH BEST BUY/TYPE: PAYMENT ID: CITIGPUFDRCO: BEST BUYEntry Class Code: PPD,33.04,,Posted,1217.14,2020-09-21,33.04,Withdrawal ACH BEST BUY/TYPE: PAYMENT ID: CITIGPUFDRCO: BEST BUYEntry Class Code: TEL,33.04
9/21/2020,,Withdrawal ACH PAYMENT FOR AMZ/TYPE: STORECARD ID: 9069872103CO: PAYMENT FOR AMZEntry Class Code: WEB,500.0,,Posted,1250.18,2020-09-21,500.0,Withdrawal ACH PAYMENT FOR AMZ/TYPE: STORECARD ID: 9069872103 CO: PAYMENT FOR AMZ Entry Class Code: WEB,500.0
9/21/2020,,Withdrawal ACH WAWA CREDIT CARD/TYPE: ONLINE PMT ID: CITICTPCO: WAWA CREDIT CARDEntry Class Code: WEB,29.0,,Posted,1750.18,2020-09-21,29.0,Withdrawal ACH WAWA CREDIT CARD/TYPE: PAYMENT ID: CITIGPUFDRCO: WAWA CREDIT CARDEntry Class Code: PPD,28.563333333333333
9/21/2020,,Withdrawal POS #000000060204/AMAZON.COM*M49XR9GP2 SEATTLE WACard 1140,102.55,,Posted,1779.18,2020-09-21,102.55,Withdrawal POS #000000000007/AMAZON.COM*2864R4HI1 SEATTLE WACard 1140,102.55
9/20/2020,,Withdrawal POS #000000058434/PUBLIX 3930 SW ARCHER ROA GAINESVILLE FLCard 1140,148.36,,Posted,1881.73,2020-09-20,148.36,Withdrawal POS #000000077534/PUBLIX 3930 SW ARCHER ROA GAINESVILLE FLCard 1140,148.36
9/20/2020,,Withdrawal Debit Card Signature Debit/PLAYSTATION NETWORK 800-345-7669 CADate 09/19/20 0 0263332251 4 5816Card 1140,159.98,,Posted,2030.09,2020-09-20,159.98,Withdrawal Debit Card Signature Debit/PLAYSTATION NETWORK 800-345-7669 CADate 02/13/21 0 1044014505 4 5816Card 1140,159.98
9/20/2020,,Withdrawal Debit Card Signature Debit/BESTBUYCOM806322187145 888-BESTBUY MNDate 09/18/20 0 0262415497 6 5732Card 1140,25.0,,Posted,2190.07,2020-09-20,25.0,Withdrawal Debit Card Signature Debit/BESTBUYCOM806322187145 888-BESTBUY MNDate 09/18/20 0 0262415497 6 5732Card 1140,25.0
9/20/2020,,Withdrawal Debit Card Signature Debit/BESTBUYCOM806322189231 888-BESTBUY MNDate 09/18/20 0 0262415494 6 5732Card 1140,25.0,,Posted,2215.07,2020-09-20,25.0,Withdrawal Debit Card Signature Debit/BESTBUYCOM806322187145 888-BESTBUY MNDate 09/18/20 0 0262415497 6 5732Card 1140,25.0
9/19/2020,,Withdrawal POS #000000058085/PUBLIX 3930 SW ARCHER ROA GAINESVILLE FLCard 1140,94.17,,Posted,2240.07,2020-09-19,94.17,Withdrawal POS #000000059255/PUBLIX 3930 SW ARCHER ROA GAINESVILLE FLCard 1140,94.17
9/19/2020,,"Withdrawal POS #000000492083/CHEVRON/CARY OIL CO., I MICANOPY FLCard 1140",29.82,,Posted,2334.24,2020-09-19,29.82,"Withdrawal POS #000000492083/CHEVRON/CARY OIL CO., I MICANOPY FLCard 1140",29.82
9/19/2020,,"Withdrawal at ATM #000000001760/PAI ISO 3401 SW 34TH ST., GAINESVILLE FLCard 1140",272.75,,Posted,2364.06,2020-09-19,272.75,"Withdrawal at ATM #000000002048/PAI ISO 3401 SW 34TH ST., GAINESVILLE FLCard 1140",272.75
9/18/2020,,Withdrawal POS #000000039667/WALGREENS STORE 2415 SW 7 GAINESVILLE FLCard 1140,45.42,,Posted,1136.81,2020-09-18,45.42,Withdrawal POS #000000305411/WALGREENS STORE 3455 SW A GAINESVILLE FLCard 1140,45.42
9/18/2020,,Withdrawal POS #000000018871/PUBLIX 3930 SW ARCHER ROA GAINESVILLE FLCard 1140,59.31,,Posted,1182.23,2020-09-18,59.31,Withdrawal POS #000000116993/PUBLIX 3930 SW ARCHER ROA GAINESVILLE FLCard 1140,59.31
9/18/2020,,Withdrawal Debit Card Signature Debit/PIZZA HUT 27918 https://ipcha FLDate 09/17/20 0 0261985303 3 5812Card 1140,35.04,,Posted,1241.54,2020-09-18,35.04,Withdrawal Debit Card Signature Debit/PIZZA HUT 27918 https://ipcha FL Date 06/09/20 0 0161727653 4 5812 Card 1140,35.54
9/17/2020,,Withdrawal ACH APPLECARD GSBANK/TYPE: PAYMENT ID: 9999999999CO: APPLECARD GSBANKEntry Class Code: WEB,707.86,,Posted,1276.58,2020-09-17,707.86,Withdrawal ACH APPLECARD GSBANK/TYPE: PAYMENT ID: 9999999999 CO: APPLECARD GSBANK Entry Class Code: WEB,707.86
9/17/2020,,Withdrawal ACH BARCLAYCARD US/TYPE: CREDITCARD ID: 2510407970CO: BARCLAYCARD USEntry Class Code: WEB,650.0,,Posted,1984.44,2020-09-17,650.0,Withdrawal ACH BARCLAYCARD US/TYPE: CREDITCARD ID: 2510407970 CO: BARCLAYCARD US Entry Class Code: WEB,650.0
9/14/2020,227.0,Draft 227,850.0,,Posted,134.44,2020-09-14,850.0,Draft 229,850.0
9/14/2020,,Withdrawal POS #000000439034/WALGREENS STORE 2415 SW 7 GAINESVILLE FLCard 1140,18.18,,Posted,984.44,2020-09-14,18.18,Withdrawal POS #000000305411/WALGREENS STORE 3455 SW A GAINESVILLE FLCard 1140,17.840000000000003
9/14/2020,,Withdrawal POS #000000413514/CIRCLE K # 21311 GAINESVILLE FLCard 1140,10.77,,Posted,1002.62,2020-09-14,10.77,Withdrawal POS #000000991864/CIRCLE K # 21142 GAINESVILLE FL Card 1140,10.77
9/12/2020,,Withdrawal POS #000000094429/PUBLIX 5200 S W 34TH STRE GAINESVILLE FLCard 1140,35.4,,Posted,975.39,2020-09-12,35.4,Withdrawal POS #000000080373/PUBLIX 5200 S W 34TH STRE GAINESVILLE FLCard 1140,35.485
9/12/2020,,"Withdrawal at ATM #000000000192/PAI ISO 3401 SW 34TH ST., GAINESVILLE FLCard 1140",82.75,,Posted,1010.79,2020-09-12,82.75,"Withdrawal at ATM #000000002048/PAI ISO 3401 SW 34TH ST., GAINESVILLE FLCard 1140",82.75
9/12/2020,,Withdrawal at ATM #000000000145/CAMPUS 1900 SW 34TH ST GAINESVILLE FLCard 1140,80.0,,Posted,1093.54,2020-09-12,80.0,Withdrawal at ATM #000000008812/CAMPUS 1900 SW 34TH ST GAINESVILLE FLCard 1140,80.0
9/8/2020,,Withdrawal POS #000000040807/PUBLIX 3930 SW ARCHER ROA GAINESVILLE FLCard 1140,64.87,,Posted,1173.54,2020-09-08,64.87,Withdrawal POS #000000098960/PUBLIX 3930 SW ARCHER ROA GAINESVILLE FLCard 1140,64.87
9/8/2020,,Withdrawal at ATM #000000006268/CAMPUS 1900 SW 34TH ST GAINESVILLE FLCard 1140,40.0,,Posted,1238.41,2020-09-08,40.0,Withdrawal at ATM #000000008812/CAMPUS 1900 SW 34TH ST GAINESVILLE FLCard 1140,40.0
9/8/2020,,Withdrawal ACH APPLECARD GSBANK/TYPE: PAYMENT ID: 9999999999CO: APPLECARD GSBANKEntry Class Code: WEB,42.0,,Posted,1278.41,2020-09-08,42.0,Withdrawal ACH APPLECARD GSBANK/TYPE: PAYMENT ID: 9999999999 CO: APPLECARD GSBANK Entry Class Code: WEB,42.0
9/8/2020,,Withdrawal ACH WAWA CREDIT CARD/TYPE: ONLINE PMT ID: CITICTPCO: WAWA CREDIT CARDEntry Class Code: WEB,28.67,,Posted,1320.41,2020-09-08,28.67,Withdrawal ACH WAWA CREDIT CARD/TYPE: PAYMENT ID: CITIGPUFDRCO: WAWA CREDIT CARDEntry Class Code: PPD,28.563333333333333
9/8/2020,,Withdrawal POS #000000074347/PUBLIX 3930 SW ARCHER ROA GAINESVILLE FLCard 1140,41.34,,Posted,1349.08,2020-09-08,41.34,Withdrawal POS #000000077534/PUBLIX 3930 SW ARCHER ROA GAINESVILLE FLCard 1140,41.34
9/6/2020,,Withdrawal at ATM #000000009659/CAMPUS 1900 SW 34TH ST GAINESVILLE FLCard 1140,80.0,,Posted,1355.58,2020-09-06,80.0,Withdrawal at ATM #000000001619/CAMPUS 1900 SW 34TH ST GAINESVILLE FL Card 1140,80.0
9/6/2020,,Withdrawal Debit Card Signature Debit/PIZZA HUT 27918 https://ipcha FLDate 09/03/20 0 0247623950 9 5812Card 1140,35.04,,Posted,1435.58,2020-09-06,35.04,Withdrawal Debit Card Signature Debit/PIZZA HUT 27918 https://ipcha FL Date 06/09/20 0 0161727653 4 5812 Card 1140,35.54
9/4/2020,,Withdrawal POS #000000116993/PUBLIX 3930 SW ARCHER ROA GAINESVILLE FLCard 1140,35.68,,Posted,1470.62,2020-09-04,35.68,Withdrawal POS #000000116993/PUBLIX 3930 SW ARCHER ROA GAINESVILLE FLCard 1140,35.68
9/4/2020,,Withdrawal at ATM #000000009522/CAMPUS 1900 SW 34TH ST GAINESVILLE FLCard 1140,40.0,,Posted,1506.3,2020-09-04,40.0,Withdrawal at ATM #000000008812/CAMPUS 1900 SW 34TH ST GAINESVILLE FLCard 1140,40.0
9/3/2020,,Withdrawal ACH COX COMM GAN/TYPE: BANK DRAFT ID: 1581620085CO: COX COMM GANEntry Class Code: WEB,131.54,,Posted,1546.3,2020-09-03,131.54,Withdrawal ACH COX COMM GAN/TYPE: BANK DRAFT ID: 1581620085CO: COX COMM GANEntry Class Code: WEB,131.54
9/3/2020,,Withdrawal ACH PAYMENT FOR AMZ/TYPE: STORECARD ID: 9069872103CO: PAYMENT FOR AMZEntry Class Code: WEB,35.09,,Posted,1677.84,2020-09-03,35.09,Withdrawal ACH PAYMENT FOR AMZ/TYPE: STORECARD ID: 9069872103 CO: PAYMENT FOR AMZ Entry Class Code: WEB,35.045
9/2/2020,,Withdrawal ACH CAPITAL ONE,35.0,,Posted,1712.93,2020-09-02,35.0,Withdrawal ACH CAPITAL ONE,35.0
9/2/2020,,Withdrawal ACH CITY OF GAINESVI/TYPE: 2000-6637- ID: 5330903620CO: CITY OF GAINESVIEntry Class Code: WEB,240.83,,Posted,1747.93,2020-09-02,240.83,Withdrawal ACH CITY OF GAINESVI/TYPE: 2000-6637- ID: 5330903620CO: CITY OF GAINESVIEntry Class Code: WEB,240.83
9/2/2020,,Withdrawal ACH DISCOVER/TYPE: E-PAYMENT ID: 2510020270CO: DISCOVEREntry Class Code: WEB,35.0,,Posted,1988.76,2020-09-02,35.0,Withdrawal ACH DISCOVER/TYPE: E-PAYMENT ID: 2510020270CO: DISCOVEREntry Class Code: WEB,35.0
9/2/2020,,Withdrawal ACH BARCLAYCARD US/TYPE: CREDITCARD ID: 2510407970CO: BARCLAYCARD USEntry Class Code: WEB,35.0,,Posted,2023.76,2020-09-02,35.0,Withdrawal ACH BARCLAYCARD US/TYPE: CREDITCARD ID: 2510407970 CO: BARCLAYCARD US Entry Class Code: WEB,35.0
9/1/2020,,Withdrawal at ATM #000000009263/CAMPUS 1900 SW 34TH ST GAINESVILLE FLCard 1140,60.0,,Posted,2058.76,2020-09-01,60.0,Withdrawal at ATM #000000008812/CAMPUS 1900 SW 34TH ST GAINESVILLE FLCard 1140,60.0
8/31/2020,,Withdrawal ACH APPLECARD GSBANK/TYPE: PAYMENT ID: 9999999999CO: APPLECARD GSBANKEntry Class Code: WEB,25.0,,Posted,2118.76,2020-08-31,25.0,Withdrawal ACH APPLECARD GSBANK/TYPE: PAYMENT ID: 9999999999 CO: APPLECARD GSBANK Entry Class Code: WEB,25.0
8/31/2020,,Withdrawal ACH DISCOVER/TYPE: E-PAYMENT ID: 2510020270CO: DISCOVEREntry Class Code: WEB,15.0,,Posted,2143.76,2020-08-31,15.0,Withdrawal ACH DISCOVER/TYPE: E-PAYMENT ID: 2510020270CO: DISCOVEREntry Class Code: WEB,15.0
8/30/2020,,Withdrawal Debit Card Signature Debit/PAYPAL *PLAYSTATION 402-935-7733 CADate 08/28/20 0 0241765429 5 7994Card 1140,14.98,,Posted,1158.76,2020-08-30,14.98,Withdrawal Debit Card Signature Debit/PAYPAL *EBAYINCSHIP 402-935-7733 CADate 08/04/20 0 0217477989 2 7399Card 1140,14.98
8/27/2020,,Withdrawal ACH PAYMENT FOR AMZ/TYPE: STORECARD ID: 9069872103CO: PAYMENT FOR AMZEntry Class Code: WEB,15.0,,Posted,8.83,2020-08-27,15.0,Withdrawal ACH PAYMENT FOR AMZ/TYPE: STORECARD ID: 9069872103 CO: PAYMENT FOR AMZ Entry Class Code: WEB,15.0
8/26/2020,,Withdrawal ATM Fee/ARCHER ROAD GAINESVILLE FLCard 1140,2.0,,Posted,23.83,2020-08-26,2.0,Withdrawal ATM Fee/ARCHER ROAD GAINESVILLE FLCard 1140,2.0
8/26/2020,,Withdrawal at ATM #000000725615/ARCHER ROAD GAINESVILLE FLCard 1140,24.0,,Posted,25.83,2020-08-26,24.0,Withdrawal at ATM #000000725615/ARCHER ROAD GAINESVILLE FLCard 1140,24.0
8/25/2020,,Withdrawal Debit Card Signature Debit/PRIVATEINTERNETACCESS WWW.PRIVATEIN CODate 08/24/20 0 0237693675 0 5734Card 1140,9.95,,Posted,21.83,2020-08-25,9.95,Withdrawal Debit Card Signature Debit/PRIVATEINTERNETACCESS WWW.PRIVATEIN CODate 01/24/21 0 1024716002 0 5734Card 1140,9.95
8/25/2020,,Withdrawal Debit Card Signature Debit/CELLULAR SALES EF-GV GAINESVILLE FLDate 08/24/20 0 0237708660 0 4812Card 1140,49.7,,Posted,31.78,2020-08-25,49.7,Withdrawal Debit Card Signature Debit/CELLULAR SALES EF-GV GAINESVILLE FLDate 08/24/20 0 0237708660 0 4812Card 1140,49.7
8/25/2020,,Withdrawal POS #000000730226/TARGET T-0687 3970 SW Arc Gainesville FLCard 1140,75.17,,Posted,81.48,2020-08-25,75.17,Withdrawal POS #000000730226/TARGET T-0687 3970 SW Arc Gainesville FLCard 1140,75.17
8/25/2020,,Withdrawal POS #000000015410/PUBLIX 3930 SW ARCHER ROA GAINESVILLE FLCard 1140,46.35,,Posted,156.65,2020-08-25,46.35,Withdrawal POS #000000116993/PUBLIX 3930 SW ARCHER ROA GAINESVILLE FLCard 1140,46.35
8/23/2020,,Withdrawal Debit Card Signature Debit/VZWRLSS*ETM SFL1434901 800-922-0204 FLDate 08/23/20 0 0236412185 0 4812Card 1140,28.0,,Posted,203.0,2020-08-23,28.0,Withdrawal Debit Card Signature Debit/VZWRLSS*ETM SFL1434901 800-922-0204 FLDate 08/23/20 0 0236412185 0 4812Card 1140,28.0
8/22/2020,,Withdrawal at ATM #000000008644/CAMPUS 1900 SW 34TH ST GAINESVILLE FLCard 1140,20.0,,Posted,31.0,2020-08-22,20.0,Withdrawal at ATM #000000008812/CAMPUS 1900 SW 34TH ST GAINESVILLE FLCard 1140,20.0
8/21/2020,,Recurring Withdrawal Debit Card - Signature Debit/DisneyPLUS 888-9057888 CADate 08/20/20 0 0233830273 3 5815Card 1140,8.03,,Posted,51.0,2020-08-21,8.03,Recurring Withdrawal Debit Card - Signature Debit/DisneyPLUS 888-9057888 CA Date 07/20/20 0 0202385035 3 5815 Card 1140,8.03
8/21/2020,,Withdrawal Debit Card Signature Debit/PAYPAL *TIGISOFTWAR 402-935-7733 CADate 08/20/20 0 0233425010 4 7372Card 1140,5.99,,Posted,59.03,2020-08-21,5.99,Withdrawal Debit Card Signature Debit/PAYPAL *TIGISOFTWAR 402-935-7733 CADate 08/20/20 0 0233425010 4 7372Card 1140,5.99
8/21/2020,,Withdrawal Debit Card Fee/VISA INTERNATIONAL SERVICE ASSESSMENTDate 08/20/20Card 1140,0.02,,Posted,65.02,2020-08-21,0.02,Withdrawal Debit Card Fee/VISA INTERNATIONAL SERVICE ASSESSMENTDate 02/18/21Card 1140,0.08
8/21/2020,,Withdrawal Debit Card Signature Debit/PAYPAL *CHARIZ 4029357733 AUDate 08/20/20 0 0233001840 3 5734Card 1140,2.99,,Posted,65.04,2020-08-21,2.99,Withdrawal Debit Card Signature Debit/PAYPAL *TIGISOFTWAR 402-935-7733 CADate 08/20/20 0 0233425010 4 7372Card 1140,2.99
8/21/2020,,Withdrawal Debit Card Fee/VISA INTERNATIONAL SERVICE ASSESSMENTDate 08/20/20Card 1140,0.01,,Posted,68.03,2020-08-21,0.01,Withdrawal Debit Card Fee/VISA INTERNATIONAL SERVICE ASSESSMENTDate 02/18/21Card 1140,0.08
8/21/2020,,Withdrawal Debit Card Signature Debit/PAYPAL *BLVCKLNGS 0635308003 FRDate 08/20/20 0 0233101255 0 7372Card 1140,1.25,,Posted,68.04,2020-08-21,1.25,Withdrawal Debit Card Signature Debit/PAYPAL *BLVCKLNGS 0635308003 FRDate 02/18/21 0 1049951415 4 7372Card 1140,1.58
8/21/2020,,Withdrawal POS #000000090559/PUBLIX 3930 SW ARCHER ROA GAINESVILLE FLCard 1140,92.68,,Posted,69.29,2020-08-21,92.68,Withdrawal POS #000000116993/PUBLIX 3930 SW ARCHER ROA GAINESVILLE FLCard 1140,92.68
8/20/2020,,Withdrawal Debit Card Signature Debit/PAYPAL *USPS 402-935-7733 DCDate 08/19/20 0 0232867544 0 9399Card 1140,7.5,,Posted,161.97,2020-08-20,7.5,Withdrawal Debit Card Signature Debit/PAYPAL *USPS 402-935-7733 DCDate 08/19/20 0 0232867544 0 9399Card 1140,7.5
8/20/2020,,Withdrawal Debit Card Signature Debit/WALGREENS #5024 800-289-2273 FLDate 08/19/20 0 0232227438 1 5912Card 1140,44.9,,Posted,169.47,2020-08-20,44.9,Withdrawal Debit Card Signature Debit/WALGREENS #5024 800-289-2273 FLDate 02/11/21 0 1042872537 0 5912Card 1140,44.9
8/19/2020,,Withdrawal/Cash Disbursed 70.00,70.0,,Posted,214.37,2020-08-19,70.0,Withdrawal/Cash Disbursed 35.00,70.0
8/16/2020,,Withdrawal POS #000000071511/PUBLIX 3930 SW ARCHER ROA GAINESVILLE FLCard 1140,27.19,,Posted,29.67,2020-08-16,27.19,Withdrawal POS #000000116993/PUBLIX 3930 SW ARCHER ROA GAINESVILLE FLCard 1140,27.255000000000003
8/14/2020,226.0,Draft 226,850.0,,Posted,56.86,2020-08-14,850.0,Draft 229,850.0
8/13/2020,,Withdrawal at ATM #000000004280/CAMPUS 1900 SW 34TH ST GAINESVILLE FLCard 1140,40.0,,Posted,906.86,2020-08-13,40.0,Withdrawal at ATM #000000008812/CAMPUS 1900 SW 34TH ST GAINESVILLE FLCard 1140,40.0
8/13/2020,,Withdrawal POS #000000079244/PUBLIX 3930 SW ARCHER ROA GAINESVILLE FLCard 1140,23.22,,Posted,946.86,2020-08-13,23.22,Withdrawal POS #000000059255/PUBLIX 3930 SW ARCHER ROA GAINESVILLE FLCard 1140,23.11
8/13/2020,,Withdrawal POS #000000462634/WALGREENS STORE 2415 SW 7 GAINESVILLE FLCard 1140,17.82,,Posted,970.08,2020-08-13,17.82,Withdrawal POS #000000305411/WALGREENS STORE 3455 SW A GAINESVILLE FLCard 1140,17.840000000000003
8/13/2020,,Withdrawal POS #000000304636/WALGREENS STORE 2415 SW 7 GAINESVILLE FLCard 1140,8.56,,Posted,987.9,2020-08-13,8.56,Withdrawal POS #000000305411/WALGREENS STORE 3455 SW A GAINESVILLE FLCard 1140,8.56
8/9/2020,,Withdrawal Debit Card Signature Debit/PlaystationNetwork 800-3457669 CADate 08/08/20 0 0221483677 4 5816Card 1140,24.93,,Posted,996.46,2020-08-09,24.93,Withdrawal Debit Card Signature Debit/PlaystationNetwork 800-3457669 CADate 08/08/20 0 0221483677 4 5816Card 1140,24.93
8/7/2020,,Withdrawal POS #000000076393/PUBLIX 3930 SW ARCHER ROA GAINESVILLE FLCard 1140,43.25,,Posted,1021.39,2020-08-07,43.25,Withdrawal POS #000000116993/PUBLIX 3930 SW ARCHER ROA GAINESVILLE FLCard 1140,43.25
8/6/2020,,Withdrawal ACH COX COMM GAN/TYPE: BANK DRAFT ID: 1581620085CO: COX COMM GANEntry Class Code: WEB,65.39,,Posted,1064.64,2020-08-06,65.39,Withdrawal ACH COX COMM GAN/TYPE: BANK DRAFT ID: 1581620085CO: COX COMM GANEntry Class Code: WEB,65.39
8/6/2020,,Withdrawal ACH PAYMENT FOR AMZ/TYPE: STORECARD ID: 9069872103CO: PAYMENT FOR AMZEntry Class Code: WEB,55.0,,Posted,1130.03,2020-08-06,55.0,Withdrawal ACH PAYMENT FOR AMZ/TYPE: STORECARD ID: 9069872103 CO: PAYMENT FOR AMZ Entry Class Code: WEB,55.0
8/5/2020,,Withdrawal POS #000000075127/PUBLIX 3930 SW ARCHER ROA GAINESVILLE FLCard 1140,2.0,,Posted,1185.03,2020-08-05,2.0,Withdrawal POS #000000059255/PUBLIX 3930 SW ARCHER ROA GAINESVILLE FLCard 1140,2.0
8/5/2020,,Withdrawal POS #000000075104/PUBLIX 3930 SW ARCHER ROA GAINESVILLE FLCard 1140,2.0,,Posted,1187.03,2020-08-05,2.0,Withdrawal POS #000000077534/PUBLIX 3930 SW ARCHER ROA GAINESVILLE FLCard 1140,2.0
8/5/2020,,Withdrawal Debit Card Signature Debit/PAYPAL *EBAYINCSHIP 402-935-7733 CADate 08/04/20 0 0217477989 2 7399Card 1140,8.76,,Posted,1189.03,2020-08-05,8.76,Withdrawal Debit Card Signature Debit/PAYPAL *EBAYINCSHIP 402-935-7733 CADate 08/04/20 0 0217477989 2 7399Card 1140,8.76
8/5/2020,,Withdrawal Debit Card Signature Debit/PAYPAL *EBAYINCSHIP 402-935-7733 CADate 08/04/20 0 0217477988 2 7399Card 1140,2.78,,Posted,1197.79,2020-08-05,2.78,Withdrawal Debit Card Signature Debit/PAYPAL *EBAYINCSHIP 402-935-7733 CADate 08/04/20 0 0217477989 2 7399Card 1140,2.78
8/5/2020,,Withdrawal Debit Card Signature Debit/PAYPAL *ZENIMAX ONL 855-296-3170 MDDate 08/04/20 0 0217738198 0 5816Card 1140,27.99,,Posted,1200.57,2020-08-05,27.99,Withdrawal Debit Card Signature Debit/PAYPAL *ZENIMAX ONL 855-296-3170 MDDate 08/04/20 0 0217738198 0 5816Card 1140,27.99
8/5/2020,,Withdrawal POS #000073015896/PETSMART # 0303 3736 SW ARCHER ROAGAINESVILLE FLCard 1140,44.58,,Posted,1228.56,2020-08-05,44.58,Withdrawal POS #000077034486/PETSMART # 0303 3736 SW ARCHER ROAGAINESVILLE FLCard 1140,44.58
8/5/2020,,Withdrawal ACH CITY OF GAINESVI/TYPE: 2000-6637- ID: 5330903620CO: CITY OF GAINESVIEntry Class Code: WEB,258.61,,Posted,1273.14,2020-08-05,258.61,Withdrawal ACH CITY OF GAINESVI/TYPE: 2000-6637- ID: 5330903620CO: CITY OF GAINESVIEntry Class Code: WEB,258.61
8/5/2020,,Withdrawal ACH APPLECARD GSBANK/TYPE: PAYMENT ID: 9999999999CO: APPLECARD GSBANKEntry Class Code: WEB,75.0,,Posted,1531.75,2020-08-05,75.0,Withdrawal ACH APPLECARD GSBANK/TYPE: PAYMENT ID: 9999999999 CO: APPLECARD GSBANK Entry Class Code: WEB,75.0
8/5/2020,,Withdrawal ACH CAPITAL ONE/TYPE: MOBILE PMT ID: 9279744980CO: CAPITAL ONEEntry Class Code: WEB,55.0,,Posted,1606.75,2020-08-05,55.0,Withdrawal ACH CAPITAL ONE/TYPE: MOBILE PMT ID: 9279744980CO: CAPITAL ONEEntry Class Code: WEB,55.0
8/5/2020,,Withdrawal ACH DISCOVER/TYPE: E-PAYMENT ID: 2510020270CO: DISCOVEREntry Class Code: WEB,55.0,,Posted,1661.75,2020-08-05,55.0,Withdrawal ACH DISCOVER/TYPE: E-PAYMENT ID: 2510020270CO: DISCOVEREntry Class Code: WEB,55.0
8/5/2020,,Withdrawal ACH BEST BUY/TYPE: PAYMENT ID: CITICTP CO: BEST BUYEntry Class Code: WEB,55.0,,Posted,1716.75,2020-08-05,55.0,Withdrawal ACH BEST BUY/TYPE: PAYMENT ID: CITICTP CO: BEST BUY Entry Class Code: WEB,55.0
8/5/2020,,Withdrawal ACH BARCLAYCARD US/TYPE: CREDITCARD ID: 2510407970CO: BARCLAYCARD USEntry Class Code: WEB,50.0,,Posted,1771.75,2020-08-05,50.0,Withdrawal ACH BARCLAYCARD US/TYPE: CREDITCARD ID: 2510407970 CO: BARCLAYCARD US Entry Class Code: WEB,50.0
8/5/2020,,Withdrawal ACH WAWA CREDIT CARD/TYPE: ONLINE PMT ID: CITICTPCO: WAWA CREDIT CARDEntry Class Code: WEB,28.02,,Posted,1821.75,2020-08-05,28.02,Withdrawal ACH WAWA CREDIT CARD/TYPE: PAYMENT ID: CITIGPUFDRCO: WAWA CREDIT CARDEntry Class Code: PPD,28.563333333333333
8/4/2020,,Withdrawal POS #000000055158/PUBLIX 3930 SW ARCHER ROA GAINESVILLE FLCard 1140,89.53,,Posted,1842.47,2020-08-04,89.53,Withdrawal POS #000000055188/PUBLIX 3930 SW ARCHER ROA GAINESVILLE FL Card 1140,89.53
8/4/2020,,Withdrawal POS #000015015644/PETSMART # 0303 3736 SW ARCHER ROAGAINESVILLE FLCard 1140,92.69,,Posted,1932.0,2020-08-04,92.69,Withdrawal POS #000077034486/PETSMART # 0303 3736 SW ARCHER ROAGAINESVILLE FLCard 1140,92.69
8/4/2020,,Withdrawal POS #000000095240/PUBLIX 3930 SW ARCHER ROA GAINESVILLE FLCard 1140,8.22,,Posted,2024.69,2020-08-04,8.22,Withdrawal POS #000000059255/PUBLIX 3930 SW ARCHER ROA GAINESVILLE FLCard 1140,8.22
7/31/2020,,Withdrawal Debit Card Signature Debit/PAYPAL *EBAYINCSHIP 408-376-7400 CADate 07/30/20 0 0212878255 2 7399Card 1140,2.84,,Posted,2032.91,2020-07-31,2.84,Withdrawal Debit Card Signature Debit/PAYPAL *EBAYINCSHIP 408-376-7400 CA Date 07/02/20 0 0184148024 3 7399 Card 1140,2.84
7/30/2020,,Withdrawal POS #000000011847/PUBLIX 5200 S W 34TH STRE GAINESVILLE FLCard 1140,30.03,,Posted,35.75,2020-07-30,30.03,Withdrawal POS #000000080373/PUBLIX 5200 S W 34TH STRE GAINESVILLE FLCard 1140,29.78333333333333
7/30/2020,,Withdrawal POS #000000037315/PUBLIX 3930 SW ARCHER ROA GAINESVILLE FLCard 1140,23.97,,Posted,43.13,2020-07-30,23.97,Withdrawal POS #000000077534/PUBLIX 3930 SW ARCHER ROA GAINESVILLE FLCard 1140,23.97
7/29/2020,,Withdrawal POS #000000071101/PUBLIX 3930 SW ARCHER ROA GAINESVILLE FLCard 1140,34.26,,Posted,67.1,2020-07-29,34.26,Withdrawal POS #000000116993/PUBLIX 3930 SW ARCHER ROA GAINESVILLE FLCard 1140,33.923333333333325
7/29/2020,,Withdrawal POS #000048013643/PETSMART # 0303 3736 SW ARCHER ROAGAINESVILLE FLCard 1140,68.59,,Posted,32.77,2020-07-29,68.59,Withdrawal POS #000077034486/PETSMART # 0303 3736 SW ARCHER ROAGAINESVILLE FLCard 1140,68.59
7/29/2020,,Withdrawal POS #000048013643/PETSMART # 0303 3736 SW ARCHER ROAGAINESVILLE FLCard 1140,68.59,,Posted,101.36,2020-07-29,68.59,Withdrawal POS #000077034486/PETSMART # 0303 3736 SW ARCHER ROAGAINESVILLE FLCard 1140,68.59
7/27/2020,,Withdrawal Courtesy Pay Fee/Entry Class Code: POS,35.0,,Posted,-68.05,2020-07-27,35.0,Withdrawal Courtesy Pay Fee/Entry Class Code: WEB,35.0
7/27/2020,,Withdrawal ACH TARGET DEBIT CRD/Location - TARGET -0687GAINESVILLE FL / Terminal ID: 071TYPE: ACH TRAN ID: 1410215170CO: TARGET DEBIT CRD,59.57,,Posted,-33.05,2020-07-27,59.57,Withdrawal ACH TARGET DEBIT CRD/Location - TARGET -0687GAINESVILLE FL / Terminal ID: 071TYPE: ACH TRAN ID: 1410215170CO: TARGET DEBIT CRD,59.57
7/26/2020,,Withdrawal Debit Card Signature Debit/PRIVATEINTERNETACCESS HTTPSWWW.PRIV CODate 07/24/20 0 0206170454 5 5734Card 1140,9.95,,Posted,25.59,2020-07-26,9.95,Withdrawal Debit Card Signature Debit/PRIVATEINTERNETACCESS HTTPSWWW.PRIV CODate 07/24/20 0 0206170454 5 5734Card 1140,9.95
7/26/2020,,Withdrawal Debit Card Signature Debit/PIZZA HUT 27921 https://ipcha FLDate 07/23/20 0 0205916161 8 5812Card 1140,40.62,,Posted,35.54,2020-07-26,40.62,Withdrawal Debit Card Signature Debit/PIZZA HUT 27918 https://ipcha FL Date 06/09/20 0 0161727653 4 5812 Card 1140,40.62
7/24/2020,,Withdrawal POS #000000878396/CK 2726162 7302 SW ARCHER RD GAINESVILLE FL Card 1140,23.44,,Posted,76.16,2020-07-24,23.44,Withdrawal POS #000000878396/CK 2726162 7302 SW ARCHER RD GAINESVILLE FL Card 1140,23.44
7/24/2020,,Withdrawal Debit Card Signature Debit/PAYPAL *KHANACADEMY 402-935-7733 CA Date 07/22/20 0 0204544073 4 8641 Card 1140,5.0,,Posted,99.6,2020-07-24,5.0,Withdrawal Debit Card Signature Debit/PAYPAL *KHANACADEMY 402-935-7733 CA Date 07/22/20 0 0204544073 4 8641 Card 1140,5.0
7/24/2020,,Withdrawal POS #000000806824/WAWA 5325 2373 SW ARCHER ROA GAINESVILLE FL Card 1140,22.69,,Posted,104.6,2020-07-24,22.69,Withdrawal POS #000000806824/WAWA 5325 2373 SW ARCHER ROA GAINESVILLE FL Card 1140,22.69
7/22/2020,,Withdrawal Debit Card Signature Debit/PAYPAL *ZENIMAX ONL 855-296-3170 MD Date 07/21/20 0 0203684968 0 5816 Card 1140,39.99,,Posted,97.29,2020-07-22,39.99,Withdrawal Debit Card Signature Debit/PAYPAL *ZENIMAX ONL 855-296-3170 MDDate 08/04/20 0 0217738198 0 5816Card 1140,39.99
7/22/2020,,Withdrawal Debit Card Signature Debit/WALGREENS #5024 GAINESVILLE FL Date 07/21/20 0 0203163833 1 5912 Card 1140,41.38,,Posted,137.28,2020-07-22,41.38,Withdrawal Debit Card Signature Debit/WALGREENS #5024 GAINESVILLE FL Date 07/21/20 0 0203163833 1 5912 Card 1140,41.38
7/22/2020,,Withdrawal POS #000000091710/PUBLIX 3930 SW ARCHER ROA GAINESVILLE FL Card 1140,209.54,,Posted,178.66,2020-07-22,209.54,Withdrawal POS #000000025042/PUBLIX 3930 SW ARCHER ROA GAINESVILLE FL Card 1140,209.54
7/21/2020,,Recurring Withdrawal Debit Card - Signature Debit/DisneyPLUS 888-9057888 CA Date 07/20/20 0 0202385035 3 5815 Card 1140,8.03,,Posted,388.2,2020-07-21,8.03,Recurring Withdrawal Debit Card - Signature Debit/DisneyPLUS 888-9057888 CA Date 07/20/20 0 0202385035 3 5815 Card 1140,8.03
7/21/2020,,Withdrawal ACH CAPITAL ONE/TYPE: MOBILE PMT ID: 9279744980 CO: CAPITAL ONE Entry Class Code: WEB,25.0,,Posted,396.23,2020-07-21,25.0,Withdrawal ACH CAPITAL ONE/TYPE: ONLINE PMT ID: 9279744991 CO: CAPITAL ONE Entry Class Code: WEB,25.0
7/20/2020,,Withdrawal ACH BEST BUY/TYPE: PAYMENT ID: CITICTP CO: BEST BUY Entry Class Code: WEB,50.0,,Posted,421.23,2020-07-20,50.0,Withdrawal ACH BEST BUY/TYPE: PAYMENT ID: CITICTP CO: BEST BUY Entry Class Code: WEB,50.0
7/17/2020,,Withdrawal Debit Card Signature Debit/WALGREENS #5024 GAINESVILLE FL Date 07/16/20 0 0198227931 1 5912 Card 1140,8.31,,Posted,471.23,2020-07-17,8.31,Withdrawal Debit Card Signature Debit/WALGREENS #5024 GAINESVILLE FL Date 07/21/20 0 0203163833 1 5912 Card 1140,8.31
7/16/2020,,Withdrawal POS #000000050234/PUBLIX 3930 SW ARCHER ROA GAINESVILLE FL Card 1140,26.58,,Posted,479.54,2020-07-16,26.58,Withdrawal POS #000000025042/PUBLIX 3930 SW ARCHER ROA GAINESVILLE FL Card 1140,26.58
7/16/2020,,Withdrawal POS #000000218861/WALGREENS STORE 2415 SW 7 GAINESVILLE FL Card 1140,18.17,,Posted,333.93,2020-07-16,18.17,Withdrawal POS #000000218861/WALGREENS STORE 2415 SW 7 GAINESVILLE FL Card 1140,18.6
7/16/2020,,Withdrawal POS #000000141777/WALGREENS STORE 2415 SW 7 GAINESVILLE FL Card 1140,8.34,,Posted,352.1,2020-07-16,8.34,Withdrawal POS #000000218861/WALGREENS STORE 2415 SW 7 GAINESVILLE FL Card 1140,8.316666666666666
7/14/2020,225.0,Draft 225,850.0,,Posted,360.44,2020-07-14,850.0,Draft 229,850.0
7/13/2020,,Withdrawal Debit Card Signature Debit/ELDERSCROLLSONLINE. 855-296-3170 MD Date 07/13/20 0 0195400748 0 7994 Card 1140,14.99,,Posted,1210.44,2020-07-13,14.99,Withdrawal Debit Card Signature Debit/ELDERSCROLLSONLINE. 855-296-3170 MD Date 07/13/20 0 0195400748 0 7994 Card 1140,14.99
7/12/2020,,Recurring Withdrawal Debit Card - Signature Debit/PlaystationNetwork 800-3457669 CA Date 07/10/20 0 0192717875 8 5816 Card 1140,9.99,,Posted,1225.43,2020-07-12,9.99,Recurring Withdrawal Debit Card - Signature Debit/PlaystationNetwork 800-3457669 CA Date 07/10/20 0 0192717875 8 5816 Card 1140,9.99
7/9/2020,,Withdrawal at ATM #000000001619/CAMPUS 1900 SW 34TH ST GAINESVILLE FL Card 1140,60.0,,Posted,1235.42,2020-07-09,60.0,Withdrawal at ATM #000000001048/PUBLIX 3100 S W 35TH BLV GAINESVILLE FL Card 1140,60.0
7/8/2020,,Withdrawal ACH APPLECARD GSBANK/TYPE: PAYMENT ID: 9999999999 CO: APPLECARD GSBANK Entry Class Code: WEB,50.0,,Posted,1295.42,2020-07-08,50.0,Withdrawal ACH APPLECARD GSBANK/TYPE: PAYMENT ID: 9999999999 CO: APPLECARD GSBANK Entry Class Code: WEB,50.0
7/8/2020,,Withdrawal POS #000000097350/PUBLIX 3930 SW ARCHER ROA GAINESVILLE FL Card 1140,30.55,,Posted,1345.42,2020-07-08,30.55,Withdrawal POS #000000025042/PUBLIX 3930 SW ARCHER ROA GAINESVILLE FL Card 1140,30.55
7/7/2020,,Withdrawal POS #000000097226/PUBLIX 3930 SW ARCHER ROA GAINESVILLE FL Card 1140,81.82,,Posted,1375.97,2020-07-07,81.82,Withdrawal POS #000000025042/PUBLIX 3930 SW ARCHER ROA GAINESVILLE FL Card 1140,81.82
7/7/2020,,Withdrawal POS #000000465552/WAWA 5325 2373 SW ARCHER ROA GAINESVILLE FL Card 1140,25.43,,Posted,1457.79,2020-07-07,25.43,Withdrawal POS #000000806824/WAWA 5325 2373 SW ARCHER ROA GAINESVILLE FL Card 1140,25.43
7/7/2020,,Withdrawal ACH APPLECARD GSBANK/TYPE: PAYMENT ID: 9999999999 CO: APPLECARD GSBANK Entry Class Code: WEB,125.0,,Posted,1483.22,2020-07-07,125.0,Withdrawal ACH APPLECARD GSBANK/TYPE: PAYMENT ID: 9999999999 CO: APPLECARD GSBANK Entry Class Code: WEB,125.0
7/7/2020,,Withdrawal ACH BARCLAYCARD US/TYPE: CREDITCARD ID: 2510407970 CO: BARCLAYCARD US Entry Class Code: WEB,50.0,,Posted,1608.22,2020-07-07,50.0,Withdrawal ACH BARCLAYCARD US/TYPE: CREDITCARD ID: 2510407970 CO: BARCLAYCARD US Entry Class Code: WEB,50.0
7/7/2020,,Withdrawal ACH DISCOVER/TYPE: E-PAYMENT ID: 2510020270 CO: DISCOVER Entry Class Code: WEB,50.0,,Posted,1658.22,2020-07-07,50.0,Withdrawal ACH DISCOVER/TYPE: E-PAYMENT ID: 2510020270 CO: DISCOVER Entry Class Code: WEB,50.0
7/6/2020,,Withdrawal ACH B2P*FLDOH-OMMU/TYPE: B2P*FLDOH ID: BILL2PAYVS CO: B2P*FLDOH-OMMU Entry Class Code: WEB,77.75,,Posted,1708.22,2020-07-06,77.75,Withdrawal ACH B2P*FLDOH-OMMU/TYPE: B2P*FLDOH ID: BILL2PAYVS CO: B2P*FLDOH-OMMU Entry Class Code: WEB,77.75
7/3/2020,,Withdrawal Debit Card Signature Debit/PAYPAL *EBAYINCSHIP 408-376-7400 CA Date 07/02/20 0 0184148024 3 7399 Card 1140,11.19,,Posted,1785.97,2020-07-03,11.19,Withdrawal Debit Card Signature Debit/PAYPAL *EBAYINCSHIP 408-376-7400 CA Date 07/02/20 0 0184148024 3 7399 Card 1140,11.19
7/2/2020,,Withdrawal ACH CITY OF GAINESVI/TYPE: 2000-6637- ID: 5330903620 CO: CITY OF GAINESVI Entry Class Code: WEB,196.5,,Posted,1797.16,2020-07-02,196.5,Withdrawal ACH CITY OF GAINESVI/TYPE: 2000-6637- ID: 5330903620 CO: CITY OF GAINESVI Entry Class Code: PPD,196.5
7/2/2020,,Withdrawal ACH APPLECARD GSBANK/TYPE: PAYMENT ID: 9999999999 CO: APPLECARD GSBANK Entry Class Code: WEB,125.0,,Posted,1993.66,2020-07-02,125.0,Withdrawal ACH APPLECARD GSBANK/TYPE: PAYMENT ID: 9999999999 CO: APPLECARD GSBANK Entry Class Code: WEB,125.0
6/30/2020,,Withdrawal ACH APPLECARD GSBANK/TYPE: PAYMENT ID: 9999999999 CO: APPLECARD GSBANK Entry Class Code: WEB,95.0,,Posted,1118.66,2020-06-30,95.0,Withdrawal ACH APPLECARD GSBANK/TYPE: PAYMENT ID: 9999999999 CO: APPLECARD GSBANK Entry Class Code: WEB,94.53
6/29/2020,,Withdrawal POS #000000030357/PUBLIX 3930 SW ARCHER ROA GAINESVILLE FL Card 1140,47.17,,Posted,1203.5,2020-06-29,47.17,Withdrawal POS #000000025042/PUBLIX 3930 SW ARCHER ROA GAINESVILLE FL Card 1140,47.17
6/29/2020,,Withdrawal ACH BARCLAYCARD US/TYPE: CREDITCARD ID: 2510407970 CO: BARCLAYCARD US Entry Class Code: WEB,39.0,,Posted,250.67,2020-06-29,39.0,Withdrawal ACH BARCLAYCARD US/TYPE: CREDITCARD ID: 2510407970 CO: BARCLAYCARD US Entry Class Code: WEB,39.5
6/29/2020,,Withdrawal ACH PAYMENT FOR AMZ/TYPE: STORECARD ID: 9069872103 CO: PAYMENT FOR AMZ Entry Class Code: WEB,25.0,,Posted,289.67,2020-06-29,25.0,Withdrawal ACH PAYMENT FOR AMZ/TYPE: STORECARD ID: 9069872103 CO: PAYMENT FOR AMZ Entry Class Code: WEB,25.0
6/28/2020,,Withdrawal POS #000000429760/WALGREENS STORE 2415 SW 7 GAINESVILLE FL Card 1140,25.18,,Posted,314.67,2020-06-28,25.18,Withdrawal POS #000000218861/WALGREENS STORE 2415 SW 7 GAINESVILLE FL Card 1140,25.18
6/25/2020,,Withdrawal POS #000000072679/PUBLIX 3930 SW ARCHER ROA GAINESVILLE FL Card 1140,53.65,,Posted,339.85,2020-06-25,53.65,Withdrawal POS #000000025042/PUBLIX 3930 SW ARCHER ROA GAINESVILLE FL Card 1140,54.09
6/25/2020,,Withdrawal Debit Card Signature Debit/PRIVATEINTERNETACCESS HTTPSWWW.PRIV CO Date 06/24/20 0 0176491301 0 5734 Card 1140,9.95,,Posted,193.5,2020-06-25,9.95,Withdrawal Debit Card Signature Debit/PRIVATEINTERNETACCESS HTTPSWWW.PRIV CODate 07/24/20 0 0206170454 5 5734Card 1140,9.95
6/25/2020,,Withdrawal ACH TARGET DEBIT CRD/Location - TARGET -0687 GAINESVILLE FL / Terminal ID: 173 TYPE: ACH TRAN ID: 1410215170CO: TARGET DEBIT CRDEntry Class,77.97,,Posted,203.45,2020-06-25,77.97,Withdrawal ACH TARGET DEBIT CRD/Location - TARGET -0687Gainesville FL / Terminal ID: 172TYPE: ACH TRAN ID: 1410215170CO: TARGET DEBIT CRDEntry Class C,77.97
6/24/2020,,Withdrawal Debit Card Signature Debit/CCVC-OCALA OCALA FL Date 06/23/20 0 0175551245 0 0742 Card 1140,448.94,,Posted,281.42,2020-06-24,448.94,Withdrawal Debit Card Signature Debit/CCVC-OCALA OCALA FL Date 06/23/20 0 0175551245 0 0742 Card 1140,448.94
6/23/2020,,Withdrawal POS #000000224049/FAST TRACK #200 3960 SW ARCHER RD GAINESVILLE FL Card 1140,25.61,,Posted,730.36,2020-06-23,25.61,Withdrawal POS #000000224049/FAST TRACK #200 3960 SW ARCHER RD GAINESVILLE FL Card 1140,25.61
6/23/2020,,Withdrawal Debit Card Signature Debit/WALGREENS #5024 GAINESVILLE FL Date 06/22/20 0 0174219688 1 5912 Card 1140,37.51,,Posted,355.97,2020-06-23,37.51,Withdrawal Debit Card Signature Debit/WALGREENS #5024 GAINESVILLE FL Date 07/21/20 0 0203163833 1 5912 Card 1140,37.51
6/23/2020,,Withdrawal POS #000000039481/PUBLIX 3930 SW ARCHER ROA GAINESVILLE FL Card 1140,60.93,,Posted,168.48,2020-06-23,60.93,Withdrawal POS #000000093462/PUBLIX 3930 SW ARCHER ROA GAINESVILLE FL Card 1140,60.93
6/22/2020,,Withdrawal at ATM #000000000203/CAMPUS 1900 SW 34TH ST GAINESVILLE FL Card 1140,20.0,,Posted,229.41,2020-06-22,20.0,Withdrawal at ATM #000000001048/PUBLIX 3100 S W 35TH BLV GAINESVILLE FL Card 1140,20.0
6/21/2020,,Withdrawal POS #000000065183/FAST TRACK #200 3960 SW ARCHER RD GAINESVILLE FL Card 1140,21.11,,Posted,249.41,2020-06-21,21.11,Withdrawal POS #000000224049/FAST TRACK #200 3960 SW ARCHER RD GAINESVILLE FL Card 1140,21.11
6/21/2020,,Withdrawal POS #000000070392/PUBLIX 3930 SW ARCHER ROA GAINESVILLE FL Card 1140,37.74,,Posted,270.52,2020-06-21,37.74,Withdrawal POS #000000025042/PUBLIX 3930 SW ARCHER ROA GAINESVILLE FL Card 1140,37.46
6/20/2020,,Withdrawal POS #000000079791/PUBLIX 3930 SW ARCHER ROA GAINESVILLE FL Card 1140,24.99,,Posted,308.26,2020-06-20,24.99,Withdrawal POS #000000055188/PUBLIX 3930 SW ARCHER ROA GAINESVILLE FL Card 1140,24.99
6/19/2020,,Withdrawal POS #000000331803/WALGREENS STORE 2415 SW 7 GAINESVILLE FL Card 1140,4.82,,Posted,33.25,2020-06-19,4.82,Withdrawal POS #000000218861/WALGREENS STORE 2415 SW 7 GAINESVILLE FL Card 1140,4.8500000000000005
6/19/2020,,Withdrawal POS #000000788644/FAST TRACK #200 3960 SW ARCHER RD GAINESVILLE FL Card 1140,16.74,,Posted,38.07,2020-06-19,16.74,Withdrawal POS #000000224049/FAST TRACK #200 3960 SW ARCHER RD GAINESVILLE FL Card 1140,16.74
6/18/2020,,Withdrawal POS #000000016208/PUBLIX 3930 SW ARCHER ROA GAINESVILLE FL Card 1140,33.17,,Posted,54.81,2020-06-18,33.17,Withdrawal POS #000000025042/PUBLIX 3930 SW ARCHER ROA GAINESVILLE FL Card 1140,33.17
6/16/2020,,Withdrawal Debit Card Signature Debit/PIZZA HUT 27918 https://ipcha FL Date 06/14/20 0 0166692117 3 5812 Card 1140,36.04,,Posted,87.98,2020-06-16,36.04,Withdrawal Debit Card Signature Debit/PIZZA HUT 27918 https://ipcha FL Date 06/09/20 0 0161727653 4 5812 Card 1140,35.54
6/15/2020,,Withdrawal POS #000000038067/PUBLIX 3930 SW ARCHER ROA GAINESVILLE FL Card 1140,71.91,,Posted,124.02,2020-06-15,71.91,Withdrawal POS #000000093462/PUBLIX 3930 SW ARCHER ROA GAINESVILLE FL Card 1140,71.91
6/12/2020,,Withdrawal Debit Card Signature Debit/WALGREENS #5024 GAINESVILLE FL Date 06/11/20 0 0163086764 1 5912 Card 1140,12.85,,Posted,195.93,2020-06-12,12.85,Withdrawal Debit Card Signature Debit/WALGREENS #5024 GAINESVILLE FL Date 07/21/20 0 0203163833 1 5912 Card 1140,12.85
6/11/2020,,Withdrawal Debit Card Signature Debit/PIZZA HUT 27918 https://ipcha FL Date 06/09/20 0 0161727653 4 5812 Card 1140,29.69,,Posted,208.78,2020-06-11,29.69,Withdrawal Debit Card Signature Debit/PIZZA HUT 27918 https://ipcha FL Date 06/09/20 0 0161727653 4 5812 Card 1140,29.69
6/11/2020,,Withdrawal ACH COX COMM GAN/TYPE: BANK DRAFT ID: 1581620085 CO: COX COMM GAN Entry Class Code: WEB,104.75,,Posted,238.47,2020-06-11,104.75,Withdrawal ACH COX COMM GAN/TYPE: BANK DRAFT ID: 1581620085 CO: COX COMM GAN Entry Class Code: PPD,104.75
6/10/2020,204.0,Draft 204,850.0,,Posted,343.22,2020-06-10,850.0,Draft 204,850.0
6/10/2020,,Withdrawal POS #000000074057/PUBLIX 3930 SW ARCHER ROA GAINESVILLE FL Card 1140,52.42,,Posted,1193.22,2020-06-10,52.42,Withdrawal POS #000000055188/PUBLIX 3930 SW ARCHER ROA GAINESVILLE FL Card 1140,52.42
6/9/2020,,Withdrawal POS #000000160819/WALGREENS STORE 2415 SW 7 GAINESVILLE FL Card 1140,7.16,,Posted,1245.64,2020-06-09,7.16,Withdrawal POS #000000218861/WALGREENS STORE 2415 SW 7 GAINESVILLE FL Card 1140,7.6450000000000005
6/8/2020,,Withdrawal ACH CAPITAL ONE/TYPE: MOBILE PMT ID: 9279744980 CO: CAPITAL ONE Entry Class Code: WEB,156.43,,Posted,1252.8,2020-06-08,156.43,Withdrawal ACH CAPITAL ONE/TYPE: ONLINE PMT ID: 9279744991 CO: CAPITAL ONE Entry Class Code: WEB,156.43
6/8/2020,,Withdrawal ACH BEST BUY/TYPE: PAYMENT ID: CITICTP CO: BEST BUY Entry Class Code: WEB,125.0,,Posted,1409.23,2020-06-08,125.0,Withdrawal ACH BEST BUY/TYPE: PAYMENT ID: CITICTP CO: BEST BUY Entry Class Code: WEB,125.0
6/8/2020,,Withdrawal ACH DISCOVER/TYPE: E-PAYMENT ID: 2510020270 CO: DISCOVER Entry Class Code: WEB,100.0,,Posted,1534.23,2020-06-08,100.0,Withdrawal ACH DISCOVER/TYPE: E-PAYMENT ID: 2510020270 CO: DISCOVER Entry Class Code: WEB,100.0
6/8/2020,,Withdrawal ACH BARCLAYCARD US/TYPE: CREDITCARD ID: 2510407970 CO: BARCLAYCARD US Entry Class Code: WEB,100.0,,Posted,1634.23,2020-06-08,100.0,Withdrawal ACH BARCLAYCARD US/TYPE: CREDITCARD ID: 2510407970 CO: BARCLAYCARD US Entry Class Code: WEB,100.0
6/8/2020,,Withdrawal ACH APPLECARD GSBANK/TYPE: PAYMENT ID: 9999999999 CO: APPLECARD GSBANK Entry Class Code: WEB,100.0,,Posted,1734.23,2020-06-08,100.0,Withdrawal ACH APPLECARD GSBANK/TYPE: PAYMENT ID: 9999999999 CO: APPLECARD GSBANK Entry Class Code: WEB,100.0
6/5/2020,,Withdrawal ACH APPLECARD GSBANK/TYPE: PAYMENT ID: 9999999999 CO: APPLECARD GSBANK Entry Class Code: WEB,50.0,,Posted,1334.23,2020-06-05,50.0,Withdrawal ACH APPLECARD GSBANK/TYPE: PAYMENT ID: 9999999999 CO: APPLECARD GSBANK Entry Class Code: WEB,50.0
6/3/2020,,Withdrawal ACH APPLECARD GSBANK/TYPE: PAYMENT ID: 9999999999 CO: APPLECARD GSBANK Entry Class Code: WEB,75.0,,Posted,1384.23,2020-06-03,75.0,Withdrawal ACH APPLECARD GSBANK/TYPE: PAYMENT ID: 9999999999 CO: APPLECARD GSBANK Entry Class Code: WEB,75.0
6/3/2020,,Withdrawal POS #000000056254/PUBLIX 5200 S W 34TH STRE GAINESVILLE FL Card 1140,19.03,,Posted,1459.23,2020-06-03,19.03,Withdrawal POS #000000080373/PUBLIX 5200 S W 34TH STRE GAINESVILLE FLCard 1140,19.03
6/2/2020,,Withdrawal ACH APPLECARD GSBANK/TYPE: PAYMENT ID: 9999999999 CO: APPLECARD GSBANK Entry Class Code: WEB,75.0,,Posted,1478.26,2020-06-02,75.0,Withdrawal ACH APPLECARD GSBANK/TYPE: PAYMENT ID: 9999999999 CO: APPLECARD GSBANK Entry Class Code: WEB,75.0
6/1/2020,,Withdrawal POS #000000784393/FAST TRACK #200 3960 SW ARCHER RD GAINESVILLE FL Card 1140,8.37,,Posted,1553.26,2020-06-01,8.37,Withdrawal POS #000000224049/FAST TRACK #200 3960 SW ARCHER RD GAINESVILLE FL Card 1140,8.37
6/1/2020,,Withdrawal POS #000000097798/PUBLIX 3930 SW ARCHER ROA GAINESVILLE FL Card 1140,105.77,,Posted,1561.63,2020-06-01,105.77,Withdrawal POS #000000055188/PUBLIX 3930 SW ARCHER ROA GAINESVILLE FL Card 1140,105.77
6/1/2020,,Withdrawal Debit Card Signature Debit/PAYPAL *DPORTAL 402-935-7733 CA Date 05/31/20 0 0152066777 2 5732 Card 1140,19.99,,Posted,1659.01,2020-06-01,19.99,Withdrawal Debit Card Signature Debit/PAYPAL *DPORTAL 402-935-7733 CA Date 05/31/20 0 0152066777 2 5732 Card 1140,19.99
6/1/2020,,Withdrawal ACH CITY OF GAINESVI/TYPE: 2000-6637- ID: 5330903620 CO: CITY OF GAINESVI Entry Class Code: WEB,182.85,,Posted,1679.0,2020-06-01,182.85,Withdrawal ACH CITY OF GAINESVI/TYPE: 2000-6637- ID: 5330903620 CO: CITY OF GAINESVI Entry Class Code: PPD,182.85
6/1/2020,,Withdrawal ACH CAPITAL ONE/TYPE: ONLINE PMT ID: 9279744991 CO: CAPITAL ONE Entry Class Code: WEB,50.0,,Posted,1861.85,2020-06-01,50.0,Withdrawal ACH CAPITAL ONE/TYPE: ONLINE PMT ID: 9279744991 CO: CAPITAL ONE Entry Class Code: WEB,50.0
6/1/2020,,Withdrawal ACH DISCOVER/TYPE: E-PAYMENT ID: 2510020270 CO: DISCOVER Entry Class Code: WEB,50.0,,Posted,1911.85,2020-06-01,50.0,Withdrawal ACH DISCOVER/TYPE: E-PAYMENT ID: 2510020270 CO: DISCOVER Entry Class Code: WEB,50.0
6/1/2020,,Withdrawal ACH BEST BUY/TYPE: PAYMENT ID: CITICTP CO: BEST BUY Entry Class Code: WEB,35.0,,Posted,1961.85,2020-06-01,35.0,Withdrawal ACH BEST BUY/TYPE: PAYMENT ID: CITICTP CO: BEST BUY Entry Class Code: WEB,35.0
5/31/2020,,Withdrawal POS #000000661036/WAWA 5291 3312 W SILVER SPRI OCALA FL Card 1140,35.6,,Posted,1996.85,2020-05-31,35.6,Withdrawal POS #000000661036/WAWA 5291 3312 W SILVER SPRI OCALA FL Card 1140,35.6
5/27/2020,,Withdrawal at ATM #000000008280/CAMPUS 1900 SW 34TH ST GAINESVILLE FL Card 1140,40.0,,Posted,32.45,2020-05-27,40.0,Withdrawal at ATM #000000001048/PUBLIX 3100 S W 35TH BLV GAINESVILLE FL Card 1140,40.0
5/27/2020,,Withdrawal ACH DISCOVER/TYPE: E-PAYMENT ID: 2510020270 CO: DISCOVER Entry Class Code: WEB,48.51,,Posted,72.45,2020-05-27,48.51,Withdrawal ACH DISCOVER/TYPE: E-PAYMENT ID: 2510020270 CO: DISCOVER Entry Class Code: WEB,48.51
5/26/2020,,Withdrawal Debit Card Signature Debit/STEAMGAMES.COM 4259522 425-8899642 WA Date 05/26/20 0 0147820747 1 5816 Card 1140,29.99,,Posted,20.96,2020-05-26,29.99,Withdrawal Debit Card Signature Debit/STEAMGAMES.COM 4259522 425-8899642 WA Date 05/26/20 0 0147820747 1 5816 Card 1140,29.99
5/26/2020,,Recurring Withdrawal Debit Card - Signature Debit/STEAMGAMES.COM 425-889-9642 WA Date 05/24/20 0 0145207548 1 5816 Card 1140,14.99,,Posted,50.95,2020-05-26,14.99,Withdrawal Debit Card Signature Debit/STEAMGAMES.COM 4259522 425-8899642 WA Date 05/26/20 0 0147820747 1 5816 Card 1140,14.99
5/26/2020,,Withdrawal ACH CAPITAL ONE/TYPE: ONLINE PMT ID: 9279744991 CO: CAPITAL ONE Entry Class Code: WEB,45.0,,Posted,65.94,2020-05-26,45.0,Withdrawal ACH CAPITAL ONE/TYPE: ONLINE PMT ID: 9279744991 CO: CAPITAL ONE Entry Class Code: WEB,45.0
5/26/2020,,Withdrawal ACH BARCLAYCARD US/TYPE: CREDITCARD ID: 2510407970 CO: BARCLAYCARD US Entry Class Code: WEB,35.0,,Posted,110.94,2020-05-26,35.0,Withdrawal ACH BARCLAYCARD US/TYPE: CREDITCARD ID: 2510407970 CO: BARCLAYCARD US Entry Class Code: WEB,35.0
5/26/2020,,Withdrawal ACH APPLECARD GSBANK/TYPE: PAYMENT ID: 9999999999 CO: APPLECARD GSBANK Entry Class Code: WEB,25.0,,Posted,145.94,2020-05-26,25.0,Withdrawal ACH APPLECARD GSBANK/TYPE: PAYMENT ID: 9999999999 CO: APPLECARD GSBANK Entry Class Code: WEB,25.0
5/25/2020,,Withdrawal Debit Card Signature Debit/PRIVATEINTERNETACCESS HTTPSWWW.PRIV CO Date 05/24/20 0 0145163402 2 5734 Card 1140,9.95,,Posted,170.94,2020-05-25,9.95,Withdrawal Debit Card Signature Debit/PRIVATEINTERNETACCESS HTTPSWWW.PRIV CODate 07/24/20 0 0206170454 5 5734Card 1140,9.95
5/25/2020,,Withdrawal Debit Card Signature Debit/WALGREENS #5024 GAINESVILLE FL Date 05/24/20 0 0145357402 1 5912 Card 1140,25.11,,Posted,180.89,2020-05-25,25.11,Withdrawal Debit Card Signature Debit/WALGREENS #5024 GAINESVILLE FL Date 07/21/20 0 0203163833 1 5912 Card 1140,25.11
5/23/2020,,Withdrawal POS #000000209403/WALGREENS STORE 2415 SW 7 GAINESVILLE FL Card 1140,9.48,,Posted,206.0,2020-05-23,9.48,Withdrawal POS #000000218861/WALGREENS STORE 2415 SW 7 GAINESVILLE FL Card 1140,9.48
5/22/2020,,Withdrawal POS #000000823051/FAST TRACK #200 3960 SW ARCHER RD GAINESVILLE FL Card 1140,16.74,,Posted,215.48,2020-05-22,16.74,Withdrawal POS #000000224049/FAST TRACK #200 3960 SW ARCHER RD GAINESVILLE FL Card 1140,16.74
5/22/2020,,Withdrawal POS #000000032628/PUBLIX 3930 SW ARCHER ROA GAINESVILLE FL Card 1140,28.46,,Posted,232.22,2020-05-22,28.46,Withdrawal POS #000000025042/PUBLIX 3930 SW ARCHER ROA GAINESVILLE FL Card 1140,28.46
5/22/2020,,Withdrawal ACH APPLECARD GSBANK/TYPE: PAYMENT ID: 9999999999 CO: APPLECARD GSBANK Entry Class Code: WEB,25.0,,Posted,260.68,2020-05-22,25.0,Withdrawal ACH APPLECARD GSBANK/TYPE: PAYMENT ID: 9999999999 CO: APPLECARD GSBANK Entry Class Code: WEB,25.0
5/20/2020,,Withdrawal POS #000000055188/PUBLIX 3930 SW ARCHER ROA GAINESVILLE FL Card 1140,33.59,,Posted,285.68,2020-05-20,33.59,Withdrawal POS #000000055188/PUBLIX 3930 SW ARCHER ROA GAINESVILLE FL Card 1140,33.24
5/19/2020,,Withdrawal POS #000000054642/WALGREENS STORE 2415 SW 7 GAINESVILLE FL Card 1140,8.13,,Posted,119.27,2020-05-19,8.13,Withdrawal POS #000000218861/WALGREENS STORE 2415 SW 7 GAINESVILLE FL Card 1140,7.6450000000000005
5/19/2020,,Withdrawal Debit Card Signature Debit/PIZZA HUT 27918 https://ipcha FL Date 05/17/20 0 0138366750 3 5812 Card 1140,24.34,,Posted,127.4,2020-05-19,24.34,Withdrawal Debit Card Signature Debit/PIZZA HUT 27918 https://ipcha FL Date 06/09/20 0 0161727653 4 5812 Card 1140,24.34
5/15/2020,,Withdrawal Debit Card Signature Debit/PIZZA HUT 27918 https://ipcha FL Date 05/13/20 0 0134239366 3 5812 Card 1140,29.69,,Posted,151.74,2020-05-15,29.69,Withdrawal Debit Card Signature Debit/PIZZA HUT 27918 https://ipcha FL Date 06/09/20 0 0161727653 4 5812 Card 1140,29.69
5/15/2020,,Withdrawal ACH BEST BUY/TYPE: PAYMENT ID: CITICTP CO: BEST BUY Entry Class Code: WEB,30.0,,Posted,181.43,2020-05-15,30.0,Withdrawal ACH BEST BUY/TYPE: PAYMENT ID: CITICTP CO: BEST BUY Entry Class Code: WEB,30.0
5/15/2020,,Withdrawal POS #000000093462/PUBLIX 3930 SW ARCHER ROA GAINESVILLE FL Card 1140,22.01,,Posted,211.43,2020-05-15,22.01,Withdrawal POS #000000025042/PUBLIX 3930 SW ARCHER ROA GAINESVILLE FL Card 1140,21.995
5/13/2020,201.0,Draft 201,850.0,,Posted,233.44,2020-05-13,850.0,Draft 204,850.0
5/13/2020,,Withdrawal Debit Card Signature Debit/WALGREENS #5024 GAINESVILLE FL Date 05/12/20 0 0133000668 1 5912 Card 1140,20.17,,Posted,1083.44,2020-05-13,20.17,Withdrawal Debit Card Signature Debit/WALGREENS #5024 GAINESVILLE FL Date 07/21/20 0 0203163833 1 5912 Card 1140,20.17
5/12/2020,,Withdrawal POS #000000052923/PUBLIX 3930 SW ARCHER ROA GAINESVILLE FL Card 1140,9.35,,Posted,1103.61,2020-05-12,9.35,Withdrawal POS #000000025042/PUBLIX 3930 SW ARCHER ROA GAINESVILLE FL Card 1140,9.35
5/11/2020,,Withdrawal ACH APPLECARD GSBANK/TYPE: PAYMENT ID: 9999999999 CO: APPLECARD GSBANK Entry Class Code: WEB,50.0,,Posted,1112.96,2020-05-11,50.0,Withdrawal ACH APPLECARD GSBANK/TYPE: PAYMENT ID: 9999999999 CO: APPLECARD GSBANK Entry Class Code: WEB,50.0
5/8/2020,,Withdrawal Debit Card Signature Debit/ATWIIKS REPO.PACKIX.C NJ Date 05/07/20 0 0128470400 3 5734 Card 1140,0.99,,Posted,1092.98,2020-05-08,0.99,Withdrawal Debit Card Signature Debit/ATWIIKS REPO.PACKIX.C NJ Date 05/07/20 0 0128470400 3 5734 Card 1140,0.99
5/8/2020,,Withdrawal Debit Card Signature Debit/ATWIIKS REPO.PACKIX.C NJ Date 05/07/20 0 0128470399 3 5734 Card 1140,0.99,,Posted,1093.97,2020-05-08,0.99,Withdrawal Debit Card Signature Debit/ATWIIKS REPO.PACKIX.C NJ Date 05/07/20 0 0128470400 3 5734 Card 1140,0.99
5/8/2020,,Withdrawal Debit Card Signature Debit/ATWIIKS REPO.PACKIX.C NJ Date 05/07/20 0 0128470398 3 5734 Card 1140,0.99,,Posted,1094.96,2020-05-08,0.99,Withdrawal Debit Card Signature Debit/ATWIIKS REPO.PACKIX.C NJ Date 05/07/20 0 0128470400 3 5734 Card 1140,0.99
5/7/2020,,Withdrawal at ATM #000000007007/CAMPUS 1900 SW 34TH ST GAINESVILLE FL Card 1140,100.0,,Posted,1095.95,2020-05-07,100.0,Withdrawal at ATM #000000001048/PUBLIX 3100 S W 35TH BLV GAINESVILLE FL Card 1140,100.0
5/7/2020,,Withdrawal POS #000000377629/FAST TRACK #200 3960 SW ARCHER RD GAINESVILLE FL Card 1140,23.37,,Posted,1195.95,2020-05-07,23.37,Withdrawal POS #000000224049/FAST TRACK #200 3960 SW ARCHER RD GAINESVILLE FL Card 1140,23.37
5/7/2020,,Withdrawal POS #000000076600/PUBLIX 3930 SW ARCHER ROA GAINESVILLE FL Card 1140,61.97,,Posted,1169.32,2020-05-07,61.97,Withdrawal POS #000000072679/PUBLIX 3930 SW ARCHER ROA GAINESVILLE FL Card 1140,61.97
5/6/2020,,Withdrawal Debit Card Signature Debit/UDEMY ONLINE COURSES HTTPSWWW.UDEM CA Date 05/05/20 0 0126837579 0 8299 Card 1140,39.96,,Posted,1231.29,2020-05-06,39.96,Withdrawal Debit Card Signature Debit/UDEMY ONLINE COURSES HTTPSWWW.UDEM CA Date 05/05/20 0 0126837579 0 8299 Card 1140,39.96
5/6/2020,,Withdrawal Debit Card Signature Debit/SANTAFECCOLBKSTOR #341 GAINESVILLE FL Date 05/04/20 0 0125445575 4 5942 Card 1140,39.99,,Posted,1271.25,2020-05-06,39.99,Withdrawal Debit Card Signature Debit/SANTAFECCOLBKSTOR #341 GAINESVILLE FL Date 05/04/20 0 0125445575 4 5942 Card 1140,39.99
5/6/2020,,Withdrawal Debit Card Signature Debit/SANTAFECCOLBKSTOR #341 GAINESVILLE FL Date 05/05/20 0 0126055676 3 5942 Card 1140,29.99,,Posted,1311.24,2020-05-06,29.99,Withdrawal Debit Card Signature Debit/SANTAFECCOLBKSTOR #341 GAINESVILLE FL Date 05/04/20 0 0125445575 4 5942 Card 1140,29.99
5/6/2020,,Withdrawal ACH APPLECARD GSBANK/TYPE: PAYMENT ID: 9999999999 CO: APPLECARD GSBANK Entry Class Code: WEB,50.0,,Posted,1341.23,2020-05-06,50.0,Withdrawal ACH APPLECARD GSBANK/TYPE: PAYMENT ID: 9999999999 CO: APPLECARD GSBANK Entry Class Code: WEB,50.0
5/6/2020,,Withdrawal ACH BEST BUY/TYPE: PAYMENT ID: CITICTP CO: BEST BUY Entry Class Code: WEB,50.0,,Posted,1391.23,2020-05-06,50.0,Withdrawal ACH BEST BUY/TYPE: PAYMENT ID: CITICTP CO: BEST BUY Entry Class Code: WEB,50.0
5/6/2020,,Withdrawal ACH CAPITAL ONE/TYPE: MOBILE PMT ID: 9279744980 CO: CAPITAL ONE Entry Class Code: WEB,25.0,,Posted,1441.23,2020-05-06,25.0,Withdrawal ACH CAPITAL ONE/TYPE: ONLINE PMT ID: 9279744991 CO: CAPITAL ONE Entry Class Code: WEB,25.0
5/6/2020,,Withdrawal ACH DISCOVER/TYPE: E-PAYMENT ID: 2510020270 CO: DISCOVER Entry Class Code: WEB,25.0,,Posted,1466.23,2020-05-06,25.0,Withdrawal ACH DISCOVER/TYPE: E-PAYMENT ID: 2510020270 CO: DISCOVER Entry Class Code: WEB,25.0
5/5/2020,,Withdrawal Debit Card Signature Debit/PAYPAL *BLVCKLNGS 402-935-7733 CA Date 05/04/20 0 0125395625 3 7372 Card 1140,1.5,,Posted,1491.23,2020-05-05,1.5,Withdrawal Debit Card Signature Debit/PAYPAL *DPORTAL 402-935-7733 CA Date 05/31/20 0 0152066777 2 5732 Card 1140,1.5
5/5/2020,,Withdrawal POS #000000050600/PUBLIX 3930 SW ARCHER ROA GAINESVILLE FL Card 1140,87.3,,Posted,1492.73,2020-05-05,87.3,Withdrawal POS #000000025042/PUBLIX 3930 SW ARCHER ROA GAINESVILLE FL Card 1140,87.3
5/5/2020,,Withdrawal POS #000000950863/CIRCLE K # 26146 GAINESVILLE FL Card 1140,15.46,,Posted,1580.03,2020-05-05,15.46,Withdrawal POS #000000991864/CIRCLE K # 21142 GAINESVILLE FL Card 1140,15.46
5/3/2020,,Withdrawal POS #000000090611/PUBLIX 3930 SW ARCHER ROA GAINESVILLE FL Card 1140,44.37,,Posted,1595.49,2020-05-03,44.37,Withdrawal POS #000000093462/PUBLIX 3930 SW ARCHER ROA GAINESVILLE FL Card 1140,44.37
5/1/2020,,Withdrawal POS #000000991864/CIRCLE K # 21142 GAINESVILLE FL Card 1140,13.33,,Posted,1639.86,2020-05-01,13.33,Withdrawal POS #000000991864/CIRCLE K # 21142 GAINESVILLE FL Card 1140,13.002500000000001
5/1/2020,,Withdrawal POS #000077341402/THE HOME DEPOT #0270 7107 NW 4TH BLVD GAINESVILLE FL Card 1140,138.22,,Posted,1653.19,2020-05-01,138.22,Withdrawal POS #000077341402/THE HOME DEPOT #0270 7107 NW 4TH BLVD GAINESVILLE FL Card 1140,138.22
5/1/2020,,Withdrawal Debit Card Signature Debit/PAYPAL *WALMART COM 402-935-7733 CA Date 04/30/20 0 0121193564 0 5310 Card 1140,40.46,,Posted,1791.41,2020-05-01,40.46,Withdrawal Debit Card Signature Debit/PAYPAL *WALMART COM 402-935-7733 CA Date 04/30/20 0 0121193564 0 5310 Card 1140,40.46
5/1/2020,,Withdrawal ACH APPLECARD GSBANK/TYPE: PAYMENT ID: 9999999999 CO: APPLECARD GSBANK Entry Class Code: WEB,120.01,,Posted,1831.87,2020-05-01,120.01,Withdrawal ACH APPLECARD GSBANK/TYPE: PAYMENT ID: 9999999999 CO: APPLECARD GSBANK Entry Class Code: WEB,120.01
5/1/2020,,Withdrawal ACH APPLECARD GSBANK/TYPE: PAYMENT ID: 9999999999 CO: APPLECARD GSBANK Entry Class Code: WEB,75.0,,Posted,1951.88,2020-05-01,75.0,Withdrawal ACH APPLECARD GSBANK/TYPE: PAYMENT ID: 9999999999 CO: APPLECARD GSBANK Entry Class Code: WEB,75.0
5/1/2020,,Withdrawal ACH BEST BUY/TYPE: PAYMENT ID: CITICTP CO: BEST BUY Entry Class Code: WEB,70.0,,Posted,2026.88,2020-05-01,70.0,Withdrawal ACH BEST BUY/TYPE: PAYMENT ID: CITICTP CO: BEST BUY Entry Class Code: WEB,70.0
4/30/2020,,Withdrawal POS #000000745678/CK 2726162 7302 SW ARCHER RD GAINESVILLE FL Card 1140,21.42,,Posted,2072.69,2020-04-30,21.42,Withdrawal POS #000000878396/CK 2726162 7302 SW ARCHER RD GAINESVILLE FL Card 1140,21.42
4/28/2020,,Withdrawal POS #000000037400/PUBLIX 3930 SW ARCHER ROA GAINESVILLE FL Card 1140,118.3,,Posted,94.11,2020-04-28,118.3,Withdrawal POS #000000093462/PUBLIX 3930 SW ARCHER ROA GAINESVILLE FL Card 1140,118.3
4/28/2020,,Withdrawal Debit Card Signature Debit/PIZZA HUT 27918 https://ipcha FL Date 04/27/20 0 0118821220 3 5812 Card 1140,24.34,,Posted,212.41,2020-04-28,24.34,Withdrawal Debit Card Signature Debit/PIZZA HUT 27918 https://ipcha FL Date 06/09/20 0 0161727653 4 5812 Card 1140,24.34
4/28/2020,,Withdrawal ACH CAPITAL ONE/TYPE: MOBILE PMT ID: 9279744980 CO: CAPITAL ONE Entry Class Code: WEB,50.0,,Posted,236.75,2020-04-28,50.0,Withdrawal ACH CAPITAL ONE/TYPE: ONLINE PMT ID: 9279744991 CO: CAPITAL ONE Entry Class Code: WEB,50.0
4/27/2020,,Withdrawal ACH CITY OF GAINESVI/TYPE: 2000-6637- ID: 5330903620 CO: CITY OF GAINESVI Entry Class Code: PPD,172.5,,Posted,286.75,2020-04-27,172.5,Withdrawal ACH CITY OF GAINESVI/TYPE: 2000-6637- ID: 5330903620 CO: CITY OF GAINESVI Entry Class Code: PPD,172.5
4/27/2020,,Withdrawal ACH APPLECARD GSBANK/TYPE: PAYMENT ID: 9999999999 CO: APPLECARD GSBANK Entry Class Code: WEB,125.0,,Posted,459.25,2020-04-27,125.0,Withdrawal ACH APPLECARD GSBANK/TYPE: PAYMENT ID: 9999999999 CO: APPLECARD GSBANK Entry Class Code: WEB,125.0
4/27/2020,,Withdrawal ACH COX COMM GAN/TYPE: BANK DRAFT ID: 1581620085 CO: COX COMM GAN Entry Class Code: WEB,104.75,,Posted,584.25,2020-04-27,104.75,Withdrawal ACH COX COMM GAN/TYPE: BANK DRAFT ID: 1581620085 CO: COX COMM GAN Entry Class Code: PPD,104.75
4/27/2020,,Withdrawal ACH BARCLAYCARD US/TYPE: CREDITCARD ID: 2510407970 CO: BARCLAYCARD US Entry Class Code: WEB,100.0,,Posted,689.0,2020-04-27,100.0,Withdrawal ACH BARCLAYCARD US/TYPE: CREDITCARD ID: 2510407970 CO: BARCLAYCARD US Entry Class Code: WEB,100.0
4/27/2020,,Withdrawal ACH BARCLAYCARD US/TYPE: CREDITCARD ID: 2510407970 CO: BARCLAYCARD US Entry Class Code: WEB,50.0,,Posted,789.0,2020-04-27,50.0,Withdrawal ACH BARCLAYCARD US/TYPE: CREDITCARD ID: 2510407970 CO: BARCLAYCARD US Entry Class Code: WEB,50.0
4/27/2020,,Withdrawal ACH CAPITAL ONE/TYPE: ONLINE PMT ID: 9279744991 CO: CAPITAL ONE Entry Class Code: WEB,50.0,,Posted,839.0,2020-04-27,50.0,Withdrawal ACH CAPITAL ONE/TYPE: ONLINE PMT ID: 9279744991 CO: CAPITAL ONE Entry Class Code: WEB,50.0
4/27/2020,,Withdrawal ACH APPLECARD GSBANK/TYPE: PAYMENT ID: 9999999999 CO: APPLECARD GSBANK Entry Class Code: WEB,50.0,,Posted,889.0,2020-04-27,50.0,Withdrawal ACH APPLECARD GSBANK/TYPE: PAYMENT ID: 9999999999 CO: APPLECARD GSBANK Entry Class Code: WEB,50.0
4/26/2020,,Withdrawal POS #000000437977/LOWE'S #3278 GAINESVILLE FL Card 1140,37.41,,Posted,939.0,2020-04-26,37.41,Withdrawal POS #000000501613/LOWE'S #3278 GAINESVILLE FLCard 1140,37.41
4/26/2020,,Withdrawal POS #000000469967/FAST TRACK #200 3960 SW ARCHER RD GAINESVILLE FL Card 1140,28.55,,Posted,976.41,2020-04-26,28.55,Withdrawal POS #000000224049/FAST TRACK #200 3960 SW ARCHER RD GAINESVILLE FL Card 1140,28.55
4/26/2020,,Withdrawal POS #000000058031/PUBLIX 3930 SW ARCHER ROA GAINESVILLE FL Card 1140,78.61,,Posted,1004.96,2020-04-26,78.61,Withdrawal POS #000000025042/PUBLIX 3930 SW ARCHER ROA GAINESVILLE FL Card 1140,78.61
4/26/2020,,Withdrawal POS #000000259790/LOWE'S #3278 GAINESVILLE FL Card 1140,45.09,,Posted,1083.57,2020-04-26,45.09,Withdrawal POS #000000501613/LOWE'S #3278 GAINESVILLE FLCard 1140,45.09
4/26/2020,,Withdrawal POS #000000310156/WALGREENS STORE 2415 SW 7 GAINESVILLE FL Card 1140,23.51,,Posted,1128.66,2020-04-26,23.51,Withdrawal POS #000000218861/WALGREENS STORE 2415 SW 7 GAINESVILLE FL Card 1140,23.965000000000003
4/26/2020,,Withdrawal at ATM #000000006206/CAMPUS 1900 SW 34TH ST GAINESVILLE FL Card 1140,60.0,,Posted,1152.17,2020-04-26,60.0,Withdrawal at ATM #000000001048/PUBLIX 3100 S W 35TH BLV GAINESVILLE FL Card 1140,60.0
4/22/2020,,Withdrawal POS #000000458124/WALGREENS STORE 2415 SW 7 GAINESVILLE FL Card 1140,7.16,,Posted,7.19,2020-04-22,7.16,Withdrawal POS #000000218861/WALGREENS STORE 2415 SW 7 GAINESVILLE FL Card 1140,7.6450000000000005
4/20/2020,,Withdrawal Debit Card Signature Debit/SANTA FE COLLEGE 352-395-5228 FL Date 04/19/20 0 0110242139 0 8220 Card 1140,23.77,,Posted,14.35,2020-04-20,23.77,Withdrawal Debit Card Signature Debit/SANTA FE COLLEGE 352-395-5228 FL Date 04/19/20 0 0110242139 0 8220 Card 1140,23.77
4/19/2020,,Withdrawal POS #000000077627/PUBLIX 3930 SW ARCHER ROA GAINESVILLE FL Card 1140,42.44,,Posted,38.12,2020-04-19,42.44,Withdrawal POS #000000093462/PUBLIX 3930 SW ARCHER ROA GAINESVILLE FL Card 1140,42.44
4/19/2020,,Withdrawal at ATM #000000005892/CAMPUS 1900 SW 34TH ST GAINESVILLE FL Card 1140,60.0,,Posted,80.56,2020-04-19,60.0,Withdrawal at ATM #000000001048/PUBLIX 3100 S W 35TH BLV GAINESVILLE FL Card 1140,60.0
4/14/2020,,Withdrawal POS #000000145275/WALGREENS STORE 2415 SW 7 GAINESVILLE FL Card 1140,8.41,,Posted,140.56,2020-04-14,8.41,Withdrawal POS #000000218861/WALGREENS STORE 2415 SW 7 GAINESVILLE FL Card 1140,8.316666666666666
4/14/2020,,Withdrawal ACH CAPITAL ONE/TYPE: MOBILE PMT ID: 9279744980 CO: CAPITAL ONE Entry Class Code: WEB,25.0,,Posted,148.97,2020-04-14,25.0,Withdrawal ACH CAPITAL ONE/TYPE: ONLINE PMT ID: 9279744991 CO: CAPITAL ONE Entry Class Code: WEB,25.0
4/14/2020,,Withdrawal ACH BARCLAYCARD US/TYPE: CREDITCARD ID: 2510407970 CO: BARCLAYCARD US Entry Class Code: WEB,25.0,,Posted,173.97,2020-04-14,25.0,Withdrawal ACH BARCLAYCARD US/TYPE: CREDITCARD ID: 2510407970 CO: BARCLAYCARD US Entry Class Code: WEB,25.0
4/13/2020,200.0,Draft 200,850.0,,Posted,198.97,2020-04-13,850.0,Draft 204,850.0
4/10/2020,,Withdrawal POS #000000053693/PUBLIX 3930 SW ARCHER ROA GAINESVILLE FL Card 1140,112.41,,Posted,1048.97,2020-04-10,112.41,Withdrawal POS #000000093462/PUBLIX 3930 SW ARCHER ROA GAINESVILLE FL Card 1140,112.41
4/10/2020,,Withdrawal ACH COX COMM GAN/TYPE: BANK DRAFT ID: 1581620085 CO: COX COMM GAN Entry Class Code: PPD,220.62,,Posted,1161.38,2020-04-10,220.62,Withdrawal ACH COX COMM GAN/TYPE: BANK DRAFT ID: 1581620085 CO: COX COMM GAN Entry Class Code: PPD,220.62
4/8/2020,,Withdrawal Home Banking Transfer/To CAMPUS Q2 PREFUN 3440431 Share 0090 External Transfer Tracking ID:5092308,25.0,,Posted,1382.0,2020-04-08,25.0,Withdrawal Home Banking Transfer/To CAMPUS Q2 PREFUN 3440431 Share 0090 External Transfer Tracking ID:5092308,25.0
4/6/2020,,Withdrawal POS #000000072049/PUBLIX 3930 SW ARCHER ROA GAINESVILLE FL Card 1140,37.18,,Posted,1407.0,2020-04-06,37.18,Withdrawal POS #000000025042/PUBLIX 3930 SW ARCHER ROA GAINESVILLE FL Card 1140,37.46
3/31/2020,,Withdrawal POS #000000889937/CIRCLE K # 26146 GAINESVILLE FL Card 1140,20.0,,Posted,1444.18,2020-03-31,20.0,Withdrawal POS #000000991864/CIRCLE K # 21142 GAINESVILLE FL Card 1140,19.643333333333334
3/30/2020,,Withdrawal ACH CITY OF GAINESVI/TYPE: 2000-6637- ID: 5330903620 CO: CITY OF GAINESVI Entry Class Code: PPD,179.59,,Posted,1464.18,2020-03-30,179.59,Withdrawal ACH CITY OF GAINESVI/TYPE: 2000-6637- ID: 5330903620 CO: CITY OF GAINESVI Entry Class Code: PPD,179.59
3/30/2020,,Withdrawal ACH CAPITAL ONE/TYPE: ONLINE PMT ID: 9279744991 CO: CAPITAL ONE Entry Class Code: WEB,75.0,,Posted,1643.77,2020-03-30,75.0,Withdrawal ACH CAPITAL ONE/TYPE: ONLINE PMT ID: 9279744991 CO: CAPITAL ONE Entry Class Code: WEB,75.0
3/30/2020,,Withdrawal ACH BARCLAYCARD US/TYPE: CREDITCARD ID: 2510407970 CO: BARCLAYCARD US Entry Class Code: WEB,75.0,,Posted,1718.77,2020-03-30,75.0,Withdrawal ACH BARCLAYCARD US/TYPE: CREDITCARD ID: 2510407970 CO: BARCLAYCARD US Entry Class Code: WEB,75.0
3/30/2020,,Withdrawal ACH APPLECARD GSBANK/TYPE: PAYMENT ID: 9999999999 CO: APPLECARD GSBANK Entry Class Code: WEB,70.0,,Posted,1793.77,2020-03-30,70.0,Withdrawal ACH APPLECARD GSBANK/TYPE: PAYMENT ID: 9999999999 CO: APPLECARD GSBANK Entry Class Code: WEB,70.0
3/29/2020,,Withdrawal POS #000000104100/PUBLIX 3930 SW ARCHER ROA GAINESVILLE FL Card 1140,165.82,,Posted,1863.77,2020-03-29,165.82,Withdrawal POS #000000091710/PUBLIX 3930 SW ARCHER ROA GAINESVILLE FL Card 1140,165.82
3/27/2020,,Withdrawal at ATM #000000004105/CAMPUS 1900 SW 34TH ST GAINESVILLE FL Card 1140,40.0,,Posted,29.59,2020-03-27,40.0,Withdrawal at ATM #000000001048/PUBLIX 3100 S W 35TH BLV GAINESVILLE FL Card 1140,40.0
3/21/2020,,Withdrawal POS #000000068262/PUBLIX 3930 SW ARCHER ROA GAINESVILLE FL Card 1140,21.98,,Posted,9.59,2020-03-21,21.98,Withdrawal POS #000000025042/PUBLIX 3930 SW ARCHER ROA GAINESVILLE FL Card 1140,21.995
3/20/2020,,Withdrawal POS #000000102982/PUBLIX 3930 SW ARCHER ROA GAINESVILLE FL Card 1140,43.0,,Posted,17.97,2020-03-20,43.0,Withdrawal POS #000000025042/PUBLIX 3930 SW ARCHER ROA GAINESVILLE FL Card 1140,43.0
3/20/2020,,Withdrawal POS #000000443789/SHELL SERVICE STATION 3901 SW ARCHER RD GAINESVILLE FL Card 1140,2.96,,Posted,60.97,2020-03-20,2.96,Withdrawal POS #000000443789/SHELL SERVICE STATION 3901 SW ARCHER RD GAINESVILLE FL Card 1140,2.96
3/19/2020,,Withdrawal POS #000000067778/PUBLIX 3930 SW ARCHER ROA GAINESVILLE FL Card 1140,8.56,,Posted,63.93,2020-03-19,8.56,Withdrawal POS #000000072679/PUBLIX 3930 SW ARCHER ROA GAINESVILLE FL Card 1140,8.56
3/18/2020,,Withdrawal POS #000000067229/PUBLIX 3930 SW ARCHER ROA GAINESVILLE FL Card 1140,38.84,,Posted,72.49,2020-03-18,38.84,Withdrawal POS #000000025042/PUBLIX 3930 SW ARCHER ROA GAINESVILLE FL Card 1140,38.84
3/18/2020,,Withdrawal ACH APPLECARD GSBANK/TYPE: PAYMENT ID: 9999999999 CO: APPLECARD GSBANK Entry Class Code: WEB,145.01,,Posted,111.33,2020-03-18,145.01,Withdrawal ACH APPLECARD GSBANK/TYPE: PAYMENT ID: 9999999999 CO: APPLECARD GSBANK Entry Class Code: WEB,145.01
3/18/2020,,Withdrawal ACH BARCLAYCARD US/TYPE: CREDITCARD ID: 2510407970 CO: BARCLAYCARD US Entry Class Code: WEB,75.0,,Posted,256.34,2020-03-18,75.0,Withdrawal ACH BARCLAYCARD US/TYPE: CREDITCARD ID: 2510407970 CO: BARCLAYCARD US Entry Class Code: WEB,75.0
3/18/2020,,Withdrawal Home Banking Transfer - To Share 0000/Funds Transfer via Online,15.0,,Posted,281.34,2020-03-18,15.0,Withdrawal Home Banking Transfer - To Share 0000/Funds Transfer via Online,15.0
3/17/2020,,Withdrawal POS #000000014434/PUBLIX 3930 SW ARCHER ROA GAINESVILLE FL Card 1140,50.07,,Posted,296.34,2020-03-17,50.07,Withdrawal POS #000000093462/PUBLIX 3930 SW ARCHER ROA GAINESVILLE FL Card 1140,50.07
3/17/2020,,Withdrawal Debit Card Signature Debit/QUINN EYE CENTER GAINESVILLE FL Date 03/16/20 0 0076666354 1 8042 Card 1140,46.2,,Posted,346.41,2020-03-17,46.2,Withdrawal Debit Card Signature Debit/QUINN EYE CENTER GAINESVILLE FL Date 03/16/20 0 0076666354 1 8042 Card 1140,46.2
3/17/2020,,Withdrawal POS #000000305060/WALGREENS STORE 2415 SW 7 GAINESVILLE FL Card 1140,8.2,,Posted,392.61,2020-03-17,8.2,Withdrawal POS #000000218861/WALGREENS STORE 2415 SW 7 GAINESVILLE FL Card 1140,8.316666666666666
3/16/2020,,Withdrawal POS #000000042897/FAST TRACK #200 3960 SW ARCHER RD GAINESVILLE FL Card 1140,9.63,,Posted,400.81,2020-03-16,9.63,Withdrawal POS #000000224049/FAST TRACK #200 3960 SW ARCHER RD GAINESVILLE FL Card 1140,9.63
3/16/2020,,Withdrawal POS #000000074536/PUBLIX 3930 SW ARCHER ROA GAINESVILLE FL Card 1140,11.14,,Posted,410.44,2020-03-16,11.14,Withdrawal POS #000000093462/PUBLIX 3930 SW ARCHER ROA GAINESVILLE FL Card 1140,11.14
3/15/2020,,Withdrawal POS #000000086755/PUBLIX 3930 SW ARCHER ROA GAINESVILLE FL Card 1140,42.57,,Posted,421.58,2020-03-15,42.57,Withdrawal POS #000000055188/PUBLIX 3930 SW ARCHER ROA GAINESVILLE FL Card 1140,42.57
3/10/2020,9002.0,Draft 9002,850.0,,Posted,464.15,2020-03-10,850.0,Draft 9002,850.0
3/10/2020,,Withdrawal ACH BARCLAYCARD US/TYPE: CREDITCARD ID: 2510407970 CO: BARCLAYCARD US Entry Class Code: WEB,55.0,,Posted,1314.15,2020-03-10,55.0,Withdrawal ACH BARCLAYCARD US/TYPE: CREDITCARD ID: 2510407970 CO: BARCLAYCARD US Entry Class Code: WEB,55.0
3/10/2020,,Withdrawal POS #000000047058/PUBLIX 3930 SW ARCHER ROA GAINESVILLE FL Card 1140,35.58,,Posted,1369.15,2020-03-10,35.58,Withdrawal POS #000000055188/PUBLIX 3930 SW ARCHER ROA GAINESVILLE FL Card 1140,35.58
3/9/2020,,Withdrawal POS #000000849438/CIRCLE K # 21424 GAINESVILLE FL Card 1140,12.83,,Posted,1404.73,2020-03-09,12.83,Withdrawal POS #000000991864/CIRCLE K # 21142 GAINESVILLE FL Card 1140,13.002500000000001
3/9/2020,,Withdrawal POS #000000675592/CIRCLE K # 21416 GAINESVILLE FL Card 1140,12.55,,Posted,1417.56,2020-03-09,12.55,Withdrawal POS #000000991864/CIRCLE K # 21142 GAINESVILLE FL Card 1140,13.002500000000001
3/6/2020,,Withdrawal POS #000000049935/PUBLIX 3100 SW 35TH BLVD GAINESVILLE FL Card 1140,23.12,,Posted,1229.11,2020-03-06,23.12,Withdrawal at ATM #000000001048/PUBLIX 3100 S W 35TH BLV GAINESVILLE FL Card 1140,23.12
3/6/2020,,Withdrawal at ATM #000000001048/PUBLIX 3100 S W 35TH BLV GAINESVILLE FL Card 1140,40.0,,Posted,1252.23,2020-03-06,40.0,Withdrawal at ATM #000000001048/PUBLIX 3100 S W 35TH BLV GAINESVILLE FL Card 1140,40.0
3/6/2020,,Withdrawal Debit Card Signature Debit/NINTENDO *AMERICAUS 800-255-3700 WA Date 03/05/20 0 0065438354 5 5816 Card 1140,4.99,,Posted,1292.23,2020-03-06,4.99,Withdrawal Debit Card Signature Debit/NINTENDO *AMERICAUS 800-255-3700 WA Date 03/05/20 0 0065438354 5 5816 Card 1140,4.49
3/5/2020,,Withdrawal Debit Card Signature Debit/NINTENDO *AMERICAUS 800-255-3700 WA Date 03/04/20 0 0064424011 5 5816 Card 1140,0.2,,Posted,1297.22,2020-03-05,0.2,Withdrawal Debit Card Signature Debit/NINTENDO *AMERICAUS 800-255-3700 WA Date 03/05/20 0 0065438354 5 5816 Card 1140,0.335
3/5/2020,,Withdrawal Debit Card Signature Debit/NINTENDO *AMERICAUS 800-255-3700 WA Date 03/04/20 0 0064421006 5 5816 Card 1140,0.1,,Posted,1297.42,2020-03-05,0.1,Withdrawal Debit Card Signature Debit/NINTENDO *AMERICAUS 800-255-3700 WA Date 03/05/20 0 0065438354 5 5816 Card 1140,0.335
3/5/2020,,Withdrawal Debit Card Signature Debit/NINTENDO *AMERICAUS 800-255-3700 WA Date 03/04/20 0 0064420629 5 5816 Card 1140,0.99,,Posted,1297.52,2020-03-05,0.99,Withdrawal Debit Card Signature Debit/NINTENDO *AMERICAUS 800-255-3700 WA Date 03/05/20 0 0065438354 5 5816 Card 1140,0.335
3/5/2020,,Withdrawal Debit Card Signature Debit/NINTENDO *AMERICAUS 800-255-3700 WA Date 03/04/20 0 0064420412 5 5816 Card 1140,3.99,,Posted,1298.51,2020-03-05,3.99,Withdrawal Debit Card Signature Debit/NINTENDO *AMERICAUS 800-255-3700 WA Date 03/05/20 0 0065438354 5 5816 Card 1140,4.49
3/5/2020,,Withdrawal Debit Card Signature Debit/NINTENDO *AMERICAUS 800-255-3700 WA Date 03/04/20 0 0064419245 5 5816 Card 1140,0.05,,Posted,1302.5,2020-03-05,0.05,Withdrawal Debit Card Signature Debit/NINTENDO *AMERICAUS 800-255-3700 WA Date 03/05/20 0 0065438354 5 5816 Card 1140,0.335
3/4/2020,,Withdrawal ACH APPLECARD GSBANK/TYPE: PAYMENT ID: 9999999999 CO: APPLECARD GSBANK Entry Class Code: WEB,70.0,,Posted,1302.55,2020-03-04,70.0,Withdrawal ACH APPLECARD GSBANK/TYPE: PAYMENT ID: 9999999999 CO: APPLECARD GSBANK Entry Class Code: WEB,70.0
3/4/2020,,Withdrawal POS #000000606847/WM SUPERCENTER # Wal-Mart Super Cen GAINESVILLE FL Card 1140,13.84,,Posted,1372.55,2020-03-04,13.84,Withdrawal POS #000000606847/WM SUPERCENTER # Wal-Mart Super Cen GAINESVILLE FL Card 1140,13.84
3/4/2020,,Withdrawal POS #000045757032/Wal-Mart Super Center 0538 WAL-SAMS GAINESVILLE FL Card 1140,7.37,,Posted,1386.39,2020-03-04,7.37,Withdrawal POS #000045757032/Wal-Mart Super Center 0538 WAL-SAMS GAINESVILLE FL Card 1140,7.37
3/2/2020,,Withdrawal ACH CITY OF GAINESVI/TYPE: 2000-6637- ID: 5330903620 CO: CITY OF GAINESVI Entry Class Code: PPD,166.52,,Posted,1393.76,2020-03-02,166.52,Withdrawal ACH CITY OF GAINESVI/TYPE: 2000-6637- ID: 5330903620 CO: CITY OF GAINESVI Entry Class Code: PPD,166.52
3/2/2020,,Withdrawal ACH BARCLAYCARD US/TYPE: CREDITCARD ID: 2510407970 CO: BARCLAYCARD US Entry Class Code: WEB,100.0,,Posted,1560.28,2020-03-02,100.0,Withdrawal ACH BARCLAYCARD US/TYPE: CREDITCARD ID: 2510407970 CO: BARCLAYCARD US Entry Class Code: WEB,100.0
3/2/2020,,Withdrawal ACH COX COMM GAN/TYPE: BANK DRAFT ID: 1581620085 CO: COX COMM GAN Entry Class Code: WEB,70.75,,Posted,1660.28,2020-03-02,70.75,Withdrawal ACH COX COMM GAN/TYPE: BANK DRAFT ID: 1581620085 CO: COX COMM GAN Entry Class Code: PPD,70.75
3/2/2020,,Withdrawal ATM Fee/GAINESVILLE OFFICE GAINESVILLE FL Card 1140,2.0,,Posted,1731.03,2020-03-02,2.0,Withdrawal ATM Fee/GAINESVILLE OFFICE GAINESVILLE FL Card 1140,2.0
3/2/2020,,Withdrawal at ATM #000000048468/GAINESVILLE OFFICE GAINESVILLE FL Card 1140,83.5,,Posted,1733.03,2020-03-02,83.5,Withdrawal at ATM #000000048468/GAINESVILLE OFFICE GAINESVILLE FL Card 1140,83.5
2/29/2020,,Withdrawal Paper Statement,3.0,,Posted,1816.53,2020-02-29,3.0,Withdrawal Paper Statement,3.0
2/29/2020,,Withdrawal POS #000000062005/PUBLIX 3930 SW ARCHER ROA GAINESVILLE FL Card 1140,54.53,,Posted,1819.53,2020-02-29,54.53,Withdrawal POS #000000025042/PUBLIX 3930 SW ARCHER ROA GAINESVILLE FL Card 1140,54.09
2/29/2020,,Withdrawal POS #000000464148/WALGREENS STORE 2415 SW 7 GAINESVILLE FL Card 1140,24.42,,Posted,-0.94,2020-02-29,24.42,Withdrawal POS #000000218861/WALGREENS STORE 2415 SW 7 GAINESVILLE FL Card 1140,23.965000000000003
2/29/2020,,Withdrawal Transfer fee,8.0,,Posted,23.48,2020-02-29,8.0,Withdrawal Transfer fee,8.0
2/26/2020,,Withdrawal POS #000000061033/PUBLIX 3930 SW ARCHER ROA GAINESVILLE FL Card 1140,9.72,,Posted,16.48,2020-02-26,9.72,Withdrawal POS #000000091710/PUBLIX 3930 SW ARCHER ROA GAINESVILLE FL Card 1140,9.72
2/25/2020,,Withdrawal POS #000000060748/WALGREENS STORE 2415 SW 7 GAINESVILLE FL Card 1140,7.16,,Posted,26.2,2020-02-25,7.16,Withdrawal POS #000000218861/WALGREENS STORE 2415 SW 7 GAINESVILLE FL Card 1140,7.6450000000000005
2/24/2020,,Withdrawal POS #000000035648/PUBLIX 3930 SW ARCHER ROA GAINESVILLE FL Card 1140,35.82,,Posted,33.36,2020-02-24,35.82,Withdrawal POS #000000025042/PUBLIX 3930 SW ARCHER ROA GAINESVILLE FL Card 1140,35.82
2/21/2020,,Withdrawal POS #000000044670/PUBLIX 3930 SW ARCHER ROA GAINESVILLE FL Card 1140,23.04,,Posted,69.18,2020-02-21,23.04,Withdrawal POS #000000091710/PUBLIX 3930 SW ARCHER ROA GAINESVILLE FL Card 1140,23.04
2/20/2020,,Withdrawal POS #000000035137/PUBLIX 3930 SW ARCHER ROA GAINESVILLE FL Card 1140,32.89,,Posted,92.22,2020-02-20,32.89,Withdrawal POS #000000055188/PUBLIX 3930 SW ARCHER ROA GAINESVILLE FL Card 1140,33.24
2/18/2020,,Withdrawal POS #000000136480/WALGREENS STORE 2415 SW 7 GAINESVILLE FL Card 1140,10.49,,Posted,125.11,2020-02-18,10.49,Withdrawal POS #000000218861/WALGREENS STORE 2415 SW 7 GAINESVILLE FL Card 1140,10.49
2/18/2020,,Withdrawal POS #000000025042/PUBLIX 3930 SW ARCHER ROA GAINESVILLE FL Card 1140,45.39,,Posted,135.6,2020-02-18,45.39,Withdrawal POS #000000025042/PUBLIX 3930 SW ARCHER ROA GAINESVILLE FL Card 1140,45.39
2/13/2020,,Withdrawal POS #000000073698/PUBLIX 3930 SW ARCHER ROA GAINESVILLE FL Card 1140,45.01,,Posted,180.99,2020-02-13,45.01,Withdrawal POS #000000072679/PUBLIX 3930 SW ARCHER ROA GAINESVILLE FL Card 1140,45.01
2/11/2020,,Withdrawal Home Banking Transfer - To Share 0000/Funds Transfer via Online,15.0,,Posted,226.0,2020-02-11,15.0,Withdrawal Home Banking Transfer - To Share 0000/Funds Transfer via Online,15.0
2/10/2020,,Withdrawal Starter Checks,3.0,,Posted,241.0,2020-02-10,3.0,Withdrawal Starter Checks,3.0
1/31/2020,,Withdrawal Paper Statement,3.0,,Posted,44.0,2020-01-31,3.0,Withdrawal Paper Statement,3.0
12/31/2019,,Withdrawal Paper Statement,3.0,,Posted,47.0,2019-12-31,3.0,Withdrawal Paper Statement,3.0
